state_residence,district_residence,Date,new_case,negative_case,Failed_test,Total_test
ANDAMAN AND NICOBAR ISLANDS,NICOBARS,2021-03-11,1,19,0,20
ANDAMAN AND NICOBAR ISLANDS,NICOBARS,2021-03-12,0,8,0,8
ANDAMAN AND NICOBAR ISLANDS,NICOBARS,2021-03-13,0,13,0,13
ANDAMAN AND NICOBAR ISLANDS,NICOBARS,2021-03-14,1,15,0,16
ANDAMAN AND NICOBAR ISLANDS,NICOBARS,2021-03-15,0,4,0,4
ANDAMAN AND NICOBAR ISLANDS,NORTH AND MIDDLE ANDAMAN,2021-03-11,0,19,0,19
ANDAMAN AND NICOBAR ISLANDS,NORTH AND MIDDLE ANDAMAN,2021-03-12,0,9,0,9
ANDAMAN AND NICOBAR ISLANDS,NORTH AND MIDDLE ANDAMAN,2021-03-13,0,5,0,5
ANDAMAN AND NICOBAR ISLANDS,NORTH AND MIDDLE ANDAMAN,2021-03-14,0,14,0,14
ANDAMAN AND NICOBAR ISLANDS,NORTH AND MIDDLE ANDAMAN,2021-03-15,0,9,0,9
ANDAMAN AND NICOBAR ISLANDS,SOUTH ANDAMANS,2021-03-11,4,281,0,285
ANDAMAN AND NICOBAR ISLANDS,SOUTH ANDAMANS,2021-03-12,2,405,2,409
ANDAMAN AND NICOBAR ISLANDS,SOUTH ANDAMANS,2021-03-13,0,375,2,377
ANDAMAN AND NICOBAR ISLANDS,SOUTH ANDAMANS,2021-03-14,0,45,1,46
ANDAMAN AND NICOBAR ISLANDS,SOUTH ANDAMANS,2021-03-15,0,388,0,388
ANDHRA PRADESH,ANANTAPUR,2021-03-11,11,4501,0,4512
ANDHRA PRADESH,ANANTAPUR,2021-03-12,10,3527,2,3539
ANDHRA PRADESH,ANANTAPUR,2021-03-13,6,3245,1,3252
ANDHRA PRADESH,ANANTAPUR,2021-03-14,19,2526,0,2545
ANDHRA PRADESH,ANANTAPUR,2021-03-15,30,2171,1,2202
ANDHRA PRADESH,CHITTOOR,2021-03-11,85,3694,0,3779
ANDHRA PRADESH,CHITTOOR,2021-03-12,43,4026,0,4069
ANDHRA PRADESH,CHITTOOR,2021-03-13,92,3124,1,3217
ANDHRA PRADESH,CHITTOOR,2021-03-14,47,2231,0,2278
ANDHRA PRADESH,CHITTOOR,2021-03-15,58,4183,1,4242
ANDHRA PRADESH,EAST GODAVARI,2021-03-11,51,2295,0,2346
ANDHRA PRADESH,EAST GODAVARI,2021-03-12,25,962,0,987
ANDHRA PRADESH,EAST GODAVARI,2021-03-13,36,715,0,751
ANDHRA PRADESH,EAST GODAVARI,2021-03-14,30,6201,0,6231
ANDHRA PRADESH,EAST GODAVARI,2021-03-15,32,2961,1,2994
ANDHRA PRADESH,GUNTUR,2021-03-11,20,2880,0,2900
ANDHRA PRADESH,GUNTUR,2021-03-12,15,1043,1,1059
ANDHRA PRADESH,GUNTUR,2021-03-13,35,2136,0,2171
ANDHRA PRADESH,GUNTUR,2021-03-14,36,1720,1,1757
ANDHRA PRADESH,GUNTUR,2021-03-15,44,1529,0,1573
ANDHRA PRADESH,KRISHNA,2021-03-11,11,3836,0,3847
ANDHRA PRADESH,KRISHNA,2021-03-12,40,1802,1,1843
ANDHRA PRADESH,KRISHNA,2021-03-13,31,1842,0,1873
ANDHRA PRADESH,KRISHNA,2021-03-14,19,5532,0,5551
ANDHRA PRADESH,KRISHNA,2021-03-15,41,5987,0,6028
ANDHRA PRADESH,KURNOOL,2021-03-11,4,4268,0,4272
ANDHRA PRADESH,KURNOOL,2021-03-12,1,2072,0,2073
ANDHRA PRADESH,KURNOOL,2021-03-13,16,3452,0,3468
ANDHRA PRADESH,KURNOOL,2021-03-14,5,537,0,542
ANDHRA PRADESH,KURNOOL,2021-03-15,21,2579,1,2601
ANDHRA PRADESH,PRAKASAM,2021-03-11,2,6861,0,6863
ANDHRA PRADESH,PRAKASAM,2021-03-12,8,2803,0,2811
ANDHRA PRADESH,PRAKASAM,2021-03-13,14,4261,0,4275
ANDHRA PRADESH,PRAKASAM,2021-03-14,11,3607,0,3618
ANDHRA PRADESH,PRAKASAM,2021-03-15,8,2962,0,2970
ANDHRA PRADESH,SPSR NELLORE,2021-03-11,4,2215,0,2219
ANDHRA PRADESH,SPSR NELLORE,2021-03-12,8,4630,0,4638
ANDHRA PRADESH,SPSR NELLORE,2021-03-13,7,2693,0,2700
ANDHRA PRADESH,SPSR NELLORE,2021-03-14,9,2105,0,2114
ANDHRA PRADESH,SPSR NELLORE,2021-03-15,11,2247,0,2258
ANDHRA PRADESH,SRIKAKULAM,2021-03-11,10,3944,0,3954
ANDHRA PRADESH,SRIKAKULAM,2021-03-12,5,2321,0,2326
ANDHRA PRADESH,SRIKAKULAM,2021-03-13,9,3300,0,3309
ANDHRA PRADESH,SRIKAKULAM,2021-03-14,8,3121,0,3129
ANDHRA PRADESH,SRIKAKULAM,2021-03-15,7,9897,0,9904
ANDHRA PRADESH,VISAKHAPATANAM,2021-03-11,26,741,0,767
ANDHRA PRADESH,VISAKHAPATANAM,2021-03-12,41,2329,1,2371
ANDHRA PRADESH,VISAKHAPATANAM,2021-03-13,59,3723,0,3782
ANDHRA PRADESH,VISAKHAPATANAM,2021-03-14,24,609,0,633
ANDHRA PRADESH,VISAKHAPATANAM,2021-03-15,59,2304,0,2363
ANDHRA PRADESH,VIZIANAGARAM,2021-03-11,2,1501,0,1503
ANDHRA PRADESH,VIZIANAGARAM,2021-03-12,6,1433,0,1439
ANDHRA PRADESH,VIZIANAGARAM,2021-03-13,3,2124,0,2127
ANDHRA PRADESH,VIZIANAGARAM,2021-03-14,2,117,0,119
ANDHRA PRADESH,VIZIANAGARAM,2021-03-15,0,2068,0,2068
ANDHRA PRADESH,WEST GODAVARI,2021-03-11,10,1602,0,1612
ANDHRA PRADESH,WEST GODAVARI,2021-03-12,5,2610,0,2615
ANDHRA PRADESH,WEST GODAVARI,2021-03-13,10,629,0,639
ANDHRA PRADESH,WEST GODAVARI,2021-03-14,3,654,0,657
ANDHRA PRADESH,WEST GODAVARI,2021-03-15,3,2574,0,2577
ANDHRA PRADESH,Y.S.R.,2021-03-11,5,3695,0,3700
ANDHRA PRADESH,Y.S.R.,2021-03-12,7,2424,0,2431
ANDHRA PRADESH,Y.S.R.,2021-03-13,18,3970,1,3989
ANDHRA PRADESH,Y.S.R.,2021-03-14,11,3826,0,3837
ANDHRA PRADESH,Y.S.R.,2021-03-15,14,1621,0,1635
ARUNACHAL PRADESH,ANJAW,2021-03-11,0,11,0,11
ARUNACHAL PRADESH,ANJAW,2021-03-12,0,7,0,7
ARUNACHAL PRADESH,ANJAW,2021-03-13,0,6,0,6
ARUNACHAL PRADESH,ANJAW,2021-03-14,0,3,0,3
ARUNACHAL PRADESH,ANJAW,2021-03-15,0,14,0,14
ARUNACHAL PRADESH,CHANGLANG,2021-03-11,0,3,0,3
ARUNACHAL PRADESH,CHANGLANG,2021-03-12,0,1,0,1
ARUNACHAL PRADESH,CHANGLANG,2021-03-15,0,1,0,1
ARUNACHAL PRADESH,DIBANG VALLEY,2021-03-11,0,2,0,2
ARUNACHAL PRADESH,DIBANG VALLEY,2021-03-12,0,3,0,3
ARUNACHAL PRADESH,DIBANG VALLEY,2021-03-15,0,1,0,1
ARUNACHAL PRADESH,EAST KAMENG,2021-03-13,0,3,0,3
ARUNACHAL PRADESH,EAST SIANG,2021-03-11,0,25,0,25
ARUNACHAL PRADESH,EAST SIANG,2021-03-12,0,14,0,14
ARUNACHAL PRADESH,EAST SIANG,2021-03-13,0,11,0,11
ARUNACHAL PRADESH,EAST SIANG,2021-03-15,0,27,0,27
ARUNACHAL PRADESH,KAMLE,2021-03-11,0,2,0,2
ARUNACHAL PRADESH,KRA  DAADI,2021-03-14,0,1,0,1
ARUNACHAL PRADESH,KRA  DAADI,2021-03-15,0,1,0,1
ARUNACHAL PRADESH,KURUNG KUMEY,2021-03-12,0,3,0,3
ARUNACHAL PRADESH,KURUNG KUMEY,2021-03-15,0,1,0,1
ARUNACHAL PRADESH,LEPARADA,2021-03-11,15,0,0,15
ARUNACHAL PRADESH,LEPARADA,2021-03-12,6,0,0,6
ARUNACHAL PRADESH,LEPARADA,2021-03-13,1,0,0,1
ARUNACHAL PRADESH,LEPARADA,2021-03-14,3,0,0,3
ARUNACHAL PRADESH,LOHIT,2021-03-11,0,2,0,2
ARUNACHAL PRADESH,LOHIT,2021-03-12,0,4,0,4
ARUNACHAL PRADESH,LOHIT,2021-03-13,0,1,0,1
ARUNACHAL PRADESH,LOHIT,2021-03-15,0,1,0,1
ARUNACHAL PRADESH,LONGDING,2021-03-15,0,1,0,1
ARUNACHAL PRADESH,LOWER DIBANG VALLEY,2021-03-12,1,0,0,1
ARUNACHAL PRADESH,LOWER DIBANG VALLEY,2021-03-13,0,1,0,1
ARUNACHAL PRADESH,LOWER SIANG,2021-03-11,0,9,0,9
ARUNACHAL PRADESH,LOWER SIANG,2021-03-12,0,6,0,6
ARUNACHAL PRADESH,LOWER SIANG,2021-03-13,0,11,2,13
ARUNACHAL PRADESH,LOWER SIANG,2021-03-15,0,10,0,10
ARUNACHAL PRADESH,LOWER SUBANSIRI,2021-03-11,0,8,0,8
ARUNACHAL PRADESH,LOWER SUBANSIRI,2021-03-12,0,2,0,2
ARUNACHAL PRADESH,LOWER SUBANSIRI,2021-03-13,0,22,0,22
ARUNACHAL PRADESH,LOWER SUBANSIRI,2021-03-15,0,12,0,12
ARUNACHAL PRADESH,NAMSAI,2021-03-14,0,1,0,1
ARUNACHAL PRADESH,NAMSAI,2021-03-15,1,1,0,2
ARUNACHAL PRADESH,PAKKE KESSANG,2021-03-15,0,2,0,2
ARUNACHAL PRADESH,PAPUM PARE,2021-03-11,0,49,0,49
ARUNACHAL PRADESH,PAPUM PARE,2021-03-12,0,17,0,17
ARUNACHAL PRADESH,PAPUM PARE,2021-03-13,0,11,0,11
ARUNACHAL PRADESH,PAPUM PARE,2021-03-14,0,1,0,1
ARUNACHAL PRADESH,PAPUM PARE,2021-03-15,0,31,0,31
ARUNACHAL PRADESH,SHI YOMI,2021-03-15,0,1,0,1
ARUNACHAL PRADESH,SIANG,2021-03-13,0,1,0,1
ARUNACHAL PRADESH,SIANG,2021-03-15,0,3,0,3
ARUNACHAL PRADESH,TAWANG,2021-03-11,0,4,0,4
ARUNACHAL PRADESH,TAWANG,2021-03-12,0,2,0,2
ARUNACHAL PRADESH,TAWANG,2021-03-13,0,1,0,1
ARUNACHAL PRADESH,TAWANG,2021-03-15,0,3,0,3
ARUNACHAL PRADESH,TIRAP,2021-03-11,0,5,0,5
ARUNACHAL PRADESH,UPPER SUBANSIRI,2021-03-12,0,1,0,1
ARUNACHAL PRADESH,UPPER SUBANSIRI,2021-03-15,0,4,0,4
ARUNACHAL PRADESH,WEST KAMENG,2021-03-11,0,13,0,13
ARUNACHAL PRADESH,WEST KAMENG,2021-03-12,0,21,0,21
ARUNACHAL PRADESH,WEST KAMENG,2021-03-13,0,34,0,34
ARUNACHAL PRADESH,WEST KAMENG,2021-03-14,0,57,0,57
ARUNACHAL PRADESH,WEST KAMENG,2021-03-15,0,20,0,20
ARUNACHAL PRADESH,WEST SIANG,2021-03-11,0,1,0,1
ARUNACHAL PRADESH,WEST SIANG,2021-03-14,0,1,0,1
ARUNACHAL PRADESH,WEST SIANG,2021-03-15,0,1,0,1
ASSAM,BAKSA,2021-03-11,0,38,0,38
ASSAM,BAKSA,2021-03-12,0,49,0,49
ASSAM,BAKSA,2021-03-13,0,46,0,46
ASSAM,BAKSA,2021-03-14,0,2,0,2
ASSAM,BAKSA,2021-03-15,1,37,0,38
ASSAM,BARPETA,2021-03-11,0,131,0,131
ASSAM,BARPETA,2021-03-12,0,124,0,124
ASSAM,BARPETA,2021-03-13,0,145,0,145
ASSAM,BARPETA,2021-03-14,0,14,0,14
ASSAM,BARPETA,2021-03-15,0,177,0,177
ASSAM,BISWANATH,2021-03-11,0,16,0,16
ASSAM,BISWANATH,2021-03-12,0,16,0,16
ASSAM,BISWANATH,2021-03-13,0,43,0,43
ASSAM,BISWANATH,2021-03-14,0,56,0,56
ASSAM,BISWANATH,2021-03-15,0,15,0,15
ASSAM,BONGAIGAON,2021-03-11,0,110,0,110
ASSAM,BONGAIGAON,2021-03-12,1,207,0,208
ASSAM,BONGAIGAON,2021-03-13,2,212,0,214
ASSAM,BONGAIGAON,2021-03-14,0,41,0,41
ASSAM,BONGAIGAON,2021-03-15,1,223,0,224
ASSAM,CACHAR,2021-03-11,1,137,4,142
ASSAM,CACHAR,2021-03-12,1,131,14,146
ASSAM,CACHAR,2021-03-13,2,123,13,138
ASSAM,CACHAR,2021-03-14,3,81,0,84
ASSAM,CACHAR,2021-03-15,0,152,9,161
ASSAM,CHARAIDEO,2021-03-11,0,92,0,92
ASSAM,CHARAIDEO,2021-03-12,0,142,0,142
ASSAM,CHARAIDEO,2021-03-13,0,78,0,78
ASSAM,CHARAIDEO,2021-03-14,0,22,0,22
ASSAM,CHARAIDEO,2021-03-15,0,103,0,103
ASSAM,CHIRANG,2021-03-11,0,67,0,67
ASSAM,CHIRANG,2021-03-12,0,14,0,14
ASSAM,CHIRANG,2021-03-13,0,20,0,20
ASSAM,CHIRANG,2021-03-14,0,3,0,3
ASSAM,CHIRANG,2021-03-15,0,114,0,114
ASSAM,DARRANG,2021-03-11,1,268,0,269
ASSAM,DARRANG,2021-03-12,0,351,0,351
ASSAM,DARRANG,2021-03-13,0,302,0,302
ASSAM,DARRANG,2021-03-14,0,123,0,123
ASSAM,DARRANG,2021-03-15,0,447,0,447
ASSAM,DHEMAJI,2021-03-11,0,47,0,47
ASSAM,DHEMAJI,2021-03-12,0,9,0,9
ASSAM,DHEMAJI,2021-03-13,0,16,0,16
ASSAM,DHEMAJI,2021-03-14,0,13,0,13
ASSAM,DHEMAJI,2021-03-15,0,26,0,26
ASSAM,DHUBRI,2021-03-11,0,164,0,164
ASSAM,DHUBRI,2021-03-12,0,151,0,151
ASSAM,DHUBRI,2021-03-13,0,210,0,210
ASSAM,DHUBRI,2021-03-14,0,35,0,35
ASSAM,DHUBRI,2021-03-15,0,280,0,280
ASSAM,DIBRUGARH,2021-03-11,3,197,0,200
ASSAM,DIBRUGARH,2021-03-12,3,181,1,185
ASSAM,DIBRUGARH,2021-03-13,0,165,0,165
ASSAM,DIBRUGARH,2021-03-14,0,55,0,55
ASSAM,DIBRUGARH,2021-03-15,1,248,0,249
ASSAM,DIMA HASAO,2021-03-11,0,16,0,16
ASSAM,DIMA HASAO,2021-03-12,0,84,0,84
ASSAM,DIMA HASAO,2021-03-13,0,27,0,27
ASSAM,DIMA HASAO,2021-03-14,0,8,0,8
ASSAM,DIMA HASAO,2021-03-15,0,18,0,18
ASSAM,GOALPARA,2021-03-11,0,217,0,217
ASSAM,GOALPARA,2021-03-12,1,269,0,270
ASSAM,GOALPARA,2021-03-13,0,375,0,375
ASSAM,GOALPARA,2021-03-14,1,55,0,56
ASSAM,GOALPARA,2021-03-15,0,205,0,205
ASSAM,GOLAGHAT,2021-03-11,0,120,0,120
ASSAM,GOLAGHAT,2021-03-12,0,58,0,58
ASSAM,GOLAGHAT,2021-03-13,1,177,0,178
ASSAM,GOLAGHAT,2021-03-14,0,28,0,28
ASSAM,GOLAGHAT,2021-03-15,1,146,0,147
ASSAM,HAILAKANDI,2021-03-11,0,223,0,223
ASSAM,HAILAKANDI,2021-03-12,0,375,4,379
ASSAM,HAILAKANDI,2021-03-13,0,315,42,357
ASSAM,HAILAKANDI,2021-03-14,1,41,0,42
ASSAM,HAILAKANDI,2021-03-15,0,367,0,367
ASSAM,HOJAI,2021-03-11,0,127,0,127
ASSAM,HOJAI,2021-03-12,0,132,0,132
ASSAM,HOJAI,2021-03-13,0,101,0,101
ASSAM,HOJAI,2021-03-14,0,16,0,16
ASSAM,HOJAI,2021-03-15,0,126,0,126
ASSAM,JORHAT,2021-03-11,2,264,0,266
ASSAM,JORHAT,2021-03-12,1,244,0,245
ASSAM,JORHAT,2021-03-13,1,139,1,141
ASSAM,JORHAT,2021-03-14,0,54,0,54
ASSAM,JORHAT,2021-03-15,7,249,0,256
ASSAM,KAMRUP,2021-03-11,2,435,0,437
ASSAM,KAMRUP,2021-03-12,0,691,0,691
ASSAM,KAMRUP,2021-03-13,0,487,2,489
ASSAM,KAMRUP,2021-03-14,0,94,1,95
ASSAM,KAMRUP,2021-03-15,0,655,1,656
ASSAM,KAMRUP METRO,2021-03-11,5,1349,0,1354
ASSAM,KAMRUP METRO,2021-03-12,3,1630,0,1633
ASSAM,KAMRUP METRO,2021-03-13,9,1418,0,1427
ASSAM,KAMRUP METRO,2021-03-14,8,1222,0,1230
ASSAM,KAMRUP METRO,2021-03-15,13,1682,1,1696
ASSAM,KARBI ANGLONG,2021-03-11,0,8,0,8
ASSAM,KARBI ANGLONG,2021-03-12,0,10,0,10
ASSAM,KARBI ANGLONG,2021-03-13,0,25,0,25
ASSAM,KARBI ANGLONG,2021-03-14,0,7,0,7
ASSAM,KARBI ANGLONG,2021-03-15,0,21,0,21
ASSAM,KARIMGANJ,2021-03-11,0,116,0,116
ASSAM,KARIMGANJ,2021-03-12,0,109,3,112
ASSAM,KARIMGANJ,2021-03-13,0,122,0,122
ASSAM,KARIMGANJ,2021-03-14,0,90,0,90
ASSAM,KARIMGANJ,2021-03-15,0,185,0,185
ASSAM,KOKRAJHAR,2021-03-11,1,5,0,6
ASSAM,KOKRAJHAR,2021-03-12,0,64,0,64
ASSAM,KOKRAJHAR,2021-03-13,0,23,0,23
ASSAM,KOKRAJHAR,2021-03-14,0,10,0,10
ASSAM,KOKRAJHAR,2021-03-15,0,26,0,26
ASSAM,LAKHIMPUR,2021-03-11,0,174,0,174
ASSAM,LAKHIMPUR,2021-03-12,0,198,0,198
ASSAM,LAKHIMPUR,2021-03-13,0,173,0,173
ASSAM,LAKHIMPUR,2021-03-14,0,54,0,54
ASSAM,LAKHIMPUR,2021-03-15,0,281,0,281
ASSAM,MAJULI,2021-03-11,0,10,0,10
ASSAM,MAJULI,2021-03-12,0,9,0,9
ASSAM,MAJULI,2021-03-13,0,7,0,7
ASSAM,MAJULI,2021-03-14,0,3,0,3
ASSAM,MAJULI,2021-03-15,0,7,0,7
ASSAM,MARIGAON,2021-03-11,0,158,0,158
ASSAM,MARIGAON,2021-03-12,0,85,0,85
ASSAM,MARIGAON,2021-03-13,0,137,0,137
ASSAM,MARIGAON,2021-03-14,0,43,0,43
ASSAM,MARIGAON,2021-03-15,0,173,0,173
ASSAM,NAGAON,2021-03-11,0,180,0,180
ASSAM,NAGAON,2021-03-12,2,213,0,215
ASSAM,NAGAON,2021-03-13,4,270,0,274
ASSAM,NAGAON,2021-03-14,0,94,0,94
ASSAM,NAGAON,2021-03-15,4,256,0,260
ASSAM,NALBARI,2021-03-11,0,27,0,27
ASSAM,NALBARI,2021-03-12,0,36,1,37
ASSAM,NALBARI,2021-03-13,0,61,0,61
ASSAM,NALBARI,2021-03-14,0,8,0,8
ASSAM,NALBARI,2021-03-15,0,71,0,71
ASSAM,SIVASAGAR,2021-03-11,1,146,0,147
ASSAM,SIVASAGAR,2021-03-12,0,34,0,34
ASSAM,SIVASAGAR,2021-03-13,0,134,0,134
ASSAM,SIVASAGAR,2021-03-14,0,13,0,13
ASSAM,SIVASAGAR,2021-03-15,0,181,0,181
ASSAM,SONITPUR,2021-03-11,3,142,0,145
ASSAM,SONITPUR,2021-03-12,1,110,0,111
ASSAM,SONITPUR,2021-03-13,0,123,0,123
ASSAM,SONITPUR,2021-03-14,0,13,0,13
ASSAM,SONITPUR,2021-03-15,0,152,0,152
ASSAM,SOUTH SALMARA MANCACHAR,2021-03-11,0,26,0,26
ASSAM,SOUTH SALMARA MANCACHAR,2021-03-12,0,22,0,22
ASSAM,SOUTH SALMARA MANCACHAR,2021-03-13,0,23,0,23
ASSAM,SOUTH SALMARA MANCACHAR,2021-03-14,0,5,0,5
ASSAM,SOUTH SALMARA MANCACHAR,2021-03-15,0,15,0,15
ASSAM,TINSUKIA,2021-03-11,8,247,2,257
ASSAM,TINSUKIA,2021-03-12,2,212,5,219
ASSAM,TINSUKIA,2021-03-13,0,172,0,172
ASSAM,TINSUKIA,2021-03-14,2,89,0,91
ASSAM,TINSUKIA,2021-03-15,1,283,0,284
ASSAM,UDALGURI,2021-03-11,0,7,0,7
ASSAM,UDALGURI,2021-03-12,0,22,0,22
ASSAM,UDALGURI,2021-03-13,0,7,0,7
ASSAM,UDALGURI,2021-03-14,0,2,0,2
ASSAM,UDALGURI,2021-03-15,0,8,0,8
ASSAM,WEST KARBI ANGLONG,2021-03-11,0,8,0,8
ASSAM,WEST KARBI ANGLONG,2021-03-12,0,9,0,9
ASSAM,WEST KARBI ANGLONG,2021-03-13,0,1,0,1
ASSAM,WEST KARBI ANGLONG,2021-03-15,0,2,0,2
BIHAR,ARARIA,2021-03-11,0,439,0,439
BIHAR,ARARIA,2021-03-12,0,471,0,471
BIHAR,ARARIA,2021-03-13,0,605,0,605
BIHAR,ARARIA,2021-03-14,0,3,0,3
BIHAR,ARARIA,2021-03-15,0,176,0,176
BIHAR,ARWAL,2021-03-11,0,510,0,510
BIHAR,ARWAL,2021-03-12,0,705,1,706
BIHAR,ARWAL,2021-03-13,0,300,15,315
BIHAR,ARWAL,2021-03-14,0,150,0,150
BIHAR,ARWAL,2021-03-15,0,344,0,344
BIHAR,AURANGABAD,2021-03-11,1,979,0,980
BIHAR,AURANGABAD,2021-03-12,0,753,0,753
BIHAR,AURANGABAD,2021-03-13,0,522,0,522
BIHAR,AURANGABAD,2021-03-14,1,582,0,583
BIHAR,AURANGABAD,2021-03-15,1,383,5,389
BIHAR,BANKA,2021-03-11,2,404,68,474
BIHAR,BANKA,2021-03-12,0,590,0,590
BIHAR,BANKA,2021-03-13,0,474,0,474
BIHAR,BANKA,2021-03-14,0,573,0,573
BIHAR,BANKA,2021-03-15,0,689,11,700
BIHAR,BEGUSARAI,2021-03-11,0,431,0,431
BIHAR,BEGUSARAI,2021-03-12,1,741,0,742
BIHAR,BEGUSARAI,2021-03-13,5,773,0,778
BIHAR,BEGUSARAI,2021-03-14,0,565,0,565
BIHAR,BEGUSARAI,2021-03-15,0,816,0,816
BIHAR,BHAGALPUR,2021-03-11,4,1150,50,1204
BIHAR,BHAGALPUR,2021-03-12,0,127,2,129
BIHAR,BHAGALPUR,2021-03-13,0,596,0,596
BIHAR,BHAGALPUR,2021-03-14,1,664,4,669
BIHAR,BHAGALPUR,2021-03-15,9,747,22,778
BIHAR,BHOJPUR,2021-03-11,1,1178,0,1179
BIHAR,BHOJPUR,2021-03-12,0,996,19,1015
BIHAR,BHOJPUR,2021-03-13,2,833,678,1513
BIHAR,BHOJPUR,2021-03-14,2,342,0,344
BIHAR,BHOJPUR,2021-03-15,2,724,0,726
BIHAR,BUXAR,2021-03-11,2,902,0,904
BIHAR,BUXAR,2021-03-12,1,424,0,425
BIHAR,BUXAR,2021-03-13,1,695,60,756
BIHAR,BUXAR,2021-03-14,0,21,1,22
BIHAR,BUXAR,2021-03-15,0,763,1,764
BIHAR,DARBHANGA,2021-03-11,1,123,0,124
BIHAR,DARBHANGA,2021-03-12,4,556,0,560
BIHAR,DARBHANGA,2021-03-13,4,533,2,539
BIHAR,DARBHANGA,2021-03-14,2,459,0,461
BIHAR,DARBHANGA,2021-03-15,2,735,2,739
BIHAR,GAYA,2021-03-11,3,1181,6,1190
BIHAR,GAYA,2021-03-12,0,1284,2,1286
BIHAR,GAYA,2021-03-13,3,895,0,898
BIHAR,GAYA,2021-03-14,1,1187,2,1190
BIHAR,GAYA,2021-03-15,5,3587,10,3602
BIHAR,GOPALGANJ,2021-03-11,2,1081,1,1084
BIHAR,GOPALGANJ,2021-03-12,1,1091,4,1096
BIHAR,GOPALGANJ,2021-03-13,0,836,21,857
BIHAR,GOPALGANJ,2021-03-14,0,940,3,943
BIHAR,GOPALGANJ,2021-03-15,2,684,6,692
BIHAR,JAMUI,2021-03-11,1,608,0,609
BIHAR,JAMUI,2021-03-12,0,988,2,990
BIHAR,JAMUI,2021-03-13,0,884,0,884
BIHAR,JAMUI,2021-03-14,0,637,0,637
BIHAR,JAMUI,2021-03-15,0,1304,0,1304
BIHAR,JEHANABAD,2021-03-11,0,173,0,173
BIHAR,JEHANABAD,2021-03-12,0,247,0,247
BIHAR,JEHANABAD,2021-03-13,0,420,0,420
BIHAR,JEHANABAD,2021-03-14,0,381,0,381
BIHAR,JEHANABAD,2021-03-15,0,298,1,299
BIHAR,KAIMUR (BHABUA),2021-03-11,0,1513,0,1513
BIHAR,KAIMUR (BHABUA),2021-03-12,0,349,0,349
BIHAR,KAIMUR (BHABUA),2021-03-13,2,999,1,1002
BIHAR,KAIMUR (BHABUA),2021-03-14,0,649,0,649
BIHAR,KAIMUR (BHABUA),2021-03-15,0,661,0,661
BIHAR,KATIHAR,2021-03-11,0,589,0,589
BIHAR,KATIHAR,2021-03-12,0,199,0,199
BIHAR,KATIHAR,2021-03-13,0,2250,0,2250
BIHAR,KATIHAR,2021-03-14,0,1617,0,1617
BIHAR,KATIHAR,2021-03-15,1,1271,0,1272
BIHAR,KHAGARIA,2021-03-11,0,100,0,100
BIHAR,KHAGARIA,2021-03-12,0,151,1,152
BIHAR,KHAGARIA,2021-03-13,0,543,0,543
BIHAR,KHAGARIA,2021-03-14,0,84,0,84
BIHAR,KHAGARIA,2021-03-15,0,180,0,180
BIHAR,KISHANGANJ,2021-03-11,0,88,0,88
BIHAR,KISHANGANJ,2021-03-12,0,327,1,328
BIHAR,KISHANGANJ,2021-03-13,1,169,0,170
BIHAR,KISHANGANJ,2021-03-14,0,154,0,154
BIHAR,KISHANGANJ,2021-03-15,3,311,0,314
BIHAR,LAKHISARAI,2021-03-11,0,378,0,378
BIHAR,LAKHISARAI,2021-03-12,0,85,0,85
BIHAR,LAKHISARAI,2021-03-13,0,166,0,166
BIHAR,LAKHISARAI,2021-03-14,0,22,0,22
BIHAR,LAKHISARAI,2021-03-15,0,86,0,86
BIHAR,MADHEPURA,2021-03-11,2,968,0,970
BIHAR,MADHEPURA,2021-03-12,0,1068,0,1068
BIHAR,MADHEPURA,2021-03-13,8,2043,2,2053
BIHAR,MADHEPURA,2021-03-14,2,2451,0,2453
BIHAR,MADHEPURA,2021-03-15,0,1144,0,1144
BIHAR,MADHUBANI,2021-03-11,4,658,2,664
BIHAR,MADHUBANI,2021-03-12,2,425,0,427
BIHAR,MADHUBANI,2021-03-13,10,663,2,675
BIHAR,MADHUBANI,2021-03-14,2,423,1,426
BIHAR,MADHUBANI,2021-03-15,3,1032,6,1041
BIHAR,MUNGER,2021-03-11,1,403,0,404
BIHAR,MUNGER,2021-03-12,2,636,5,643
BIHAR,MUNGER,2021-03-13,2,404,1,407
BIHAR,MUNGER,2021-03-14,2,281,0,283
BIHAR,MUNGER,2021-03-15,2,550,0,552
BIHAR,MUZAFFARPUR,2021-03-11,0,1076,0,1076
BIHAR,MUZAFFARPUR,2021-03-12,3,1184,0,1187
BIHAR,MUZAFFARPUR,2021-03-13,1,1467,0,1468
BIHAR,MUZAFFARPUR,2021-03-14,0,953,1,954
BIHAR,MUZAFFARPUR,2021-03-15,1,1174,0,1175
BIHAR,NALANDA,2021-03-11,0,837,0,837
BIHAR,NALANDA,2021-03-12,0,1970,1,1971
BIHAR,NALANDA,2021-03-13,0,1750,1,1751
BIHAR,NALANDA,2021-03-14,0,479,3,482
BIHAR,NALANDA,2021-03-15,3,1330,4,1337
BIHAR,NAWADA,2021-03-11,0,251,0,251
BIHAR,NAWADA,2021-03-12,0,578,117,695
BIHAR,NAWADA,2021-03-13,0,982,0,982
BIHAR,NAWADA,2021-03-14,0,262,0,262
BIHAR,NAWADA,2021-03-15,0,663,0,663
BIHAR,PASHCHIM CHAMPARAN,2021-03-11,1,432,44,477
BIHAR,PASHCHIM CHAMPARAN,2021-03-12,0,700,49,749
BIHAR,PASHCHIM CHAMPARAN,2021-03-13,0,329,4,333
BIHAR,PASHCHIM CHAMPARAN,2021-03-14,0,414,0,414
BIHAR,PASHCHIM CHAMPARAN,2021-03-15,1,548,0,549
BIHAR,PATNA,2021-03-11,95,1356,3,1454
BIHAR,PATNA,2021-03-12,24,1787,47,1858
BIHAR,PATNA,2021-03-13,35,2150,4,2189
BIHAR,PATNA,2021-03-14,20,1338,0,1358
BIHAR,PATNA,2021-03-15,30,2190,0,2220
BIHAR,PURBI CHAMPARAN,2021-03-11,0,1523,1,1524
BIHAR,PURBI CHAMPARAN,2021-03-12,0,1250,1,1251
BIHAR,PURBI CHAMPARAN,2021-03-13,1,981,0,982
BIHAR,PURBI CHAMPARAN,2021-03-14,1,821,0,822
BIHAR,PURBI CHAMPARAN,2021-03-15,5,1183,0,1188
BIHAR,PURNIA,2021-03-11,2,333,51,386
BIHAR,PURNIA,2021-03-12,0,225,79,304
BIHAR,PURNIA,2021-03-13,1,450,60,511
BIHAR,PURNIA,2021-03-14,1,231,0,232
BIHAR,PURNIA,2021-03-15,0,511,31,542
BIHAR,ROHTAS,2021-03-11,1,507,0,508
BIHAR,ROHTAS,2021-03-12,2,408,0,410
BIHAR,ROHTAS,2021-03-13,1,1073,0,1074
BIHAR,ROHTAS,2021-03-14,0,154,0,154
BIHAR,ROHTAS,2021-03-15,0,1697,0,1697
BIHAR,SAHARSA,2021-03-11,0,94,0,94
BIHAR,SAHARSA,2021-03-12,1,587,0,588
BIHAR,SAHARSA,2021-03-13,0,274,0,274
BIHAR,SAHARSA,2021-03-14,0,4,0,4
BIHAR,SAHARSA,2021-03-15,0,727,0,727
BIHAR,SAMASTIPUR,2021-03-11,1,1196,21,1218
BIHAR,SAMASTIPUR,2021-03-12,0,1105,12,1117
BIHAR,SAMASTIPUR,2021-03-13,0,1047,11,1058
BIHAR,SAMASTIPUR,2021-03-14,1,353,11,365
BIHAR,SAMASTIPUR,2021-03-15,1,1133,8,1142
BIHAR,SARAN,2021-03-11,1,485,0,486
BIHAR,SARAN,2021-03-12,0,959,1,960
BIHAR,SARAN,2021-03-13,2,1310,1,1313
BIHAR,SARAN,2021-03-14,2,277,0,279
BIHAR,SARAN,2021-03-15,1,1092,1,1094
BIHAR,SHEIKHPURA,2021-03-11,0,13,0,13
BIHAR,SHEIKHPURA,2021-03-12,0,60,0,60
BIHAR,SHEIKHPURA,2021-03-13,0,183,1,184
BIHAR,SHEIKHPURA,2021-03-14,0,2,0,2
BIHAR,SHEIKHPURA,2021-03-15,0,18,0,18
BIHAR,SHEOHAR,2021-03-11,0,758,0,758
BIHAR,SHEOHAR,2021-03-12,0,562,0,562
BIHAR,SHEOHAR,2021-03-13,0,621,0,621
BIHAR,SHEOHAR,2021-03-14,0,717,0,717
BIHAR,SHEOHAR,2021-03-15,1,65,0,66
BIHAR,SITAMARHI,2021-03-11,0,326,0,326
BIHAR,SITAMARHI,2021-03-12,0,545,0,545
BIHAR,SITAMARHI,2021-03-13,0,832,2,834
BIHAR,SITAMARHI,2021-03-14,0,276,0,276
BIHAR,SITAMARHI,2021-03-15,0,757,0,757
BIHAR,SIWAN,2021-03-11,2,2330,5,2337
BIHAR,SIWAN,2021-03-12,4,1524,1,1529
BIHAR,SIWAN,2021-03-13,3,1689,1,1693
BIHAR,SIWAN,2021-03-14,2,1699,2,1703
BIHAR,SIWAN,2021-03-15,0,2405,2,2407
BIHAR,SUPAUL,2021-03-11,0,616,15,631
BIHAR,SUPAUL,2021-03-12,0,599,2,601
BIHAR,SUPAUL,2021-03-13,0,743,2,745
BIHAR,SUPAUL,2021-03-14,1,649,0,650
BIHAR,SUPAUL,2021-03-15,0,818,76,894
BIHAR,VAISHALI,2021-03-11,0,612,0,612
BIHAR,VAISHALI,2021-03-12,0,333,0,333
BIHAR,VAISHALI,2021-03-13,0,835,0,835
BIHAR,VAISHALI,2021-03-14,0,284,0,284
BIHAR,VAISHALI,2021-03-15,0,1349,4,1353
CHANDIGARH,CHANDIGARH,2021-03-11,108,1096,4,1208
CHANDIGARH,CHANDIGARH,2021-03-12,130,1446,6,1582
CHANDIGARH,CHANDIGARH,2021-03-13,176,1767,10,1953
CHANDIGARH,CHANDIGARH,2021-03-14,129,1288,11,1428
CHANDIGARH,CHANDIGARH,2021-03-15,144,1707,9,1860
CHHATTISGARH,BALOD,2021-03-11,3,718,0,721
CHHATTISGARH,BALOD,2021-03-12,3,920,0,923
CHHATTISGARH,BALOD,2021-03-13,1,920,0,921
CHHATTISGARH,BALOD,2021-03-14,5,623,0,628
CHHATTISGARH,BALOD,2021-03-15,6,774,0,780
CHHATTISGARH,BALODA BAZAR,2021-03-11,2,393,3,398
CHHATTISGARH,BALODA BAZAR,2021-03-12,13,641,0,654
CHHATTISGARH,BALODA BAZAR,2021-03-13,16,555,0,571
CHHATTISGARH,BALODA BAZAR,2021-03-14,9,127,2,138
CHHATTISGARH,BALODA BAZAR,2021-03-15,17,314,3,334
CHHATTISGARH,BALRAMPUR,2021-03-11,0,91,0,91
CHHATTISGARH,BALRAMPUR,2021-03-12,7,613,0,620
CHHATTISGARH,BALRAMPUR,2021-03-13,3,372,1,376
CHHATTISGARH,BALRAMPUR,2021-03-14,1,341,1,343
CHHATTISGARH,BALRAMPUR,2021-03-15,2,643,0,645
CHHATTISGARH,BASTAR,2021-03-11,7,988,0,995
CHHATTISGARH,BASTAR,2021-03-12,8,1113,0,1121
CHHATTISGARH,BASTAR,2021-03-13,9,1387,1,1397
CHHATTISGARH,BASTAR,2021-03-14,7,626,0,633
CHHATTISGARH,BASTAR,2021-03-15,2,1666,0,1668
CHHATTISGARH,BEMETARA,2021-03-11,1,698,1,700
CHHATTISGARH,BEMETARA,2021-03-12,7,563,0,570
CHHATTISGARH,BEMETARA,2021-03-13,6,551,15,572
CHHATTISGARH,BEMETARA,2021-03-14,2,107,0,109
CHHATTISGARH,BEMETARA,2021-03-15,12,313,0,325
CHHATTISGARH,BIJAPUR,2021-03-11,0,268,1,269
CHHATTISGARH,BIJAPUR,2021-03-12,1,217,1,219
CHHATTISGARH,BIJAPUR,2021-03-13,0,194,0,194
CHHATTISGARH,BIJAPUR,2021-03-14,1,180,0,181
CHHATTISGARH,BIJAPUR,2021-03-15,0,325,0,325
CHHATTISGARH,BILASPUR,2021-03-11,26,814,0,840
CHHATTISGARH,BILASPUR,2021-03-12,44,2161,4,2209
CHHATTISGARH,BILASPUR,2021-03-13,36,1837,8,1881
CHHATTISGARH,BILASPUR,2021-03-14,73,1410,7,1490
CHHATTISGARH,BILASPUR,2021-03-15,52,3747,28,3827
CHHATTISGARH,DANTEWADA,2021-03-11,0,99,0,99
CHHATTISGARH,DANTEWADA,2021-03-12,2,255,0,257
CHHATTISGARH,DANTEWADA,2021-03-13,4,352,0,356
CHHATTISGARH,DANTEWADA,2021-03-14,1,285,0,286
CHHATTISGARH,DANTEWADA,2021-03-15,1,269,0,270
CHHATTISGARH,DHAMTARI,2021-03-11,0,175,16,191
CHHATTISGARH,DHAMTARI,2021-03-12,4,467,11,482
CHHATTISGARH,DHAMTARI,2021-03-13,7,498,53,558
CHHATTISGARH,DHAMTARI,2021-03-14,4,80,21,105
CHHATTISGARH,DHAMTARI,2021-03-15,17,473,7,497
CHHATTISGARH,DURG,2021-03-11,137,1205,2,1344
CHHATTISGARH,DURG,2021-03-12,115,1306,2,1423
CHHATTISGARH,DURG,2021-03-13,184,1579,2,1765
CHHATTISGARH,DURG,2021-03-14,138,782,2,922
CHHATTISGARH,DURG,2021-03-15,161,996,3,1160
CHHATTISGARH,GARIYABAND,2021-03-11,0,196,5,201
CHHATTISGARH,GARIYABAND,2021-03-12,2,151,5,158
CHHATTISGARH,GARIYABAND,2021-03-13,8,236,6,250
CHHATTISGARH,GARIYABAND,2021-03-14,0,204,13,217
CHHATTISGARH,GARIYABAND,2021-03-15,3,240,14,257
CHHATTISGARH,GAURELLA PENDRA MARWAHI,2021-03-11,0,156,0,156
CHHATTISGARH,GAURELLA PENDRA MARWAHI,2021-03-12,0,856,0,856
CHHATTISGARH,GAURELLA PENDRA MARWAHI,2021-03-13,1,707,0,708
CHHATTISGARH,GAURELLA PENDRA MARWAHI,2021-03-14,0,269,0,269
CHHATTISGARH,GAURELLA PENDRA MARWAHI,2021-03-15,1,508,0,509
CHHATTISGARH,JANJGIR CHAMPA,2021-03-11,7,2284,2,2293
CHHATTISGARH,JANJGIR CHAMPA,2021-03-12,13,2490,0,2503
CHHATTISGARH,JANJGIR CHAMPA,2021-03-13,6,1816,0,1822
CHHATTISGARH,JANJGIR CHAMPA,2021-03-14,15,1903,0,1918
CHHATTISGARH,JANJGIR CHAMPA,2021-03-15,23,3255,0,3278
CHHATTISGARH,JASHPUR,2021-03-11,12,182,0,194
CHHATTISGARH,JASHPUR,2021-03-12,19,393,2,414
CHHATTISGARH,JASHPUR,2021-03-13,9,131,0,140
CHHATTISGARH,JASHPUR,2021-03-14,14,212,0,226
CHHATTISGARH,JASHPUR,2021-03-15,14,364,0,378
CHHATTISGARH,KABIRDHAM,2021-03-11,7,584,0,591
CHHATTISGARH,KABIRDHAM,2021-03-12,2,318,0,320
CHHATTISGARH,KABIRDHAM,2021-03-13,2,600,2,604
CHHATTISGARH,KABIRDHAM,2021-03-14,3,23,0,26
CHHATTISGARH,KABIRDHAM,2021-03-15,0,120,0,120
CHHATTISGARH,KANKER,2021-03-11,4,823,1,828
CHHATTISGARH,KANKER,2021-03-12,3,1333,0,1336
CHHATTISGARH,KANKER,2021-03-13,2,2090,0,2092
CHHATTISGARH,KANKER,2021-03-14,4,2963,1,2968
CHHATTISGARH,KANKER,2021-03-15,10,3302,0,3312
CHHATTISGARH,KONDAGAON,2021-03-11,0,175,0,175
CHHATTISGARH,KONDAGAON,2021-03-12,0,969,0,969
CHHATTISGARH,KONDAGAON,2021-03-13,0,509,0,509
CHHATTISGARH,KONDAGAON,2021-03-14,0,201,0,201
CHHATTISGARH,KONDAGAON,2021-03-15,0,539,0,539
CHHATTISGARH,KORBA,2021-03-11,8,830,0,838
CHHATTISGARH,KORBA,2021-03-12,18,1319,0,1337
CHHATTISGARH,KORBA,2021-03-13,15,1120,0,1135
CHHATTISGARH,KORBA,2021-03-14,9,625,0,634
CHHATTISGARH,KORBA,2021-03-15,10,1088,1,1099
CHHATTISGARH,KOREA,2021-03-11,5,51,0,56
CHHATTISGARH,KOREA,2021-03-12,15,520,0,535
CHHATTISGARH,KOREA,2021-03-13,12,354,1,367
CHHATTISGARH,KOREA,2021-03-14,10,121,1,132
CHHATTISGARH,KOREA,2021-03-15,10,340,0,350
CHHATTISGARH,MAHASAMUND,2021-03-11,13,852,0,865
CHHATTISGARH,MAHASAMUND,2021-03-12,10,1236,6,1252
CHHATTISGARH,MAHASAMUND,2021-03-13,5,1029,3,1037
CHHATTISGARH,MAHASAMUND,2021-03-14,4,641,2,647
CHHATTISGARH,MAHASAMUND,2021-03-15,20,959,3,982
CHHATTISGARH,MUNGELI,2021-03-11,0,414,0,414
CHHATTISGARH,MUNGELI,2021-03-12,0,537,0,537
CHHATTISGARH,MUNGELI,2021-03-13,5,521,2,528
CHHATTISGARH,MUNGELI,2021-03-14,3,330,0,333
CHHATTISGARH,MUNGELI,2021-03-15,4,487,0,491
CHHATTISGARH,NARAYANPUR,2021-03-11,0,71,0,71
CHHATTISGARH,NARAYANPUR,2021-03-12,0,256,0,256
CHHATTISGARH,NARAYANPUR,2021-03-13,0,80,0,80
CHHATTISGARH,NARAYANPUR,2021-03-14,0,99,0,99
CHHATTISGARH,NARAYANPUR,2021-03-15,2,120,0,122
CHHATTISGARH,RAIGARH,2021-03-11,5,663,1,669
CHHATTISGARH,RAIGARH,2021-03-12,7,853,12,872
CHHATTISGARH,RAIGARH,2021-03-13,5,943,0,948
CHHATTISGARH,RAIGARH,2021-03-14,11,1205,7,1223
CHHATTISGARH,RAIGARH,2021-03-15,18,1242,3,1263
CHHATTISGARH,RAIPUR,2021-03-11,169,1305,39,1513
CHHATTISGARH,RAIPUR,2021-03-12,176,2156,35,2367
CHHATTISGARH,RAIPUR,2021-03-13,247,1903,38,2188
CHHATTISGARH,RAIPUR,2021-03-14,184,969,20,1173
CHHATTISGARH,RAIPUR,2021-03-15,304,2358,42,2704
CHHATTISGARH,RAJNANDGAON,2021-03-11,21,972,80,1073
CHHATTISGARH,RAJNANDGAON,2021-03-12,19,1173,14,1206
CHHATTISGARH,RAJNANDGAON,2021-03-13,32,1122,6,1160
CHHATTISGARH,RAJNANDGAON,2021-03-14,11,173,15,199
CHHATTISGARH,RAJNANDGAON,2021-03-15,34,635,19,688
CHHATTISGARH,SUKMA,2021-03-11,2,205,1,208
CHHATTISGARH,SUKMA,2021-03-12,0,326,0,326
CHHATTISGARH,SUKMA,2021-03-13,0,72,0,72
CHHATTISGARH,SUKMA,2021-03-14,0,16,0,16
CHHATTISGARH,SUKMA,2021-03-15,0,100,0,100
CHHATTISGARH,SURAJPUR,2021-03-11,11,466,0,477
CHHATTISGARH,SURAJPUR,2021-03-12,23,688,0,711
CHHATTISGARH,SURAJPUR,2021-03-13,16,774,4,794
CHHATTISGARH,SURAJPUR,2021-03-14,20,588,1,609
CHHATTISGARH,SURAJPUR,2021-03-15,17,789,0,806
CHHATTISGARH,SURGUJA,2021-03-11,15,319,1,335
CHHATTISGARH,SURGUJA,2021-03-12,25,796,1,822
CHHATTISGARH,SURGUJA,2021-03-13,23,527,0,550
CHHATTISGARH,SURGUJA,2021-03-14,17,250,1,268
CHHATTISGARH,SURGUJA,2021-03-15,39,624,0,663
DADRA AND NAGAR HAVELI,DADRA AND NAGAR HAVELI,2021-03-11,3,191,0,194
DADRA AND NAGAR HAVELI,DADRA AND NAGAR HAVELI,2021-03-12,5,243,1,249
DADRA AND NAGAR HAVELI,DADRA AND NAGAR HAVELI,2021-03-13,3,197,0,200
DADRA AND NAGAR HAVELI,DADRA AND NAGAR HAVELI,2021-03-14,0,82,0,82
DADRA AND NAGAR HAVELI,DADRA AND NAGAR HAVELI,2021-03-15,2,218,0,220
DAMAN AND DIU,DAMAN,2021-03-11,0,61,0,61
DAMAN AND DIU,DAMAN,2021-03-12,4,158,0,162
DAMAN AND DIU,DAMAN,2021-03-13,0,12,0,12
DAMAN AND DIU,DAMAN,2021-03-14,1,106,0,107
DAMAN AND DIU,DAMAN,2021-03-15,1,41,0,42
DAMAN AND DIU,DIU,2021-03-11,0,55,0,55
DAMAN AND DIU,DIU,2021-03-12,0,14,0,14
DAMAN AND DIU,DIU,2021-03-13,0,25,0,25
DAMAN AND DIU,DIU,2021-03-14,0,40,0,40
DAMAN AND DIU,DIU,2021-03-15,0,9,0,9
DELHI,CENTRAL,2021-03-11,18,6201,51,6270
DELHI,CENTRAL,2021-03-12,24,6555,14,6593
DELHI,CENTRAL,2021-03-13,19,5681,42,5742
DELHI,CENTRAL,2021-03-14,13,4783,18,4814
DELHI,CENTRAL,2021-03-15,16,6023,11,6050
DELHI,EAST,2021-03-11,31,3411,0,3442
DELHI,EAST,2021-03-12,47,4521,6,4574
DELHI,EAST,2021-03-13,42,4128,4,4174
DELHI,EAST,2021-03-14,25,2490,0,2515
DELHI,EAST,2021-03-15,32,3331,5,3368
DELHI,NEW DELHI,2021-03-11,83,6735,7,6825
DELHI,NEW DELHI,2021-03-12,54,7309,26,7389
DELHI,NEW DELHI,2021-03-13,60,5521,8,5589
DELHI,NEW DELHI,2021-03-14,48,5496,0,5544
DELHI,NEW DELHI,2021-03-15,55,5578,18,5651
DELHI,NORTH,2021-03-11,34,9382,9,9425
DELHI,NORTH,2021-03-12,36,7528,1,7565
DELHI,NORTH,2021-03-13,26,6174,1,6201
DELHI,NORTH,2021-03-14,27,8477,14,8518
DELHI,NORTH,2021-03-15,28,6964,3,6995
DELHI,NORTH EAST,2021-03-11,6,5108,4,5118
DELHI,NORTH EAST,2021-03-12,6,4565,0,4571
DELHI,NORTH EAST,2021-03-13,15,6130,12,6157
DELHI,NORTH EAST,2021-03-14,9,3649,11,3669
DELHI,NORTH EAST,2021-03-15,10,4929,0,4939
DELHI,NORTH WEST,2021-03-11,64,7163,9,7236
DELHI,NORTH WEST,2021-03-12,90,6825,22,6937
DELHI,NORTH WEST,2021-03-13,48,7839,22,7909
DELHI,NORTH WEST,2021-03-14,47,6995,2,7044
DELHI,NORTH WEST,2021-03-15,49,8592,24,8665
DELHI,SHAHDARA,2021-03-11,11,6844,1,6856
DELHI,SHAHDARA,2021-03-12,13,6959,6,6978
DELHI,SHAHDARA,2021-03-13,10,4851,4,4865
DELHI,SHAHDARA,2021-03-14,17,5885,7,5909
DELHI,SHAHDARA,2021-03-15,14,7292,0,7306
DELHI,SOUTH,2021-03-11,83,5237,28,5348
DELHI,SOUTH,2021-03-12,66,9311,9,9386
DELHI,SOUTH,2021-03-13,89,6635,6,6730
DELHI,SOUTH,2021-03-14,75,6810,22,6907
DELHI,SOUTH,2021-03-15,130,7254,32,7416
DELHI,SOUTH EAST,2021-03-11,20,5346,0,5366
DELHI,SOUTH EAST,2021-03-12,17,5654,2,5673
DELHI,SOUTH EAST,2021-03-13,20,6120,3,6143
DELHI,SOUTH EAST,2021-03-14,24,4243,0,4267
DELHI,SOUTH EAST,2021-03-15,26,5256,7,5289
DELHI,SOUTH WEST,2021-03-11,38,6296,2,6336
DELHI,SOUTH WEST,2021-03-12,48,5712,5,5765
DELHI,SOUTH WEST,2021-03-13,54,6710,5,6769
DELHI,SOUTH WEST,2021-03-14,40,5909,1,5950
DELHI,SOUTH WEST,2021-03-15,32,5757,0,5789
DELHI,WEST,2021-03-11,72,9644,5,9721
DELHI,WEST,2021-03-12,77,8745,13,8835
DELHI,WEST,2021-03-13,68,7795,6,7869
DELHI,WEST,2021-03-14,72,7023,2,7097
DELHI,WEST,2021-03-15,86,8487,4,8577
GOA,NORTH GOA,2021-03-11,49,796,0,845
GOA,NORTH GOA,2021-03-12,43,770,0,813
GOA,NORTH GOA,2021-03-13,46,628,0,674
GOA,NORTH GOA,2021-03-14,26,685,2,713
GOA,NORTH GOA,2021-03-15,34,483,0,517
GOA,SOUTH GOA,2021-03-11,56,849,0,905
GOA,SOUTH GOA,2021-03-12,52,810,0,862
GOA,SOUTH GOA,2021-03-13,54,727,0,781
GOA,SOUTH GOA,2021-03-14,28,641,0,669
GOA,SOUTH GOA,2021-03-15,37,615,0,652
GUJARAT,AHMADABAD,2021-03-11,203,3943,114,4260
GUJARAT,AHMADABAD,2021-03-12,201,3747,27,3975
GUJARAT,AHMADABAD,2021-03-13,242,3853,31,4126
GUJARAT,AHMADABAD,2021-03-14,119,2722,2,2843
GUJARAT,AHMADABAD,2021-03-15,194,3603,90,3887
GUJARAT,AMRELI,2021-03-11,5,464,0,469
GUJARAT,AMRELI,2021-03-12,2,708,0,710
GUJARAT,AMRELI,2021-03-13,4,589,1,594
GUJARAT,AMRELI,2021-03-14,2,373,0,375
GUJARAT,AMRELI,2021-03-15,17,516,1,534
GUJARAT,ANAND,2021-03-11,12,504,3,519
GUJARAT,ANAND,2021-03-12,34,507,2,543
GUJARAT,ANAND,2021-03-13,45,895,24,964
GUJARAT,ANAND,2021-03-14,42,427,0,469
GUJARAT,ANAND,2021-03-15,69,931,25,1025
GUJARAT,ARVALLI,2021-03-11,6,161,0,167
GUJARAT,ARVALLI,2021-03-12,1,352,5,358
GUJARAT,ARVALLI,2021-03-13,4,260,5,269
GUJARAT,ARVALLI,2021-03-14,1,63,0,64
GUJARAT,ARVALLI,2021-03-15,7,343,0,350
GUJARAT,BANAS KANTHA,2021-03-11,4,41,3,48
GUJARAT,BANAS KANTHA,2021-03-12,12,445,0,457
GUJARAT,BANAS KANTHA,2021-03-13,2,321,0,323
GUJARAT,BANAS KANTHA,2021-03-14,3,30,0,33
GUJARAT,BANAS KANTHA,2021-03-15,3,378,0,381
GUJARAT,BHARUCH,2021-03-11,29,255,3,287
GUJARAT,BHARUCH,2021-03-12,30,451,4,485
GUJARAT,BHARUCH,2021-03-13,65,253,4,322
GUJARAT,BHARUCH,2021-03-14,23,73,1,97
GUJARAT,BHARUCH,2021-03-15,61,492,1,554
GUJARAT,BHAVNAGAR,2021-03-11,19,635,0,654
GUJARAT,BHAVNAGAR,2021-03-12,12,786,0,798
GUJARAT,BHAVNAGAR,2021-03-13,22,1414,2,1438
GUJARAT,BHAVNAGAR,2021-03-14,44,1146,0,1190
GUJARAT,BHAVNAGAR,2021-03-15,25,1021,0,1046
GUJARAT,BOTAD,2021-03-11,0,57,0,57
GUJARAT,BOTAD,2021-03-12,0,69,0,69
GUJARAT,BOTAD,2021-03-13,0,90,0,90
GUJARAT,BOTAD,2021-03-14,0,110,0,110
GUJARAT,BOTAD,2021-03-15,0,219,0,219
GUJARAT,CHHOTAUDEPUR,2021-03-11,2,37,1,40
GUJARAT,CHHOTAUDEPUR,2021-03-12,17,241,1,259
GUJARAT,CHHOTAUDEPUR,2021-03-13,2,85,0,87
GUJARAT,CHHOTAUDEPUR,2021-03-14,1,23,0,24
GUJARAT,CHHOTAUDEPUR,2021-03-15,26,337,5,368
GUJARAT,DANG,2021-03-11,0,51,0,51
GUJARAT,DANG,2021-03-12,0,37,0,37
GUJARAT,DANG,2021-03-13,1,35,0,36
GUJARAT,DANG,2021-03-14,0,1,0,1
GUJARAT,DANG,2021-03-15,1,28,0,29
GUJARAT,DEVBHUMI DWARKA,2021-03-11,1,139,1,141
GUJARAT,DEVBHUMI DWARKA,2021-03-12,2,126,0,128
GUJARAT,DEVBHUMI DWARKA,2021-03-13,10,217,0,227
GUJARAT,DEVBHUMI DWARKA,2021-03-14,4,123,0,127
GUJARAT,DEVBHUMI DWARKA,2021-03-15,2,47,0,49
GUJARAT,DOHAD,2021-03-11,0,169,1,170
GUJARAT,DOHAD,2021-03-12,7,618,0,625
GUJARAT,DOHAD,2021-03-13,15,429,1,445
GUJARAT,DOHAD,2021-03-14,3,327,0,330
GUJARAT,DOHAD,2021-03-15,6,317,0,323
GUJARAT,GANDHINAGAR,2021-03-11,20,399,1,420
GUJARAT,GANDHINAGAR,2021-03-12,34,828,5,867
GUJARAT,GANDHINAGAR,2021-03-13,35,809,2,846
GUJARAT,GANDHINAGAR,2021-03-14,19,527,0,546
GUJARAT,GANDHINAGAR,2021-03-15,23,938,5,966
GUJARAT,GIR SOMNATH,2021-03-11,4,143,0,147
GUJARAT,GIR SOMNATH,2021-03-12,5,169,0,174
GUJARAT,GIR SOMNATH,2021-03-13,3,101,1,105
GUJARAT,GIR SOMNATH,2021-03-14,6,17,0,23
GUJARAT,GIR SOMNATH,2021-03-15,14,155,0,169
GUJARAT,JAMNAGAR,2021-03-11,8,392,4,404
GUJARAT,JAMNAGAR,2021-03-12,20,917,5,942
GUJARAT,JAMNAGAR,2021-03-13,19,845,5,869
GUJARAT,JAMNAGAR,2021-03-14,9,391,0,400
GUJARAT,JAMNAGAR,2021-03-15,23,839,4,866
GUJARAT,JUNAGADH,2021-03-11,6,370,0,376
GUJARAT,JUNAGADH,2021-03-12,2,488,0,490
GUJARAT,JUNAGADH,2021-03-13,3,422,0,425
GUJARAT,JUNAGADH,2021-03-14,5,315,0,320
GUJARAT,JUNAGADH,2021-03-15,8,442,1,451
GUJARAT,KACHCHH,2021-03-11,24,601,6,631
GUJARAT,KACHCHH,2021-03-12,15,567,8,590
GUJARAT,KACHCHH,2021-03-13,23,777,12,812
GUJARAT,KACHCHH,2021-03-14,25,558,13,596
GUJARAT,KACHCHH,2021-03-15,15,618,34,667
GUJARAT,KHEDA,2021-03-11,16,1116,10,1142
GUJARAT,KHEDA,2021-03-12,14,899,47,960
GUJARAT,KHEDA,2021-03-13,34,746,12,792
GUJARAT,KHEDA,2021-03-14,18,416,7,441
GUJARAT,KHEDA,2021-03-15,47,1013,23,1083
GUJARAT,MAHESANA,2021-03-11,5,172,4,181
GUJARAT,MAHESANA,2021-03-12,22,190,0,212
GUJARAT,MAHESANA,2021-03-13,16,181,0,197
GUJARAT,MAHESANA,2021-03-14,11,200,0,211
GUJARAT,MAHESANA,2021-03-15,6,286,1,293
GUJARAT,MAHISAGAR,2021-03-11,7,312,0,319
GUJARAT,MAHISAGAR,2021-03-12,13,468,0,481
GUJARAT,MAHISAGAR,2021-03-13,16,488,2,506
GUJARAT,MAHISAGAR,2021-03-14,8,214,1,223
GUJARAT,MAHISAGAR,2021-03-15,12,531,1,544
GUJARAT,MORBI,2021-03-11,6,232,5,243
GUJARAT,MORBI,2021-03-12,6,286,9,301
GUJARAT,MORBI,2021-03-13,13,277,0,290
GUJARAT,MORBI,2021-03-14,6,201,0,207
GUJARAT,MORBI,2021-03-15,3,288,0,291
GUJARAT,NARMADA,2021-03-11,4,79,1,84
GUJARAT,NARMADA,2021-03-12,2,24,0,26
GUJARAT,NARMADA,2021-03-13,4,40,9,53
GUJARAT,NARMADA,2021-03-14,12,20,0,32
GUJARAT,NARMADA,2021-03-15,6,14,0,20
GUJARAT,NAVSARI,2021-03-11,2,111,0,113
GUJARAT,NAVSARI,2021-03-12,7,372,0,379
GUJARAT,NAVSARI,2021-03-13,7,300,0,307
GUJARAT,NAVSARI,2021-03-14,3,64,0,67
GUJARAT,NAVSARI,2021-03-15,4,375,2,381
GUJARAT,PANCH MAHALS,2021-03-11,23,335,2,360
GUJARAT,PANCH MAHALS,2021-03-12,31,231,0,262
GUJARAT,PANCH MAHALS,2021-03-13,24,266,1,291
GUJARAT,PANCH MAHALS,2021-03-14,37,214,0,251
GUJARAT,PANCH MAHALS,2021-03-15,14,255,0,269
GUJARAT,PATAN,2021-03-11,9,81,0,90
GUJARAT,PATAN,2021-03-12,6,313,0,319
GUJARAT,PATAN,2021-03-13,17,467,0,484
GUJARAT,PATAN,2021-03-14,12,77,0,89
GUJARAT,PATAN,2021-03-15,5,301,1,307
GUJARAT,PORBANDAR,2021-03-11,1,191,0,192
GUJARAT,PORBANDAR,2021-03-12,0,257,0,257
GUJARAT,PORBANDAR,2021-03-13,1,278,0,279
GUJARAT,PORBANDAR,2021-03-14,0,144,0,144
GUJARAT,PORBANDAR,2021-03-15,2,299,0,301
GUJARAT,RAJKOT,2021-03-11,39,944,10,993
GUJARAT,RAJKOT,2021-03-12,65,1582,97,1744
GUJARAT,RAJKOT,2021-03-13,58,1250,0,1308
GUJARAT,RAJKOT,2021-03-14,34,791,0,825
GUJARAT,RAJKOT,2021-03-15,141,1721,0,1862
GUJARAT,SABAR KANTHA,2021-03-11,14,178,6,198
GUJARAT,SABAR KANTHA,2021-03-12,6,286,1,293
GUJARAT,SABAR KANTHA,2021-03-13,9,204,11,224
GUJARAT,SABAR KANTHA,2021-03-14,7,42,1,50
GUJARAT,SABAR KANTHA,2021-03-15,16,200,3,219
GUJARAT,SURAT,2021-03-11,185,1640,1,1826
GUJARAT,SURAT,2021-03-12,175,2080,3,2258
GUJARAT,SURAT,2021-03-13,213,1816,2,2031
GUJARAT,SURAT,2021-03-14,93,831,0,924
GUJARAT,SURAT,2021-03-15,266,1901,51,2218
GUJARAT,SURENDRANAGAR,2021-03-11,0,88,0,88
GUJARAT,SURENDRANAGAR,2021-03-12,2,675,1,678
GUJARAT,SURENDRANAGAR,2021-03-13,3,459,0,462
GUJARAT,SURENDRANAGAR,2021-03-14,2,179,0,181
GUJARAT,SURENDRANAGAR,2021-03-15,0,467,4,471
GUJARAT,TAPI,2021-03-11,8,134,0,142
GUJARAT,TAPI,2021-03-12,9,262,2,273
GUJARAT,TAPI,2021-03-13,7,243,0,250
GUJARAT,TAPI,2021-03-14,5,57,0,62
GUJARAT,TAPI,2021-03-15,8,284,0,292
GUJARAT,VADODARA,2021-03-11,147,1006,131,1284
GUJARAT,VADODARA,2021-03-12,154,1516,200,1870
GUJARAT,VADODARA,2021-03-13,145,1350,122,1617
GUJARAT,VADODARA,2021-03-14,86,668,90,844
GUJARAT,VADODARA,2021-03-15,222,1662,133,2017
GUJARAT,VALSAD,2021-03-11,3,386,0,389
GUJARAT,VALSAD,2021-03-12,14,417,0,431
GUJARAT,VALSAD,2021-03-13,6,357,1,364
GUJARAT,VALSAD,2021-03-14,7,266,0,273
GUJARAT,VALSAD,2021-03-15,7,319,0,326
HARYANA,AMBALA,2021-03-11,87,1370,31,1488
HARYANA,AMBALA,2021-03-12,74,688,13,775
HARYANA,AMBALA,2021-03-13,77,555,6,638
HARYANA,AMBALA,2021-03-14,39,153,2,194
HARYANA,AMBALA,2021-03-15,111,622,17,750
HARYANA,BHIWANI,2021-03-11,5,155,0,160
HARYANA,BHIWANI,2021-03-12,3,200,1,204
HARYANA,BHIWANI,2021-03-13,4,176,0,180
HARYANA,BHIWANI,2021-03-14,1,237,0,238
HARYANA,BHIWANI,2021-03-15,5,237,0,242
HARYANA,CHARKI DADRI,2021-03-11,0,393,0,393
HARYANA,CHARKI DADRI,2021-03-12,1,520,1,522
HARYANA,CHARKI DADRI,2021-03-13,1,549,0,550
HARYANA,CHARKI DADRI,2021-03-14,0,333,0,333
HARYANA,CHARKI DADRI,2021-03-15,0,209,0,209
HARYANA,FARIDABAD,2021-03-11,27,913,3,943
HARYANA,FARIDABAD,2021-03-12,44,1005,1,1050
HARYANA,FARIDABAD,2021-03-13,55,1007,2,1064
HARYANA,FARIDABAD,2021-03-14,40,515,2,557
HARYANA,FARIDABAD,2021-03-15,33,1064,0,1097
HARYANA,FATEHABAD,2021-03-11,1,331,0,332
HARYANA,FATEHABAD,2021-03-12,23,225,0,248
HARYANA,FATEHABAD,2021-03-13,7,192,0,199
HARYANA,FATEHABAD,2021-03-14,7,113,0,120
HARYANA,FATEHABAD,2021-03-15,6,88,0,94
HARYANA,GURUGRAM,2021-03-11,98,3258,17,3373
HARYANA,GURUGRAM,2021-03-12,97,3857,24,3978
HARYANA,GURUGRAM,2021-03-13,89,2870,17,2976
HARYANA,GURUGRAM,2021-03-14,110,2825,6,2941
HARYANA,GURUGRAM,2021-03-15,112,3291,9,3412
HARYANA,HISAR,2021-03-11,2,683,0,685
HARYANA,HISAR,2021-03-12,5,1639,1,1645
HARYANA,HISAR,2021-03-13,8,962,0,970
HARYANA,HISAR,2021-03-14,8,737,0,745
HARYANA,HISAR,2021-03-15,7,1021,0,1028
HARYANA,JHAJJAR,2021-03-11,1,641,0,642
HARYANA,JHAJJAR,2021-03-12,2,481,0,483
HARYANA,JHAJJAR,2021-03-13,1,710,0,711
HARYANA,JHAJJAR,2021-03-14,0,477,0,477
HARYANA,JHAJJAR,2021-03-15,3,961,2,966
HARYANA,JIND,2021-03-11,9,340,8,357
HARYANA,JIND,2021-03-12,4,152,2,158
HARYANA,JIND,2021-03-13,7,140,2,149
HARYANA,JIND,2021-03-14,20,344,12,376
HARYANA,JIND,2021-03-15,10,246,4,260
HARYANA,KAITHAL,2021-03-11,18,353,1,372
HARYANA,KAITHAL,2021-03-12,13,376,6,395
HARYANA,KAITHAL,2021-03-13,7,199,2,208
HARYANA,KAITHAL,2021-03-14,24,76,0,100
HARYANA,KAITHAL,2021-03-15,4,284,1,289
HARYANA,KARNAL,2021-03-11,19,181,0,200
HARYANA,KARNAL,2021-03-12,195,607,0,802
HARYANA,KARNAL,2021-03-13,109,642,2,753
HARYANA,KARNAL,2021-03-14,10,139,0,149
HARYANA,KARNAL,2021-03-15,22,491,1,514
HARYANA,KURUKSHETRA,2021-03-11,81,1022,19,1122
HARYANA,KURUKSHETRA,2021-03-12,44,581,1,626
HARYANA,KURUKSHETRA,2021-03-13,45,161,0,206
HARYANA,KURUKSHETRA,2021-03-14,86,234,1,321
HARYANA,KURUKSHETRA,2021-03-15,60,934,4,998
HARYANA,MAHENDRAGARH,2021-03-11,2,195,1,198
HARYANA,MAHENDRAGARH,2021-03-12,0,383,0,383
HARYANA,MAHENDRAGARH,2021-03-13,0,360,2,362
HARYANA,MAHENDRAGARH,2021-03-14,2,560,0,562
HARYANA,MAHENDRAGARH,2021-03-15,0,133,1,134
HARYANA,NUH,2021-03-11,1,17,0,18
HARYANA,NUH,2021-03-12,0,195,0,195
HARYANA,NUH,2021-03-13,0,81,0,81
HARYANA,NUH,2021-03-14,0,158,0,158
HARYANA,NUH,2021-03-15,0,253,1,254
HARYANA,PALWAL,2021-03-11,0,33,0,33
HARYANA,PALWAL,2021-03-12,1,44,0,45
HARYANA,PALWAL,2021-03-13,1,261,0,262
HARYANA,PALWAL,2021-03-14,1,129,5,135
HARYANA,PALWAL,2021-03-15,1,83,0,84
HARYANA,PANCHKULA,2021-03-11,64,1132,9,1205
HARYANA,PANCHKULA,2021-03-12,34,324,6,364
HARYANA,PANCHKULA,2021-03-13,72,743,7,822
HARYANA,PANCHKULA,2021-03-14,96,562,5,663
HARYANA,PANCHKULA,2021-03-15,50,1116,28,1194
HARYANA,PANIPAT,2021-03-11,8,991,1,1000
HARYANA,PANIPAT,2021-03-12,12,880,0,892
HARYANA,PANIPAT,2021-03-13,18,855,1,874
HARYANA,PANIPAT,2021-03-14,8,328,2,338
HARYANA,PANIPAT,2021-03-15,6,894,0,900
HARYANA,REWARI,2021-03-11,0,342,0,342
HARYANA,REWARI,2021-03-12,4,838,29,871
HARYANA,REWARI,2021-03-13,6,650,32,688
HARYANA,REWARI,2021-03-14,0,734,0,734
HARYANA,REWARI,2021-03-15,1,643,11,655
HARYANA,ROHTAK,2021-03-11,3,256,1,260
HARYANA,ROHTAK,2021-03-12,14,522,0,536
HARYANA,ROHTAK,2021-03-13,13,372,0,385
HARYANA,ROHTAK,2021-03-14,1,185,0,186
HARYANA,ROHTAK,2021-03-15,10,334,0,344
HARYANA,SIRSA,2021-03-11,2,708,11,721
HARYANA,SIRSA,2021-03-12,8,726,7,741
HARYANA,SIRSA,2021-03-13,2,815,44,861
HARYANA,SIRSA,2021-03-14,3,844,16,863
HARYANA,SIRSA,2021-03-15,4,614,1,619
HARYANA,SONIPAT,2021-03-11,9,1136,1,1146
HARYANA,SONIPAT,2021-03-12,10,1052,1,1063
HARYANA,SONIPAT,2021-03-13,17,1273,0,1290
HARYANA,SONIPAT,2021-03-14,14,811,0,825
HARYANA,SONIPAT,2021-03-15,7,456,0,463
HARYANA,YAMUNANAGAR,2021-03-11,46,509,4,559
HARYANA,YAMUNANAGAR,2021-03-12,32,952,1,985
HARYANA,YAMUNANAGAR,2021-03-13,42,624,1,667
HARYANA,YAMUNANAGAR,2021-03-14,17,243,0,260
HARYANA,YAMUNANAGAR,2021-03-15,102,588,1,691
HIMACHAL PRADESH,BILASPUR,2021-03-11,6,104,3,113
HIMACHAL PRADESH,BILASPUR,2021-03-12,2,214,2,218
HIMACHAL PRADESH,BILASPUR,2021-03-13,1,188,1,190
HIMACHAL PRADESH,BILASPUR,2021-03-14,2,93,0,95
HIMACHAL PRADESH,BILASPUR,2021-03-15,4,1360,0,1364
HIMACHAL PRADESH,CHAMBA,2021-03-11,0,169,1,170
HIMACHAL PRADESH,CHAMBA,2021-03-12,2,444,7,453
HIMACHAL PRADESH,CHAMBA,2021-03-13,1,268,1,270
HIMACHAL PRADESH,CHAMBA,2021-03-14,0,93,0,93
HIMACHAL PRADESH,CHAMBA,2021-03-15,1,359,4,364
HIMACHAL PRADESH,HAMIRPUR,2021-03-11,1,281,1,283
HIMACHAL PRADESH,HAMIRPUR,2021-03-12,6,121,2,129
HIMACHAL PRADESH,HAMIRPUR,2021-03-13,11,456,2,469
HIMACHAL PRADESH,HAMIRPUR,2021-03-14,2,204,0,206
HIMACHAL PRADESH,HAMIRPUR,2021-03-15,6,230,2,238
HIMACHAL PRADESH,KANGRA,2021-03-11,11,799,1,811
HIMACHAL PRADESH,KANGRA,2021-03-12,11,653,4,668
HIMACHAL PRADESH,KANGRA,2021-03-13,24,275,2,301
HIMACHAL PRADESH,KANGRA,2021-03-14,9,572,0,581
HIMACHAL PRADESH,KANGRA,2021-03-15,20,1069,3,1092
HIMACHAL PRADESH,KINNAUR,2021-03-11,0,1,0,1
HIMACHAL PRADESH,KINNAUR,2021-03-12,0,76,0,76
HIMACHAL PRADESH,KINNAUR,2021-03-13,0,44,1,45
HIMACHAL PRADESH,KINNAUR,2021-03-14,0,2,0,2
HIMACHAL PRADESH,KINNAUR,2021-03-15,0,46,0,46
HIMACHAL PRADESH,KULLU,2021-03-11,1,25,1,27
HIMACHAL PRADESH,KULLU,2021-03-12,4,75,2,81
HIMACHAL PRADESH,KULLU,2021-03-13,4,37,8,49
HIMACHAL PRADESH,KULLU,2021-03-14,0,27,1,28
HIMACHAL PRADESH,KULLU,2021-03-15,2,90,1,93
HIMACHAL PRADESH,LAHUL AND SPITI,2021-03-11,0,1,0,1
HIMACHAL PRADESH,LAHUL AND SPITI,2021-03-12,0,2,0,2
HIMACHAL PRADESH,LAHUL AND SPITI,2021-03-14,0,1,0,1
HIMACHAL PRADESH,LAHUL AND SPITI,2021-03-15,0,2,0,2
HIMACHAL PRADESH,MANDI,2021-03-11,3,94,16,113
HIMACHAL PRADESH,MANDI,2021-03-12,4,177,2,183
HIMACHAL PRADESH,MANDI,2021-03-13,16,299,51,366
HIMACHAL PRADESH,MANDI,2021-03-14,3,80,6,89
HIMACHAL PRADESH,MANDI,2021-03-15,6,366,3,375
HIMACHAL PRADESH,SHIMLA,2021-03-11,5,156,3,164
HIMACHAL PRADESH,SHIMLA,2021-03-12,11,332,1,344
HIMACHAL PRADESH,SHIMLA,2021-03-13,9,484,10,503
HIMACHAL PRADESH,SHIMLA,2021-03-14,8,127,5,140
HIMACHAL PRADESH,SHIMLA,2021-03-15,30,512,5,547
HIMACHAL PRADESH,SIRMAUR,2021-03-11,51,246,0,297
HIMACHAL PRADESH,SIRMAUR,2021-03-12,8,131,0,139
HIMACHAL PRADESH,SIRMAUR,2021-03-13,2,157,0,159
HIMACHAL PRADESH,SIRMAUR,2021-03-14,5,85,1,91
HIMACHAL PRADESH,SIRMAUR,2021-03-15,4,76,2,82
HIMACHAL PRADESH,SOLAN,2021-03-11,8,310,1,319
HIMACHAL PRADESH,SOLAN,2021-03-12,6,371,0,377
HIMACHAL PRADESH,SOLAN,2021-03-13,19,614,2,635
HIMACHAL PRADESH,SOLAN,2021-03-14,9,325,1,335
HIMACHAL PRADESH,SOLAN,2021-03-15,12,455,1,468
HIMACHAL PRADESH,UNA,2021-03-11,18,279,0,297
HIMACHAL PRADESH,UNA,2021-03-12,17,440,0,457
HIMACHAL PRADESH,UNA,2021-03-13,28,188,0,216
HIMACHAL PRADESH,UNA,2021-03-14,11,241,0,252
HIMACHAL PRADESH,UNA,2021-03-15,19,360,0,379
INDIA,INDIA,2021-03-11,8,2,0,10
INDIA,INDIA,2021-03-12,9,0,0,9
INDIA,INDIA,2021-03-13,6,1,0,7
INDIA,INDIA,2021-03-14,1,3,0,4
INDIA,INDIA,2021-03-15,8,3,0,11
JAMMU AND KASHMIR,ANANTNAG,2021-03-11,4,249,0,253
JAMMU AND KASHMIR,ANANTNAG,2021-03-12,1,259,0,260
JAMMU AND KASHMIR,ANANTNAG,2021-03-13,4,392,0,396
JAMMU AND KASHMIR,ANANTNAG,2021-03-14,1,164,0,165
JAMMU AND KASHMIR,ANANTNAG,2021-03-15,4,380,0,384
JAMMU AND KASHMIR,BANDIPORA,2021-03-11,1,44,0,45
JAMMU AND KASHMIR,BANDIPORA,2021-03-12,0,61,0,61
JAMMU AND KASHMIR,BANDIPORA,2021-03-13,2,291,3,296
JAMMU AND KASHMIR,BANDIPORA,2021-03-14,0,26,0,26
JAMMU AND KASHMIR,BANDIPORA,2021-03-15,2,89,2,93
JAMMU AND KASHMIR,BARAMULLA,2021-03-11,3,308,1,312
JAMMU AND KASHMIR,BARAMULLA,2021-03-12,10,304,0,314
JAMMU AND KASHMIR,BARAMULLA,2021-03-13,12,491,0,503
JAMMU AND KASHMIR,BARAMULLA,2021-03-14,0,248,0,248
JAMMU AND KASHMIR,BARAMULLA,2021-03-15,10,351,0,361
JAMMU AND KASHMIR,BUDGAM,2021-03-11,6,998,1,1005
JAMMU AND KASHMIR,BUDGAM,2021-03-12,8,711,0,719
JAMMU AND KASHMIR,BUDGAM,2021-03-13,2,710,0,712
JAMMU AND KASHMIR,BUDGAM,2021-03-14,0,205,0,205
JAMMU AND KASHMIR,BUDGAM,2021-03-15,18,830,0,848
JAMMU AND KASHMIR,DODA,2021-03-11,0,33,0,33
JAMMU AND KASHMIR,DODA,2021-03-12,0,9,0,9
JAMMU AND KASHMIR,DODA,2021-03-13,0,14,0,14
JAMMU AND KASHMIR,DODA,2021-03-14,1,23,0,24
JAMMU AND KASHMIR,DODA,2021-03-15,0,20,0,20
JAMMU AND KASHMIR,GANDERBAL,2021-03-11,4,128,0,132
JAMMU AND KASHMIR,GANDERBAL,2021-03-12,4,128,0,132
JAMMU AND KASHMIR,GANDERBAL,2021-03-13,0,66,0,66
JAMMU AND KASHMIR,GANDERBAL,2021-03-14,4,88,0,92
JAMMU AND KASHMIR,GANDERBAL,2021-03-15,2,96,0,98
JAMMU AND KASHMIR,JAMMU,2021-03-11,16,772,0,788
JAMMU AND KASHMIR,JAMMU,2021-03-12,15,840,0,855
JAMMU AND KASHMIR,JAMMU,2021-03-13,13,905,1,919
JAMMU AND KASHMIR,JAMMU,2021-03-14,7,575,0,582
JAMMU AND KASHMIR,JAMMU,2021-03-15,14,1092,1,1107
JAMMU AND KASHMIR,KATHUA,2021-03-11,0,44,0,44
JAMMU AND KASHMIR,KATHUA,2021-03-12,0,26,0,26
JAMMU AND KASHMIR,KATHUA,2021-03-13,1,196,1,198
JAMMU AND KASHMIR,KATHUA,2021-03-14,0,9,0,9
JAMMU AND KASHMIR,KATHUA,2021-03-15,2,64,0,66
JAMMU AND KASHMIR,KISHTWAR,2021-03-11,0,90,0,90
JAMMU AND KASHMIR,KISHTWAR,2021-03-12,0,90,0,90
JAMMU AND KASHMIR,KISHTWAR,2021-03-13,0,62,0,62
JAMMU AND KASHMIR,KISHTWAR,2021-03-14,0,56,0,56
JAMMU AND KASHMIR,KISHTWAR,2021-03-15,3,87,0,90
JAMMU AND KASHMIR,KULGAM,2021-03-11,0,54,1,55
JAMMU AND KASHMIR,KULGAM,2021-03-12,2,71,0,73
JAMMU AND KASHMIR,KULGAM,2021-03-13,2,87,0,89
JAMMU AND KASHMIR,KULGAM,2021-03-14,15,70,0,85
JAMMU AND KASHMIR,KULGAM,2021-03-15,2,228,0,230
JAMMU AND KASHMIR,KUPWARA,2021-03-11,7,146,0,153
JAMMU AND KASHMIR,KUPWARA,2021-03-12,0,154,0,154
JAMMU AND KASHMIR,KUPWARA,2021-03-13,2,152,0,154
JAMMU AND KASHMIR,KUPWARA,2021-03-14,0,131,0,131
JAMMU AND KASHMIR,KUPWARA,2021-03-15,8,302,1,311
JAMMU AND KASHMIR,POONCH,2021-03-11,0,141,0,141
JAMMU AND KASHMIR,POONCH,2021-03-12,1,183,0,184
JAMMU AND KASHMIR,POONCH,2021-03-13,0,321,3,324
JAMMU AND KASHMIR,POONCH,2021-03-14,0,179,0,179
JAMMU AND KASHMIR,POONCH,2021-03-15,1,371,0,372
JAMMU AND KASHMIR,PULWAMA,2021-03-11,4,304,1,309
JAMMU AND KASHMIR,PULWAMA,2021-03-12,6,409,0,415
JAMMU AND KASHMIR,PULWAMA,2021-03-13,4,810,2,816
JAMMU AND KASHMIR,PULWAMA,2021-03-14,1,173,0,174
JAMMU AND KASHMIR,PULWAMA,2021-03-15,7,577,3,587
JAMMU AND KASHMIR,RAJOURI,2021-03-11,0,50,0,50
JAMMU AND KASHMIR,RAJOURI,2021-03-12,2,57,0,59
JAMMU AND KASHMIR,RAJOURI,2021-03-13,0,166,1,167
JAMMU AND KASHMIR,RAJOURI,2021-03-14,1,80,0,81
JAMMU AND KASHMIR,RAJOURI,2021-03-15,0,237,1,238
JAMMU AND KASHMIR,RAMBAN,2021-03-11,0,64,0,64
JAMMU AND KASHMIR,RAMBAN,2021-03-12,0,16,0,16
JAMMU AND KASHMIR,RAMBAN,2021-03-13,0,39,0,39
JAMMU AND KASHMIR,RAMBAN,2021-03-14,0,40,0,40
JAMMU AND KASHMIR,RAMBAN,2021-03-15,4,169,0,173
JAMMU AND KASHMIR,REASI,2021-03-11,1,54,0,55
JAMMU AND KASHMIR,REASI,2021-03-12,2,89,0,91
JAMMU AND KASHMIR,REASI,2021-03-13,5,93,0,98
JAMMU AND KASHMIR,REASI,2021-03-14,0,5,0,5
JAMMU AND KASHMIR,REASI,2021-03-15,1,77,0,78
JAMMU AND KASHMIR,SAMBA,2021-03-11,0,90,0,90
JAMMU AND KASHMIR,SAMBA,2021-03-12,0,183,1,184
JAMMU AND KASHMIR,SAMBA,2021-03-13,0,91,0,91
JAMMU AND KASHMIR,SAMBA,2021-03-14,0,120,0,120
JAMMU AND KASHMIR,SAMBA,2021-03-15,0,114,1,115
JAMMU AND KASHMIR,SHOPIAN,2021-03-11,0,261,0,261
JAMMU AND KASHMIR,SHOPIAN,2021-03-12,0,209,0,209
JAMMU AND KASHMIR,SHOPIAN,2021-03-13,1,313,1,315
JAMMU AND KASHMIR,SHOPIAN,2021-03-14,0,16,0,16
JAMMU AND KASHMIR,SHOPIAN,2021-03-15,0,157,1,158
JAMMU AND KASHMIR,SRINAGAR,2021-03-11,54,3569,5,3628
JAMMU AND KASHMIR,SRINAGAR,2021-03-12,65,3549,2,3616
JAMMU AND KASHMIR,SRINAGAR,2021-03-13,32,3804,6,3842
JAMMU AND KASHMIR,SRINAGAR,2021-03-14,21,1813,0,1834
JAMMU AND KASHMIR,SRINAGAR,2021-03-15,82,3759,5,3846
JAMMU AND KASHMIR,UDHAMPUR,2021-03-11,1,456,5,462
JAMMU AND KASHMIR,UDHAMPUR,2021-03-12,2,428,0,430
JAMMU AND KASHMIR,UDHAMPUR,2021-03-13,0,635,0,635
JAMMU AND KASHMIR,UDHAMPUR,2021-03-14,0,82,0,82
JAMMU AND KASHMIR,UDHAMPUR,2021-03-15,1,719,1,721
JHARKHAND,BOKARO,2021-03-11,5,449,0,454
JHARKHAND,BOKARO,2021-03-12,2,813,2,817
JHARKHAND,BOKARO,2021-03-13,4,1286,4,1294
JHARKHAND,BOKARO,2021-03-14,2,209,0,211
JHARKHAND,BOKARO,2021-03-15,6,696,1,703
JHARKHAND,CHATRA,2021-03-11,0,40,0,40
JHARKHAND,CHATRA,2021-03-12,0,150,0,150
JHARKHAND,CHATRA,2021-03-13,1,632,0,633
JHARKHAND,CHATRA,2021-03-14,0,138,1,139
JHARKHAND,CHATRA,2021-03-15,1,199,0,200
JHARKHAND,DEOGHAR,2021-03-11,0,406,0,406
JHARKHAND,DEOGHAR,2021-03-12,0,310,0,310
JHARKHAND,DEOGHAR,2021-03-13,2,246,0,248
JHARKHAND,DEOGHAR,2021-03-14,1,289,0,290
JHARKHAND,DEOGHAR,2021-03-15,3,719,0,722
JHARKHAND,DHANBAD,2021-03-11,3,122,0,125
JHARKHAND,DHANBAD,2021-03-12,1,252,0,253
JHARKHAND,DHANBAD,2021-03-13,2,2019,0,2021
JHARKHAND,DHANBAD,2021-03-14,4,502,0,506
JHARKHAND,DHANBAD,2021-03-15,1,303,0,304
JHARKHAND,DUMKA,2021-03-11,0,581,7,588
JHARKHAND,DUMKA,2021-03-12,1,676,3,680
JHARKHAND,DUMKA,2021-03-13,1,674,4,679
JHARKHAND,DUMKA,2021-03-14,0,361,3,364
JHARKHAND,DUMKA,2021-03-15,1,172,9,182
JHARKHAND,EAST SINGHBUM,2021-03-11,23,1546,2,1571
JHARKHAND,EAST SINGHBUM,2021-03-12,15,1868,3,1886
JHARKHAND,EAST SINGHBUM,2021-03-13,7,1701,1,1709
JHARKHAND,EAST SINGHBUM,2021-03-14,9,584,0,593
JHARKHAND,EAST SINGHBUM,2021-03-15,18,1751,0,1769
JHARKHAND,GARHWA,2021-03-11,0,343,1,344
JHARKHAND,GARHWA,2021-03-12,0,749,1,750
JHARKHAND,GARHWA,2021-03-13,0,487,1,488
JHARKHAND,GARHWA,2021-03-14,0,309,1,310
JHARKHAND,GARHWA,2021-03-15,0,450,0,450
JHARKHAND,GIRIDIH,2021-03-11,2,639,0,641
JHARKHAND,GIRIDIH,2021-03-12,0,1467,0,1467
JHARKHAND,GIRIDIH,2021-03-13,6,2033,1,2040
JHARKHAND,GIRIDIH,2021-03-14,2,504,0,506
JHARKHAND,GIRIDIH,2021-03-15,3,1031,0,1034
JHARKHAND,GODDA,2021-03-11,0,108,0,108
JHARKHAND,GODDA,2021-03-12,1,290,1,292
JHARKHAND,GODDA,2021-03-13,0,266,0,266
JHARKHAND,GODDA,2021-03-14,0,28,0,28
JHARKHAND,GODDA,2021-03-15,0,101,0,101
JHARKHAND,GUMLA,2021-03-11,2,86,0,88
JHARKHAND,GUMLA,2021-03-12,2,565,0,567
JHARKHAND,GUMLA,2021-03-13,4,327,0,331
JHARKHAND,GUMLA,2021-03-14,2,11,0,13
JHARKHAND,GUMLA,2021-03-15,5,147,0,152
JHARKHAND,HAZARIBAGH,2021-03-11,0,482,0,482
JHARKHAND,HAZARIBAGH,2021-03-12,1,510,0,511
JHARKHAND,HAZARIBAGH,2021-03-13,4,368,0,372
JHARKHAND,HAZARIBAGH,2021-03-14,0,281,0,281
JHARKHAND,HAZARIBAGH,2021-03-15,1,553,1,555
JHARKHAND,JAMTARA,2021-03-11,0,42,0,42
JHARKHAND,JAMTARA,2021-03-12,0,87,0,87
JHARKHAND,JAMTARA,2021-03-13,0,220,0,220
JHARKHAND,JAMTARA,2021-03-14,1,72,0,73
JHARKHAND,JAMTARA,2021-03-15,1,321,0,322
JHARKHAND,KHUNTI,2021-03-11,0,90,0,90
JHARKHAND,KHUNTI,2021-03-12,0,217,2,219
JHARKHAND,KHUNTI,2021-03-13,0,327,0,327
JHARKHAND,KHUNTI,2021-03-14,0,42,0,42
JHARKHAND,KHUNTI,2021-03-15,0,47,0,47
JHARKHAND,KODERMA,2021-03-11,0,266,1,267
JHARKHAND,KODERMA,2021-03-12,3,441,0,444
JHARKHAND,KODERMA,2021-03-13,1,578,0,579
JHARKHAND,KODERMA,2021-03-14,0,56,0,56
JHARKHAND,KODERMA,2021-03-15,1,649,0,650
JHARKHAND,LATEHAR,2021-03-11,0,3,0,3
JHARKHAND,LATEHAR,2021-03-12,1,632,0,633
JHARKHAND,LATEHAR,2021-03-13,1,553,0,554
JHARKHAND,LATEHAR,2021-03-14,2,204,7,213
JHARKHAND,LATEHAR,2021-03-15,0,787,0,787
JHARKHAND,LOHARDAGA,2021-03-11,3,97,0,100
JHARKHAND,LOHARDAGA,2021-03-12,0,141,0,141
JHARKHAND,LOHARDAGA,2021-03-13,0,98,0,98
JHARKHAND,LOHARDAGA,2021-03-14,0,57,0,57
JHARKHAND,LOHARDAGA,2021-03-15,0,266,0,266
JHARKHAND,PAKUR,2021-03-11,1,1,1,3
JHARKHAND,PAKUR,2021-03-12,0,143,0,143
JHARKHAND,PAKUR,2021-03-13,2,157,0,159
JHARKHAND,PAKUR,2021-03-14,2,38,0,40
JHARKHAND,PAKUR,2021-03-15,0,4,0,4
JHARKHAND,PALAMU,2021-03-11,0,812,0,812
JHARKHAND,PALAMU,2021-03-12,1,523,0,524
JHARKHAND,PALAMU,2021-03-13,0,633,0,633
JHARKHAND,PALAMU,2021-03-14,1,824,1,826
JHARKHAND,PALAMU,2021-03-15,2,991,0,993
JHARKHAND,RAMGARH,2021-03-11,3,143,1,147
JHARKHAND,RAMGARH,2021-03-12,1,76,0,77
JHARKHAND,RAMGARH,2021-03-13,0,161,0,161
JHARKHAND,RAMGARH,2021-03-14,0,17,0,17
JHARKHAND,RAMGARH,2021-03-15,2,224,0,226
JHARKHAND,RANCHI,2021-03-11,85,863,0,948
JHARKHAND,RANCHI,2021-03-12,71,982,2,1055
JHARKHAND,RANCHI,2021-03-13,93,1472,0,1565
JHARKHAND,RANCHI,2021-03-14,71,558,0,629
JHARKHAND,RANCHI,2021-03-15,121,1323,1,1445
JHARKHAND,SAHEBGANJ,2021-03-11,0,62,0,62
JHARKHAND,SAHEBGANJ,2021-03-12,0,228,0,228
JHARKHAND,SAHEBGANJ,2021-03-13,0,149,0,149
JHARKHAND,SAHEBGANJ,2021-03-14,0,41,0,41
JHARKHAND,SAHEBGANJ,2021-03-15,0,105,0,105
JHARKHAND,SARAIKELA KHARSAWAN,2021-03-11,3,520,0,523
JHARKHAND,SARAIKELA KHARSAWAN,2021-03-12,0,229,0,229
JHARKHAND,SARAIKELA KHARSAWAN,2021-03-13,1,77,0,78
JHARKHAND,SARAIKELA KHARSAWAN,2021-03-14,1,28,0,29
JHARKHAND,SARAIKELA KHARSAWAN,2021-03-15,0,123,0,123
JHARKHAND,SIMDEGA,2021-03-11,2,178,0,180
JHARKHAND,SIMDEGA,2021-03-12,0,811,0,811
JHARKHAND,SIMDEGA,2021-03-13,1,425,0,426
JHARKHAND,SIMDEGA,2021-03-14,2,167,0,169
JHARKHAND,SIMDEGA,2021-03-15,0,224,0,224
JHARKHAND,WEST SINGHBHUM,2021-03-11,0,599,0,599
JHARKHAND,WEST SINGHBHUM,2021-03-12,0,242,1,243
JHARKHAND,WEST SINGHBHUM,2021-03-13,0,719,0,719
JHARKHAND,WEST SINGHBHUM,2021-03-14,0,1097,0,1097
JHARKHAND,WEST SINGHBHUM,2021-03-15,0,98,0,98
KARNATAKA,BAGALKOTE,2021-03-11,5,887,1,893
KARNATAKA,BAGALKOTE,2021-03-12,3,1903,2,1908
KARNATAKA,BAGALKOTE,2021-03-13,0,1312,2,1314
KARNATAKA,BAGALKOTE,2021-03-14,1,2645,0,2646
KARNATAKA,BAGALKOTE,2021-03-15,4,1545,1,1550
KARNATAKA,BALLARI,2021-03-11,18,2191,14,2223
KARNATAKA,BALLARI,2021-03-12,5,1218,24,1247
KARNATAKA,BALLARI,2021-03-13,11,2473,30,2514
KARNATAKA,BALLARI,2021-03-14,19,2646,5,2670
KARNATAKA,BALLARI,2021-03-15,7,1820,12,1839
KARNATAKA,BELAGAVI,2021-03-11,5,1523,1,1529
KARNATAKA,BELAGAVI,2021-03-12,12,1432,0,1444
KARNATAKA,BELAGAVI,2021-03-13,20,1187,4,1211
KARNATAKA,BELAGAVI,2021-03-14,13,703,2,718
KARNATAKA,BELAGAVI,2021-03-15,18,1427,0,1445
KARNATAKA,BENGALURU RURAL,2021-03-11,8,419,1,428
KARNATAKA,BENGALURU RURAL,2021-03-12,22,923,3,948
KARNATAKA,BENGALURU RURAL,2021-03-13,17,704,2,723
KARNATAKA,BENGALURU RURAL,2021-03-14,9,496,2,507
KARNATAKA,BENGALURU RURAL,2021-03-15,45,1211,6,1262
KARNATAKA,BENGALURU URBAN,2021-03-11,568,38139,473,39180
KARNATAKA,BENGALURU URBAN,2021-03-12,647,38803,411,39861
KARNATAKA,BENGALURU URBAN,2021-03-13,684,37037,244,37965
KARNATAKA,BENGALURU URBAN,2021-03-14,589,29735,122,30446
KARNATAKA,BENGALURU URBAN,2021-03-15,779,37615,204,38598
KARNATAKA,BIDAR,2021-03-11,25,1042,0,1067
KARNATAKA,BIDAR,2021-03-12,16,320,1,337
KARNATAKA,BIDAR,2021-03-13,16,891,2,909
KARNATAKA,BIDAR,2021-03-14,38,675,0,713
KARNATAKA,BIDAR,2021-03-15,35,655,2,692
KARNATAKA,CHAMARAJANAGARA,2021-03-11,1,669,2,672
KARNATAKA,CHAMARAJANAGARA,2021-03-12,0,242,1,243
KARNATAKA,CHAMARAJANAGARA,2021-03-13,4,632,1,637
KARNATAKA,CHAMARAJANAGARA,2021-03-14,3,382,0,385
KARNATAKA,CHAMARAJANAGARA,2021-03-15,0,181,0,181
KARNATAKA,CHIKKABALLAPURA,2021-03-11,8,1536,0,1544
KARNATAKA,CHIKKABALLAPURA,2021-03-12,2,893,0,895
KARNATAKA,CHIKKABALLAPURA,2021-03-13,6,1002,2,1010
KARNATAKA,CHIKKABALLAPURA,2021-03-14,12,1327,5,1344
KARNATAKA,CHIKKABALLAPURA,2021-03-15,8,899,1,908
KARNATAKA,CHIKKAMAGALURU,2021-03-11,6,973,0,979
KARNATAKA,CHIKKAMAGALURU,2021-03-12,7,307,1,315
KARNATAKA,CHIKKAMAGALURU,2021-03-13,4,528,1,533
KARNATAKA,CHIKKAMAGALURU,2021-03-14,3,355,1,359
KARNATAKA,CHIKKAMAGALURU,2021-03-15,3,215,2,220
KARNATAKA,CHITRADURGA,2021-03-11,1,217,0,218
KARNATAKA,CHITRADURGA,2021-03-12,4,729,4,737
KARNATAKA,CHITRADURGA,2021-03-13,5,1519,3,1527
KARNATAKA,CHITRADURGA,2021-03-14,9,1338,1,1348
KARNATAKA,CHITRADURGA,2021-03-15,11,394,3,408
KARNATAKA,DAKSHINA KANNADA,2021-03-11,39,1824,0,1863
KARNATAKA,DAKSHINA KANNADA,2021-03-12,46,2160,0,2206
KARNATAKA,DAKSHINA KANNADA,2021-03-13,60,1961,4,2025
KARNATAKA,DAKSHINA KANNADA,2021-03-14,115,674,0,789
KARNATAKA,DAKSHINA KANNADA,2021-03-15,52,1634,3,1689
KARNATAKA,DAVANGERE,2021-03-11,1,2000,12,2013
KARNATAKA,DAVANGERE,2021-03-12,5,1596,102,1703
KARNATAKA,DAVANGERE,2021-03-13,5,1990,78,2073
KARNATAKA,DAVANGERE,2021-03-14,0,2102,53,2155
KARNATAKA,DAVANGERE,2021-03-15,7,1904,88,1999
KARNATAKA,DHARWAD,2021-03-11,8,1772,6,1786
KARNATAKA,DHARWAD,2021-03-12,10,1863,30,1903
KARNATAKA,DHARWAD,2021-03-13,26,2454,20,2500
KARNATAKA,DHARWAD,2021-03-14,19,1284,14,1317
KARNATAKA,DHARWAD,2021-03-15,5,1674,57,1736
KARNATAKA,GADAG,2021-03-11,3,970,47,1020
KARNATAKA,GADAG,2021-03-12,6,533,27,566
KARNATAKA,GADAG,2021-03-13,1,1131,99,1231
KARNATAKA,GADAG,2021-03-14,0,842,147,989
KARNATAKA,GADAG,2021-03-15,12,690,45,747
KARNATAKA,HASSAN,2021-03-11,13,2201,50,2264
KARNATAKA,HASSAN,2021-03-12,12,2366,200,2578
KARNATAKA,HASSAN,2021-03-13,14,651,5,670
KARNATAKA,HASSAN,2021-03-14,16,2479,3,2498
KARNATAKA,HASSAN,2021-03-15,16,242,10,268
KARNATAKA,HAVERI,2021-03-11,0,520,0,520
KARNATAKA,HAVERI,2021-03-12,0,842,0,842
KARNATAKA,HAVERI,2021-03-13,0,383,0,383
KARNATAKA,HAVERI,2021-03-14,0,304,3,307
KARNATAKA,HAVERI,2021-03-15,0,430,1,431
KARNATAKA,KALABURAGI,2021-03-11,50,1058,8,1116
KARNATAKA,KALABURAGI,2021-03-12,55,2009,9,2073
KARNATAKA,KALABURAGI,2021-03-13,38,2716,15,2769
KARNATAKA,KALABURAGI,2021-03-14,53,1285,46,1384
KARNATAKA,KALABURAGI,2021-03-15,54,865,8,927
KARNATAKA,KODAGU,2021-03-11,5,844,11,860
KARNATAKA,KODAGU,2021-03-12,2,145,0,147
KARNATAKA,KODAGU,2021-03-13,9,831,32,872
KARNATAKA,KODAGU,2021-03-14,0,20,0,20
KARNATAKA,KODAGU,2021-03-15,1,129,6,136
KARNATAKA,KOLAR,2021-03-11,16,1354,4,1374
KARNATAKA,KOLAR,2021-03-12,4,799,2,805
KARNATAKA,KOLAR,2021-03-13,12,1263,10,1285
KARNATAKA,KOLAR,2021-03-14,6,1090,0,1096
KARNATAKA,KOLAR,2021-03-15,6,688,2,696
KARNATAKA,KOPPAL,2021-03-11,3,762,1,766
KARNATAKA,KOPPAL,2021-03-12,0,208,0,208
KARNATAKA,KOPPAL,2021-03-13,2,509,2,513
KARNATAKA,KOPPAL,2021-03-14,1,498,1,500
KARNATAKA,KOPPAL,2021-03-15,2,146,1,149
KARNATAKA,MANDYA,2021-03-11,2,1177,6,1185
KARNATAKA,MANDYA,2021-03-12,10,838,7,855
KARNATAKA,MANDYA,2021-03-13,3,1712,9,1724
KARNATAKA,MANDYA,2021-03-14,7,916,1,924
KARNATAKA,MANDYA,2021-03-15,3,1112,6,1121
KARNATAKA,MYSURU,2021-03-11,25,2511,20,2556
KARNATAKA,MYSURU,2021-03-12,49,1196,2,1247
KARNATAKA,MYSURU,2021-03-13,48,2289,35,2372
KARNATAKA,MYSURU,2021-03-14,45,1728,0,1773
KARNATAKA,MYSURU,2021-03-15,44,1664,0,1708
KARNATAKA,RAICHUR,2021-03-11,2,454,0,456
KARNATAKA,RAICHUR,2021-03-12,1,836,53,890
KARNATAKA,RAICHUR,2021-03-13,3,559,2,564
KARNATAKA,RAICHUR,2021-03-14,2,436,0,438
KARNATAKA,RAICHUR,2021-03-15,7,868,0,875
KARNATAKA,RAMANAGARA,2021-03-11,2,752,0,754
KARNATAKA,RAMANAGARA,2021-03-12,0,356,2,358
KARNATAKA,RAMANAGARA,2021-03-13,1,649,2,652
KARNATAKA,RAMANAGARA,2021-03-14,2,411,0,413
KARNATAKA,RAMANAGARA,2021-03-15,2,301,1,304
KARNATAKA,SHIVAMOGGA,2021-03-11,3,781,7,791
KARNATAKA,SHIVAMOGGA,2021-03-12,7,915,1,923
KARNATAKA,SHIVAMOGGA,2021-03-13,9,571,2,582
KARNATAKA,SHIVAMOGGA,2021-03-14,6,1093,7,1106
KARNATAKA,SHIVAMOGGA,2021-03-15,7,686,1,694
KARNATAKA,TUMAKURU,2021-03-11,38,976,5,1019
KARNATAKA,TUMAKURU,2021-03-12,41,2413,12,2466
KARNATAKA,TUMAKURU,2021-03-13,20,1031,6,1057
KARNATAKA,TUMAKURU,2021-03-14,40,1148,7,1195
KARNATAKA,TUMAKURU,2021-03-15,35,2300,29,2364
KARNATAKA,UDUPI,2021-03-11,11,1236,0,1247
KARNATAKA,UDUPI,2021-03-12,15,1422,0,1437
KARNATAKA,UDUPI,2021-03-13,13,1409,0,1422
KARNATAKA,UDUPI,2021-03-14,26,1125,4,1155
KARNATAKA,UDUPI,2021-03-15,50,1572,2,1624
KARNATAKA,UTTARA KANNADA,2021-03-11,10,1495,36,1541
KARNATAKA,UTTARA KANNADA,2021-03-12,6,1121,7,1134
KARNATAKA,UTTARA KANNADA,2021-03-13,9,678,8,695
KARNATAKA,UTTARA KANNADA,2021-03-14,8,1372,95,1475
KARNATAKA,UTTARA KANNADA,2021-03-15,3,1405,45,1453
KARNATAKA,VIJAYAPURA,2021-03-11,8,969,0,977
KARNATAKA,VIJAYAPURA,2021-03-12,10,1738,0,1748
KARNATAKA,VIJAYAPURA,2021-03-13,10,708,0,718
KARNATAKA,VIJAYAPURA,2021-03-14,0,858,0,858
KARNATAKA,VIJAYAPURA,2021-03-15,15,1992,3,2010
KARNATAKA,YADGIR,2021-03-11,4,877,0,881
KARNATAKA,YADGIR,2021-03-12,2,736,1,739
KARNATAKA,YADGIR,2021-03-13,5,782,0,787
KARNATAKA,YADGIR,2021-03-14,2,866,0,868
KARNATAKA,YADGIR,2021-03-15,3,487,0,490
KERALA,ALAPPUZHA,2021-03-11,70,3481,48,3599
KERALA,ALAPPUZHA,2021-03-12,51,6717,378,7146
KERALA,ALAPPUZHA,2021-03-13,50,7652,313,8015
KERALA,ALAPPUZHA,2021-03-14,1739,62,205,2006
KERALA,ALAPPUZHA,2021-03-15,1765,6391,74,8230
KERALA,ERNAKULAM,2021-03-11,120,10978,48,11146
KERALA,ERNAKULAM,2021-03-12,227,15848,333,16408
KERALA,ERNAKULAM,2021-03-13,179,15773,290,16242
KERALA,ERNAKULAM,2021-03-14,7373,147,285,7805
KERALA,ERNAKULAM,2021-03-15,4873,12751,78,17702
KERALA,IDUKKI,2021-03-11,15,1056,180,1251
KERALA,IDUKKI,2021-03-12,8,920,106,1034
KERALA,IDUKKI,2021-03-13,6,989,51,1046
KERALA,IDUKKI,2021-03-14,1574,37,49,1660
KERALA,IDUKKI,2021-03-15,1139,3581,20,4740
KERALA,KANNUR,2021-03-11,89,3439,9,3537
KERALA,KANNUR,2021-03-12,17,7201,100,7318
KERALA,KANNUR,2021-03-13,18,6598,69,6685
KERALA,KANNUR,2021-03-14,3044,93,201,3338
KERALA,KANNUR,2021-03-15,1541,6643,27,8211
KERALA,KASARAGOD,2021-03-11,86,2122,31,2239
KERALA,KASARAGOD,2021-03-12,38,4383,113,4534
KERALA,KASARAGOD,2021-03-13,22,4906,202,5130
KERALA,KASARAGOD,2021-03-14,565,72,84,721
KERALA,KASARAGOD,2021-03-15,368,3158,20,3546
KERALA,KOLLAM,2021-03-11,72,2926,17,3015
KERALA,KOLLAM,2021-03-12,20,5187,266,5473
KERALA,KOLLAM,2021-03-13,8,4831,639,5478
KERALA,KOLLAM,2021-03-14,2147,99,117,2363
KERALA,KOLLAM,2021-03-15,2833,9742,32,12607
KERALA,KOTTAYAM,2021-03-11,118,2987,183,3288
KERALA,KOTTAYAM,2021-03-12,220,4016,353,4589
KERALA,KOTTAYAM,2021-03-13,118,4594,176,4888
KERALA,KOTTAYAM,2021-03-14,3047,62,103,3212
KERALA,KOTTAYAM,2021-03-15,3412,7434,65,10911
KERALA,KOZHIKODE,2021-03-11,83,6333,102,6518
KERALA,KOZHIKODE,2021-03-12,37,16505,580,17122
KERALA,KOZHIKODE,2021-03-13,54,15602,472,16128
KERALA,KOZHIKODE,2021-03-14,4037,136,480,4653
KERALA,KOZHIKODE,2021-03-15,3070,9345,150,12565
KERALA,MALAPPURAM,2021-03-11,55,9356,84,9495
KERALA,MALAPPURAM,2021-03-12,31,17998,172,18201
KERALA,MALAPPURAM,2021-03-13,27,14160,212,14399
KERALA,MALAPPURAM,2021-03-14,2818,125,433,3376
KERALA,MALAPPURAM,2021-03-15,1541,7560,70,9171
KERALA,PALAKKAD,2021-03-11,49,4809,30,4888
KERALA,PALAKKAD,2021-03-12,61,9183,214,9458
KERALA,PALAKKAD,2021-03-13,29,9333,81,9443
KERALA,PALAKKAD,2021-03-14,4502,137,322,4961
KERALA,PALAKKAD,2021-03-15,1671,6254,26,7951
KERALA,PATHANAMTHITTA,2021-03-11,59,3249,26,3334
KERALA,PATHANAMTHITTA,2021-03-12,124,7858,194,8176
KERALA,PATHANAMTHITTA,2021-03-13,30,9479,100,9609
KERALA,PATHANAMTHITTA,2021-03-14,2752,43,45,2840
KERALA,PATHANAMTHITTA,2021-03-15,2071,7352,38,9461
KERALA,THIRUVANANTHAPURAM,2021-03-11,67,5450,29,5546
KERALA,THIRUVANANTHAPURAM,2021-03-12,33,11313,162,11508
KERALA,THIRUVANANTHAPURAM,2021-03-13,23,13836,209,14068
KERALA,THIRUVANANTHAPURAM,2021-03-14,2463,146,146,2755
KERALA,THIRUVANANTHAPURAM,2021-03-15,2451,9719,47,12217
KERALA,THRISSUR,2021-03-11,82,11106,66,11254
KERALA,THRISSUR,2021-03-12,45,23833,108,23986
KERALA,THRISSUR,2021-03-13,37,25695,42,25774
KERALA,THRISSUR,2021-03-14,5528,342,234,6104
KERALA,THRISSUR,2021-03-15,3457,12425,27,15909
KERALA,WAYANAD,2021-03-11,15,1767,33,1815
KERALA,WAYANAD,2021-03-12,4,4726,290,5020
KERALA,WAYANAD,2021-03-13,3,6524,295,6822
KERALA,WAYANAD,2021-03-14,1511,56,120,1687
KERALA,WAYANAD,2021-03-15,1537,3803,74,5414
LADAKH,KARGIL,2021-03-11,0,54,0,54
LADAKH,KARGIL,2021-03-12,1,97,0,98
LADAKH,KARGIL,2021-03-13,0,84,1,85
LADAKH,KARGIL,2021-03-14,0,46,0,46
LADAKH,KARGIL,2021-03-15,2,256,2,260
LADAKH,LEH LADAKH,2021-03-11,2,158,2,162
LADAKH,LEH LADAKH,2021-03-12,5,120,0,125
LADAKH,LEH LADAKH,2021-03-13,2,302,2,306
LADAKH,LEH LADAKH,2021-03-14,0,24,0,24
LADAKH,LEH LADAKH,2021-03-15,5,509,0,514
LAKSHADWEEP,LAKSHADWEEP DISTRICT,2021-03-11,30,477,0,507
LAKSHADWEEP,LAKSHADWEEP DISTRICT,2021-03-12,6,224,0,230
LAKSHADWEEP,LAKSHADWEEP DISTRICT,2021-03-13,14,456,2,472
LAKSHADWEEP,LAKSHADWEEP DISTRICT,2021-03-14,1,196,0,197
LAKSHADWEEP,LAKSHADWEEP DISTRICT,2021-03-15,16,596,0,612
MADHYA PRADESH,AGAR MALWA,2021-03-11,2,230,0,232
MADHYA PRADESH,AGAR MALWA,2021-03-12,1,34,0,35
MADHYA PRADESH,AGAR MALWA,2021-03-13,1,166,1,168
MADHYA PRADESH,AGAR MALWA,2021-03-14,2,53,0,55
MADHYA PRADESH,AGAR MALWA,2021-03-15,1,172,0,173
MADHYA PRADESH,ALIRAJPUR,2021-03-11,2,42,0,44
MADHYA PRADESH,ALIRAJPUR,2021-03-12,8,253,0,261
MADHYA PRADESH,ALIRAJPUR,2021-03-13,2,153,0,155
MADHYA PRADESH,ALIRAJPUR,2021-03-14,1,26,0,27
MADHYA PRADESH,ALIRAJPUR,2021-03-15,2,84,0,86
MADHYA PRADESH,ANUPPUR,2021-03-11,0,43,0,43
MADHYA PRADESH,ANUPPUR,2021-03-12,2,83,0,85
MADHYA PRADESH,ANUPPUR,2021-03-13,0,61,0,61
MADHYA PRADESH,ANUPPUR,2021-03-14,0,32,0,32
MADHYA PRADESH,ANUPPUR,2021-03-15,5,103,0,108
MADHYA PRADESH,ASHOKNAGAR,2021-03-11,1,84,0,85
MADHYA PRADESH,ASHOKNAGAR,2021-03-12,4,88,0,92
MADHYA PRADESH,ASHOKNAGAR,2021-03-13,3,95,0,98
MADHYA PRADESH,ASHOKNAGAR,2021-03-14,1,15,0,16
MADHYA PRADESH,ASHOKNAGAR,2021-03-15,2,105,0,107
MADHYA PRADESH,BALAGHAT,2021-03-11,4,253,0,257
MADHYA PRADESH,BALAGHAT,2021-03-12,0,470,0,470
MADHYA PRADESH,BALAGHAT,2021-03-13,2,217,0,219
MADHYA PRADESH,BALAGHAT,2021-03-14,2,25,0,27
MADHYA PRADESH,BALAGHAT,2021-03-15,7,152,0,159
MADHYA PRADESH,BARWANI,2021-03-11,4,123,0,127
MADHYA PRADESH,BARWANI,2021-03-12,11,54,0,65
MADHYA PRADESH,BARWANI,2021-03-13,9,136,0,145
MADHYA PRADESH,BARWANI,2021-03-14,17,218,0,235
MADHYA PRADESH,BARWANI,2021-03-15,9,123,0,132
MADHYA PRADESH,BETUL,2021-03-11,27,259,2,288
MADHYA PRADESH,BETUL,2021-03-12,7,239,0,246
MADHYA PRADESH,BETUL,2021-03-13,22,251,0,273
MADHYA PRADESH,BETUL,2021-03-14,11,183,2,196
MADHYA PRADESH,BETUL,2021-03-15,11,167,1,179
MADHYA PRADESH,BHIND,2021-03-11,1,166,0,167
MADHYA PRADESH,BHIND,2021-03-12,0,153,0,153
MADHYA PRADESH,BHIND,2021-03-13,1,121,1,123
MADHYA PRADESH,BHIND,2021-03-14,1,255,0,256
MADHYA PRADESH,BHIND,2021-03-15,1,102,0,103
MADHYA PRADESH,BHOPAL,2021-03-11,243,1603,7,1853
MADHYA PRADESH,BHOPAL,2021-03-12,196,1195,6,1397
MADHYA PRADESH,BHOPAL,2021-03-13,263,1369,7,1639
MADHYA PRADESH,BHOPAL,2021-03-14,182,1100,7,1289
MADHYA PRADESH,BHOPAL,2021-03-15,264,1298,3,1565
MADHYA PRADESH,BURHANPUR,2021-03-11,36,528,0,564
MADHYA PRADESH,BURHANPUR,2021-03-12,19,340,0,359
MADHYA PRADESH,BURHANPUR,2021-03-13,21,492,0,513
MADHYA PRADESH,BURHANPUR,2021-03-14,8,279,3,290
MADHYA PRADESH,BURHANPUR,2021-03-15,27,511,0,538
MADHYA PRADESH,CHHATARPUR,2021-03-11,1,164,0,165
MADHYA PRADESH,CHHATARPUR,2021-03-12,1,154,0,155
MADHYA PRADESH,CHHATARPUR,2021-03-13,0,71,0,71
MADHYA PRADESH,CHHATARPUR,2021-03-14,1,98,0,99
MADHYA PRADESH,CHHATARPUR,2021-03-15,0,175,0,175
MADHYA PRADESH,CHHINDWARA,2021-03-11,29,146,2,177
MADHYA PRADESH,CHHINDWARA,2021-03-12,46,296,0,342
MADHYA PRADESH,CHHINDWARA,2021-03-13,45,281,46,372
MADHYA PRADESH,CHHINDWARA,2021-03-14,25,196,18,239
MADHYA PRADESH,CHHINDWARA,2021-03-15,36,248,3,287
MADHYA PRADESH,DAMOH,2021-03-11,0,237,0,237
MADHYA PRADESH,DAMOH,2021-03-12,10,196,0,206
MADHYA PRADESH,DAMOH,2021-03-13,5,77,0,82
MADHYA PRADESH,DAMOH,2021-03-14,1,12,0,13
MADHYA PRADESH,DAMOH,2021-03-15,8,381,2,391
MADHYA PRADESH,DATIA,2021-03-11,0,79,0,79
MADHYA PRADESH,DATIA,2021-03-12,0,178,34,212
MADHYA PRADESH,DATIA,2021-03-13,2,219,14,235
MADHYA PRADESH,DATIA,2021-03-14,0,58,0,58
MADHYA PRADESH,DATIA,2021-03-15,2,237,15,254
MADHYA PRADESH,DEWAS,2021-03-11,2,33,0,35
MADHYA PRADESH,DEWAS,2021-03-12,22,704,0,726
MADHYA PRADESH,DEWAS,2021-03-13,3,811,0,814
MADHYA PRADESH,DEWAS,2021-03-14,0,233,0,233
MADHYA PRADESH,DEWAS,2021-03-15,23,400,0,423
MADHYA PRADESH,DHAR,2021-03-11,11,159,0,170
MADHYA PRADESH,DHAR,2021-03-12,7,141,0,148
MADHYA PRADESH,DHAR,2021-03-13,14,170,0,184
MADHYA PRADESH,DHAR,2021-03-14,5,118,0,123
MADHYA PRADESH,DHAR,2021-03-15,8,227,1,236
MADHYA PRADESH,DINDORI,2021-03-11,1,38,0,39
MADHYA PRADESH,DINDORI,2021-03-12,1,424,1,426
MADHYA PRADESH,DINDORI,2021-03-13,0,298,0,298
MADHYA PRADESH,DINDORI,2021-03-14,1,99,0,100
MADHYA PRADESH,DINDORI,2021-03-15,1,54,0,55
MADHYA PRADESH,EAST NIMAR,2021-03-11,12,217,1,230
MADHYA PRADESH,EAST NIMAR,2021-03-12,3,167,0,170
MADHYA PRADESH,EAST NIMAR,2021-03-13,13,367,0,380
MADHYA PRADESH,EAST NIMAR,2021-03-14,21,276,5,302
MADHYA PRADESH,EAST NIMAR,2021-03-15,20,233,0,253
MADHYA PRADESH,GUNA,2021-03-11,0,175,1,176
MADHYA PRADESH,GUNA,2021-03-12,5,238,1,244
MADHYA PRADESH,GUNA,2021-03-13,4,254,0,258
MADHYA PRADESH,GUNA,2021-03-14,4,110,0,114
MADHYA PRADESH,GUNA,2021-03-15,1,242,0,243
MADHYA PRADESH,GWALIOR,2021-03-11,39,533,2,574
MADHYA PRADESH,GWALIOR,2021-03-12,26,687,0,713
MADHYA PRADESH,GWALIOR,2021-03-13,39,592,1,632
MADHYA PRADESH,GWALIOR,2021-03-14,18,474,0,492
MADHYA PRADESH,GWALIOR,2021-03-15,33,659,1,693
MADHYA PRADESH,HARDA,2021-03-11,3,119,1,123
MADHYA PRADESH,HARDA,2021-03-12,0,148,0,148
MADHYA PRADESH,HARDA,2021-03-13,5,150,0,155
MADHYA PRADESH,HARDA,2021-03-14,0,119,10,129
MADHYA PRADESH,HARDA,2021-03-15,1,156,0,157
MADHYA PRADESH,HOSHANGABAD,2021-03-11,13,198,0,211
MADHYA PRADESH,HOSHANGABAD,2021-03-12,6,172,0,178
MADHYA PRADESH,HOSHANGABAD,2021-03-13,7,118,0,125
MADHYA PRADESH,HOSHANGABAD,2021-03-14,2,193,1,196
MADHYA PRADESH,HOSHANGABAD,2021-03-15,10,144,0,154
MADHYA PRADESH,INDORE,2021-03-11,847,2449,3,3299
MADHYA PRADESH,INDORE,2021-03-12,690,2554,0,3244
MADHYA PRADESH,INDORE,2021-03-13,851,2119,1,2971
MADHYA PRADESH,INDORE,2021-03-14,500,1514,2,2016
MADHYA PRADESH,INDORE,2021-03-15,751,2387,2,3140
MADHYA PRADESH,JABALPUR,2021-03-11,21,223,0,244
MADHYA PRADESH,JABALPUR,2021-03-12,60,685,1,746
MADHYA PRADESH,JABALPUR,2021-03-13,59,509,2,570
MADHYA PRADESH,JABALPUR,2021-03-14,50,427,1,478
MADHYA PRADESH,JABALPUR,2021-03-15,63,616,1,680
MADHYA PRADESH,JHABUA,2021-03-11,8,111,0,119
MADHYA PRADESH,JHABUA,2021-03-12,14,259,0,273
MADHYA PRADESH,JHABUA,2021-03-13,9,134,0,143
MADHYA PRADESH,JHABUA,2021-03-14,5,167,0,172
MADHYA PRADESH,JHABUA,2021-03-15,10,179,0,189
MADHYA PRADESH,KATNI,2021-03-11,2,328,2,332
MADHYA PRADESH,KATNI,2021-03-12,4,160,0,164
MADHYA PRADESH,KATNI,2021-03-13,0,313,1,314
MADHYA PRADESH,KATNI,2021-03-14,2,28,0,30
MADHYA PRADESH,KATNI,2021-03-15,0,191,0,191
MADHYA PRADESH,KHARGONE,2021-03-11,6,80,0,86
MADHYA PRADESH,KHARGONE,2021-03-12,20,312,0,332
MADHYA PRADESH,KHARGONE,2021-03-13,13,303,0,316
MADHYA PRADESH,KHARGONE,2021-03-14,1,57,0,58
MADHYA PRADESH,KHARGONE,2021-03-15,30,286,0,316
MADHYA PRADESH,MANDLA,2021-03-11,4,52,0,56
MADHYA PRADESH,MANDLA,2021-03-12,2,63,0,65
MADHYA PRADESH,MANDLA,2021-03-13,3,520,0,523
MADHYA PRADESH,MANDLA,2021-03-14,2,57,0,59
MADHYA PRADESH,MANDLA,2021-03-15,0,64,0,64
MADHYA PRADESH,MANDSAUR,2021-03-11,6,120,5,131
MADHYA PRADESH,MANDSAUR,2021-03-12,18,195,0,213
MADHYA PRADESH,MANDSAUR,2021-03-13,24,351,2,377
MADHYA PRADESH,MANDSAUR,2021-03-14,11,210,6,227
MADHYA PRADESH,MANDSAUR,2021-03-15,19,221,0,240
MADHYA PRADESH,MORENA,2021-03-11,0,320,1,321
MADHYA PRADESH,MORENA,2021-03-12,10,324,0,334
MADHYA PRADESH,MORENA,2021-03-13,2,287,1,290
MADHYA PRADESH,MORENA,2021-03-14,0,222,0,222
MADHYA PRADESH,MORENA,2021-03-15,4,192,0,196
MADHYA PRADESH,NARSINGHPUR,2021-03-11,1,25,0,26
MADHYA PRADESH,NARSINGHPUR,2021-03-12,1,255,2,258
MADHYA PRADESH,NARSINGHPUR,2021-03-13,1,50,0,51
MADHYA PRADESH,NARSINGHPUR,2021-03-14,0,105,0,105
MADHYA PRADESH,NARSINGHPUR,2021-03-15,6,639,4,649
MADHYA PRADESH,NEEMUCH,2021-03-11,5,91,0,96
MADHYA PRADESH,NEEMUCH,2021-03-12,4,199,0,203
MADHYA PRADESH,NEEMUCH,2021-03-13,7,166,2,175
MADHYA PRADESH,NEEMUCH,2021-03-14,2,128,1,131
MADHYA PRADESH,NEEMUCH,2021-03-15,11,183,0,194
MADHYA PRADESH,NIWARI,2021-03-11,0,24,0,24
MADHYA PRADESH,NIWARI,2021-03-12,4,16,0,20
MADHYA PRADESH,NIWARI,2021-03-13,3,35,0,38
MADHYA PRADESH,NIWARI,2021-03-14,0,6,0,6
MADHYA PRADESH,NIWARI,2021-03-15,0,22,0,22
MADHYA PRADESH,PANNA,2021-03-11,1,233,0,234
MADHYA PRADESH,PANNA,2021-03-12,1,114,0,115
MADHYA PRADESH,PANNA,2021-03-13,2,156,0,158
MADHYA PRADESH,PANNA,2021-03-14,3,346,2,351
MADHYA PRADESH,PANNA,2021-03-15,5,167,0,172
MADHYA PRADESH,RAISEN,2021-03-11,5,37,0,42
MADHYA PRADESH,RAISEN,2021-03-12,11,67,0,78
MADHYA PRADESH,RAISEN,2021-03-13,6,108,0,114
MADHYA PRADESH,RAISEN,2021-03-14,5,26,0,31
MADHYA PRADESH,RAISEN,2021-03-15,11,79,0,90
MADHYA PRADESH,RAJGARH,2021-03-11,0,129,0,129
MADHYA PRADESH,RAJGARH,2021-03-12,2,120,1,123
MADHYA PRADESH,RAJGARH,2021-03-13,5,140,0,145
MADHYA PRADESH,RAJGARH,2021-03-14,0,64,0,64
MADHYA PRADESH,RAJGARH,2021-03-15,9,155,0,164
MADHYA PRADESH,RATLAM,2021-03-11,20,170,6,196
MADHYA PRADESH,RATLAM,2021-03-12,25,362,2,389
MADHYA PRADESH,RATLAM,2021-03-13,26,375,7,408
MADHYA PRADESH,RATLAM,2021-03-14,30,130,3,163
MADHYA PRADESH,RATLAM,2021-03-15,37,321,6,364
MADHYA PRADESH,REWA,2021-03-11,8,584,11,603
MADHYA PRADESH,REWA,2021-03-12,1,143,0,144
MADHYA PRADESH,REWA,2021-03-13,3,468,5,476
MADHYA PRADESH,REWA,2021-03-14,3,436,3,442
MADHYA PRADESH,REWA,2021-03-15,9,123,0,132
MADHYA PRADESH,SAGAR,2021-03-11,10,224,0,234
MADHYA PRADESH,SAGAR,2021-03-12,6,522,0,528
MADHYA PRADESH,SAGAR,2021-03-13,13,625,2,640
MADHYA PRADESH,SAGAR,2021-03-14,26,533,1,560
MADHYA PRADESH,SAGAR,2021-03-15,13,214,0,227
MADHYA PRADESH,SATNA,2021-03-11,2,90,0,92
MADHYA PRADESH,SATNA,2021-03-12,6,506,0,512
MADHYA PRADESH,SATNA,2021-03-13,1,250,1,252
MADHYA PRADESH,SATNA,2021-03-14,9,60,0,69
MADHYA PRADESH,SATNA,2021-03-15,14,134,0,148
MADHYA PRADESH,SEHORE,2021-03-11,16,295,0,311
MADHYA PRADESH,SEHORE,2021-03-12,4,249,0,253
MADHYA PRADESH,SEHORE,2021-03-13,8,270,0,278
MADHYA PRADESH,SEHORE,2021-03-14,12,256,4,272
MADHYA PRADESH,SEHORE,2021-03-15,7,104,0,111
MADHYA PRADESH,SEONI,2021-03-11,3,148,0,151
MADHYA PRADESH,SEONI,2021-03-12,2,78,0,80
MADHYA PRADESH,SEONI,2021-03-13,5,171,30,206
MADHYA PRADESH,SEONI,2021-03-14,1,141,6,148
MADHYA PRADESH,SEONI,2021-03-15,3,110,0,113
MADHYA PRADESH,SHAHDOL,2021-03-11,3,191,12,206
MADHYA PRADESH,SHAHDOL,2021-03-12,0,356,8,364
MADHYA PRADESH,SHAHDOL,2021-03-13,4,260,4,268
MADHYA PRADESH,SHAHDOL,2021-03-14,1,113,1,115
MADHYA PRADESH,SHAHDOL,2021-03-15,0,143,10,153
MADHYA PRADESH,SHAJAPUR,2021-03-11,3,142,0,145
MADHYA PRADESH,SHAJAPUR,2021-03-12,9,139,0,148
MADHYA PRADESH,SHAJAPUR,2021-03-13,10,48,0,58
MADHYA PRADESH,SHAJAPUR,2021-03-14,7,135,0,142
MADHYA PRADESH,SHAJAPUR,2021-03-15,15,261,0,276
MADHYA PRADESH,SHEOPUR,2021-03-11,1,110,0,111
MADHYA PRADESH,SHEOPUR,2021-03-12,0,65,0,65
MADHYA PRADESH,SHEOPUR,2021-03-13,5,167,1,173
MADHYA PRADESH,SHEOPUR,2021-03-14,2,106,0,108
MADHYA PRADESH,SHEOPUR,2021-03-15,3,74,0,77
MADHYA PRADESH,SHIVPURI,2021-03-11,1,54,0,55
MADHYA PRADESH,SHIVPURI,2021-03-12,1,124,0,125
MADHYA PRADESH,SHIVPURI,2021-03-13,15,199,1,215
MADHYA PRADESH,SHIVPURI,2021-03-14,11,66,1,78
MADHYA PRADESH,SHIVPURI,2021-03-15,1,144,0,145
MADHYA PRADESH,SIDHI,2021-03-11,1,238,0,239
MADHYA PRADESH,SIDHI,2021-03-12,1,158,1,160
MADHYA PRADESH,SIDHI,2021-03-13,11,8,0,19
MADHYA PRADESH,SIDHI,2021-03-14,0,175,0,175
MADHYA PRADESH,SIDHI,2021-03-15,0,156,0,156
MADHYA PRADESH,SINGRAULI,2021-03-11,1,29,0,30
MADHYA PRADESH,SINGRAULI,2021-03-12,0,205,0,205
MADHYA PRADESH,SINGRAULI,2021-03-13,0,110,0,110
MADHYA PRADESH,SINGRAULI,2021-03-14,2,103,1,106
MADHYA PRADESH,SINGRAULI,2021-03-15,3,106,0,109
MADHYA PRADESH,TIKAMGARH,2021-03-11,1,169,0,170
MADHYA PRADESH,TIKAMGARH,2021-03-12,1,150,0,151
MADHYA PRADESH,TIKAMGARH,2021-03-13,3,177,0,180
MADHYA PRADESH,TIKAMGARH,2021-03-14,1,70,0,71
MADHYA PRADESH,TIKAMGARH,2021-03-15,3,275,0,278
MADHYA PRADESH,UJJAIN,2021-03-11,46,146,0,192
MADHYA PRADESH,UJJAIN,2021-03-12,9,234,0,243
MADHYA PRADESH,UJJAIN,2021-03-13,16,486,0,502
MADHYA PRADESH,UJJAIN,2021-03-14,16,29,0,45
MADHYA PRADESH,UJJAIN,2021-03-15,58,696,0,754
MADHYA PRADESH,UMARIA,2021-03-11,0,185,5,190
MADHYA PRADESH,UMARIA,2021-03-12,3,32,0,35
MADHYA PRADESH,UMARIA,2021-03-13,2,46,1,49
MADHYA PRADESH,UMARIA,2021-03-14,0,59,0,59
MADHYA PRADESH,UMARIA,2021-03-15,3,109,27,139
MADHYA PRADESH,VIDISHA,2021-03-11,3,80,15,98
MADHYA PRADESH,VIDISHA,2021-03-12,7,103,2,112
MADHYA PRADESH,VIDISHA,2021-03-13,6,93,1,100
MADHYA PRADESH,VIDISHA,2021-03-14,5,103,2,110
MADHYA PRADESH,VIDISHA,2021-03-15,7,78,0,85
MAHARASHTRA,AHMEDNAGAR,2021-03-11,501,1356,90,1947
MAHARASHTRA,AHMEDNAGAR,2021-03-12,458,1222,7,1687
MAHARASHTRA,AHMEDNAGAR,2021-03-13,450,1130,33,1613
MAHARASHTRA,AHMEDNAGAR,2021-03-14,560,1627,80,2267
MAHARASHTRA,AHMEDNAGAR,2021-03-15,463,889,55,1407
MAHARASHTRA,AKOLA,2021-03-11,329,2983,9,3321
MAHARASHTRA,AKOLA,2021-03-12,402,2144,8,2554
MAHARASHTRA,AKOLA,2021-03-13,311,2945,17,3273
MAHARASHTRA,AKOLA,2021-03-14,251,2432,17,2700
MAHARASHTRA,AKOLA,2021-03-15,351,2708,10,3069
MAHARASHTRA,AMRAVATI,2021-03-11,482,3456,2,3940
MAHARASHTRA,AMRAVATI,2021-03-12,453,2746,4,3203
MAHARASHTRA,AMRAVATI,2021-03-13,385,2558,4,2947
MAHARASHTRA,AMRAVATI,2021-03-14,384,2806,3,3193
MAHARASHTRA,AMRAVATI,2021-03-15,369,2593,1,2963
MAHARASHTRA,AURANGABAD,2021-03-11,722,1352,35,2109
MAHARASHTRA,AURANGABAD,2021-03-12,792,2063,5,2860
MAHARASHTRA,AURANGABAD,2021-03-13,930,2792,205,3927
MAHARASHTRA,AURANGABAD,2021-03-14,893,2377,449,3719
MAHARASHTRA,AURANGABAD,2021-03-15,998,2913,97,4008
MAHARASHTRA,BEED,2021-03-11,171,1543,2,1716
MAHARASHTRA,BEED,2021-03-12,190,1500,2,1692
MAHARASHTRA,BEED,2021-03-13,264,2374,3,2641
MAHARASHTRA,BEED,2021-03-14,265,2218,1,2484
MAHARASHTRA,BEED,2021-03-15,290,2332,3,2625
MAHARASHTRA,BHANDARA,2021-03-11,75,985,0,1060
MAHARASHTRA,BHANDARA,2021-03-12,65,777,0,842
MAHARASHTRA,BHANDARA,2021-03-13,66,782,1,849
MAHARASHTRA,BHANDARA,2021-03-14,82,1046,0,1128
MAHARASHTRA,BHANDARA,2021-03-15,73,1221,1,1295
MAHARASHTRA,BULDHANA,2021-03-11,395,794,11,1200
MAHARASHTRA,BULDHANA,2021-03-12,551,739,11,1301
MAHARASHTRA,BULDHANA,2021-03-13,340,791,11,1142
MAHARASHTRA,BULDHANA,2021-03-14,354,1078,16,1448
MAHARASHTRA,BULDHANA,2021-03-15,443,1190,15,1648
MAHARASHTRA,CHANDRAPUR,2021-03-11,72,803,0,875
MAHARASHTRA,CHANDRAPUR,2021-03-12,126,1328,8,1462
MAHARASHTRA,CHANDRAPUR,2021-03-13,133,1482,3,1618
MAHARASHTRA,CHANDRAPUR,2021-03-14,56,404,0,460
MAHARASHTRA,CHANDRAPUR,2021-03-15,157,1455,4,1616
MAHARASHTRA,DHULE,2021-03-11,202,388,2,592
MAHARASHTRA,DHULE,2021-03-12,200,485,13,698
MAHARASHTRA,DHULE,2021-03-13,244,1107,1,1352
MAHARASHTRA,DHULE,2021-03-14,316,1800,2,2118
MAHARASHTRA,DHULE,2021-03-15,310,1408,1,1719
MAHARASHTRA,GADCHIROLI,2021-03-11,40,1479,2,1521
MAHARASHTRA,GADCHIROLI,2021-03-12,25,636,1,662
MAHARASHTRA,GADCHIROLI,2021-03-13,22,983,0,1005
MAHARASHTRA,GADCHIROLI,2021-03-14,17,446,0,463
MAHARASHTRA,GADCHIROLI,2021-03-15,47,1000,4,1051
MAHARASHTRA,GONDIA,2021-03-11,27,387,0,414
MAHARASHTRA,GONDIA,2021-03-12,15,560,0,575
MAHARASHTRA,GONDIA,2021-03-13,42,162,0,204
MAHARASHTRA,GONDIA,2021-03-14,50,4346,0,4396
MAHARASHTRA,GONDIA,2021-03-15,50,3924,2,3976
MAHARASHTRA,HINGOLI,2021-03-11,95,328,0,423
MAHARASHTRA,HINGOLI,2021-03-12,61,174,0,235
MAHARASHTRA,HINGOLI,2021-03-13,62,323,0,385
MAHARASHTRA,HINGOLI,2021-03-14,48,382,0,430
MAHARASHTRA,HINGOLI,2021-03-15,101,471,0,572
MAHARASHTRA,JALGAON,2021-03-11,800,2272,5,3077
MAHARASHTRA,JALGAON,2021-03-12,787,1391,6,2184
MAHARASHTRA,JALGAON,2021-03-13,702,1398,37,2137
MAHARASHTRA,JALGAON,2021-03-14,556,773,1,1330
MAHARASHTRA,JALGAON,2021-03-15,667,1140,17,1824
MAHARASHTRA,JALNA,2021-03-11,238,596,0,834
MAHARASHTRA,JALNA,2021-03-12,176,616,0,792
MAHARASHTRA,JALNA,2021-03-13,245,707,1,953
MAHARASHTRA,JALNA,2021-03-14,186,593,5,784
MAHARASHTRA,JALNA,2021-03-15,255,696,0,951
MAHARASHTRA,KOLHAPUR,2021-03-11,36,1309,43,1388
MAHARASHTRA,KOLHAPUR,2021-03-12,44,784,74,902
MAHARASHTRA,KOLHAPUR,2021-03-13,37,1334,52,1423
MAHARASHTRA,KOLHAPUR,2021-03-14,31,884,19,934
MAHARASHTRA,KOLHAPUR,2021-03-15,46,662,6,714
MAHARASHTRA,LATUR,2021-03-11,121,1480,5,1606
MAHARASHTRA,LATUR,2021-03-12,139,1097,2,1238
MAHARASHTRA,LATUR,2021-03-13,144,1812,10,1966
MAHARASHTRA,LATUR,2021-03-14,153,934,12,1099
MAHARASHTRA,LATUR,2021-03-15,182,1030,2,1214
MAHARASHTRA,MUMBAI,2021-03-11,1485,15095,36,16616
MAHARASHTRA,MUMBAI,2021-03-12,1458,15167,39,16664
MAHARASHTRA,MUMBAI,2021-03-13,1776,15242,52,17070
MAHARASHTRA,MUMBAI,2021-03-14,1449,11587,23,13059
MAHARASHTRA,MUMBAI,2021-03-15,1599,13377,22,14998
MAHARASHTRA,MUMBAI SUBURBAN,2021-03-11,402,3772,6,4180
MAHARASHTRA,MUMBAI SUBURBAN,2021-03-12,445,3084,5,3534
MAHARASHTRA,MUMBAI SUBURBAN,2021-03-13,438,3229,3,3670
MAHARASHTRA,MUMBAI SUBURBAN,2021-03-14,371,2264,9,2644
MAHARASHTRA,MUMBAI SUBURBAN,2021-03-15,538,2739,7,3284
MAHARASHTRA,NAGPUR,2021-03-11,2202,4755,46,7003
MAHARASHTRA,NAGPUR,2021-03-12,2381,5970,40,8391
MAHARASHTRA,NAGPUR,2021-03-13,2534,6135,37,8706
MAHARASHTRA,NAGPUR,2021-03-14,2414,4987,37,7438
MAHARASHTRA,NAGPUR,2021-03-15,2895,6745,28,9668
MAHARASHTRA,NANDED,2021-03-11,398,482,28,908
MAHARASHTRA,NANDED,2021-03-12,674,1180,40,1894
MAHARASHTRA,NANDED,2021-03-13,422,1606,33,2061
MAHARASHTRA,NANDED,2021-03-14,454,1554,22,2030
MAHARASHTRA,NANDED,2021-03-15,687,1524,46,2257
MAHARASHTRA,NANDURBAR,2021-03-11,63,308,1,372
MAHARASHTRA,NANDURBAR,2021-03-12,208,388,1,597
MAHARASHTRA,NANDURBAR,2021-03-13,173,979,2,1154
MAHARASHTRA,NANDURBAR,2021-03-14,270,1721,0,1991
MAHARASHTRA,NANDURBAR,2021-03-15,396,2103,1,2500
MAHARASHTRA,NASHIK,2021-03-11,1112,1599,43,2754
MAHARASHTRA,NASHIK,2021-03-12,1117,1671,100,2888
MAHARASHTRA,NASHIK,2021-03-13,1413,1986,110,3509
MAHARASHTRA,NASHIK,2021-03-14,1169,1593,56,2818
MAHARASHTRA,NASHIK,2021-03-15,764,1179,137,2080
MAHARASHTRA,OSMANABAD,2021-03-11,78,249,2,329
MAHARASHTRA,OSMANABAD,2021-03-12,38,460,0,498
MAHARASHTRA,OSMANABAD,2021-03-13,57,286,0,343
MAHARASHTRA,OSMANABAD,2021-03-14,73,270,4,347
MAHARASHTRA,OSMANABAD,2021-03-15,70,639,5,714
MAHARASHTRA,PALGHAR,2021-03-11,83,633,3,719
MAHARASHTRA,PALGHAR,2021-03-12,99,757,3,859
MAHARASHTRA,PALGHAR,2021-03-13,121,791,7,919
MAHARASHTRA,PALGHAR,2021-03-14,89,329,1,419
MAHARASHTRA,PALGHAR,2021-03-15,130,953,10,1093
MAHARASHTRA,PARBHANI,2021-03-11,83,1506,2,1591
MAHARASHTRA,PARBHANI,2021-03-12,57,1161,0,1218
MAHARASHTRA,PARBHANI,2021-03-13,86,2209,3,2298
MAHARASHTRA,PARBHANI,2021-03-14,150,1341,2,1493
MAHARASHTRA,PARBHANI,2021-03-15,160,1926,0,2086
MAHARASHTRA,PUNE,2021-03-11,3433,7379,841,11653
MAHARASHTRA,PUNE,2021-03-12,3324,8964,871,13159
MAHARASHTRA,PUNE,2021-03-13,3724,8320,1403,13447
MAHARASHTRA,PUNE,2021-03-14,2575,6169,591,9335
MAHARASHTRA,PUNE,2021-03-15,3785,8697,873,13355
MAHARASHTRA,RAIGAD,2021-03-11,167,1389,5,1561
MAHARASHTRA,RAIGAD,2021-03-12,263,1470,18,1751
MAHARASHTRA,RAIGAD,2021-03-13,281,1573,1,1855
MAHARASHTRA,RAIGAD,2021-03-14,255,1224,4,1483
MAHARASHTRA,RAIGAD,2021-03-15,270,1914,3,2187
MAHARASHTRA,RATNAGIRI,2021-03-11,23,501,1,525
MAHARASHTRA,RATNAGIRI,2021-03-12,25,638,0,663
MAHARASHTRA,RATNAGIRI,2021-03-13,16,503,3,522
MAHARASHTRA,RATNAGIRI,2021-03-14,6,206,0,212
MAHARASHTRA,RATNAGIRI,2021-03-15,113,523,0,636
MAHARASHTRA,SANGLI,2021-03-11,39,712,16,767
MAHARASHTRA,SANGLI,2021-03-12,54,880,5,939
MAHARASHTRA,SANGLI,2021-03-13,42,591,17,650
MAHARASHTRA,SANGLI,2021-03-14,49,518,20,587
MAHARASHTRA,SANGLI,2021-03-15,71,537,11,619
MAHARASHTRA,SATARA,2021-03-11,160,3765,56,3981
MAHARASHTRA,SATARA,2021-03-12,113,2315,24,2452
MAHARASHTRA,SATARA,2021-03-13,151,1843,44,2038
MAHARASHTRA,SATARA,2021-03-14,155,1462,77,1694
MAHARASHTRA,SATARA,2021-03-15,142,908,18,1068
MAHARASHTRA,SINDHUDURG,2021-03-11,24,251,0,275
MAHARASHTRA,SINDHUDURG,2021-03-12,7,287,0,294
MAHARASHTRA,SINDHUDURG,2021-03-13,20,224,1,245
MAHARASHTRA,SINDHUDURG,2021-03-14,5,153,0,158
MAHARASHTRA,SINDHUDURG,2021-03-15,18,211,0,229
MAHARASHTRA,SOLAPUR,2021-03-11,165,2180,59,2404
MAHARASHTRA,SOLAPUR,2021-03-12,223,2467,95,2785
MAHARASHTRA,SOLAPUR,2021-03-13,224,2782,91,3097
MAHARASHTRA,SOLAPUR,2021-03-14,152,1702,25,1879
MAHARASHTRA,SOLAPUR,2021-03-15,329,1921,88,2338
MAHARASHTRA,THANE,2021-03-11,1364,7751,65,9180
MAHARASHTRA,THANE,2021-03-12,1293,7963,120,9376
MAHARASHTRA,THANE,2021-03-13,1462,8119,40,9621
MAHARASHTRA,THANE,2021-03-14,1156,5551,24,6731
MAHARASHTRA,THANE,2021-03-15,1542,6889,59,8490
MAHARASHTRA,WARDHA,2021-03-11,176,1199,2,1377
MAHARASHTRA,WARDHA,2021-03-12,309,2103,6,2418
MAHARASHTRA,WARDHA,2021-03-13,317,4335,0,4652
MAHARASHTRA,WARDHA,2021-03-14,354,4147,10,4511
MAHARASHTRA,WARDHA,2021-03-15,324,2601,2,2927
MAHARASHTRA,WASHIM,2021-03-11,181,1125,12,1318
MAHARASHTRA,WASHIM,2021-03-12,163,1059,14,1236
MAHARASHTRA,WASHIM,2021-03-13,135,964,8,1107
MAHARASHTRA,WASHIM,2021-03-14,187,1030,7,1224
MAHARASHTRA,WASHIM,2021-03-15,216,1572,6,1794
MAHARASHTRA,YAVATMAL,2021-03-11,467,1253,1,1721
MAHARASHTRA,YAVATMAL,2021-03-12,294,1157,2,1453
MAHARASHTRA,YAVATMAL,2021-03-13,268,1024,3,1295
MAHARASHTRA,YAVATMAL,2021-03-14,282,689,2,973
MAHARASHTRA,YAVATMAL,2021-03-15,454,1054,2,1510
MANIPUR,BISHNUPUR,2021-03-11,0,69,0,69
MANIPUR,BISHNUPUR,2021-03-12,0,63,0,63
MANIPUR,BISHNUPUR,2021-03-13,0,62,0,62
MANIPUR,BISHNUPUR,2021-03-14,0,21,0,21
MANIPUR,BISHNUPUR,2021-03-15,1,80,0,81
MANIPUR,CHANDEL,2021-03-11,0,14,0,14
MANIPUR,CHANDEL,2021-03-12,0,13,0,13
MANIPUR,CHANDEL,2021-03-13,1,13,0,14
MANIPUR,CHANDEL,2021-03-14,0,4,0,4
MANIPUR,CHANDEL,2021-03-15,0,11,0,11
MANIPUR,CHURACHANDPUR,2021-03-11,1,138,0,139
MANIPUR,CHURACHANDPUR,2021-03-12,0,165,0,165
MANIPUR,CHURACHANDPUR,2021-03-13,2,113,0,115
MANIPUR,CHURACHANDPUR,2021-03-14,1,58,0,59
MANIPUR,CHURACHANDPUR,2021-03-15,0,126,0,126
MANIPUR,IMPHAL EAST,2021-03-11,1,158,0,159
MANIPUR,IMPHAL EAST,2021-03-12,0,139,0,139
MANIPUR,IMPHAL EAST,2021-03-13,0,252,0,252
MANIPUR,IMPHAL EAST,2021-03-14,1,106,0,107
MANIPUR,IMPHAL EAST,2021-03-15,0,109,0,109
MANIPUR,IMPHAL WEST,2021-03-11,0,529,0,529
MANIPUR,IMPHAL WEST,2021-03-12,1,390,1,392
MANIPUR,IMPHAL WEST,2021-03-13,0,399,0,399
MANIPUR,IMPHAL WEST,2021-03-14,0,210,1,211
MANIPUR,IMPHAL WEST,2021-03-15,0,260,0,260
MANIPUR,JIRIBAM,2021-03-11,0,1,0,1
MANIPUR,KAKCHING,2021-03-11,0,73,0,73
MANIPUR,KAKCHING,2021-03-12,6,92,0,98
MANIPUR,KAKCHING,2021-03-13,7,78,0,85
MANIPUR,KAKCHING,2021-03-14,0,17,0,17
MANIPUR,KAKCHING,2021-03-15,0,39,0,39
MANIPUR,KAMJONG,2021-03-12,0,3,0,3
MANIPUR,KAMJONG,2021-03-13,0,1,0,1
MANIPUR,KAMJONG,2021-03-14,0,5,0,5
MANIPUR,KAMJONG,2021-03-15,0,4,0,4
MANIPUR,KANGPOKPI,2021-03-11,0,24,0,24
MANIPUR,KANGPOKPI,2021-03-12,0,22,0,22
MANIPUR,KANGPOKPI,2021-03-13,0,21,0,21
MANIPUR,KANGPOKPI,2021-03-14,0,14,0,14
MANIPUR,KANGPOKPI,2021-03-15,0,8,0,8
MANIPUR,NONEY,2021-03-11,0,4,0,4
MANIPUR,NONEY,2021-03-12,0,4,0,4
MANIPUR,NONEY,2021-03-13,0,3,0,3
MANIPUR,NONEY,2021-03-14,0,1,0,1
MANIPUR,NONEY,2021-03-15,0,4,0,4
MANIPUR,PHERZAWL,2021-03-11,0,45,0,45
MANIPUR,SENAPATI,2021-03-11,0,21,0,21
MANIPUR,SENAPATI,2021-03-12,0,11,0,11
MANIPUR,SENAPATI,2021-03-13,1,9,0,10
MANIPUR,SENAPATI,2021-03-14,0,8,0,8
MANIPUR,SENAPATI,2021-03-15,0,15,0,15
MANIPUR,TAMENGLONG,2021-03-11,1,53,0,54
MANIPUR,TAMENGLONG,2021-03-12,1,100,0,101
MANIPUR,TAMENGLONG,2021-03-13,0,19,0,19
MANIPUR,TAMENGLONG,2021-03-14,0,30,0,30
MANIPUR,TAMENGLONG,2021-03-15,0,87,0,87
MANIPUR,TENGNOUPAL,2021-03-11,0,5,0,5
MANIPUR,TENGNOUPAL,2021-03-12,0,5,0,5
MANIPUR,TENGNOUPAL,2021-03-13,0,4,0,4
MANIPUR,TENGNOUPAL,2021-03-14,0,2,0,2
MANIPUR,TENGNOUPAL,2021-03-15,0,2,0,2
MANIPUR,THOUBAL,2021-03-11,3,186,0,189
MANIPUR,THOUBAL,2021-03-12,10,146,0,156
MANIPUR,THOUBAL,2021-03-13,8,123,0,131
MANIPUR,THOUBAL,2021-03-14,13,132,0,145
MANIPUR,THOUBAL,2021-03-15,0,103,0,103
MANIPUR,UKHRUL,2021-03-11,0,65,0,65
MANIPUR,UKHRUL,2021-03-12,0,35,0,35
MANIPUR,UKHRUL,2021-03-13,0,15,0,15
MANIPUR,UKHRUL,2021-03-14,0,13,0,13
MANIPUR,UKHRUL,2021-03-15,0,91,0,91
MEGHALAYA,EAST GARO HILLS,2021-03-11,0,23,0,23
MEGHALAYA,EAST GARO HILLS,2021-03-12,0,24,0,24
MEGHALAYA,EAST GARO HILLS,2021-03-13,0,11,0,11
MEGHALAYA,EAST GARO HILLS,2021-03-14,0,2,0,2
MEGHALAYA,EAST GARO HILLS,2021-03-15,0,35,0,35
MEGHALAYA,EAST JAINTIA HILLS,2021-03-11,0,76,0,76
MEGHALAYA,EAST JAINTIA HILLS,2021-03-12,0,39,0,39
MEGHALAYA,EAST JAINTIA HILLS,2021-03-13,0,20,0,20
MEGHALAYA,EAST JAINTIA HILLS,2021-03-14,0,5,0,5
MEGHALAYA,EAST JAINTIA HILLS,2021-03-15,0,56,0,56
MEGHALAYA,EAST KHASI HILLS,2021-03-11,0,775,0,775
MEGHALAYA,EAST KHASI HILLS,2021-03-12,0,518,0,518
MEGHALAYA,EAST KHASI HILLS,2021-03-13,3,656,1,660
MEGHALAYA,EAST KHASI HILLS,2021-03-14,1,270,0,271
MEGHALAYA,EAST KHASI HILLS,2021-03-15,2,820,0,822
MEGHALAYA,NORTH GARO HILLS,2021-03-11,0,7,0,7
MEGHALAYA,NORTH GARO HILLS,2021-03-12,0,12,0,12
MEGHALAYA,NORTH GARO HILLS,2021-03-13,0,9,0,9
MEGHALAYA,NORTH GARO HILLS,2021-03-15,0,28,0,28
MEGHALAYA,RI BHOI,2021-03-11,0,159,0,159
MEGHALAYA,RI BHOI,2021-03-12,4,97,0,101
MEGHALAYA,RI BHOI,2021-03-13,0,38,0,38
MEGHALAYA,RI BHOI,2021-03-14,1,5,0,6
MEGHALAYA,RI BHOI,2021-03-15,0,45,0,45
MEGHALAYA,SOUTH GARO HILLS,2021-03-11,0,8,0,8
MEGHALAYA,SOUTH GARO HILLS,2021-03-12,0,7,0,7
MEGHALAYA,SOUTH GARO HILLS,2021-03-13,0,10,0,10
MEGHALAYA,SOUTH GARO HILLS,2021-03-15,0,4,0,4
MEGHALAYA,SOUTH WEST GARO HILLS,2021-03-11,0,25,0,25
MEGHALAYA,SOUTH WEST GARO HILLS,2021-03-12,0,21,0,21
MEGHALAYA,SOUTH WEST GARO HILLS,2021-03-13,0,14,0,14
MEGHALAYA,SOUTH WEST GARO HILLS,2021-03-15,0,24,0,24
MEGHALAYA,SOUTH WEST KHASI HILLS,2021-03-11,0,9,0,9
MEGHALAYA,SOUTH WEST KHASI HILLS,2021-03-12,0,29,0,29
MEGHALAYA,SOUTH WEST KHASI HILLS,2021-03-13,0,3,0,3
MEGHALAYA,SOUTH WEST KHASI HILLS,2021-03-15,0,6,0,6
MEGHALAYA,WEST GARO HILLS,2021-03-11,1,87,0,88
MEGHALAYA,WEST GARO HILLS,2021-03-12,0,153,0,153
MEGHALAYA,WEST GARO HILLS,2021-03-13,0,91,0,91
MEGHALAYA,WEST GARO HILLS,2021-03-15,0,49,0,49
MEGHALAYA,WEST JAINTIA HILLS,2021-03-11,0,73,0,73
MEGHALAYA,WEST JAINTIA HILLS,2021-03-12,0,40,0,40
MEGHALAYA,WEST JAINTIA HILLS,2021-03-13,0,43,0,43
MEGHALAYA,WEST JAINTIA HILLS,2021-03-14,0,44,0,44
MEGHALAYA,WEST JAINTIA HILLS,2021-03-15,1,57,0,58
MEGHALAYA,WEST KHASI HILLS,2021-03-11,0,51,0,51
MEGHALAYA,WEST KHASI HILLS,2021-03-12,0,32,0,32
MEGHALAYA,WEST KHASI HILLS,2021-03-13,0,40,0,40
MEGHALAYA,WEST KHASI HILLS,2021-03-14,0,3,0,3
MEGHALAYA,WEST KHASI HILLS,2021-03-15,0,61,0,61
MIZORAM,AIZAWL,2021-03-11,0,369,0,369
MIZORAM,AIZAWL,2021-03-12,0,280,0,280
MIZORAM,AIZAWL,2021-03-13,1,310,0,311
MIZORAM,AIZAWL,2021-03-14,0,83,0,83
MIZORAM,AIZAWL,2021-03-15,3,434,0,437
MIZORAM,CHAMPHAI,2021-03-11,1,6,0,7
MIZORAM,CHAMPHAI,2021-03-12,0,2,0,2
MIZORAM,CHAMPHAI,2021-03-13,0,6,0,6
MIZORAM,CHAMPHAI,2021-03-14,0,1,0,1
MIZORAM,CHAMPHAI,2021-03-15,0,59,0,59
MIZORAM,HNAHTHIAL,2021-03-12,0,2,0,2
MIZORAM,HNAHTHIAL,2021-03-15,0,2,0,2
MIZORAM,KHAWZAWL,2021-03-15,0,1,0,1
MIZORAM,KOLASIB,2021-03-11,0,30,0,30
MIZORAM,KOLASIB,2021-03-12,0,47,0,47
MIZORAM,KOLASIB,2021-03-13,0,127,0,127
MIZORAM,KOLASIB,2021-03-14,0,142,0,142
MIZORAM,KOLASIB,2021-03-15,0,6,0,6
MIZORAM,LAWNGTLAI,2021-03-11,0,17,0,17
MIZORAM,LAWNGTLAI,2021-03-12,0,7,0,7
MIZORAM,LAWNGTLAI,2021-03-15,0,5,0,5
MIZORAM,LUNGLEI,2021-03-11,0,5,0,5
MIZORAM,LUNGLEI,2021-03-12,0,4,0,4
MIZORAM,LUNGLEI,2021-03-13,0,1,0,1
MIZORAM,LUNGLEI,2021-03-15,0,22,0,22
MIZORAM,MAMIT,2021-03-11,0,80,0,80
MIZORAM,MAMIT,2021-03-12,0,20,0,20
MIZORAM,MAMIT,2021-03-13,0,54,0,54
MIZORAM,MAMIT,2021-03-14,0,4,0,4
MIZORAM,MAMIT,2021-03-15,0,48,0,48
MIZORAM,SAIHA,2021-03-11,0,1,0,1
MIZORAM,SAIHA,2021-03-12,0,10,0,10
MIZORAM,SAIHA,2021-03-14,1,8,0,9
MIZORAM,SAIHA,2021-03-15,0,1,0,1
MIZORAM,SAITUAL,2021-03-11,0,45,0,45
MIZORAM,SAITUAL,2021-03-12,0,28,0,28
MIZORAM,SAITUAL,2021-03-13,0,30,0,30
MIZORAM,SAITUAL,2021-03-15,0,15,0,15
MIZORAM,SERCHHIP,2021-03-11,0,5,0,5
MIZORAM,SERCHHIP,2021-03-12,0,6,0,6
MIZORAM,SERCHHIP,2021-03-13,0,1,0,1
MIZORAM,SERCHHIP,2021-03-15,0,8,0,8
NAGALAND,DIMAPUR,2021-03-11,1,251,0,252
NAGALAND,DIMAPUR,2021-03-12,18,52,0,70
NAGALAND,DIMAPUR,2021-03-13,47,88,0,135
NAGALAND,DIMAPUR,2021-03-14,0,12,0,12
NAGALAND,DIMAPUR,2021-03-15,0,295,0,295
NAGALAND,KIPHIRE,2021-03-11,0,6,0,6
NAGALAND,KIPHIRE,2021-03-15,0,2,0,2
NAGALAND,KOHIMA,2021-03-11,19,20,0,39
NAGALAND,KOHIMA,2021-03-12,23,15,0,38
NAGALAND,KOHIMA,2021-03-13,33,27,0,60
NAGALAND,KOHIMA,2021-03-14,0,4,0,4
NAGALAND,KOHIMA,2021-03-15,44,51,0,95
NAGALAND,LONGLENG,2021-03-11,0,3,0,3
NAGALAND,LONGLENG,2021-03-13,0,1,0,1
NAGALAND,LONGLENG,2021-03-14,0,1,0,1
NAGALAND,LONGLENG,2021-03-15,0,2,0,2
NAGALAND,MOKOKCHUNG,2021-03-11,1,15,0,16
NAGALAND,MOKOKCHUNG,2021-03-12,1,18,0,19
NAGALAND,MOKOKCHUNG,2021-03-13,0,21,0,21
NAGALAND,MOKOKCHUNG,2021-03-14,0,5,0,5
NAGALAND,MOKOKCHUNG,2021-03-15,0,16,0,16
NAGALAND,MON,2021-03-11,0,1,0,1
NAGALAND,MON,2021-03-12,0,1,0,1
NAGALAND,MON,2021-03-13,0,3,0,3
NAGALAND,MON,2021-03-15,0,26,0,26
NAGALAND,PEREN,2021-03-11,8,32,0,40
NAGALAND,PEREN,2021-03-12,5,2,0,7
NAGALAND,PEREN,2021-03-13,0,1,0,1
NAGALAND,PEREN,2021-03-15,0,3,0,3
NAGALAND,PHEK,2021-03-11,0,2,0,2
NAGALAND,PHEK,2021-03-12,0,1,0,1
NAGALAND,PHEK,2021-03-13,0,2,0,2
NAGALAND,PHEK,2021-03-15,0,7,0,7
NAGALAND,TUENSANG,2021-03-11,0,1,0,1
NAGALAND,TUENSANG,2021-03-15,0,5,0,5
NAGALAND,WOKHA,2021-03-11,0,3,0,3
NAGALAND,WOKHA,2021-03-12,0,1,0,1
NAGALAND,WOKHA,2021-03-15,0,2,0,2
NAGALAND,ZUNHEBOTO,2021-03-11,1,0,0,1
NAGALAND,ZUNHEBOTO,2021-03-13,0,2,0,2
NAGALAND,ZUNHEBOTO,2021-03-14,0,1,0,1
NAGALAND,ZUNHEBOTO,2021-03-15,0,7,0,7
ODISHA,ANUGUL,2021-03-11,3,484,0,487
ODISHA,ANUGUL,2021-03-12,6,548,0,554
ODISHA,ANUGUL,2021-03-13,1,522,0,523
ODISHA,ANUGUL,2021-03-14,5,309,0,314
ODISHA,ANUGUL,2021-03-15,3,543,0,546
ODISHA,BALANGIR,2021-03-11,2,805,3,810
ODISHA,BALANGIR,2021-03-12,2,877,1,880
ODISHA,BALANGIR,2021-03-13,0,766,0,766
ODISHA,BALANGIR,2021-03-14,3,679,2,684
ODISHA,BALANGIR,2021-03-15,7,802,2,811
ODISHA,BALESHWAR,2021-03-11,4,1100,0,1104
ODISHA,BALESHWAR,2021-03-12,11,1807,0,1818
ODISHA,BALESHWAR,2021-03-13,4,1805,0,1809
ODISHA,BALESHWAR,2021-03-14,6,1333,0,1339
ODISHA,BALESHWAR,2021-03-15,2,1698,1,1701
ODISHA,BARGARH,2021-03-11,3,376,0,379
ODISHA,BARGARH,2021-03-12,6,353,0,359
ODISHA,BARGARH,2021-03-13,11,378,0,389
ODISHA,BARGARH,2021-03-14,7,328,0,335
ODISHA,BARGARH,2021-03-15,10,454,0,464
ODISHA,BHADRAK,2021-03-11,0,305,0,305
ODISHA,BHADRAK,2021-03-12,0,493,0,493
ODISHA,BHADRAK,2021-03-13,1,465,0,466
ODISHA,BHADRAK,2021-03-14,0,239,0,239
ODISHA,BHADRAK,2021-03-15,0,456,1,457
ODISHA,BOUDH,2021-03-11,0,126,0,126
ODISHA,BOUDH,2021-03-12,0,227,0,227
ODISHA,BOUDH,2021-03-13,0,155,0,155
ODISHA,BOUDH,2021-03-14,0,209,0,209
ODISHA,BOUDH,2021-03-15,0,167,0,167
ODISHA,CUTTACK,2021-03-11,12,1091,1,1104
ODISHA,CUTTACK,2021-03-12,3,1868,1,1872
ODISHA,CUTTACK,2021-03-13,12,1602,5,1619
ODISHA,CUTTACK,2021-03-14,3,724,1,728
ODISHA,CUTTACK,2021-03-15,7,1981,2,1990
ODISHA,DEOGARH,2021-03-11,3,90,0,93
ODISHA,DEOGARH,2021-03-12,0,68,0,68
ODISHA,DEOGARH,2021-03-13,1,80,0,81
ODISHA,DEOGARH,2021-03-14,0,204,0,204
ODISHA,DEOGARH,2021-03-15,2,167,0,169
ODISHA,DHENKANAL,2021-03-11,0,639,3,642
ODISHA,DHENKANAL,2021-03-12,1,515,0,516
ODISHA,DHENKANAL,2021-03-13,1,314,0,315
ODISHA,DHENKANAL,2021-03-14,1,222,0,223
ODISHA,DHENKANAL,2021-03-15,0,616,0,616
ODISHA,GAJAPATI,2021-03-11,0,87,0,87
ODISHA,GAJAPATI,2021-03-12,3,396,1,400
ODISHA,GAJAPATI,2021-03-13,0,128,0,128
ODISHA,GAJAPATI,2021-03-14,0,234,1,235
ODISHA,GAJAPATI,2021-03-15,0,222,0,222
ODISHA,GANJAM,2021-03-11,0,1031,66,1097
ODISHA,GANJAM,2021-03-12,2,799,22,823
ODISHA,GANJAM,2021-03-13,7,1157,40,1204
ODISHA,GANJAM,2021-03-14,2,616,0,618
ODISHA,GANJAM,2021-03-15,4,825,15,844
ODISHA,JAGATSINGHAPUR,2021-03-11,0,287,0,287
ODISHA,JAGATSINGHAPUR,2021-03-12,1,465,0,466
ODISHA,JAGATSINGHAPUR,2021-03-13,1,570,0,571
ODISHA,JAGATSINGHAPUR,2021-03-14,0,232,0,232
ODISHA,JAGATSINGHAPUR,2021-03-15,3,846,1,850
ODISHA,JAJAPUR,2021-03-11,1,299,0,300
ODISHA,JAJAPUR,2021-03-12,4,674,0,678
ODISHA,JAJAPUR,2021-03-13,10,832,0,842
ODISHA,JAJAPUR,2021-03-14,2,185,0,187
ODISHA,JAJAPUR,2021-03-15,3,1006,10,1019
ODISHA,JHARSUGUDA,2021-03-11,1,309,2,312
ODISHA,JHARSUGUDA,2021-03-12,5,273,0,278
ODISHA,JHARSUGUDA,2021-03-13,3,333,0,336
ODISHA,JHARSUGUDA,2021-03-14,1,332,0,333
ODISHA,JHARSUGUDA,2021-03-15,6,489,0,495
ODISHA,KALAHANDI,2021-03-11,4,184,0,188
ODISHA,KALAHANDI,2021-03-12,0,173,0,173
ODISHA,KALAHANDI,2021-03-13,0,85,0,85
ODISHA,KALAHANDI,2021-03-14,0,445,0,445
ODISHA,KALAHANDI,2021-03-15,0,373,0,373
ODISHA,KANDHAMAL,2021-03-11,0,577,0,577
ODISHA,KANDHAMAL,2021-03-12,0,640,0,640
ODISHA,KANDHAMAL,2021-03-13,2,640,0,642
ODISHA,KANDHAMAL,2021-03-14,0,623,0,623
ODISHA,KANDHAMAL,2021-03-15,0,704,0,704
ODISHA,KENDRAPARA,2021-03-11,0,902,0,902
ODISHA,KENDRAPARA,2021-03-12,1,1101,0,1102
ODISHA,KENDRAPARA,2021-03-13,1,903,0,904
ODISHA,KENDRAPARA,2021-03-14,0,902,0,902
ODISHA,KENDRAPARA,2021-03-15,0,1031,0,1031
ODISHA,KENDUJHAR,2021-03-11,0,449,0,449
ODISHA,KENDUJHAR,2021-03-12,1,619,0,620
ODISHA,KENDUJHAR,2021-03-13,1,675,0,676
ODISHA,KENDUJHAR,2021-03-14,0,515,0,515
ODISHA,KENDUJHAR,2021-03-15,0,590,0,590
ODISHA,KHORDHA,2021-03-11,9,1564,2,1575
ODISHA,KHORDHA,2021-03-12,15,1739,0,1754
ODISHA,KHORDHA,2021-03-13,11,1566,5,1582
ODISHA,KHORDHA,2021-03-14,7,892,0,899
ODISHA,KHORDHA,2021-03-15,15,2260,2,2277
ODISHA,KORAPUT,2021-03-11,0,1200,0,1200
ODISHA,KORAPUT,2021-03-12,2,1364,0,1366
ODISHA,KORAPUT,2021-03-13,1,1390,0,1391
ODISHA,KORAPUT,2021-03-14,0,1396,0,1396
ODISHA,KORAPUT,2021-03-15,0,1358,0,1358
ODISHA,MALKANGIRI,2021-03-11,0,103,0,103
ODISHA,MALKANGIRI,2021-03-12,0,216,2,218
ODISHA,MALKANGIRI,2021-03-13,0,204,0,204
ODISHA,MALKANGIRI,2021-03-14,0,99,0,99
ODISHA,MALKANGIRI,2021-03-15,0,314,0,314
ODISHA,MAYURBHANJ,2021-03-11,8,1122,0,1130
ODISHA,MAYURBHANJ,2021-03-12,8,1492,0,1500
ODISHA,MAYURBHANJ,2021-03-13,6,1382,0,1388
ODISHA,MAYURBHANJ,2021-03-14,8,1108,0,1116
ODISHA,MAYURBHANJ,2021-03-15,9,1588,0,1597
ODISHA,NABARANGPUR,2021-03-11,0,562,0,562
ODISHA,NABARANGPUR,2021-03-12,0,745,0,745
ODISHA,NABARANGPUR,2021-03-13,0,882,0,882
ODISHA,NABARANGPUR,2021-03-14,0,510,2,512
ODISHA,NABARANGPUR,2021-03-15,4,976,0,980
ODISHA,NAYAGARH,2021-03-11,0,379,0,379
ODISHA,NAYAGARH,2021-03-12,0,764,3,767
ODISHA,NAYAGARH,2021-03-13,1,359,0,360
ODISHA,NAYAGARH,2021-03-14,2,424,0,426
ODISHA,NAYAGARH,2021-03-15,0,1368,2,1370
ODISHA,NUAPADA,2021-03-11,0,93,0,93
ODISHA,NUAPADA,2021-03-12,2,88,0,90
ODISHA,NUAPADA,2021-03-13,0,119,0,119
ODISHA,NUAPADA,2021-03-14,1,91,0,92
ODISHA,NUAPADA,2021-03-15,2,115,0,117
ODISHA,PURI,2021-03-11,0,630,1,631
ODISHA,PURI,2021-03-12,1,645,0,646
ODISHA,PURI,2021-03-13,2,669,0,671
ODISHA,PURI,2021-03-14,1,577,0,578
ODISHA,PURI,2021-03-15,0,620,0,620
ODISHA,RAYAGADA,2021-03-11,1,752,0,753
ODISHA,RAYAGADA,2021-03-12,0,663,2,665
ODISHA,RAYAGADA,2021-03-13,0,495,0,495
ODISHA,RAYAGADA,2021-03-14,2,186,0,188
ODISHA,RAYAGADA,2021-03-15,3,580,0,583
ODISHA,SAMBALPUR,2021-03-11,3,363,0,366
ODISHA,SAMBALPUR,2021-03-12,3,330,0,333
ODISHA,SAMBALPUR,2021-03-13,4,299,0,303
ODISHA,SAMBALPUR,2021-03-14,5,159,0,164
ODISHA,SAMBALPUR,2021-03-15,4,606,0,610
ODISHA,SONEPUR,2021-03-11,0,120,0,120
ODISHA,SONEPUR,2021-03-12,0,273,0,273
ODISHA,SONEPUR,2021-03-13,1,135,0,136
ODISHA,SONEPUR,2021-03-14,0,81,0,81
ODISHA,SONEPUR,2021-03-15,0,335,0,335
ODISHA,SUNDARGARH,2021-03-11,8,448,2,458
ODISHA,SUNDARGARH,2021-03-12,14,437,1,452
ODISHA,SUNDARGARH,2021-03-13,5,375,2,382
ODISHA,SUNDARGARH,2021-03-14,4,366,6,376
ODISHA,SUNDARGARH,2021-03-15,7,438,3,448
PUDUCHERRY,KARAIKAL,2021-03-11,9,250,1,260
PUDUCHERRY,KARAIKAL,2021-03-12,2,193,0,195
PUDUCHERRY,KARAIKAL,2021-03-13,3,217,0,220
PUDUCHERRY,KARAIKAL,2021-03-14,0,55,0,55
PUDUCHERRY,KARAIKAL,2021-03-15,5,129,0,134
PUDUCHERRY,MAHE,2021-03-11,0,97,0,97
PUDUCHERRY,MAHE,2021-03-12,6,196,1,203
PUDUCHERRY,MAHE,2021-03-13,0,50,0,50
PUDUCHERRY,MAHE,2021-03-14,2,80,1,83
PUDUCHERRY,MAHE,2021-03-15,2,101,0,103
PUDUCHERRY,PONDICHERRY,2021-03-11,18,299,2,319
PUDUCHERRY,PONDICHERRY,2021-03-12,21,295,1,317
PUDUCHERRY,PONDICHERRY,2021-03-13,17,288,4,309
PUDUCHERRY,PONDICHERRY,2021-03-14,18,137,1,156
PUDUCHERRY,PONDICHERRY,2021-03-15,44,366,0,410
PUDUCHERRY,YANAM,2021-03-11,0,1,0,1
PUDUCHERRY,YANAM,2021-03-12,0,1,0,1
PUDUCHERRY,YANAM,2021-03-13,0,1,0,1
PUDUCHERRY,YANAM,2021-03-15,0,6,0,6
PUNJAB,AMRITSAR,2021-03-11,118,2378,12,2508
PUNJAB,AMRITSAR,2021-03-12,215,1569,23,1807
PUNJAB,AMRITSAR,2021-03-13,135,1675,20,1830
PUNJAB,AMRITSAR,2021-03-14,200,1728,1,1929
PUNJAB,AMRITSAR,2021-03-15,159,1028,14,1201
PUNJAB,BARNALA,2021-03-11,4,47,24,75
PUNJAB,BARNALA,2021-03-12,4,192,1,197
PUNJAB,BARNALA,2021-03-13,12,282,8,302
PUNJAB,BARNALA,2021-03-14,2,298,23,323
PUNJAB,BARNALA,2021-03-15,8,136,1,145
PUNJAB,BATHINDA,2021-03-11,40,632,5,677
PUNJAB,BATHINDA,2021-03-12,54,463,5,522
PUNJAB,BATHINDA,2021-03-13,34,340,14,388
PUNJAB,BATHINDA,2021-03-14,19,583,16,618
PUNJAB,BATHINDA,2021-03-15,68,954,27,1049
PUNJAB,FARIDKOT,2021-03-11,19,476,1,496
PUNJAB,FARIDKOT,2021-03-12,31,341,35,407
PUNJAB,FARIDKOT,2021-03-13,42,460,30,532
PUNJAB,FARIDKOT,2021-03-14,8,76,6,90
PUNJAB,FARIDKOT,2021-03-15,32,511,4,547
PUNJAB,FATEHGARH SAHIB,2021-03-11,11,26,0,37
PUNJAB,FATEHGARH SAHIB,2021-03-12,47,581,3,631
PUNJAB,FATEHGARH SAHIB,2021-03-13,34,845,0,879
PUNJAB,FATEHGARH SAHIB,2021-03-14,15,437,0,452
PUNJAB,FATEHGARH SAHIB,2021-03-15,9,332,0,341
PUNJAB,FAZILKA,2021-03-11,4,28,0,32
PUNJAB,FAZILKA,2021-03-12,28,839,36,903
PUNJAB,FAZILKA,2021-03-13,15,1479,68,1562
PUNJAB,FAZILKA,2021-03-14,5,34,2,41
PUNJAB,FAZILKA,2021-03-15,7,1071,72,1150
PUNJAB,FIROZEPUR,2021-03-11,7,962,12,981
PUNJAB,FIROZEPUR,2021-03-12,51,656,6,713
PUNJAB,FIROZEPUR,2021-03-13,5,417,0,422
PUNJAB,FIROZEPUR,2021-03-14,12,472,2,486
PUNJAB,FIROZEPUR,2021-03-15,10,106,1,117
PUNJAB,GURDASPUR,2021-03-11,31,405,1,437
PUNJAB,GURDASPUR,2021-03-12,87,1061,1,1149
PUNJAB,GURDASPUR,2021-03-13,59,698,0,757
PUNJAB,GURDASPUR,2021-03-14,81,667,0,748
PUNJAB,GURDASPUR,2021-03-15,52,1126,1,1179
PUNJAB,HOSHIARPUR,2021-03-11,93,732,0,825
PUNJAB,HOSHIARPUR,2021-03-12,251,1521,5,1777
PUNJAB,HOSHIARPUR,2021-03-13,285,2926,12,3223
PUNJAB,HOSHIARPUR,2021-03-14,304,2995,25,3324
PUNJAB,HOSHIARPUR,2021-03-15,276,2509,21,2806
PUNJAB,JALANDHAR,2021-03-11,179,2363,5,2547
PUNJAB,JALANDHAR,2021-03-12,337,3194,118,3649
PUNJAB,JALANDHAR,2021-03-13,270,2212,33,2515
PUNJAB,JALANDHAR,2021-03-14,260,2676,174,3110
PUNJAB,JALANDHAR,2021-03-15,281,2222,43,2546
PUNJAB,KAPURTHALA,2021-03-11,89,720,0,809
PUNJAB,KAPURTHALA,2021-03-12,174,1136,1,1311
PUNJAB,KAPURTHALA,2021-03-13,75,744,0,819
PUNJAB,KAPURTHALA,2021-03-14,132,1208,0,1340
PUNJAB,KAPURTHALA,2021-03-15,74,1125,2,1201
PUNJAB,LUDHIANA,2021-03-11,205,4393,8,4606
PUNJAB,LUDHIANA,2021-03-12,214,4497,25,4736
PUNJAB,LUDHIANA,2021-03-13,227,2394,10,2631
PUNJAB,LUDHIANA,2021-03-14,133,3712,7,3852
PUNJAB,LUDHIANA,2021-03-15,308,3847,9,4164
PUNJAB,MANSA,2021-03-11,6,766,1,773
PUNJAB,MANSA,2021-03-12,21,356,0,377
PUNJAB,MANSA,2021-03-13,13,652,0,665
PUNJAB,MANSA,2021-03-14,0,569,2,571
PUNJAB,MANSA,2021-03-15,17,377,1,395
PUNJAB,MOGA,2021-03-11,23,526,8,557
PUNJAB,MOGA,2021-03-12,28,192,2,222
PUNJAB,MOGA,2021-03-13,33,497,4,534
PUNJAB,MOGA,2021-03-14,18,274,6,298
PUNJAB,MOGA,2021-03-15,28,271,21,320
PUNJAB,PATHANKOT,2021-03-11,5,44,0,49
PUNJAB,PATHANKOT,2021-03-12,7,86,1,94
PUNJAB,PATHANKOT,2021-03-13,16,320,0,336
PUNJAB,PATHANKOT,2021-03-14,18,180,1,199
PUNJAB,PATHANKOT,2021-03-15,6,316,1,323
PUNJAB,PATIALA,2021-03-11,100,1939,2,2041
PUNJAB,PATIALA,2021-03-12,155,2221,2,2378
PUNJAB,PATIALA,2021-03-13,180,2049,1,2230
PUNJAB,PATIALA,2021-03-14,189,1622,0,1811
PUNJAB,PATIALA,2021-03-15,158,2003,1,2162
PUNJAB,RUPNAGAR,2021-03-11,18,732,1,751
PUNJAB,RUPNAGAR,2021-03-12,73,1216,1,1290
PUNJAB,RUPNAGAR,2021-03-13,28,886,2,916
PUNJAB,RUPNAGAR,2021-03-14,49,1367,1,1417
PUNJAB,RUPNAGAR,2021-03-15,41,500,1,542
PUNJAB,S.A.S NAGAR,2021-03-11,217,1921,6,2144
PUNJAB,S.A.S NAGAR,2021-03-12,232,1275,8,1515
PUNJAB,S.A.S NAGAR,2021-03-13,197,1240,12,1449
PUNJAB,S.A.S NAGAR,2021-03-14,254,1132,9,1395
PUNJAB,S.A.S NAGAR,2021-03-15,153,1266,37,1456
PUNJAB,SANGRUR,2021-03-11,27,1036,0,1063
PUNJAB,SANGRUR,2021-03-12,34,1360,2,1396
PUNJAB,SANGRUR,2021-03-13,41,1543,5,1589
PUNJAB,SANGRUR,2021-03-14,4,1506,0,1510
PUNJAB,SANGRUR,2021-03-15,42,1185,1,1228
PUNJAB,SHAHID BHAGAT SINGH NAGAR,2021-03-11,154,1538,0,1692
PUNJAB,SHAHID BHAGAT SINGH NAGAR,2021-03-12,78,319,1,398
PUNJAB,SHAHID BHAGAT SINGH NAGAR,2021-03-13,149,1012,0,1161
PUNJAB,SHAHID BHAGAT SINGH NAGAR,2021-03-14,106,1042,0,1148
PUNJAB,SHAHID BHAGAT SINGH NAGAR,2021-03-15,104,608,0,712
PUNJAB,SRI MUKTSAR SAHIB,2021-03-11,16,332,3,351
PUNJAB,SRI MUKTSAR SAHIB,2021-03-12,9,189,4,202
PUNJAB,SRI MUKTSAR SAHIB,2021-03-13,15,449,6,470
PUNJAB,SRI MUKTSAR SAHIB,2021-03-14,2,357,0,359
PUNJAB,SRI MUKTSAR SAHIB,2021-03-15,8,74,2,84
PUNJAB,TARN TARAN,2021-03-11,7,385,0,392
PUNJAB,TARN TARAN,2021-03-12,32,660,0,692
PUNJAB,TARN TARAN,2021-03-13,8,111,0,119
PUNJAB,TARN TARAN,2021-03-14,31,361,2,394
PUNJAB,TARN TARAN,2021-03-15,5,395,0,400
RAJASTHAN,AJMER,2021-03-11,1,154,359,514
RAJASTHAN,AJMER,2021-03-12,0,62,701,763
RAJASTHAN,AJMER,2021-03-13,0,58,557,615
RAJASTHAN,AJMER,2021-03-14,2,36,252,290
RAJASTHAN,AJMER,2021-03-15,2,40,600,642
RAJASTHAN,ALWAR,2021-03-11,4,2179,32,2215
RAJASTHAN,ALWAR,2021-03-12,6,1065,23,1094
RAJASTHAN,ALWAR,2021-03-13,5,1219,39,1263
RAJASTHAN,ALWAR,2021-03-14,13,709,53,775
RAJASTHAN,ALWAR,2021-03-15,3,862,203,1068
RAJASTHAN,BANSWARA,2021-03-11,1,32,0,33
RAJASTHAN,BANSWARA,2021-03-12,3,41,0,44
RAJASTHAN,BANSWARA,2021-03-13,0,37,3,40
RAJASTHAN,BANSWARA,2021-03-14,0,16,0,16
RAJASTHAN,BANSWARA,2021-03-15,0,86,0,86
RAJASTHAN,BARAN,2021-03-11,1,121,0,122
RAJASTHAN,BARAN,2021-03-12,0,74,0,74
RAJASTHAN,BARAN,2021-03-13,5,110,0,115
RAJASTHAN,BARAN,2021-03-14,2,67,1,70
RAJASTHAN,BARAN,2021-03-15,4,30,0,34
RAJASTHAN,BARMER,2021-03-11,1,98,0,99
RAJASTHAN,BARMER,2021-03-12,1,62,0,63
RAJASTHAN,BARMER,2021-03-13,1,108,0,109
RAJASTHAN,BARMER,2021-03-14,1,125,0,126
RAJASTHAN,BARMER,2021-03-15,1,135,0,136
RAJASTHAN,BHARATPUR,2021-03-11,0,138,10,148
RAJASTHAN,BHARATPUR,2021-03-12,0,114,1,115
RAJASTHAN,BHARATPUR,2021-03-13,1,244,2,247
RAJASTHAN,BHARATPUR,2021-03-14,4,256,5,265
RAJASTHAN,BHARATPUR,2021-03-15,4,121,0,125
RAJASTHAN,BHILWARA,2021-03-11,39,1101,1,1141
RAJASTHAN,BHILWARA,2021-03-12,18,468,7,493
RAJASTHAN,BHILWARA,2021-03-13,1,268,0,269
RAJASTHAN,BHILWARA,2021-03-14,8,332,5,345
RAJASTHAN,BHILWARA,2021-03-15,22,526,8,556
RAJASTHAN,BIKANER,2021-03-11,0,757,3,760
RAJASTHAN,BIKANER,2021-03-12,0,537,2,539
RAJASTHAN,BIKANER,2021-03-13,0,851,5,856
RAJASTHAN,BIKANER,2021-03-14,0,210,2,212
RAJASTHAN,BIKANER,2021-03-15,2,545,5,552
RAJASTHAN,BUNDI,2021-03-11,0,49,0,49
RAJASTHAN,BUNDI,2021-03-12,0,103,0,103
RAJASTHAN,BUNDI,2021-03-13,0,127,1,128
RAJASTHAN,BUNDI,2021-03-14,0,106,0,106
RAJASTHAN,BUNDI,2021-03-15,0,43,0,43
RAJASTHAN,CHITTORGARH,2021-03-11,4,331,1,336
RAJASTHAN,CHITTORGARH,2021-03-12,2,388,1,391
RAJASTHAN,CHITTORGARH,2021-03-13,3,165,0,168
RAJASTHAN,CHITTORGARH,2021-03-14,6,260,0,266
RAJASTHAN,CHITTORGARH,2021-03-15,5,144,0,149
RAJASTHAN,CHURU,2021-03-11,0,382,4,386
RAJASTHAN,CHURU,2021-03-12,1,120,1,122
RAJASTHAN,CHURU,2021-03-13,2,245,1,248
RAJASTHAN,CHURU,2021-03-14,0,247,2,249
RAJASTHAN,CHURU,2021-03-15,0,130,2,132
RAJASTHAN,DAUSA,2021-03-11,1,197,2,200
RAJASTHAN,DAUSA,2021-03-12,0,47,4,51
RAJASTHAN,DAUSA,2021-03-13,0,287,3,290
RAJASTHAN,DAUSA,2021-03-14,1,147,11,159
RAJASTHAN,DAUSA,2021-03-15,0,35,5,40
RAJASTHAN,DHOLPUR,2021-03-11,3,45,1,49
RAJASTHAN,DHOLPUR,2021-03-12,6,157,7,170
RAJASTHAN,DHOLPUR,2021-03-13,1,131,4,136
RAJASTHAN,DHOLPUR,2021-03-14,0,9,1,10
RAJASTHAN,DHOLPUR,2021-03-15,3,11,0,14
RAJASTHAN,DUNGARPUR,2021-03-11,32,103,0,135
RAJASTHAN,DUNGARPUR,2021-03-12,18,157,0,175
RAJASTHAN,DUNGARPUR,2021-03-13,20,353,0,373
RAJASTHAN,DUNGARPUR,2021-03-14,9,143,0,152
RAJASTHAN,DUNGARPUR,2021-03-15,14,204,0,218
RAJASTHAN,GANGANAGAR,2021-03-11,61,165,12,238
RAJASTHAN,GANGANAGAR,2021-03-12,90,199,4,293
RAJASTHAN,GANGANAGAR,2021-03-13,73,80,6,159
RAJASTHAN,GANGANAGAR,2021-03-14,2,8,0,10
RAJASTHAN,GANGANAGAR,2021-03-15,135,277,11,423
RAJASTHAN,HANUMANGARH,2021-03-11,10,253,3,266
RAJASTHAN,HANUMANGARH,2021-03-12,6,616,3,625
RAJASTHAN,HANUMANGARH,2021-03-13,0,405,0,405
RAJASTHAN,HANUMANGARH,2021-03-14,2,613,1,616
RAJASTHAN,HANUMANGARH,2021-03-15,5,454,3,462
RAJASTHAN,JAIPUR,2021-03-11,66,2062,315,2443
RAJASTHAN,JAIPUR,2021-03-12,83,1915,280,2278
RAJASTHAN,JAIPUR,2021-03-13,131,2099,324,2554
RAJASTHAN,JAIPUR,2021-03-14,42,2003,263,2308
RAJASTHAN,JAIPUR,2021-03-15,102,1886,283,2271
RAJASTHAN,JAISALMER,2021-03-11,0,110,0,110
RAJASTHAN,JAISALMER,2021-03-12,0,31,0,31
RAJASTHAN,JAISALMER,2021-03-13,0,66,0,66
RAJASTHAN,JAISALMER,2021-03-14,0,156,0,156
RAJASTHAN,JAISALMER,2021-03-15,4,147,0,151
RAJASTHAN,JALORE,2021-03-11,0,191,1,192
RAJASTHAN,JALORE,2021-03-12,2,544,2,548
RAJASTHAN,JALORE,2021-03-13,2,455,1,458
RAJASTHAN,JALORE,2021-03-14,2,343,0,345
RAJASTHAN,JALORE,2021-03-15,2,188,0,190
RAJASTHAN,JHALAWAR,2021-03-11,0,165,0,165
RAJASTHAN,JHALAWAR,2021-03-12,20,89,5,114
RAJASTHAN,JHALAWAR,2021-03-13,0,20,0,20
RAJASTHAN,JHALAWAR,2021-03-14,0,74,1,75
RAJASTHAN,JHALAWAR,2021-03-15,19,322,7,348
RAJASTHAN,JHUNJHUNU,2021-03-11,1,77,4,82
RAJASTHAN,JHUNJHUNU,2021-03-12,0,56,1,57
RAJASTHAN,JHUNJHUNU,2021-03-13,1,56,4,61
RAJASTHAN,JHUNJHUNU,2021-03-14,0,77,8,85
RAJASTHAN,JHUNJHUNU,2021-03-15,3,55,3,61
RAJASTHAN,JODHPUR,2021-03-11,27,1281,13,1321
RAJASTHAN,JODHPUR,2021-03-12,29,1054,2,1085
RAJASTHAN,JODHPUR,2021-03-13,16,498,3,517
RAJASTHAN,JODHPUR,2021-03-14,9,330,17,356
RAJASTHAN,JODHPUR,2021-03-15,36,1296,22,1354
RAJASTHAN,KARAULI,2021-03-11,2,156,2,160
RAJASTHAN,KARAULI,2021-03-12,1,195,3,199
RAJASTHAN,KARAULI,2021-03-13,6,197,5,208
RAJASTHAN,KARAULI,2021-03-14,2,138,4,144
RAJASTHAN,KARAULI,2021-03-15,3,152,1,156
RAJASTHAN,KOTA,2021-03-11,0,1206,3,1209
RAJASTHAN,KOTA,2021-03-12,2,1081,4,1087
RAJASTHAN,KOTA,2021-03-13,59,1023,5,1087
RAJASTHAN,KOTA,2021-03-14,0,1518,0,1518
RAJASTHAN,KOTA,2021-03-15,57,971,9,1037
RAJASTHAN,NAGAUR,2021-03-11,1,61,11,73
RAJASTHAN,NAGAUR,2021-03-12,1,49,5,55
RAJASTHAN,NAGAUR,2021-03-13,2,116,129,247
RAJASTHAN,NAGAUR,2021-03-14,0,40,30,70
RAJASTHAN,NAGAUR,2021-03-15,5,61,4,70
RAJASTHAN,PALI,2021-03-11,2,17,9,28
RAJASTHAN,PALI,2021-03-12,1,17,0,18
RAJASTHAN,PALI,2021-03-13,0,19,8,27
RAJASTHAN,PALI,2021-03-14,1,17,1,19
RAJASTHAN,PALI,2021-03-15,1,22,0,23
RAJASTHAN,PRATAPGARH,2021-03-11,6,6,0,12
RAJASTHAN,PRATAPGARH,2021-03-12,12,3,0,15
RAJASTHAN,PRATAPGARH,2021-03-13,0,2,0,2
RAJASTHAN,PRATAPGARH,2021-03-14,3,0,0,3
RAJASTHAN,PRATAPGARH,2021-03-15,12,4,0,16
RAJASTHAN,RAJSAMAND,2021-03-11,3,72,3,78
RAJASTHAN,RAJSAMAND,2021-03-12,16,326,1,343
RAJASTHAN,RAJSAMAND,2021-03-13,28,268,4,300
RAJASTHAN,RAJSAMAND,2021-03-14,19,218,0,237
RAJASTHAN,RAJSAMAND,2021-03-15,24,335,1,360
RAJASTHAN,SAWAI MADHOPUR,2021-03-11,0,179,6,185
RAJASTHAN,SAWAI MADHOPUR,2021-03-12,0,108,58,166
RAJASTHAN,SAWAI MADHOPUR,2021-03-13,0,13,5,18
RAJASTHAN,SAWAI MADHOPUR,2021-03-14,0,80,6,86
RAJASTHAN,SAWAI MADHOPUR,2021-03-15,0,52,6,58
RAJASTHAN,SIKAR,2021-03-11,1,114,7,122
RAJASTHAN,SIKAR,2021-03-12,4,141,2,147
RAJASTHAN,SIKAR,2021-03-13,0,88,11,99
RAJASTHAN,SIKAR,2021-03-14,0,234,13,247
RAJASTHAN,SIKAR,2021-03-15,2,301,3,306
RAJASTHAN,SIROHI,2021-03-11,0,105,0,105
RAJASTHAN,SIROHI,2021-03-12,0,95,0,95
RAJASTHAN,SIROHI,2021-03-13,1,128,0,129
RAJASTHAN,SIROHI,2021-03-14,0,25,0,25
RAJASTHAN,SIROHI,2021-03-15,0,285,0,285
RAJASTHAN,TONK,2021-03-11,0,101,8,109
RAJASTHAN,TONK,2021-03-12,1,72,5,78
RAJASTHAN,TONK,2021-03-13,0,164,4,168
RAJASTHAN,TONK,2021-03-14,1,21,8,30
RAJASTHAN,TONK,2021-03-15,1,291,2,294
RAJASTHAN,UDAIPUR,2021-03-11,74,914,2,990
RAJASTHAN,UDAIPUR,2021-03-12,68,686,0,754
RAJASTHAN,UDAIPUR,2021-03-13,125,946,0,1071
RAJASTHAN,UDAIPUR,2021-03-14,88,801,0,889
RAJASTHAN,UDAIPUR,2021-03-15,125,589,0,714
SIKKIM,EAST DISTRICT,2021-03-11,4,125,0,129
SIKKIM,EAST DISTRICT,2021-03-12,1,105,0,106
SIKKIM,EAST DISTRICT,2021-03-13,1,121,0,122
SIKKIM,EAST DISTRICT,2021-03-14,0,4,0,4
SIKKIM,EAST DISTRICT,2021-03-15,4,112,0,116
SIKKIM,NORTH DISTRICT,2021-03-11,0,4,0,4
SIKKIM,NORTH DISTRICT,2021-03-12,0,13,0,13
SIKKIM,NORTH DISTRICT,2021-03-13,1,0,0,1
SIKKIM,NORTH DISTRICT,2021-03-14,0,1,0,1
SIKKIM,NORTH DISTRICT,2021-03-15,0,1,0,1
SIKKIM,SOUTH DISTRICT,2021-03-11,0,10,0,10
SIKKIM,SOUTH DISTRICT,2021-03-12,0,33,0,33
SIKKIM,SOUTH DISTRICT,2021-03-13,0,3,0,3
SIKKIM,SOUTH DISTRICT,2021-03-14,0,2,0,2
SIKKIM,SOUTH DISTRICT,2021-03-15,0,20,0,20
SIKKIM,WEST DISTRICT,2021-03-11,0,7,0,7
SIKKIM,WEST DISTRICT,2021-03-12,0,5,0,5
SIKKIM,WEST DISTRICT,2021-03-13,0,2,0,2
SIKKIM,WEST DISTRICT,2021-03-15,0,10,0,10
TAMIL NADU,ARIYALUR,2021-03-11,1,364,0,365
TAMIL NADU,ARIYALUR,2021-03-12,2,448,0,450
TAMIL NADU,ARIYALUR,2021-03-13,1,108,0,109
TAMIL NADU,ARIYALUR,2021-03-14,0,95,1,96
TAMIL NADU,ARIYALUR,2021-03-15,6,538,0,544
TAMIL NADU,CHENGALPATTU,2021-03-11,78,2413,0,2491
TAMIL NADU,CHENGALPATTU,2021-03-12,71,2205,0,2276
TAMIL NADU,CHENGALPATTU,2021-03-13,86,2752,1,2839
TAMIL NADU,CHENGALPATTU,2021-03-14,64,3802,0,3866
TAMIL NADU,CHENGALPATTU,2021-03-15,97,2477,0,2574
TAMIL NADU,CHENNAI,2021-03-11,420,10637,28,11085
TAMIL NADU,CHENNAI,2021-03-12,461,12070,35,12566
TAMIL NADU,CHENNAI,2021-03-13,503,11759,16,12278
TAMIL NADU,CHENNAI,2021-03-14,419,9284,23,9726
TAMIL NADU,CHENNAI,2021-03-15,505,10720,5,11230
TAMIL NADU,COIMBATORE,2021-03-11,71,2387,3,2461
TAMIL NADU,COIMBATORE,2021-03-12,79,2256,0,2335
TAMIL NADU,COIMBATORE,2021-03-13,80,2218,0,2298
TAMIL NADU,COIMBATORE,2021-03-14,88,1872,0,1960
TAMIL NADU,COIMBATORE,2021-03-15,101,1933,0,2034
TAMIL NADU,CUDDALORE,2021-03-11,17,3930,3,3950
TAMIL NADU,CUDDALORE,2021-03-12,15,3153,0,3168
TAMIL NADU,CUDDALORE,2021-03-13,11,2515,0,2526
TAMIL NADU,CUDDALORE,2021-03-14,7,1448,0,1455
TAMIL NADU,CUDDALORE,2021-03-15,11,1260,0,1271
TAMIL NADU,DHARMAPURI,2021-03-11,4,663,0,667
TAMIL NADU,DHARMAPURI,2021-03-12,2,644,0,646
TAMIL NADU,DHARMAPURI,2021-03-13,2,638,1,641
TAMIL NADU,DHARMAPURI,2021-03-14,2,642,0,644
TAMIL NADU,DHARMAPURI,2021-03-15,0,340,0,340
TAMIL NADU,DINDIGUL,2021-03-11,4,622,0,626
TAMIL NADU,DINDIGUL,2021-03-12,23,517,0,540
TAMIL NADU,DINDIGUL,2021-03-13,12,870,0,882
TAMIL NADU,DINDIGUL,2021-03-14,10,141,0,151
TAMIL NADU,DINDIGUL,2021-03-15,6,1528,2,1536
TAMIL NADU,ERODE,2021-03-11,13,1154,0,1167
TAMIL NADU,ERODE,2021-03-12,12,1564,0,1576
TAMIL NADU,ERODE,2021-03-13,19,1471,0,1490
TAMIL NADU,ERODE,2021-03-14,19,1843,0,1862
TAMIL NADU,ERODE,2021-03-15,14,2243,0,2257
TAMIL NADU,KALLAKURICHI,2021-03-11,1,433,0,434
TAMIL NADU,KALLAKURICHI,2021-03-12,1,287,0,288
TAMIL NADU,KALLAKURICHI,2021-03-13,1,397,0,398
TAMIL NADU,KALLAKURICHI,2021-03-14,0,200,0,200
TAMIL NADU,KALLAKURICHI,2021-03-15,2,266,2,270
TAMIL NADU,KANCHIPURAM,2021-03-11,23,1915,0,1938
TAMIL NADU,KANCHIPURAM,2021-03-12,23,1794,1,1818
TAMIL NADU,KANCHIPURAM,2021-03-13,25,1545,0,1570
TAMIL NADU,KANCHIPURAM,2021-03-14,23,1288,1,1312
TAMIL NADU,KANCHIPURAM,2021-03-15,33,2289,2,2324
TAMIL NADU,KANNIYAKUMARI,2021-03-11,5,2020,5,2030
TAMIL NADU,KANNIYAKUMARI,2021-03-12,14,1794,4,1812
TAMIL NADU,KANNIYAKUMARI,2021-03-13,10,1745,6,1761
TAMIL NADU,KANNIYAKUMARI,2021-03-14,13,1220,2,1235
TAMIL NADU,KANNIYAKUMARI,2021-03-15,7,1195,0,1202
TAMIL NADU,KARUR,2021-03-11,5,1095,0,1100
TAMIL NADU,KARUR,2021-03-12,4,971,0,975
TAMIL NADU,KARUR,2021-03-13,8,831,0,839
TAMIL NADU,KARUR,2021-03-14,7,1025,0,1032
TAMIL NADU,KARUR,2021-03-15,5,713,0,718
TAMIL NADU,KRISHNAGIRI,2021-03-11,4,1416,0,1420
TAMIL NADU,KRISHNAGIRI,2021-03-12,10,639,0,649
TAMIL NADU,KRISHNAGIRI,2021-03-13,5,957,2,964
TAMIL NADU,KRISHNAGIRI,2021-03-14,7,859,0,866
TAMIL NADU,KRISHNAGIRI,2021-03-15,4,380,2,386
TAMIL NADU,MADURAI,2021-03-11,17,1799,0,1816
TAMIL NADU,MADURAI,2021-03-12,26,2328,0,2354
TAMIL NADU,MADURAI,2021-03-13,19,2159,0,2178
TAMIL NADU,MADURAI,2021-03-14,20,1216,2,1238
TAMIL NADU,MADURAI,2021-03-15,10,1820,2,1832
TAMIL NADU,NAGAPATTINAM,2021-03-11,10,491,1,502
TAMIL NADU,NAGAPATTINAM,2021-03-12,10,517,1,528
TAMIL NADU,NAGAPATTINAM,2021-03-13,7,521,1,529
TAMIL NADU,NAGAPATTINAM,2021-03-14,7,157,2,166
TAMIL NADU,NAGAPATTINAM,2021-03-15,11,164,1,176
TAMIL NADU,NAMAKKAL,2021-03-11,3,832,0,835
TAMIL NADU,NAMAKKAL,2021-03-12,7,1051,0,1058
TAMIL NADU,NAMAKKAL,2021-03-13,10,1316,0,1326
TAMIL NADU,NAMAKKAL,2021-03-14,7,1325,0,1332
TAMIL NADU,NAMAKKAL,2021-03-15,7,1094,0,1101
TAMIL NADU,PERAMBALUR,2021-03-11,1,219,0,220
TAMIL NADU,PERAMBALUR,2021-03-12,3,339,0,342
TAMIL NADU,PERAMBALUR,2021-03-13,0,456,1,457
TAMIL NADU,PERAMBALUR,2021-03-14,2,482,0,484
TAMIL NADU,PERAMBALUR,2021-03-15,0,280,0,280
TAMIL NADU,PUDUKKOTTAI,2021-03-11,2,576,0,578
TAMIL NADU,PUDUKKOTTAI,2021-03-12,4,564,1,569
TAMIL NADU,PUDUKKOTTAI,2021-03-13,3,505,0,508
TAMIL NADU,PUDUKKOTTAI,2021-03-14,11,532,1,544
TAMIL NADU,PUDUKKOTTAI,2021-03-15,4,137,1,142
TAMIL NADU,RAMANATHAPURAM,2021-03-11,2,745,0,747
TAMIL NADU,RAMANATHAPURAM,2021-03-12,1,950,0,951
TAMIL NADU,RAMANATHAPURAM,2021-03-13,0,959,0,959
TAMIL NADU,RAMANATHAPURAM,2021-03-14,2,378,0,380
TAMIL NADU,RAMANATHAPURAM,2021-03-15,0,490,0,490
TAMIL NADU,RANIPET,2021-03-11,2,221,0,223
TAMIL NADU,RANIPET,2021-03-12,2,270,0,272
TAMIL NADU,RANIPET,2021-03-13,3,258,0,261
TAMIL NADU,RANIPET,2021-03-14,1,66,0,67
TAMIL NADU,RANIPET,2021-03-15,2,476,0,478
TAMIL NADU,SALEM,2021-03-11,27,2220,2,2249
TAMIL NADU,SALEM,2021-03-12,16,955,1,972
TAMIL NADU,SALEM,2021-03-13,12,905,4,921
TAMIL NADU,SALEM,2021-03-14,5,1102,2,1109
TAMIL NADU,SALEM,2021-03-15,10,1403,1,1414
TAMIL NADU,SIVAGANGA,2021-03-11,5,361,0,366
TAMIL NADU,SIVAGANGA,2021-03-12,5,443,1,449
TAMIL NADU,SIVAGANGA,2021-03-13,10,455,0,465
TAMIL NADU,SIVAGANGA,2021-03-14,6,189,0,195
TAMIL NADU,SIVAGANGA,2021-03-15,8,187,0,195
TAMIL NADU,TENKASI,2021-03-11,2,404,1,407
TAMIL NADU,TENKASI,2021-03-12,1,444,4,449
TAMIL NADU,TENKASI,2021-03-13,1,577,22,600
TAMIL NADU,TENKASI,2021-03-14,1,480,4,485
TAMIL NADU,TENKASI,2021-03-15,4,290,0,294
TAMIL NADU,THANJAVUR,2021-03-11,21,8615,2,8638
TAMIL NADU,THANJAVUR,2021-03-12,25,8421,20,8466
TAMIL NADU,THANJAVUR,2021-03-13,54,8823,0,8877
TAMIL NADU,THANJAVUR,2021-03-14,64,7094,20,7178
TAMIL NADU,THANJAVUR,2021-03-15,46,8125,0,8171
TAMIL NADU,THE NILGIRIS,2021-03-11,12,1010,11,1033
TAMIL NADU,THE NILGIRIS,2021-03-12,16,996,0,1012
TAMIL NADU,THE NILGIRIS,2021-03-13,12,1033,5,1050
TAMIL NADU,THE NILGIRIS,2021-03-14,8,952,6,966
TAMIL NADU,THE NILGIRIS,2021-03-15,2,666,0,668
TAMIL NADU,THENI,2021-03-11,3,523,0,526
TAMIL NADU,THENI,2021-03-12,6,282,0,288
TAMIL NADU,THENI,2021-03-13,4,405,0,409
TAMIL NADU,THENI,2021-03-14,4,363,0,367
TAMIL NADU,THENI,2021-03-15,3,417,0,420
TAMIL NADU,THIRUVALLUR,2021-03-11,52,2304,1,2357
TAMIL NADU,THIRUVALLUR,2021-03-12,45,1800,8,1853
TAMIL NADU,THIRUVALLUR,2021-03-13,55,1906,5,1966
TAMIL NADU,THIRUVALLUR,2021-03-14,36,1220,1,1257
TAMIL NADU,THIRUVALLUR,2021-03-15,65,1459,4,1528
TAMIL NADU,THIRUVARUR,2021-03-11,10,1884,0,1894
TAMIL NADU,THIRUVARUR,2021-03-12,16,1851,0,1867
TAMIL NADU,THIRUVARUR,2021-03-13,12,1575,1,1588
TAMIL NADU,THIRUVARUR,2021-03-14,21,158,6,185
TAMIL NADU,THIRUVARUR,2021-03-15,8,1450,0,1458
TAMIL NADU,TIRUCHIRAPPALLI,2021-03-11,14,1446,0,1460
TAMIL NADU,TIRUCHIRAPPALLI,2021-03-12,13,2082,1,2096
TAMIL NADU,TIRUCHIRAPPALLI,2021-03-13,15,1228,0,1243
TAMIL NADU,TIRUCHIRAPPALLI,2021-03-14,22,1577,3,1602
TAMIL NADU,TIRUCHIRAPPALLI,2021-03-15,34,1484,0,1518
TAMIL NADU,TIRUNELVELI,2021-03-11,4,787,0,791
TAMIL NADU,TIRUNELVELI,2021-03-12,4,766,1,771
TAMIL NADU,TIRUNELVELI,2021-03-13,11,653,1,665
TAMIL NADU,TIRUNELVELI,2021-03-14,6,280,1,287
TAMIL NADU,TIRUNELVELI,2021-03-15,8,914,0,922
TAMIL NADU,TIRUPATHUR,2021-03-11,2,1595,11,1608
TAMIL NADU,TIRUPATHUR,2021-03-12,7,1400,8,1415
TAMIL NADU,TIRUPATHUR,2021-03-13,7,2095,1,2103
TAMIL NADU,TIRUPATHUR,2021-03-14,0,1698,0,1698
TAMIL NADU,TIRUPATHUR,2021-03-15,8,3169,2,3179
TAMIL NADU,TIRUPPUR,2021-03-11,38,1925,0,1963
TAMIL NADU,TIRUPPUR,2021-03-12,25,1624,0,1649
TAMIL NADU,TIRUPPUR,2021-03-13,43,1961,0,2004
TAMIL NADU,TIRUPPUR,2021-03-14,23,616,1,640
TAMIL NADU,TIRUPPUR,2021-03-15,22,1218,1,1241
TAMIL NADU,TIRUVANNAMALAI,2021-03-11,16,736,0,752
TAMIL NADU,TIRUVANNAMALAI,2021-03-12,4,628,0,632
TAMIL NADU,TIRUVANNAMALAI,2021-03-13,2,465,0,467
TAMIL NADU,TIRUVANNAMALAI,2021-03-14,2,242,0,244
TAMIL NADU,TIRUVANNAMALAI,2021-03-15,1,671,0,672
TAMIL NADU,TUTICORIN,2021-03-11,2,661,0,663
TAMIL NADU,TUTICORIN,2021-03-12,7,609,2,618
TAMIL NADU,TUTICORIN,2021-03-13,7,651,0,658
TAMIL NADU,TUTICORIN,2021-03-14,2,492,0,494
TAMIL NADU,TUTICORIN,2021-03-15,3,291,2,296
TAMIL NADU,VELLORE,2021-03-11,32,1397,0,1429
TAMIL NADU,VELLORE,2021-03-12,15,923,0,938
TAMIL NADU,VELLORE,2021-03-13,18,963,2,983
TAMIL NADU,VELLORE,2021-03-14,10,617,0,627
TAMIL NADU,VELLORE,2021-03-15,22,1136,0,1158
TAMIL NADU,VILLUPURAM,2021-03-11,3,740,1,744
TAMIL NADU,VILLUPURAM,2021-03-12,4,840,0,844
TAMIL NADU,VILLUPURAM,2021-03-13,2,735,0,737
TAMIL NADU,VILLUPURAM,2021-03-14,3,705,0,708
TAMIL NADU,VILLUPURAM,2021-03-15,2,697,0,699
TAMIL NADU,VIRUDHUNAGAR,2021-03-11,5,535,1,541
TAMIL NADU,VIRUDHUNAGAR,2021-03-12,1,493,0,494
TAMIL NADU,VIRUDHUNAGAR,2021-03-13,15,745,3,763
TAMIL NADU,VIRUDHUNAGAR,2021-03-14,7,128,0,135
TAMIL NADU,VIRUDHUNAGAR,2021-03-15,2,1389,7,1398
TELANGANA,ADILABAD,2021-03-11,1,2064,0,2065
TELANGANA,ADILABAD,2021-03-12,0,1020,0,1020
TELANGANA,ADILABAD,2021-03-13,2,970,0,972
TELANGANA,ADILABAD,2021-03-14,3,520,0,523
TELANGANA,ADILABAD,2021-03-15,1,1065,0,1066
TELANGANA,BHADRADRI KOTHAGUDEM,2021-03-11,0,118,0,118
TELANGANA,BHADRADRI KOTHAGUDEM,2021-03-12,0,356,0,356
TELANGANA,BHADRADRI KOTHAGUDEM,2021-03-13,0,569,0,569
TELANGANA,BHADRADRI KOTHAGUDEM,2021-03-14,0,172,0,172
TELANGANA,BHADRADRI KOTHAGUDEM,2021-03-15,0,648,0,648
TELANGANA,HYDERABAD,2021-03-11,41,4922,4,4967
TELANGANA,HYDERABAD,2021-03-12,24,6829,4,6857
TELANGANA,HYDERABAD,2021-03-13,56,7661,7,7724
TELANGANA,HYDERABAD,2021-03-14,40,3499,13,3552
TELANGANA,HYDERABAD,2021-03-15,45,7517,0,7562
TELANGANA,JAGITIAL,2021-03-11,0,485,0,485
TELANGANA,JAGITIAL,2021-03-12,0,737,0,737
TELANGANA,JAGITIAL,2021-03-13,0,977,0,977
TELANGANA,JAGITIAL,2021-03-14,0,471,0,471
TELANGANA,JAGITIAL,2021-03-15,0,1190,0,1190
TELANGANA,JANGOAN,2021-03-11,0,360,0,360
TELANGANA,JANGOAN,2021-03-12,0,485,0,485
TELANGANA,JANGOAN,2021-03-13,0,962,0,962
TELANGANA,JANGOAN,2021-03-14,0,477,0,477
TELANGANA,JANGOAN,2021-03-15,0,777,0,777
TELANGANA,JAYASHANKAR BHUPALAPALLY,2021-03-11,0,62,0,62
TELANGANA,JAYASHANKAR BHUPALAPALLY,2021-03-12,0,99,0,99
TELANGANA,JAYASHANKAR BHUPALAPALLY,2021-03-13,0,270,0,270
TELANGANA,JAYASHANKAR BHUPALAPALLY,2021-03-14,0,164,0,164
TELANGANA,JAYASHANKAR BHUPALAPALLY,2021-03-15,0,661,0,661
TELANGANA,JOGULAMBA GADWAL,2021-03-11,0,213,0,213
TELANGANA,JOGULAMBA GADWAL,2021-03-12,0,718,0,718
TELANGANA,JOGULAMBA GADWAL,2021-03-13,0,1530,0,1530
TELANGANA,JOGULAMBA GADWAL,2021-03-14,0,771,0,771
TELANGANA,JOGULAMBA GADWAL,2021-03-15,0,886,0,886
TELANGANA,KAMAREDDY,2021-03-11,0,150,0,150
TELANGANA,KAMAREDDY,2021-03-12,0,342,0,342
TELANGANA,KAMAREDDY,2021-03-13,0,739,0,739
TELANGANA,KAMAREDDY,2021-03-14,1,246,0,247
TELANGANA,KAMAREDDY,2021-03-15,0,1195,0,1195
TELANGANA,KARIMNAGAR,2021-03-11,1,521,0,522
TELANGANA,KARIMNAGAR,2021-03-12,0,1129,0,1129
TELANGANA,KARIMNAGAR,2021-03-13,2,1485,0,1487
TELANGANA,KARIMNAGAR,2021-03-14,0,933,0,933
TELANGANA,KARIMNAGAR,2021-03-15,0,1974,0,1974
TELANGANA,KHAMMAM,2021-03-11,0,139,0,139
TELANGANA,KHAMMAM,2021-03-12,0,769,0,769
TELANGANA,KHAMMAM,2021-03-13,4,1045,0,1049
TELANGANA,KHAMMAM,2021-03-14,0,173,0,173
TELANGANA,KHAMMAM,2021-03-15,3,1515,0,1518
TELANGANA,KUMURAM BHEEM ASIFABAD,2021-03-11,0,111,0,111
TELANGANA,KUMURAM BHEEM ASIFABAD,2021-03-12,0,279,0,279
TELANGANA,KUMURAM BHEEM ASIFABAD,2021-03-13,0,454,0,454
TELANGANA,KUMURAM BHEEM ASIFABAD,2021-03-14,0,299,0,299
TELANGANA,KUMURAM BHEEM ASIFABAD,2021-03-15,0,545,0,545
TELANGANA,MAHABUBABAD,2021-03-11,0,304,0,304
TELANGANA,MAHABUBABAD,2021-03-12,0,647,0,647
TELANGANA,MAHABUBABAD,2021-03-13,0,357,0,357
TELANGANA,MAHABUBABAD,2021-03-14,0,365,0,365
TELANGANA,MAHABUBABAD,2021-03-15,0,446,0,446
TELANGANA,MAHABUBNAGAR,2021-03-11,1,262,0,263
TELANGANA,MAHABUBNAGAR,2021-03-12,0,880,0,880
TELANGANA,MAHABUBNAGAR,2021-03-13,0,1451,0,1451
TELANGANA,MAHABUBNAGAR,2021-03-14,0,1151,0,1151
TELANGANA,MAHABUBNAGAR,2021-03-15,0,1425,0,1425
TELANGANA,MANCHERIAL,2021-03-11,0,370,0,370
TELANGANA,MANCHERIAL,2021-03-12,0,620,0,620
TELANGANA,MANCHERIAL,2021-03-13,0,1802,0,1802
TELANGANA,MANCHERIAL,2021-03-14,0,1148,0,1148
TELANGANA,MANCHERIAL,2021-03-15,0,1819,0,1819
TELANGANA,MEDAK,2021-03-11,4,137,0,141
TELANGANA,MEDAK,2021-03-12,1,241,0,242
TELANGANA,MEDAK,2021-03-13,1,611,0,612
TELANGANA,MEDAK,2021-03-14,2,137,0,139
TELANGANA,MEDAK,2021-03-15,0,851,1,852
TELANGANA,MEDCHAL MALKAJGIRI,2021-03-11,0,567,0,567
TELANGANA,MEDCHAL MALKAJGIRI,2021-03-12,0,1854,0,1854
TELANGANA,MEDCHAL MALKAJGIRI,2021-03-13,1,2276,1,2278
TELANGANA,MEDCHAL MALKAJGIRI,2021-03-14,2,817,1,820
TELANGANA,MEDCHAL MALKAJGIRI,2021-03-15,0,2738,0,2738
TELANGANA,MULUGU,2021-03-11,0,23,0,23
TELANGANA,MULUGU,2021-03-12,0,87,0,87
TELANGANA,MULUGU,2021-03-13,0,337,0,337
TELANGANA,MULUGU,2021-03-14,0,18,0,18
TELANGANA,MULUGU,2021-03-15,0,341,0,341
TELANGANA,NAGARKURNOOL,2021-03-11,0,906,0,906
TELANGANA,NAGARKURNOOL,2021-03-12,0,1356,0,1356
TELANGANA,NAGARKURNOOL,2021-03-13,0,1857,0,1857
TELANGANA,NAGARKURNOOL,2021-03-14,0,1395,0,1395
TELANGANA,NAGARKURNOOL,2021-03-15,0,1896,0,1896
TELANGANA,NALGONDA,2021-03-11,0,233,0,233
TELANGANA,NALGONDA,2021-03-12,0,1214,0,1214
TELANGANA,NALGONDA,2021-03-13,0,2844,0,2844
TELANGANA,NALGONDA,2021-03-14,0,1661,0,1661
TELANGANA,NALGONDA,2021-03-15,0,3091,0,3091
TELANGANA,NARAYANPET,2021-03-11,0,145,0,145
TELANGANA,NARAYANPET,2021-03-12,0,107,0,107
TELANGANA,NARAYANPET,2021-03-13,0,235,0,235
TELANGANA,NARAYANPET,2021-03-14,0,41,0,41
TELANGANA,NARAYANPET,2021-03-15,0,416,0,416
TELANGANA,NIRMAL,2021-03-11,0,45,0,45
TELANGANA,NIRMAL,2021-03-12,0,773,0,773
TELANGANA,NIRMAL,2021-03-13,0,73,0,73
TELANGANA,NIRMAL,2021-03-14,0,28,0,28
TELANGANA,NIRMAL,2021-03-15,0,285,0,285
TELANGANA,NIZAMABAD,2021-03-11,0,145,0,145
TELANGANA,NIZAMABAD,2021-03-12,0,492,0,492
TELANGANA,NIZAMABAD,2021-03-13,0,819,0,819
TELANGANA,NIZAMABAD,2021-03-14,0,430,0,430
TELANGANA,NIZAMABAD,2021-03-15,1,2411,0,2412
TELANGANA,PEDDAPALLI,2021-03-11,0,291,0,291
TELANGANA,PEDDAPALLI,2021-03-12,0,941,0,941
TELANGANA,PEDDAPALLI,2021-03-13,0,1756,0,1756
TELANGANA,PEDDAPALLI,2021-03-14,0,812,0,812
TELANGANA,PEDDAPALLI,2021-03-15,0,1877,0,1877
TELANGANA,RAJANNA SIRCILLA,2021-03-11,0,112,0,112
TELANGANA,RAJANNA SIRCILLA,2021-03-12,0,179,0,179
TELANGANA,RAJANNA SIRCILLA,2021-03-13,0,447,0,447
TELANGANA,RAJANNA SIRCILLA,2021-03-14,0,42,0,42
TELANGANA,RAJANNA SIRCILLA,2021-03-15,0,454,0,454
TELANGANA,RANGA REDDY,2021-03-11,2,864,1,867
TELANGANA,RANGA REDDY,2021-03-12,4,2312,0,2316
TELANGANA,RANGA REDDY,2021-03-13,7,2789,0,2796
TELANGANA,RANGA REDDY,2021-03-14,8,1386,2,1396
TELANGANA,RANGA REDDY,2021-03-15,7,3177,1,3185
TELANGANA,SANGAREDDY,2021-03-11,1,505,0,506
TELANGANA,SANGAREDDY,2021-03-12,0,420,0,420
TELANGANA,SANGAREDDY,2021-03-13,1,866,0,867
TELANGANA,SANGAREDDY,2021-03-14,1,288,0,289
TELANGANA,SANGAREDDY,2021-03-15,7,1300,0,1307
TELANGANA,SIDDIPET,2021-03-11,1,536,0,537
TELANGANA,SIDDIPET,2021-03-12,0,1119,0,1119
TELANGANA,SIDDIPET,2021-03-13,0,2139,0,2139
TELANGANA,SIDDIPET,2021-03-14,0,1448,0,1448
TELANGANA,SIDDIPET,2021-03-15,0,1883,0,1883
TELANGANA,SURYAPET,2021-03-11,0,370,0,370
TELANGANA,SURYAPET,2021-03-12,0,550,0,550
TELANGANA,SURYAPET,2021-03-13,0,919,0,919
TELANGANA,SURYAPET,2021-03-14,0,352,0,352
TELANGANA,SURYAPET,2021-03-15,0,1121,0,1121
TELANGANA,VIKARABAD,2021-03-11,0,239,0,239
TELANGANA,VIKARABAD,2021-03-12,0,426,0,426
TELANGANA,VIKARABAD,2021-03-13,0,910,0,910
TELANGANA,VIKARABAD,2021-03-14,0,167,0,167
TELANGANA,VIKARABAD,2021-03-15,2,778,0,780
TELANGANA,WANAPARTHY,2021-03-11,0,111,0,111
TELANGANA,WANAPARTHY,2021-03-12,0,282,0,282
TELANGANA,WANAPARTHY,2021-03-13,0,411,0,411
TELANGANA,WANAPARTHY,2021-03-14,0,78,0,78
TELANGANA,WANAPARTHY,2021-03-15,0,651,0,651
TELANGANA,WARANGAL RURAL,2021-03-11,1,139,0,140
TELANGANA,WARANGAL RURAL,2021-03-12,0,313,0,313
TELANGANA,WARANGAL RURAL,2021-03-13,5,1010,0,1015
TELANGANA,WARANGAL RURAL,2021-03-14,0,1060,0,1060
TELANGANA,WARANGAL RURAL,2021-03-15,0,1092,0,1092
TELANGANA,WARANGAL URBAN,2021-03-11,0,812,0,812
TELANGANA,WARANGAL URBAN,2021-03-12,0,1404,0,1404
TELANGANA,WARANGAL URBAN,2021-03-13,0,2232,0,2232
TELANGANA,WARANGAL URBAN,2021-03-14,1,1862,0,1863
TELANGANA,WARANGAL URBAN,2021-03-15,0,2839,0,2839
TELANGANA,YADADRI BHUVANAGIRI,2021-03-11,0,82,0,82
TELANGANA,YADADRI BHUVANAGIRI,2021-03-12,0,283,0,283
TELANGANA,YADADRI BHUVANAGIRI,2021-03-13,0,298,0,298
TELANGANA,YADADRI BHUVANAGIRI,2021-03-14,0,8,0,8
TELANGANA,YADADRI BHUVANAGIRI,2021-03-15,0,588,0,588
TRIPURA,DHALAI,2021-03-11,0,2,0,2
TRIPURA,DHALAI,2021-03-12,0,32,0,32
TRIPURA,DHALAI,2021-03-13,0,23,0,23
TRIPURA,DHALAI,2021-03-14,0,2,0,2
TRIPURA,DHALAI,2021-03-15,0,9,0,9
TRIPURA,GOMATI,2021-03-11,0,17,0,17
TRIPURA,GOMATI,2021-03-12,1,16,0,17
TRIPURA,GOMATI,2021-03-13,0,13,0,13
TRIPURA,GOMATI,2021-03-14,0,15,0,15
TRIPURA,GOMATI,2021-03-15,0,66,0,66
TRIPURA,KHOWAI,2021-03-11,0,5,0,5
TRIPURA,KHOWAI,2021-03-12,0,15,0,15
TRIPURA,KHOWAI,2021-03-13,0,20,0,20
TRIPURA,KHOWAI,2021-03-14,0,5,0,5
TRIPURA,KHOWAI,2021-03-15,0,22,0,22
TRIPURA,NORTH TRIPURA,2021-03-11,0,91,0,91
TRIPURA,NORTH TRIPURA,2021-03-12,0,83,0,83
TRIPURA,NORTH TRIPURA,2021-03-13,0,100,0,100
TRIPURA,NORTH TRIPURA,2021-03-14,0,53,0,53
TRIPURA,NORTH TRIPURA,2021-03-15,0,117,0,117
TRIPURA,SEPAHIJALA,2021-03-11,0,9,0,9
TRIPURA,SEPAHIJALA,2021-03-12,0,55,0,55
TRIPURA,SEPAHIJALA,2021-03-13,0,52,0,52
TRIPURA,SEPAHIJALA,2021-03-14,0,7,0,7
TRIPURA,SEPAHIJALA,2021-03-15,0,47,0,47
TRIPURA,SOUTH TRIPURA,2021-03-11,0,16,0,16
TRIPURA,SOUTH TRIPURA,2021-03-12,0,35,0,35
TRIPURA,SOUTH TRIPURA,2021-03-13,0,60,0,60
TRIPURA,SOUTH TRIPURA,2021-03-14,0,18,0,18
TRIPURA,SOUTH TRIPURA,2021-03-15,2,38,0,40
TRIPURA,UNAKOTI,2021-03-11,0,5,0,5
TRIPURA,UNAKOTI,2021-03-12,0,14,0,14
TRIPURA,UNAKOTI,2021-03-13,0,4,0,4
TRIPURA,UNAKOTI,2021-03-15,0,5,0,5
TRIPURA,WEST TRIPURA,2021-03-11,0,104,0,104
TRIPURA,WEST TRIPURA,2021-03-12,2,240,0,242
TRIPURA,WEST TRIPURA,2021-03-13,4,152,1,157
TRIPURA,WEST TRIPURA,2021-03-14,3,68,0,71
TRIPURA,WEST TRIPURA,2021-03-15,12,304,0,316
UTTAR PRADESH,AGRA,2021-03-11,1,1220,1,1222
UTTAR PRADESH,AGRA,2021-03-12,1,1884,1,1886
UTTAR PRADESH,AGRA,2021-03-13,9,1756,11,1776
UTTAR PRADESH,AGRA,2021-03-14,3,1316,1,1320
UTTAR PRADESH,AGRA,2021-03-15,4,1495,3,1502
UTTAR PRADESH,ALIGARH,2021-03-11,1,2603,9,2613
UTTAR PRADESH,ALIGARH,2021-03-12,1,2283,31,2315
UTTAR PRADESH,ALIGARH,2021-03-13,4,2361,3,2368
UTTAR PRADESH,ALIGARH,2021-03-14,5,2196,0,2201
UTTAR PRADESH,ALIGARH,2021-03-15,15,3083,5,3103
UTTAR PRADESH,AMBEDKAR NAGAR,2021-03-11,1,767,14,782
UTTAR PRADESH,AMBEDKAR NAGAR,2021-03-12,0,1021,7,1028
UTTAR PRADESH,AMBEDKAR NAGAR,2021-03-13,0,927,28,955
UTTAR PRADESH,AMBEDKAR NAGAR,2021-03-14,0,756,8,764
UTTAR PRADESH,AMBEDKAR NAGAR,2021-03-15,1,545,1,547
UTTAR PRADESH,AMETHI,2021-03-11,0,1332,0,1332
UTTAR PRADESH,AMETHI,2021-03-12,0,794,10,804
UTTAR PRADESH,AMETHI,2021-03-13,1,544,2,547
UTTAR PRADESH,AMETHI,2021-03-14,0,551,18,569
UTTAR PRADESH,AMETHI,2021-03-15,0,1203,1,1204
UTTAR PRADESH,AMROHA,2021-03-11,1,567,0,568
UTTAR PRADESH,AMROHA,2021-03-12,1,535,0,536
UTTAR PRADESH,AMROHA,2021-03-13,2,118,0,120
UTTAR PRADESH,AMROHA,2021-03-14,2,404,0,406
UTTAR PRADESH,AMROHA,2021-03-15,1,1090,0,1091
UTTAR PRADESH,AURAIYA,2021-03-11,1,991,63,1055
UTTAR PRADESH,AURAIYA,2021-03-12,1,391,94,486
UTTAR PRADESH,AURAIYA,2021-03-13,2,767,25,794
UTTAR PRADESH,AURAIYA,2021-03-14,0,810,103,913
UTTAR PRADESH,AURAIYA,2021-03-15,1,665,46,712
UTTAR PRADESH,AYODHYA,2021-03-11,3,1254,0,1257
UTTAR PRADESH,AYODHYA,2021-03-12,0,987,0,987
UTTAR PRADESH,AYODHYA,2021-03-13,0,1414,0,1414
UTTAR PRADESH,AYODHYA,2021-03-14,2,952,1,955
UTTAR PRADESH,AYODHYA,2021-03-15,0,1019,0,1019
UTTAR PRADESH,AZAMGARH,2021-03-11,2,973,0,975
UTTAR PRADESH,AZAMGARH,2021-03-12,5,688,1,694
UTTAR PRADESH,AZAMGARH,2021-03-13,2,223,1,226
UTTAR PRADESH,AZAMGARH,2021-03-14,2,811,5,818
UTTAR PRADESH,AZAMGARH,2021-03-15,1,441,6,448
UTTAR PRADESH,BAGHPAT,2021-03-11,0,1204,45,1249
UTTAR PRADESH,BAGHPAT,2021-03-12,1,997,5,1003
UTTAR PRADESH,BAGHPAT,2021-03-13,1,1117,10,1128
UTTAR PRADESH,BAGHPAT,2021-03-14,0,2100,97,2197
UTTAR PRADESH,BAGHPAT,2021-03-15,0,1332,21,1353
UTTAR PRADESH,BAHRAICH,2021-03-11,1,1246,10,1257
UTTAR PRADESH,BAHRAICH,2021-03-12,2,1439,42,1483
UTTAR PRADESH,BAHRAICH,2021-03-13,1,1584,9,1594
UTTAR PRADESH,BAHRAICH,2021-03-14,1,1755,58,1814
UTTAR PRADESH,BAHRAICH,2021-03-15,1,1481,20,1502
UTTAR PRADESH,BALLIA,2021-03-11,1,1655,0,1656
UTTAR PRADESH,BALLIA,2021-03-12,3,1143,55,1201
UTTAR PRADESH,BALLIA,2021-03-13,0,1208,0,1208
UTTAR PRADESH,BALLIA,2021-03-14,2,1577,5,1584
UTTAR PRADESH,BALLIA,2021-03-15,3,1951,13,1967
UTTAR PRADESH,BALRAMPUR,2021-03-11,2,780,0,782
UTTAR PRADESH,BALRAMPUR,2021-03-12,1,879,0,880
UTTAR PRADESH,BALRAMPUR,2021-03-13,3,702,0,705
UTTAR PRADESH,BALRAMPUR,2021-03-14,6,930,1,937
UTTAR PRADESH,BALRAMPUR,2021-03-15,4,783,0,787
UTTAR PRADESH,BANDA,2021-03-11,55,1374,5,1434
UTTAR PRADESH,BANDA,2021-03-12,0,1563,17,1580
UTTAR PRADESH,BANDA,2021-03-13,2,1591,28,1621
UTTAR PRADESH,BANDA,2021-03-14,0,1727,1,1728
UTTAR PRADESH,BANDA,2021-03-15,0,1686,85,1771
UTTAR PRADESH,BARABANKI,2021-03-11,6,1151,0,1157
UTTAR PRADESH,BARABANKI,2021-03-12,1,954,1,956
UTTAR PRADESH,BARABANKI,2021-03-13,4,1413,1,1418
UTTAR PRADESH,BARABANKI,2021-03-14,3,1306,0,1309
UTTAR PRADESH,BARABANKI,2021-03-15,2,1137,47,1186
UTTAR PRADESH,BAREILLY,2021-03-11,11,1429,3,1443
UTTAR PRADESH,BAREILLY,2021-03-12,8,2051,2,2061
UTTAR PRADESH,BAREILLY,2021-03-13,11,1925,32,1968
UTTAR PRADESH,BAREILLY,2021-03-14,5,1899,3,1907
UTTAR PRADESH,BAREILLY,2021-03-15,12,1484,34,1530
UTTAR PRADESH,BASTI,2021-03-11,2,1700,22,1724
UTTAR PRADESH,BASTI,2021-03-12,1,636,15,652
UTTAR PRADESH,BASTI,2021-03-13,2,837,25,864
UTTAR PRADESH,BASTI,2021-03-14,2,746,16,764
UTTAR PRADESH,BASTI,2021-03-15,2,1704,58,1764
UTTAR PRADESH,BHADOHI,2021-03-11,2,668,0,670
UTTAR PRADESH,BHADOHI,2021-03-12,0,709,0,709
UTTAR PRADESH,BHADOHI,2021-03-13,1,1105,1,1107
UTTAR PRADESH,BHADOHI,2021-03-14,0,1645,0,1645
UTTAR PRADESH,BHADOHI,2021-03-15,1,1536,2,1539
UTTAR PRADESH,BIJNOR,2021-03-11,2,980,0,982
UTTAR PRADESH,BIJNOR,2021-03-12,3,615,1,619
UTTAR PRADESH,BIJNOR,2021-03-13,2,856,0,858
UTTAR PRADESH,BIJNOR,2021-03-14,0,788,0,788
UTTAR PRADESH,BIJNOR,2021-03-15,1,832,0,833
UTTAR PRADESH,BUDAUN,2021-03-11,1,420,37,458
UTTAR PRADESH,BUDAUN,2021-03-12,0,2347,28,2375
UTTAR PRADESH,BUDAUN,2021-03-13,1,363,42,406
UTTAR PRADESH,BUDAUN,2021-03-14,0,460,21,481
UTTAR PRADESH,BUDAUN,2021-03-15,1,395,13,409
UTTAR PRADESH,BULANDSHAHR,2021-03-11,1,417,1,419
UTTAR PRADESH,BULANDSHAHR,2021-03-12,1,1636,3,1640
UTTAR PRADESH,BULANDSHAHR,2021-03-13,0,484,20,504
UTTAR PRADESH,BULANDSHAHR,2021-03-14,4,498,27,529
UTTAR PRADESH,BULANDSHAHR,2021-03-15,1,3922,81,4004
UTTAR PRADESH,CHANDAULI,2021-03-11,1,598,1,600
UTTAR PRADESH,CHANDAULI,2021-03-12,0,549,5,554
UTTAR PRADESH,CHANDAULI,2021-03-13,1,733,0,734
UTTAR PRADESH,CHANDAULI,2021-03-14,3,543,24,570
UTTAR PRADESH,CHANDAULI,2021-03-15,1,267,22,290
UTTAR PRADESH,CHITRAKOOT,2021-03-11,0,922,0,922
UTTAR PRADESH,CHITRAKOOT,2021-03-12,0,923,0,923
UTTAR PRADESH,CHITRAKOOT,2021-03-13,0,833,5,838
UTTAR PRADESH,CHITRAKOOT,2021-03-14,0,584,16,600
UTTAR PRADESH,CHITRAKOOT,2021-03-15,0,484,14,498
UTTAR PRADESH,DEORIA,2021-03-11,1,919,1,921
UTTAR PRADESH,DEORIA,2021-03-12,3,494,61,558
UTTAR PRADESH,DEORIA,2021-03-13,41,1167,2,1210
UTTAR PRADESH,DEORIA,2021-03-14,1,1212,41,1254
UTTAR PRADESH,DEORIA,2021-03-15,1,760,4,765
UTTAR PRADESH,ETAH,2021-03-11,4,478,22,504
UTTAR PRADESH,ETAH,2021-03-12,0,702,4,706
UTTAR PRADESH,ETAH,2021-03-13,1,511,40,552
UTTAR PRADESH,ETAH,2021-03-14,1,1282,28,1311
UTTAR PRADESH,ETAH,2021-03-15,0,859,3,862
UTTAR PRADESH,ETAWAH,2021-03-11,0,1129,0,1129
UTTAR PRADESH,ETAWAH,2021-03-12,0,1163,1,1164
UTTAR PRADESH,ETAWAH,2021-03-13,0,843,3,846
UTTAR PRADESH,ETAWAH,2021-03-14,0,929,9,938
UTTAR PRADESH,ETAWAH,2021-03-15,2,1694,1,1697
UTTAR PRADESH,FARRUKHABAD,2021-03-11,0,340,0,340
UTTAR PRADESH,FARRUKHABAD,2021-03-12,0,592,20,612
UTTAR PRADESH,FARRUKHABAD,2021-03-13,0,481,31,512
UTTAR PRADESH,FARRUKHABAD,2021-03-14,0,950,41,991
UTTAR PRADESH,FARRUKHABAD,2021-03-15,1,835,10,846
UTTAR PRADESH,FATEHPUR,2021-03-11,1,1022,69,1092
UTTAR PRADESH,FATEHPUR,2021-03-12,1,982,104,1087
UTTAR PRADESH,FATEHPUR,2021-03-13,2,864,9,875
UTTAR PRADESH,FATEHPUR,2021-03-14,0,837,91,928
UTTAR PRADESH,FATEHPUR,2021-03-15,5,994,90,1089
UTTAR PRADESH,FIROZABAD,2021-03-11,0,2555,6,2561
UTTAR PRADESH,FIROZABAD,2021-03-12,1,1540,2,1543
UTTAR PRADESH,FIROZABAD,2021-03-13,3,1581,0,1584
UTTAR PRADESH,FIROZABAD,2021-03-14,2,1518,6,1526
UTTAR PRADESH,FIROZABAD,2021-03-15,4,1913,20,1937
UTTAR PRADESH,GAUTAM BUDDHA NAGAR,2021-03-11,67,1804,10,1881
UTTAR PRADESH,GAUTAM BUDDHA NAGAR,2021-03-12,49,1948,7,2004
UTTAR PRADESH,GAUTAM BUDDHA NAGAR,2021-03-13,40,1655,27,1722
UTTAR PRADESH,GAUTAM BUDDHA NAGAR,2021-03-14,55,1663,35,1753
UTTAR PRADESH,GAUTAM BUDDHA NAGAR,2021-03-15,51,2336,15,2402
UTTAR PRADESH,GHAZIABAD,2021-03-11,44,3544,127,3715
UTTAR PRADESH,GHAZIABAD,2021-03-12,39,4023,55,4117
UTTAR PRADESH,GHAZIABAD,2021-03-13,30,2778,21,2829
UTTAR PRADESH,GHAZIABAD,2021-03-14,57,1972,169,2198
UTTAR PRADESH,GHAZIABAD,2021-03-15,51,2526,83,2660
UTTAR PRADESH,GHAZIPUR,2021-03-11,0,743,0,743
UTTAR PRADESH,GHAZIPUR,2021-03-12,2,357,0,359
UTTAR PRADESH,GHAZIPUR,2021-03-13,2,522,8,532
UTTAR PRADESH,GHAZIPUR,2021-03-14,0,1889,45,1934
UTTAR PRADESH,GHAZIPUR,2021-03-15,2,426,42,470
UTTAR PRADESH,GONDA,2021-03-11,1,968,0,969
UTTAR PRADESH,GONDA,2021-03-12,3,950,2,955
UTTAR PRADESH,GONDA,2021-03-13,1,1014,0,1015
UTTAR PRADESH,GONDA,2021-03-14,3,837,0,840
UTTAR PRADESH,GONDA,2021-03-15,5,838,1,844
UTTAR PRADESH,GORAKHPUR,2021-03-11,3,1503,2,1508
UTTAR PRADESH,GORAKHPUR,2021-03-12,2,1779,19,1800
UTTAR PRADESH,GORAKHPUR,2021-03-13,5,1302,9,1316
UTTAR PRADESH,GORAKHPUR,2021-03-14,1,1665,27,1693
UTTAR PRADESH,GORAKHPUR,2021-03-15,2,2043,12,2057
UTTAR PRADESH,HAMIRPUR,2021-03-11,0,1063,76,1139
UTTAR PRADESH,HAMIRPUR,2021-03-12,0,414,0,414
UTTAR PRADESH,HAMIRPUR,2021-03-13,0,768,0,768
UTTAR PRADESH,HAMIRPUR,2021-03-14,2,768,82,852
UTTAR PRADESH,HAMIRPUR,2021-03-15,0,705,30,735
UTTAR PRADESH,HAPUR,2021-03-11,0,1533,42,1575
UTTAR PRADESH,HAPUR,2021-03-12,0,1005,33,1038
UTTAR PRADESH,HAPUR,2021-03-13,1,1760,31,1792
UTTAR PRADESH,HAPUR,2021-03-14,0,1241,46,1287
UTTAR PRADESH,HAPUR,2021-03-15,1,432,1,434
UTTAR PRADESH,HARDOI,2021-03-11,3,1260,0,1263
UTTAR PRADESH,HARDOI,2021-03-12,0,1127,5,1132
UTTAR PRADESH,HARDOI,2021-03-13,1,1456,1,1458
UTTAR PRADESH,HARDOI,2021-03-14,1,1002,8,1011
UTTAR PRADESH,HARDOI,2021-03-15,2,939,1,942
UTTAR PRADESH,HATHRAS,2021-03-11,0,843,0,843
UTTAR PRADESH,HATHRAS,2021-03-12,0,1122,0,1122
UTTAR PRADESH,HATHRAS,2021-03-13,0,1094,0,1094
UTTAR PRADESH,HATHRAS,2021-03-14,0,878,0,878
UTTAR PRADESH,HATHRAS,2021-03-15,0,657,0,657
UTTAR PRADESH,JALAUN,2021-03-11,0,893,1,894
UTTAR PRADESH,JALAUN,2021-03-12,1,669,0,670
UTTAR PRADESH,JALAUN,2021-03-13,0,936,2,938
UTTAR PRADESH,JALAUN,2021-03-14,1,710,1,712
UTTAR PRADESH,JALAUN,2021-03-15,0,967,1,968
UTTAR PRADESH,JAUNPUR,2021-03-11,4,2465,0,2469
UTTAR PRADESH,JAUNPUR,2021-03-12,1,393,2,396
UTTAR PRADESH,JAUNPUR,2021-03-13,1,1963,0,1964
UTTAR PRADESH,JAUNPUR,2021-03-14,2,639,14,655
UTTAR PRADESH,JAUNPUR,2021-03-15,4,314,8,326
UTTAR PRADESH,JHANSI,2021-03-11,2,2066,1,2069
UTTAR PRADESH,JHANSI,2021-03-12,2,1574,1,1577
UTTAR PRADESH,JHANSI,2021-03-13,7,2492,0,2499
UTTAR PRADESH,JHANSI,2021-03-14,4,1547,2,1553
UTTAR PRADESH,JHANSI,2021-03-15,5,1918,3,1926
UTTAR PRADESH,KANNAUJ,2021-03-11,1,1286,0,1287
UTTAR PRADESH,KANNAUJ,2021-03-12,0,1113,0,1113
UTTAR PRADESH,KANNAUJ,2021-03-13,0,1579,0,1579
UTTAR PRADESH,KANNAUJ,2021-03-14,1,1718,0,1719
UTTAR PRADESH,KANNAUJ,2021-03-15,2,1784,0,1786
UTTAR PRADESH,KANPUR DEHAT,2021-03-11,1,1016,0,1017
UTTAR PRADESH,KANPUR DEHAT,2021-03-12,1,1012,10,1023
UTTAR PRADESH,KANPUR DEHAT,2021-03-13,6,1321,0,1327
UTTAR PRADESH,KANPUR DEHAT,2021-03-14,2,848,15,865
UTTAR PRADESH,KANPUR DEHAT,2021-03-15,3,1043,0,1046
UTTAR PRADESH,KANPUR NAGAR,2021-03-11,11,1714,3,1728
UTTAR PRADESH,KANPUR NAGAR,2021-03-12,6,1111,1,1118
UTTAR PRADESH,KANPUR NAGAR,2021-03-13,7,2182,0,2189
UTTAR PRADESH,KANPUR NAGAR,2021-03-14,4,1866,3,1873
UTTAR PRADESH,KANPUR NAGAR,2021-03-15,8,2214,5,2227
UTTAR PRADESH,KASGANJ,2021-03-11,0,394,3,397
UTTAR PRADESH,KASGANJ,2021-03-12,0,43,0,43
UTTAR PRADESH,KASGANJ,2021-03-13,0,706,0,706
UTTAR PRADESH,KASGANJ,2021-03-14,0,137,1,138
UTTAR PRADESH,KASGANJ,2021-03-15,0,2051,5,2056
UTTAR PRADESH,KAUSHAMBI,2021-03-11,0,989,0,989
UTTAR PRADESH,KAUSHAMBI,2021-03-12,0,2322,0,2322
UTTAR PRADESH,KAUSHAMBI,2021-03-13,0,1431,0,1431
UTTAR PRADESH,KAUSHAMBI,2021-03-14,0,1068,0,1068
UTTAR PRADESH,KAUSHAMBI,2021-03-15,1,1069,0,1070
UTTAR PRADESH,KHERI,2021-03-11,0,1669,1,1670
UTTAR PRADESH,KHERI,2021-03-12,2,1062,0,1064
UTTAR PRADESH,KHERI,2021-03-13,5,1373,7,1385
UTTAR PRADESH,KHERI,2021-03-14,1,863,6,870
UTTAR PRADESH,KHERI,2021-03-15,0,1454,0,1454
UTTAR PRADESH,KUSHI NAGAR,2021-03-11,0,924,49,973
UTTAR PRADESH,KUSHI NAGAR,2021-03-12,3,464,20,487
UTTAR PRADESH,KUSHI NAGAR,2021-03-13,3,923,27,953
UTTAR PRADESH,KUSHI NAGAR,2021-03-14,1,1018,25,1044
UTTAR PRADESH,KUSHI NAGAR,2021-03-15,0,865,9,874
UTTAR PRADESH,LALITPUR,2021-03-11,2,1534,2,1538
UTTAR PRADESH,LALITPUR,2021-03-12,3,1241,2,1246
UTTAR PRADESH,LALITPUR,2021-03-13,3,1092,1,1096
UTTAR PRADESH,LALITPUR,2021-03-14,0,1238,1,1239
UTTAR PRADESH,LALITPUR,2021-03-15,3,1521,2,1526
UTTAR PRADESH,LUCKNOW,2021-03-11,26,4657,11,4694
UTTAR PRADESH,LUCKNOW,2021-03-12,33,3943,72,4048
UTTAR PRADESH,LUCKNOW,2021-03-13,27,5995,25,6047
UTTAR PRADESH,LUCKNOW,2021-03-14,47,5243,71,5361
UTTAR PRADESH,LUCKNOW,2021-03-15,37,5455,29,5521
UTTAR PRADESH,MAHARAJGANJ,2021-03-11,1,489,142,632
UTTAR PRADESH,MAHARAJGANJ,2021-03-12,1,511,4,516
UTTAR PRADESH,MAHARAJGANJ,2021-03-13,1,738,66,805
UTTAR PRADESH,MAHARAJGANJ,2021-03-14,1,600,118,719
UTTAR PRADESH,MAHARAJGANJ,2021-03-15,1,689,47,737
UTTAR PRADESH,MAHOBA,2021-03-11,1,386,5,392
UTTAR PRADESH,MAHOBA,2021-03-12,1,305,0,306
UTTAR PRADESH,MAHOBA,2021-03-13,0,452,32,484
UTTAR PRADESH,MAHOBA,2021-03-14,0,314,0,314
UTTAR PRADESH,MAHOBA,2021-03-15,0,472,35,507
UTTAR PRADESH,MAINPURI,2021-03-11,2,1153,0,1155
UTTAR PRADESH,MAINPURI,2021-03-12,1,1195,0,1196
UTTAR PRADESH,MAINPURI,2021-03-13,0,1325,4,1329
UTTAR PRADESH,MAINPURI,2021-03-14,0,1525,58,1583
UTTAR PRADESH,MAINPURI,2021-03-15,0,1288,0,1288
UTTAR PRADESH,MATHURA,2021-03-11,5,981,31,1017
UTTAR PRADESH,MATHURA,2021-03-12,4,911,0,915
UTTAR PRADESH,MATHURA,2021-03-13,10,1367,7,1384
UTTAR PRADESH,MATHURA,2021-03-14,2,1203,5,1210
UTTAR PRADESH,MATHURA,2021-03-15,11,1102,7,1120
UTTAR PRADESH,MAU,2021-03-11,1,1084,17,1102
UTTAR PRADESH,MAU,2021-03-12,0,850,12,862
UTTAR PRADESH,MAU,2021-03-13,1,506,1,508
UTTAR PRADESH,MAU,2021-03-14,36,776,18,830
UTTAR PRADESH,MAU,2021-03-15,3,811,20,834
UTTAR PRADESH,MEERUT,2021-03-11,3,2163,5,2171
UTTAR PRADESH,MEERUT,2021-03-12,3,2017,1,2021
UTTAR PRADESH,MEERUT,2021-03-13,9,3278,3,3290
UTTAR PRADESH,MEERUT,2021-03-14,7,2221,14,2242
UTTAR PRADESH,MEERUT,2021-03-15,22,3324,13,3359
UTTAR PRADESH,MIRZAPUR,2021-03-11,1,823,0,824
UTTAR PRADESH,MIRZAPUR,2021-03-12,0,1136,0,1136
UTTAR PRADESH,MIRZAPUR,2021-03-13,0,1303,0,1303
UTTAR PRADESH,MIRZAPUR,2021-03-14,0,1568,0,1568
UTTAR PRADESH,MIRZAPUR,2021-03-15,0,1098,11,1109
UTTAR PRADESH,MORADABAD,2021-03-11,4,1429,12,1445
UTTAR PRADESH,MORADABAD,2021-03-12,3,840,0,843
UTTAR PRADESH,MORADABAD,2021-03-13,2,1638,0,1640
UTTAR PRADESH,MORADABAD,2021-03-14,1,1962,20,1983
UTTAR PRADESH,MORADABAD,2021-03-15,7,2193,2,2202
UTTAR PRADESH,MUZAFFARNAGAR,2021-03-11,4,1761,0,1765
UTTAR PRADESH,MUZAFFARNAGAR,2021-03-12,10,1288,1,1299
UTTAR PRADESH,MUZAFFARNAGAR,2021-03-13,9,1684,1,1694
UTTAR PRADESH,MUZAFFARNAGAR,2021-03-14,3,1389,8,1400
UTTAR PRADESH,MUZAFFARNAGAR,2021-03-15,13,1119,7,1139
UTTAR PRADESH,PILIBHIT,2021-03-11,3,1069,8,1080
UTTAR PRADESH,PILIBHIT,2021-03-12,1,795,0,796
UTTAR PRADESH,PILIBHIT,2021-03-13,3,1143,6,1152
UTTAR PRADESH,PILIBHIT,2021-03-14,2,852,1,855
UTTAR PRADESH,PILIBHIT,2021-03-15,1,1337,2,1340
UTTAR PRADESH,PRATAPGARH,2021-03-11,1,1350,6,1357
UTTAR PRADESH,PRATAPGARH,2021-03-12,5,1299,15,1319
UTTAR PRADESH,PRATAPGARH,2021-03-13,3,1601,2,1606
UTTAR PRADESH,PRATAPGARH,2021-03-14,1,1503,1,1505
UTTAR PRADESH,PRATAPGARH,2021-03-15,2,1531,39,1572
UTTAR PRADESH,PRAYAGRAJ,2021-03-11,14,1588,1,1603
UTTAR PRADESH,PRAYAGRAJ,2021-03-12,12,4462,2,4476
UTTAR PRADESH,PRAYAGRAJ,2021-03-13,6,3390,0,3396
UTTAR PRADESH,PRAYAGRAJ,2021-03-14,3,1262,0,1265
UTTAR PRADESH,PRAYAGRAJ,2021-03-15,7,2496,2,2505
UTTAR PRADESH,RAE BARELI,2021-03-11,3,1653,2,1658
UTTAR PRADESH,RAE BARELI,2021-03-12,16,1403,8,1427
UTTAR PRADESH,RAE BARELI,2021-03-13,1,1547,4,1552
UTTAR PRADESH,RAE BARELI,2021-03-14,2,1567,1,1570
UTTAR PRADESH,RAE BARELI,2021-03-15,1,1887,4,1892
UTTAR PRADESH,RAMPUR,2021-03-11,2,1059,47,1108
UTTAR PRADESH,RAMPUR,2021-03-12,2,982,32,1016
UTTAR PRADESH,RAMPUR,2021-03-13,3,1189,30,1222
UTTAR PRADESH,RAMPUR,2021-03-14,0,1226,4,1230
UTTAR PRADESH,RAMPUR,2021-03-15,0,1342,14,1356
UTTAR PRADESH,SAHARANPUR,2021-03-11,4,619,0,623
UTTAR PRADESH,SAHARANPUR,2021-03-12,7,1134,0,1141
UTTAR PRADESH,SAHARANPUR,2021-03-13,7,1346,0,1353
UTTAR PRADESH,SAHARANPUR,2021-03-14,6,1684,1,1691
UTTAR PRADESH,SAHARANPUR,2021-03-15,3,2115,60,2178
UTTAR PRADESH,SAMBHAL,2021-03-11,3,1180,78,1261
UTTAR PRADESH,SAMBHAL,2021-03-12,0,1372,83,1455
UTTAR PRADESH,SAMBHAL,2021-03-13,3,1295,101,1399
UTTAR PRADESH,SAMBHAL,2021-03-14,0,1208,137,1345
UTTAR PRADESH,SAMBHAL,2021-03-15,0,914,179,1093
UTTAR PRADESH,SANT KABEER NAGAR,2021-03-11,2,1051,0,1053
UTTAR PRADESH,SANT KABEER NAGAR,2021-03-12,3,856,1,860
UTTAR PRADESH,SANT KABEER NAGAR,2021-03-13,1,1310,1,1312
UTTAR PRADESH,SANT KABEER NAGAR,2021-03-14,0,773,0,773
UTTAR PRADESH,SANT KABEER NAGAR,2021-03-15,4,883,0,887
UTTAR PRADESH,SHAHJAHANPUR,2021-03-11,2,940,0,942
UTTAR PRADESH,SHAHJAHANPUR,2021-03-12,1,638,102,741
UTTAR PRADESH,SHAHJAHANPUR,2021-03-13,9,770,23,802
UTTAR PRADESH,SHAHJAHANPUR,2021-03-14,6,1900,18,1924
UTTAR PRADESH,SHAHJAHANPUR,2021-03-15,1,1270,4,1275
UTTAR PRADESH,SHAMLI,2021-03-11,1,1442,0,1443
UTTAR PRADESH,SHAMLI,2021-03-12,1,1307,0,1308
UTTAR PRADESH,SHAMLI,2021-03-13,1,1531,1,1533
UTTAR PRADESH,SHAMLI,2021-03-14,0,1291,0,1291
UTTAR PRADESH,SHAMLI,2021-03-15,0,1209,0,1209
UTTAR PRADESH,SHRAVASTI,2021-03-11,0,771,0,771
UTTAR PRADESH,SHRAVASTI,2021-03-12,0,610,11,621
UTTAR PRADESH,SHRAVASTI,2021-03-13,0,697,1,698
UTTAR PRADESH,SHRAVASTI,2021-03-14,0,623,0,623
UTTAR PRADESH,SHRAVASTI,2021-03-15,0,659,0,659
UTTAR PRADESH,SIDDHARTH NAGAR,2021-03-11,0,262,290,552
UTTAR PRADESH,SIDDHARTH NAGAR,2021-03-12,1,762,63,826
UTTAR PRADESH,SIDDHARTH NAGAR,2021-03-13,3,852,271,1126
UTTAR PRADESH,SIDDHARTH NAGAR,2021-03-14,1,348,237,586
UTTAR PRADESH,SIDDHARTH NAGAR,2021-03-15,1,824,11,836
UTTAR PRADESH,SITAPUR,2021-03-11,3,814,2,819
UTTAR PRADESH,SITAPUR,2021-03-12,0,898,2,900
UTTAR PRADESH,SITAPUR,2021-03-13,1,1173,9,1183
UTTAR PRADESH,SITAPUR,2021-03-14,0,1134,7,1141
UTTAR PRADESH,SITAPUR,2021-03-15,0,1166,3,1169
UTTAR PRADESH,SONBHADRA,2021-03-11,2,1307,1,1310
UTTAR PRADESH,SONBHADRA,2021-03-12,0,1042,1,1043
UTTAR PRADESH,SONBHADRA,2021-03-13,2,1761,0,1763
UTTAR PRADESH,SONBHADRA,2021-03-14,3,512,1,516
UTTAR PRADESH,SONBHADRA,2021-03-15,1,618,16,635
UTTAR PRADESH,SULTANPUR,2021-03-11,1,1168,8,1177
UTTAR PRADESH,SULTANPUR,2021-03-12,1,688,3,692
UTTAR PRADESH,SULTANPUR,2021-03-13,1,844,8,853
UTTAR PRADESH,SULTANPUR,2021-03-14,1,654,11,666
UTTAR PRADESH,SULTANPUR,2021-03-15,1,448,1,450
UTTAR PRADESH,UNNAO,2021-03-11,3,1719,11,1733
UTTAR PRADESH,UNNAO,2021-03-12,1,1584,1,1586
UTTAR PRADESH,UNNAO,2021-03-13,0,1711,2,1713
UTTAR PRADESH,UNNAO,2021-03-14,3,1905,38,1946
UTTAR PRADESH,UNNAO,2021-03-15,1,1907,3,1911
UTTAR PRADESH,VARANASI,2021-03-11,13,1228,0,1241
UTTAR PRADESH,VARANASI,2021-03-12,11,4103,3,4117
UTTAR PRADESH,VARANASI,2021-03-13,16,2702,1,2719
UTTAR PRADESH,VARANASI,2021-03-14,14,2828,0,2842
UTTAR PRADESH,VARANASI,2021-03-15,14,4575,96,4685
UTTARAKHAND,ALMORA,2021-03-11,0,60,2,62
UTTARAKHAND,ALMORA,2021-03-12,5,94,0,99
UTTARAKHAND,ALMORA,2021-03-13,0,103,0,103
UTTARAKHAND,ALMORA,2021-03-14,0,14,0,14
UTTARAKHAND,ALMORA,2021-03-15,0,129,0,129
UTTARAKHAND,BAGESHWAR,2021-03-11,2,38,0,40
UTTARAKHAND,BAGESHWAR,2021-03-12,0,53,0,53
UTTARAKHAND,BAGESHWAR,2021-03-13,1,370,5,376
UTTARAKHAND,BAGESHWAR,2021-03-14,0,2,0,2
UTTARAKHAND,BAGESHWAR,2021-03-15,0,7,0,7
UTTARAKHAND,CHAMOLI,2021-03-11,0,16,0,16
UTTARAKHAND,CHAMOLI,2021-03-12,0,90,0,90
UTTARAKHAND,CHAMOLI,2021-03-13,0,62,0,62
UTTARAKHAND,CHAMOLI,2021-03-14,0,9,0,9
UTTARAKHAND,CHAMOLI,2021-03-15,0,54,0,54
UTTARAKHAND,CHAMPAWAT,2021-03-11,0,5,0,5
UTTARAKHAND,CHAMPAWAT,2021-03-12,0,54,0,54
UTTARAKHAND,CHAMPAWAT,2021-03-13,0,7,0,7
UTTARAKHAND,CHAMPAWAT,2021-03-14,0,4,0,4
UTTARAKHAND,CHAMPAWAT,2021-03-15,0,32,0,32
UTTARAKHAND,DEHRADUN,2021-03-11,10,995,1,1006
UTTARAKHAND,DEHRADUN,2021-03-12,18,1186,2,1206
UTTARAKHAND,DEHRADUN,2021-03-13,29,1669,2,1700
UTTARAKHAND,DEHRADUN,2021-03-14,30,926,3,959
UTTARAKHAND,DEHRADUN,2021-03-15,23,1223,3,1249
UTTARAKHAND,HARIDWAR,2021-03-11,23,18416,0,18439
UTTARAKHAND,HARIDWAR,2021-03-12,25,22539,5,22569
UTTARAKHAND,HARIDWAR,2021-03-13,10,4557,0,4567
UTTARAKHAND,HARIDWAR,2021-03-14,5,4002,6,4013
UTTARAKHAND,HARIDWAR,2021-03-15,16,2329,0,2345
UTTARAKHAND,NAINITAL,2021-03-11,11,129,0,140
UTTARAKHAND,NAINITAL,2021-03-12,24,771,3,798
UTTARAKHAND,NAINITAL,2021-03-13,8,628,6,642
UTTARAKHAND,NAINITAL,2021-03-14,2,111,0,113
UTTARAKHAND,NAINITAL,2021-03-15,9,784,0,793
UTTARAKHAND,PAURI GARHWAL,2021-03-11,5,679,1,685
UTTARAKHAND,PAURI GARHWAL,2021-03-12,0,1521,5,1526
UTTARAKHAND,PAURI GARHWAL,2021-03-13,3,1361,0,1364
UTTARAKHAND,PAURI GARHWAL,2021-03-14,0,1598,3,1601
UTTARAKHAND,PAURI GARHWAL,2021-03-15,2,1356,0,1358
UTTARAKHAND,PITHORAGARH,2021-03-11,0,30,0,30
UTTARAKHAND,PITHORAGARH,2021-03-12,2,428,1,431
UTTARAKHAND,PITHORAGARH,2021-03-13,1,46,0,47
UTTARAKHAND,PITHORAGARH,2021-03-14,0,20,0,20
UTTARAKHAND,PITHORAGARH,2021-03-15,0,418,0,418
UTTARAKHAND,RUDRA PRAYAG,2021-03-11,3,189,2,194
UTTARAKHAND,RUDRA PRAYAG,2021-03-12,0,82,3,85
UTTARAKHAND,RUDRA PRAYAG,2021-03-13,1,18,0,19
UTTARAKHAND,RUDRA PRAYAG,2021-03-14,0,106,2,108
UTTARAKHAND,RUDRA PRAYAG,2021-03-15,0,22,0,22
UTTARAKHAND,TEHRI GARHWAL,2021-03-11,1,45,0,46
UTTARAKHAND,TEHRI GARHWAL,2021-03-12,0,149,0,149
UTTARAKHAND,TEHRI GARHWAL,2021-03-13,0,219,1,220
UTTARAKHAND,TEHRI GARHWAL,2021-03-14,2,164,1,167
UTTARAKHAND,TEHRI GARHWAL,2021-03-15,0,76,0,76
UTTARAKHAND,UDAM SINGH NAGAR,2021-03-11,3,768,74,845
UTTARAKHAND,UDAM SINGH NAGAR,2021-03-12,5,1245,70,1320
UTTARAKHAND,UDAM SINGH NAGAR,2021-03-13,5,934,81,1020
UTTARAKHAND,UDAM SINGH NAGAR,2021-03-14,5,378,0,383
UTTARAKHAND,UDAM SINGH NAGAR,2021-03-15,6,1205,89,1300
UTTARAKHAND,UTTAR KASHI,2021-03-11,1,433,5,439
UTTARAKHAND,UTTAR KASHI,2021-03-12,0,27,5,32
UTTARAKHAND,UTTAR KASHI,2021-03-13,2,12,0,14
UTTARAKHAND,UTTAR KASHI,2021-03-14,0,260,18,278
UTTARAKHAND,UTTAR KASHI,2021-03-15,0,381,31,412
WEST BENGAL,24 PARAGANAS NORTH,2021-03-11,67,2647,10,2724
WEST BENGAL,24 PARAGANAS NORTH,2021-03-12,65,2624,17,2706
WEST BENGAL,24 PARAGANAS NORTH,2021-03-13,100,3133,24,3257
WEST BENGAL,24 PARAGANAS NORTH,2021-03-14,40,2245,11,2296
WEST BENGAL,24 PARAGANAS NORTH,2021-03-15,68,2353,14,2435
WEST BENGAL,24 PARAGANAS SOUTH,2021-03-11,20,2599,212,2831
WEST BENGAL,24 PARAGANAS SOUTH,2021-03-12,16,2379,4,2399
WEST BENGAL,24 PARAGANAS SOUTH,2021-03-13,10,2736,9,2755
WEST BENGAL,24 PARAGANAS SOUTH,2021-03-14,14,1950,8,1972
WEST BENGAL,24 PARAGANAS SOUTH,2021-03-15,16,2709,6,2731
WEST BENGAL,ALIPURDUAR,2021-03-11,0,1056,4,1060
WEST BENGAL,ALIPURDUAR,2021-03-12,0,798,0,798
WEST BENGAL,ALIPURDUAR,2021-03-13,0,532,0,532
WEST BENGAL,ALIPURDUAR,2021-03-14,0,232,0,232
WEST BENGAL,ALIPURDUAR,2021-03-15,1,269,8,278
WEST BENGAL,BANKURA,2021-03-11,15,183,0,198
WEST BENGAL,BANKURA,2021-03-12,17,181,0,198
WEST BENGAL,BANKURA,2021-03-13,3,292,0,295
WEST BENGAL,BANKURA,2021-03-14,1,150,0,151
WEST BENGAL,BANKURA,2021-03-15,1,417,0,418
WEST BENGAL,BIRBHUM,2021-03-11,0,432,13,445
WEST BENGAL,BIRBHUM,2021-03-12,4,486,9,499
WEST BENGAL,BIRBHUM,2021-03-13,3,582,10,595
WEST BENGAL,BIRBHUM,2021-03-14,1,321,0,322
WEST BENGAL,BIRBHUM,2021-03-15,1,292,4,297
WEST BENGAL,COOCHBEHAR,2021-03-11,0,1218,4,1222
WEST BENGAL,COOCHBEHAR,2021-03-12,0,1159,0,1159
WEST BENGAL,COOCHBEHAR,2021-03-13,0,1899,0,1899
WEST BENGAL,COOCHBEHAR,2021-03-14,1,977,0,978
WEST BENGAL,COOCHBEHAR,2021-03-15,1,772,0,773
WEST BENGAL,DARJEELING,2021-03-11,6,339,0,345
WEST BENGAL,DARJEELING,2021-03-12,5,417,0,422
WEST BENGAL,DARJEELING,2021-03-13,2,453,1,456
WEST BENGAL,DARJEELING,2021-03-14,3,275,0,278
WEST BENGAL,DARJEELING,2021-03-15,0,179,0,179
WEST BENGAL,DINAJPUR DAKSHIN,2021-03-11,0,496,17,513
WEST BENGAL,DINAJPUR DAKSHIN,2021-03-12,0,454,25,479
WEST BENGAL,DINAJPUR DAKSHIN,2021-03-13,0,534,4,538
WEST BENGAL,DINAJPUR DAKSHIN,2021-03-14,0,583,2,585
WEST BENGAL,DINAJPUR DAKSHIN,2021-03-15,0,452,12,464
WEST BENGAL,DINAJPUR UTTAR,2021-03-11,2,180,0,182
WEST BENGAL,DINAJPUR UTTAR,2021-03-12,4,171,0,175
WEST BENGAL,DINAJPUR UTTAR,2021-03-13,2,252,0,254
WEST BENGAL,DINAJPUR UTTAR,2021-03-14,4,94,0,98
WEST BENGAL,DINAJPUR UTTAR,2021-03-15,0,270,0,270
WEST BENGAL,HOOGHLY,2021-03-11,11,621,7,639
WEST BENGAL,HOOGHLY,2021-03-12,3,502,2,507
WEST BENGAL,HOOGHLY,2021-03-13,13,588,2,603
WEST BENGAL,HOOGHLY,2021-03-14,6,487,2,495
WEST BENGAL,HOOGHLY,2021-03-15,11,480,0,491
WEST BENGAL,HOWRAH,2021-03-11,25,943,58,1026
WEST BENGAL,HOWRAH,2021-03-12,22,853,28,903
WEST BENGAL,HOWRAH,2021-03-13,34,929,27,990
WEST BENGAL,HOWRAH,2021-03-14,12,530,26,568
WEST BENGAL,HOWRAH,2021-03-15,26,843,38,907
WEST BENGAL,JALPAIGURI,2021-03-11,5,413,0,418
WEST BENGAL,JALPAIGURI,2021-03-12,4,357,0,361
WEST BENGAL,JALPAIGURI,2021-03-13,3,447,0,450
WEST BENGAL,JALPAIGURI,2021-03-14,1,83,0,84
WEST BENGAL,JALPAIGURI,2021-03-15,1,370,0,371
WEST BENGAL,JHARGRAM,2021-03-11,3,50,0,53
WEST BENGAL,JHARGRAM,2021-03-12,0,54,0,54
WEST BENGAL,JHARGRAM,2021-03-13,0,13,0,13
WEST BENGAL,JHARGRAM,2021-03-14,0,16,0,16
WEST BENGAL,JHARGRAM,2021-03-15,0,59,0,59
WEST BENGAL,KALIMPONG,2021-03-11,0,123,0,123
WEST BENGAL,KALIMPONG,2021-03-12,0,99,0,99
WEST BENGAL,KALIMPONG,2021-03-13,0,121,0,121
WEST BENGAL,KALIMPONG,2021-03-14,1,87,0,88
WEST BENGAL,KALIMPONG,2021-03-15,0,46,0,46
WEST BENGAL,KOLKATA,2021-03-11,137,3063,13,3213
WEST BENGAL,KOLKATA,2021-03-12,140,2825,15,2980
WEST BENGAL,KOLKATA,2021-03-13,145,3656,18,3819
WEST BENGAL,KOLKATA,2021-03-14,118,2373,6,2497
WEST BENGAL,KOLKATA,2021-03-15,120,3390,4,3514
WEST BENGAL,MALDAH,2021-03-11,2,522,3,527
WEST BENGAL,MALDAH,2021-03-12,0,368,0,368
WEST BENGAL,MALDAH,2021-03-13,0,348,1,349
WEST BENGAL,MALDAH,2021-03-14,4,27,0,31
WEST BENGAL,MALDAH,2021-03-15,7,460,4,471
WEST BENGAL,MEDINIPUR EAST,2021-03-11,4,515,0,519
WEST BENGAL,MEDINIPUR EAST,2021-03-12,1,677,0,678
WEST BENGAL,MEDINIPUR EAST,2021-03-13,3,711,1,715
WEST BENGAL,MEDINIPUR EAST,2021-03-14,3,400,3,406
WEST BENGAL,MEDINIPUR EAST,2021-03-15,2,678,0,680
WEST BENGAL,MEDINIPUR WEST,2021-03-11,2,273,2,277
WEST BENGAL,MEDINIPUR WEST,2021-03-12,3,434,5,442
WEST BENGAL,MEDINIPUR WEST,2021-03-13,1,390,6,397
WEST BENGAL,MEDINIPUR WEST,2021-03-14,4,351,2,357
WEST BENGAL,MEDINIPUR WEST,2021-03-15,1,282,1,284
WEST BENGAL,MURSHIDABAD,2021-03-11,1,723,2,726
WEST BENGAL,MURSHIDABAD,2021-03-12,1,865,5,871
WEST BENGAL,MURSHIDABAD,2021-03-13,11,1004,1,1016
WEST BENGAL,MURSHIDABAD,2021-03-14,2,486,4,492
WEST BENGAL,MURSHIDABAD,2021-03-15,1,636,2,639
WEST BENGAL,NADIA,2021-03-11,7,908,18,933
WEST BENGAL,NADIA,2021-03-12,3,568,7,578
WEST BENGAL,NADIA,2021-03-13,4,616,40,660
WEST BENGAL,NADIA,2021-03-14,1,376,4,381
WEST BENGAL,NADIA,2021-03-15,6,649,21,676
WEST BENGAL,PASCHIM BARDHAMAN,2021-03-11,24,422,3,449
WEST BENGAL,PASCHIM BARDHAMAN,2021-03-12,12,424,1,437
WEST BENGAL,PASCHIM BARDHAMAN,2021-03-13,9,403,2,414
WEST BENGAL,PASCHIM BARDHAMAN,2021-03-14,12,256,1,269
WEST BENGAL,PASCHIM BARDHAMAN,2021-03-15,18,196,9,223
WEST BENGAL,PURBA BARDHAMAN,2021-03-11,1,520,1,522
WEST BENGAL,PURBA BARDHAMAN,2021-03-12,0,424,0,424
WEST BENGAL,PURBA BARDHAMAN,2021-03-13,0,612,0,612
WEST BENGAL,PURBA BARDHAMAN,2021-03-14,2,389,0,391
WEST BENGAL,PURBA BARDHAMAN,2021-03-15,1,630,2,633
WEST BENGAL,PURULIA,2021-03-11,0,428,0,428
WEST BENGAL,PURULIA,2021-03-12,3,295,0,298
WEST BENGAL,PURULIA,2021-03-13,3,434,0,437
WEST BENGAL,PURULIA,2021-03-14,4,376,0,380
WEST BENGAL,PURULIA,2021-03-15,4,192,0,196
ANDAMAN AND NICOBAR ISLANDS,NICOBARS,2021-03-01,1,17,0,18
ANDAMAN AND NICOBAR ISLANDS,NICOBARS,2021-03-02,0,10,0,10
ANDAMAN AND NICOBAR ISLANDS,NICOBARS,2021-03-03,0,12,1,13
ANDAMAN AND NICOBAR ISLANDS,NICOBARS,2021-03-04,0,29,0,29
ANDAMAN AND NICOBAR ISLANDS,NICOBARS,2021-03-05,0,11,0,11
ANDAMAN AND NICOBAR ISLANDS,NORTH AND MIDDLE ANDAMAN,2021-03-01,0,9,0,9
ANDAMAN AND NICOBAR ISLANDS,NORTH AND MIDDLE ANDAMAN,2021-03-02,0,17,0,17
ANDAMAN AND NICOBAR ISLANDS,NORTH AND MIDDLE ANDAMAN,2021-03-03,0,10,0,10
ANDAMAN AND NICOBAR ISLANDS,NORTH AND MIDDLE ANDAMAN,2021-03-04,0,12,0,12
ANDAMAN AND NICOBAR ISLANDS,NORTH AND MIDDLE ANDAMAN,2021-03-05,1,12,0,13
ANDAMAN AND NICOBAR ISLANDS,SOUTH ANDAMANS,2021-03-01,1,257,0,258
ANDAMAN AND NICOBAR ISLANDS,SOUTH ANDAMANS,2021-03-02,0,320,0,320
ANDAMAN AND NICOBAR ISLANDS,SOUTH ANDAMANS,2021-03-03,7,605,1,613
ANDAMAN AND NICOBAR ISLANDS,SOUTH ANDAMANS,2021-03-04,0,264,0,264
ANDAMAN AND NICOBAR ISLANDS,SOUTH ANDAMANS,2021-03-05,0,386,1,387
ANDHRA PRADESH,ANANTAPUR,2021-03-01,17,8330,1,8348
ANDHRA PRADESH,ANANTAPUR,2021-03-02,16,5021,0,5037
ANDHRA PRADESH,ANANTAPUR,2021-03-03,18,10441,2,10461
ANDHRA PRADESH,ANANTAPUR,2021-03-04,14,3790,0,3804
ANDHRA PRADESH,ANANTAPUR,2021-03-05,7,3091,0,3098
ANDHRA PRADESH,CHITTOOR,2021-03-01,76,7538,0,7614
ANDHRA PRADESH,CHITTOOR,2021-03-02,72,7475,0,7547
ANDHRA PRADESH,CHITTOOR,2021-03-03,52,5281,0,5333
ANDHRA PRADESH,CHITTOOR,2021-03-04,35,5284,0,5319
ANDHRA PRADESH,CHITTOOR,2021-03-05,31,5045,0,5076
ANDHRA PRADESH,EAST GODAVARI,2021-03-01,26,6526,0,6552
ANDHRA PRADESH,EAST GODAVARI,2021-03-02,19,6824,0,6843
ANDHRA PRADESH,EAST GODAVARI,2021-03-03,35,5063,1,5099
ANDHRA PRADESH,EAST GODAVARI,2021-03-04,12,4952,0,4964
ANDHRA PRADESH,EAST GODAVARI,2021-03-05,6,3011,0,3017
ANDHRA PRADESH,GUNTUR,2021-03-01,31,7961,0,7992
ANDHRA PRADESH,GUNTUR,2021-03-02,23,6796,0,6819
ANDHRA PRADESH,GUNTUR,2021-03-03,26,6373,0,6399
ANDHRA PRADESH,GUNTUR,2021-03-04,17,2703,0,2720
ANDHRA PRADESH,GUNTUR,2021-03-05,7,1823,0,1830
ANDHRA PRADESH,KRISHNA,2021-03-01,35,7229,0,7264
ANDHRA PRADESH,KRISHNA,2021-03-02,36,2673,0,2709
ANDHRA PRADESH,KRISHNA,2021-03-03,58,3855,0,3913
ANDHRA PRADESH,KRISHNA,2021-03-04,21,2652,0,2673
ANDHRA PRADESH,KRISHNA,2021-03-05,17,1824,0,1841
ANDHRA PRADESH,KURNOOL,2021-03-01,9,6526,0,6535
ANDHRA PRADESH,KURNOOL,2021-03-02,20,7404,0,7424
ANDHRA PRADESH,KURNOOL,2021-03-03,16,9117,0,9133
ANDHRA PRADESH,KURNOOL,2021-03-04,5,4819,0,4824
ANDHRA PRADESH,KURNOOL,2021-03-05,5,4675,1,4681
ANDHRA PRADESH,PRAKASAM,2021-03-01,6,4910,0,4916
ANDHRA PRADESH,PRAKASAM,2021-03-02,19,5429,0,5448
ANDHRA PRADESH,PRAKASAM,2021-03-03,10,6002,0,6012
ANDHRA PRADESH,PRAKASAM,2021-03-04,4,4933,0,4937
ANDHRA PRADESH,PRAKASAM,2021-03-05,5,4868,0,4873
ANDHRA PRADESH,SPSR NELLORE,2021-03-01,10,7230,0,7240
ANDHRA PRADESH,SPSR NELLORE,2021-03-02,17,4964,2,4983
ANDHRA PRADESH,SPSR NELLORE,2021-03-03,18,6732,0,6750
ANDHRA PRADESH,SPSR NELLORE,2021-03-04,1,5579,0,5580
ANDHRA PRADESH,SPSR NELLORE,2021-03-05,5,4990,0,4995
ANDHRA PRADESH,SRIKAKULAM,2021-03-01,6,3787,0,3793
ANDHRA PRADESH,SRIKAKULAM,2021-03-02,17,3740,0,3757
ANDHRA PRADESH,SRIKAKULAM,2021-03-03,11,5139,0,5150
ANDHRA PRADESH,SRIKAKULAM,2021-03-04,4,2362,0,2366
ANDHRA PRADESH,SRIKAKULAM,2021-03-05,9,2189,0,2198
ANDHRA PRADESH,VISAKHAPATANAM,2021-03-01,48,5008,0,5056
ANDHRA PRADESH,VISAKHAPATANAM,2021-03-02,59,3581,1,3641
ANDHRA PRADESH,VISAKHAPATANAM,2021-03-03,61,4602,1,4664
ANDHRA PRADESH,VISAKHAPATANAM,2021-03-04,14,2449,0,2463
ANDHRA PRADESH,VISAKHAPATANAM,2021-03-05,26,2220,3,2249
ANDHRA PRADESH,VIZIANAGARAM,2021-03-01,10,3773,0,3783
ANDHRA PRADESH,VIZIANAGARAM,2021-03-02,5,6160,0,6165
ANDHRA PRADESH,VIZIANAGARAM,2021-03-03,1,4320,2,4323
ANDHRA PRADESH,VIZIANAGARAM,2021-03-04,3,2029,0,2032
ANDHRA PRADESH,VIZIANAGARAM,2021-03-05,1,2731,0,2732
ANDHRA PRADESH,WEST GODAVARI,2021-03-01,10,8586,0,8596
ANDHRA PRADESH,WEST GODAVARI,2021-03-02,16,4941,0,4957
ANDHRA PRADESH,WEST GODAVARI,2021-03-03,11,3121,0,3132
ANDHRA PRADESH,WEST GODAVARI,2021-03-04,4,6554,0,6558
ANDHRA PRADESH,WEST GODAVARI,2021-03-05,9,2391,0,2400
ANDHRA PRADESH,Y.S.R.,2021-03-01,15,6477,0,6492
ANDHRA PRADESH,Y.S.R.,2021-03-02,10,6510,0,6520
ANDHRA PRADESH,Y.S.R.,2021-03-03,13,4730,0,4743
ANDHRA PRADESH,Y.S.R.,2021-03-04,7,5471,0,5478
ANDHRA PRADESH,Y.S.R.,2021-03-05,12,4073,0,4085
ARUNACHAL PRADESH,ANJAW,2021-03-03,0,18,0,18
ARUNACHAL PRADESH,CHANGLANG,2021-03-01,0,1,0,1
ARUNACHAL PRADESH,CHANGLANG,2021-03-02,0,5,0,5
ARUNACHAL PRADESH,CHANGLANG,2021-03-04,0,5,0,5
ARUNACHAL PRADESH,EAST KAMENG,2021-03-01,0,1,0,1
ARUNACHAL PRADESH,EAST SIANG,2021-03-01,0,32,0,32
ARUNACHAL PRADESH,EAST SIANG,2021-03-02,0,48,0,48
ARUNACHAL PRADESH,EAST SIANG,2021-03-03,0,25,0,25
ARUNACHAL PRADESH,EAST SIANG,2021-03-04,0,13,0,13
ARUNACHAL PRADESH,EAST SIANG,2021-03-05,0,23,0,23
ARUNACHAL PRADESH,KAMLE,2021-03-01,0,1,0,1
ARUNACHAL PRADESH,KURUNG KUMEY,2021-03-02,0,1,0,1
ARUNACHAL PRADESH,LEPARADA,2021-03-02,4,0,0,4
ARUNACHAL PRADESH,LOHIT,2021-03-01,0,1,0,1
ARUNACHAL PRADESH,LOHIT,2021-03-02,0,1,0,1
ARUNACHAL PRADESH,LOHIT,2021-03-03,0,2,0,2
ARUNACHAL PRADESH,LOHIT,2021-03-04,0,2,0,2
ARUNACHAL PRADESH,LOWER DIBANG VALLEY,2021-03-04,0,36,0,36
ARUNACHAL PRADESH,LOWER DIBANG VALLEY,2021-03-05,0,17,0,17
ARUNACHAL PRADESH,LOWER SIANG,2021-03-01,0,22,0,22
ARUNACHAL PRADESH,LOWER SIANG,2021-03-02,0,10,0,10
ARUNACHAL PRADESH,LOWER SIANG,2021-03-03,0,6,0,6
ARUNACHAL PRADESH,LOWER SIANG,2021-03-04,0,8,0,8
ARUNACHAL PRADESH,LOWER SIANG,2021-03-05,0,10,0,10
ARUNACHAL PRADESH,LOWER SUBANSIRI,2021-03-02,0,8,0,8
ARUNACHAL PRADESH,LOWER SUBANSIRI,2021-03-03,0,9,0,9
ARUNACHAL PRADESH,LOWER SUBANSIRI,2021-03-04,0,32,0,32
ARUNACHAL PRADESH,NAMSAI,2021-03-02,0,1,0,1
ARUNACHAL PRADESH,NAMSAI,2021-03-04,0,1,0,1
ARUNACHAL PRADESH,PAKKE KESSANG,2021-03-01,0,1,0,1
ARUNACHAL PRADESH,PAKKE KESSANG,2021-03-04,0,3,0,3
ARUNACHAL PRADESH,PAKKE KESSANG,2021-03-05,0,1,0,1
ARUNACHAL PRADESH,PAPUM PARE,2021-03-01,0,27,0,27
ARUNACHAL PRADESH,PAPUM PARE,2021-03-02,0,12,0,12
ARUNACHAL PRADESH,PAPUM PARE,2021-03-03,0,32,1,33
ARUNACHAL PRADESH,PAPUM PARE,2021-03-04,0,27,0,27
ARUNACHAL PRADESH,PAPUM PARE,2021-03-05,1,28,1,30
ARUNACHAL PRADESH,SHI YOMI,2021-03-01,0,1,0,1
ARUNACHAL PRADESH,SHI YOMI,2021-03-05,0,1,0,1
ARUNACHAL PRADESH,SIANG,2021-03-04,0,1,0,1
ARUNACHAL PRADESH,TAWANG,2021-03-02,0,2,0,2
ARUNACHAL PRADESH,TAWANG,2021-03-03,0,2,0,2
ARUNACHAL PRADESH,TIRAP,2021-03-04,0,1,0,1
ARUNACHAL PRADESH,UPPER SIANG,2021-03-01,0,1,0,1
ARUNACHAL PRADESH,UPPER SUBANSIRI,2021-03-05,0,1,0,1
ARUNACHAL PRADESH,WEST KAMENG,2021-03-01,0,23,0,23
ARUNACHAL PRADESH,WEST KAMENG,2021-03-02,0,30,0,30
ARUNACHAL PRADESH,WEST KAMENG,2021-03-03,0,50,0,50
ARUNACHAL PRADESH,WEST KAMENG,2021-03-04,0,34,0,34
ARUNACHAL PRADESH,WEST KAMENG,2021-03-05,0,34,0,34
ARUNACHAL PRADESH,WEST SIANG,2021-03-01,0,2,0,2
ARUNACHAL PRADESH,WEST SIANG,2021-03-03,0,2,0,2
ARUNACHAL PRADESH,WEST SIANG,2021-03-04,0,2,0,2
ASSAM,BAKSA,2021-03-01,0,52,0,52
ASSAM,BAKSA,2021-03-02,0,40,0,40
ASSAM,BAKSA,2021-03-03,0,67,0,67
ASSAM,BAKSA,2021-03-04,0,36,0,36
ASSAM,BAKSA,2021-03-05,0,19,0,19
ASSAM,BARPETA,2021-03-01,0,165,0,165
ASSAM,BARPETA,2021-03-02,0,89,0,89
ASSAM,BARPETA,2021-03-03,0,233,0,233
ASSAM,BARPETA,2021-03-04,0,131,0,131
ASSAM,BARPETA,2021-03-05,0,137,0,137
ASSAM,BISWANATH,2021-03-01,0,50,0,50
ASSAM,BISWANATH,2021-03-02,0,82,0,82
ASSAM,BISWANATH,2021-03-03,0,63,0,63
ASSAM,BISWANATH,2021-03-04,0,49,0,49
ASSAM,BISWANATH,2021-03-05,0,7,0,7
ASSAM,BONGAIGAON,2021-03-01,0,217,0,217
ASSAM,BONGAIGAON,2021-03-02,0,129,0,129
ASSAM,BONGAIGAON,2021-03-03,0,142,0,142
ASSAM,BONGAIGAON,2021-03-04,1,231,0,232
ASSAM,BONGAIGAON,2021-03-05,0,156,0,156
ASSAM,CACHAR,2021-03-01,0,3363,9,3372
ASSAM,CACHAR,2021-03-02,1,2895,29,2925
ASSAM,CACHAR,2021-03-03,0,257,4,261
ASSAM,CACHAR,2021-03-04,3,237,23,263
ASSAM,CACHAR,2021-03-05,1,146,32,179
ASSAM,CHARAIDEO,2021-03-01,0,142,0,142
ASSAM,CHARAIDEO,2021-03-02,0,78,0,78
ASSAM,CHARAIDEO,2021-03-03,0,74,0,74
ASSAM,CHARAIDEO,2021-03-04,0,129,0,129
ASSAM,CHARAIDEO,2021-03-05,0,113,0,113
ASSAM,CHIRANG,2021-03-01,0,184,0,184
ASSAM,CHIRANG,2021-03-02,0,142,0,142
ASSAM,CHIRANG,2021-03-03,0,69,0,69
ASSAM,CHIRANG,2021-03-04,0,128,0,128
ASSAM,CHIRANG,2021-03-05,0,37,0,37
ASSAM,DARRANG,2021-03-01,1,431,0,432
ASSAM,DARRANG,2021-03-02,0,362,0,362
ASSAM,DARRANG,2021-03-03,0,409,0,409
ASSAM,DARRANG,2021-03-04,0,323,0,323
ASSAM,DARRANG,2021-03-05,0,332,0,332
ASSAM,DHEMAJI,2021-03-01,0,33,0,33
ASSAM,DHEMAJI,2021-03-02,0,40,0,40
ASSAM,DHEMAJI,2021-03-03,0,25,0,25
ASSAM,DHEMAJI,2021-03-04,0,33,0,33
ASSAM,DHEMAJI,2021-03-05,0,22,0,22
ASSAM,DHUBRI,2021-03-01,0,296,0,296
ASSAM,DHUBRI,2021-03-02,0,194,0,194
ASSAM,DHUBRI,2021-03-03,0,205,0,205
ASSAM,DHUBRI,2021-03-04,0,179,0,179
ASSAM,DHUBRI,2021-03-05,1,156,0,157
ASSAM,DIBRUGARH,2021-03-01,1,555,0,556
ASSAM,DIBRUGARH,2021-03-02,5,354,1,360
ASSAM,DIBRUGARH,2021-03-03,3,206,0,209
ASSAM,DIBRUGARH,2021-03-04,1,221,5,227
ASSAM,DIBRUGARH,2021-03-05,11,182,0,193
ASSAM,DIMA HASAO,2021-03-01,0,39,0,39
ASSAM,DIMA HASAO,2021-03-02,0,35,0,35
ASSAM,DIMA HASAO,2021-03-03,0,43,0,43
ASSAM,DIMA HASAO,2021-03-04,0,35,0,35
ASSAM,DIMA HASAO,2021-03-05,0,47,0,47
ASSAM,GOALPARA,2021-03-01,0,325,0,325
ASSAM,GOALPARA,2021-03-02,1,336,0,337
ASSAM,GOALPARA,2021-03-03,0,242,0,242
ASSAM,GOALPARA,2021-03-04,1,238,0,239
ASSAM,GOALPARA,2021-03-05,0,324,0,324
ASSAM,GOLAGHAT,2021-03-01,0,195,0,195
ASSAM,GOLAGHAT,2021-03-02,0,170,0,170
ASSAM,GOLAGHAT,2021-03-03,0,101,0,101
ASSAM,GOLAGHAT,2021-03-04,0,103,0,103
ASSAM,GOLAGHAT,2021-03-05,0,88,0,88
ASSAM,HAILAKANDI,2021-03-01,0,192,33,225
ASSAM,HAILAKANDI,2021-03-02,0,143,1,144
ASSAM,HAILAKANDI,2021-03-03,2,321,0,323
ASSAM,HAILAKANDI,2021-03-04,0,350,0,350
ASSAM,HAILAKANDI,2021-03-05,0,427,3,430
ASSAM,HOJAI,2021-03-01,0,188,1,189
ASSAM,HOJAI,2021-03-02,1,163,0,164
ASSAM,HOJAI,2021-03-03,0,153,0,153
ASSAM,HOJAI,2021-03-04,0,61,0,61
ASSAM,HOJAI,2021-03-05,0,151,0,151
ASSAM,JORHAT,2021-03-01,0,209,0,209
ASSAM,JORHAT,2021-03-02,3,242,0,245
ASSAM,JORHAT,2021-03-03,1,187,1,189
ASSAM,JORHAT,2021-03-04,2,323,0,325
ASSAM,JORHAT,2021-03-05,1,181,0,182
ASSAM,KAMRUP,2021-03-01,1,696,0,697
ASSAM,KAMRUP,2021-03-02,1,446,0,447
ASSAM,KAMRUP,2021-03-03,0,599,0,599
ASSAM,KAMRUP,2021-03-04,1,433,0,434
ASSAM,KAMRUP,2021-03-05,0,428,0,428
ASSAM,KAMRUP METRO,2021-03-01,20,1364,10,1394
ASSAM,KAMRUP METRO,2021-03-02,5,1297,14,1316
ASSAM,KAMRUP METRO,2021-03-03,11,1129,0,1140
ASSAM,KAMRUP METRO,2021-03-04,5,1186,1,1192
ASSAM,KAMRUP METRO,2021-03-05,10,1712,2,1724
ASSAM,KARBI ANGLONG,2021-03-01,0,11,0,11
ASSAM,KARBI ANGLONG,2021-03-02,0,58,0,58
ASSAM,KARBI ANGLONG,2021-03-03,0,9,0,9
ASSAM,KARBI ANGLONG,2021-03-04,0,26,0,26
ASSAM,KARBI ANGLONG,2021-03-05,0,74,0,74
ASSAM,KARIMGANJ,2021-03-01,1,187,0,188
ASSAM,KARIMGANJ,2021-03-02,0,192,0,192
ASSAM,KARIMGANJ,2021-03-03,0,200,0,200
ASSAM,KARIMGANJ,2021-03-04,0,140,0,140
ASSAM,KARIMGANJ,2021-03-05,0,152,27,179
ASSAM,KOKRAJHAR,2021-03-01,0,33,0,33
ASSAM,KOKRAJHAR,2021-03-02,0,43,0,43
ASSAM,KOKRAJHAR,2021-03-03,0,19,0,19
ASSAM,KOKRAJHAR,2021-03-04,0,67,0,67
ASSAM,KOKRAJHAR,2021-03-05,0,31,0,31
ASSAM,LAKHIMPUR,2021-03-01,0,176,0,176
ASSAM,LAKHIMPUR,2021-03-02,0,212,0,212
ASSAM,LAKHIMPUR,2021-03-03,0,197,0,197
ASSAM,LAKHIMPUR,2021-03-04,0,193,0,193
ASSAM,LAKHIMPUR,2021-03-05,0,234,0,234
ASSAM,MAJULI,2021-03-01,0,1,0,1
ASSAM,MAJULI,2021-03-02,0,8,0,8
ASSAM,MAJULI,2021-03-03,0,9,0,9
ASSAM,MAJULI,2021-03-04,0,7,0,7
ASSAM,MAJULI,2021-03-05,0,22,0,22
ASSAM,MARIGAON,2021-03-01,0,76,0,76
ASSAM,MARIGAON,2021-03-02,0,79,0,79
ASSAM,MARIGAON,2021-03-03,0,73,0,73
ASSAM,MARIGAON,2021-03-04,0,82,0,82
ASSAM,MARIGAON,2021-03-05,0,94,0,94
ASSAM,NAGAON,2021-03-01,0,328,0,328
ASSAM,NAGAON,2021-03-02,1,464,0,465
ASSAM,NAGAON,2021-03-03,0,263,0,263
ASSAM,NAGAON,2021-03-04,0,226,0,226
ASSAM,NAGAON,2021-03-05,2,233,0,235
ASSAM,NALBARI,2021-03-01,0,69,0,69
ASSAM,NALBARI,2021-03-02,0,51,0,51
ASSAM,NALBARI,2021-03-03,0,58,1,59
ASSAM,NALBARI,2021-03-04,0,36,0,36
ASSAM,NALBARI,2021-03-05,0,44,0,44
ASSAM,SIVASAGAR,2021-03-01,0,146,0,146
ASSAM,SIVASAGAR,2021-03-02,0,124,0,124
ASSAM,SIVASAGAR,2021-03-03,0,138,0,138
ASSAM,SIVASAGAR,2021-03-04,0,108,0,108
ASSAM,SIVASAGAR,2021-03-05,0,93,0,93
ASSAM,SONITPUR,2021-03-01,0,165,0,165
ASSAM,SONITPUR,2021-03-02,0,118,0,118
ASSAM,SONITPUR,2021-03-03,2,116,0,118
ASSAM,SONITPUR,2021-03-04,0,136,0,136
ASSAM,SONITPUR,2021-03-05,0,150,0,150
ASSAM,SOUTH SALMARA MANCACHAR,2021-03-01,0,17,0,17
ASSAM,SOUTH SALMARA MANCACHAR,2021-03-02,0,11,0,11
ASSAM,SOUTH SALMARA MANCACHAR,2021-03-03,0,22,0,22
ASSAM,SOUTH SALMARA MANCACHAR,2021-03-04,0,17,0,17
ASSAM,SOUTH SALMARA MANCACHAR,2021-03-05,0,15,0,15
ASSAM,TINSUKIA,2021-03-01,7,202,0,209
ASSAM,TINSUKIA,2021-03-02,5,377,1,383
ASSAM,TINSUKIA,2021-03-03,4,201,5,210
ASSAM,TINSUKIA,2021-03-04,20,350,0,370
ASSAM,TINSUKIA,2021-03-05,6,220,0,226
ASSAM,UDALGURI,2021-03-01,0,22,0,22
ASSAM,UDALGURI,2021-03-02,0,4,0,4
ASSAM,UDALGURI,2021-03-03,1,9,0,10
ASSAM,UDALGURI,2021-03-04,0,8,0,8
ASSAM,UDALGURI,2021-03-05,0,5,0,5
ASSAM,WEST KARBI ANGLONG,2021-03-01,0,12,0,12
ASSAM,WEST KARBI ANGLONG,2021-03-02,0,4,0,4
ASSAM,WEST KARBI ANGLONG,2021-03-03,0,4,0,4
ASSAM,WEST KARBI ANGLONG,2021-03-04,0,3,0,3
ASSAM,WEST KARBI ANGLONG,2021-03-05,0,8,0,8
BIHAR,ARARIA,2021-03-01,1,1342,1,1344
BIHAR,ARARIA,2021-03-02,0,701,0,701
BIHAR,ARARIA,2021-03-03,1,436,0,437
BIHAR,ARARIA,2021-03-04,0,312,0,312
BIHAR,ARARIA,2021-03-05,1,202,0,203
BIHAR,ARWAL,2021-03-01,0,486,11,497
BIHAR,ARWAL,2021-03-02,0,631,1,632
BIHAR,ARWAL,2021-03-03,0,696,16,712
BIHAR,ARWAL,2021-03-04,0,300,0,300
BIHAR,ARWAL,2021-03-05,0,240,1,241
BIHAR,AURANGABAD,2021-03-01,2,3183,0,3185
BIHAR,AURANGABAD,2021-03-02,2,4597,1,4600
BIHAR,AURANGABAD,2021-03-03,1,3220,0,3221
BIHAR,AURANGABAD,2021-03-04,2,1560,0,1562
BIHAR,AURANGABAD,2021-03-05,0,1481,0,1481
BIHAR,BANKA,2021-03-01,0,360,0,360
BIHAR,BANKA,2021-03-02,0,504,17,521
BIHAR,BANKA,2021-03-03,1,472,0,473
BIHAR,BANKA,2021-03-04,1,1369,0,1370
BIHAR,BANKA,2021-03-05,0,900,0,900
BIHAR,BEGUSARAI,2021-03-01,0,1086,0,1086
BIHAR,BEGUSARAI,2021-03-02,2,2342,0,2344
BIHAR,BEGUSARAI,2021-03-03,0,1144,0,1144
BIHAR,BEGUSARAI,2021-03-04,1,1117,0,1118
BIHAR,BEGUSARAI,2021-03-05,0,241,0,241
BIHAR,BHAGALPUR,2021-03-01,5,2543,7,2555
BIHAR,BHAGALPUR,2021-03-02,2,1502,1,1505
BIHAR,BHAGALPUR,2021-03-03,0,1370,39,1409
BIHAR,BHAGALPUR,2021-03-04,3,857,1,861
BIHAR,BHAGALPUR,2021-03-05,2,365,0,367
BIHAR,BHOJPUR,2021-03-01,5,3778,0,3783
BIHAR,BHOJPUR,2021-03-02,1,3316,0,3317
BIHAR,BHOJPUR,2021-03-03,1,1995,2,1998
BIHAR,BHOJPUR,2021-03-04,1,2147,37,2185
BIHAR,BHOJPUR,2021-03-05,0,431,3,434
BIHAR,BUXAR,2021-03-01,1,1785,0,1786
BIHAR,BUXAR,2021-03-02,1,2848,0,2849
BIHAR,BUXAR,2021-03-03,0,1889,0,1889
BIHAR,BUXAR,2021-03-04,0,1284,12,1296
BIHAR,BUXAR,2021-03-05,0,86,0,86
BIHAR,DARBHANGA,2021-03-01,0,362,0,362
BIHAR,DARBHANGA,2021-03-02,6,918,0,924
BIHAR,DARBHANGA,2021-03-03,2,653,19,674
BIHAR,DARBHANGA,2021-03-04,3,504,12,519
BIHAR,DARBHANGA,2021-03-05,2,800,0,802
BIHAR,GAYA,2021-03-01,3,1995,15,2013
BIHAR,GAYA,2021-03-02,0,1678,0,1678
BIHAR,GAYA,2021-03-03,2,1829,7,1838
BIHAR,GAYA,2021-03-04,0,1118,5,1123
BIHAR,GAYA,2021-03-05,0,797,13,810
BIHAR,GOPALGANJ,2021-03-01,1,653,0,654
BIHAR,GOPALGANJ,2021-03-02,0,322,0,322
BIHAR,GOPALGANJ,2021-03-03,2,933,13,948
BIHAR,GOPALGANJ,2021-03-04,3,275,1,279
BIHAR,GOPALGANJ,2021-03-05,1,600,4,605
BIHAR,JAMUI,2021-03-01,1,1704,0,1705
BIHAR,JAMUI,2021-03-02,1,2037,2,2040
BIHAR,JAMUI,2021-03-03,1,353,0,354
BIHAR,JAMUI,2021-03-04,1,583,0,584
BIHAR,JAMUI,2021-03-05,0,118,0,118
BIHAR,JEHANABAD,2021-03-01,0,141,0,141
BIHAR,JEHANABAD,2021-03-02,0,114,0,114
BIHAR,JEHANABAD,2021-03-03,0,113,0,113
BIHAR,JEHANABAD,2021-03-04,0,188,7,195
BIHAR,JEHANABAD,2021-03-05,0,133,0,133
BIHAR,KAIMUR (BHABUA),2021-03-01,0,464,0,464
BIHAR,KAIMUR (BHABUA),2021-03-02,0,1322,0,1322
BIHAR,KAIMUR (BHABUA),2021-03-03,0,718,0,718
BIHAR,KAIMUR (BHABUA),2021-03-04,0,848,0,848
BIHAR,KAIMUR (BHABUA),2021-03-05,0,574,1,575
BIHAR,KATIHAR,2021-03-01,0,1064,0,1064
BIHAR,KATIHAR,2021-03-02,0,1476,1,1477
BIHAR,KATIHAR,2021-03-03,0,2336,0,2336
BIHAR,KATIHAR,2021-03-04,3,1074,0,1077
BIHAR,KATIHAR,2021-03-05,0,121,0,121
BIHAR,KHAGARIA,2021-03-01,0,1130,19,1149
BIHAR,KHAGARIA,2021-03-02,0,1089,12,1101
BIHAR,KHAGARIA,2021-03-03,1,626,0,627
BIHAR,KHAGARIA,2021-03-04,0,582,4,586
BIHAR,KHAGARIA,2021-03-05,0,266,1,267
BIHAR,KISHANGANJ,2021-03-01,1,110,0,111
BIHAR,KISHANGANJ,2021-03-02,0,474,0,474
BIHAR,KISHANGANJ,2021-03-03,0,244,0,244
BIHAR,KISHANGANJ,2021-03-04,0,360,0,360
BIHAR,KISHANGANJ,2021-03-05,1,166,0,167
BIHAR,LAKHISARAI,2021-03-01,0,1823,0,1823
BIHAR,LAKHISARAI,2021-03-02,0,2013,0,2013
BIHAR,LAKHISARAI,2021-03-03,0,1537,0,1537
BIHAR,LAKHISARAI,2021-03-04,0,641,0,641
BIHAR,LAKHISARAI,2021-03-05,0,228,0,228
BIHAR,MADHEPURA,2021-03-01,1,194,0,195
BIHAR,MADHEPURA,2021-03-02,0,1466,0,1466
BIHAR,MADHEPURA,2021-03-03,1,540,0,541
BIHAR,MADHEPURA,2021-03-04,0,991,0,991
BIHAR,MADHEPURA,2021-03-05,1,895,0,896
BIHAR,MADHUBANI,2021-03-01,0,1254,6,1260
BIHAR,MADHUBANI,2021-03-02,2,1051,0,1053
BIHAR,MADHUBANI,2021-03-03,6,1024,3,1033
BIHAR,MADHUBANI,2021-03-04,5,947,8,960
BIHAR,MADHUBANI,2021-03-05,1,550,1,552
BIHAR,MUNGER,2021-03-01,1,1341,10,1352
BIHAR,MUNGER,2021-03-02,3,2133,13,2149
BIHAR,MUNGER,2021-03-03,7,1631,67,1705
BIHAR,MUNGER,2021-03-04,0,1612,1,1613
BIHAR,MUNGER,2021-03-05,0,569,2,571
BIHAR,MUZAFFARPUR,2021-03-01,1,1070,0,1071
BIHAR,MUZAFFARPUR,2021-03-02,1,676,1,678
BIHAR,MUZAFFARPUR,2021-03-03,1,749,0,750
BIHAR,MUZAFFARPUR,2021-03-04,3,948,0,951
BIHAR,MUZAFFARPUR,2021-03-05,1,184,0,185
BIHAR,NALANDA,2021-03-01,0,1583,0,1583
BIHAR,NALANDA,2021-03-02,0,2406,3,2409
BIHAR,NALANDA,2021-03-03,1,2382,0,2383
BIHAR,NALANDA,2021-03-04,1,1678,1,1680
BIHAR,NALANDA,2021-03-05,3,1196,0,1199
BIHAR,NAWADA,2021-03-01,12,514,1,527
BIHAR,NAWADA,2021-03-02,2,939,0,941
BIHAR,NAWADA,2021-03-03,7,638,0,645
BIHAR,NAWADA,2021-03-04,0,666,0,666
BIHAR,NAWADA,2021-03-05,0,344,0,344
BIHAR,PASHCHIM CHAMPARAN,2021-03-01,0,951,18,969
BIHAR,PASHCHIM CHAMPARAN,2021-03-02,2,1067,9,1078
BIHAR,PASHCHIM CHAMPARAN,2021-03-03,1,1130,6,1137
BIHAR,PASHCHIM CHAMPARAN,2021-03-04,0,539,0,539
BIHAR,PASHCHIM CHAMPARAN,2021-03-05,1,338,0,339
BIHAR,PATNA,2021-03-01,16,2029,1,2046
BIHAR,PATNA,2021-03-02,17,2800,8,2825
BIHAR,PATNA,2021-03-03,10,2020,1,2031
BIHAR,PATNA,2021-03-04,25,2530,1,2556
BIHAR,PATNA,2021-03-05,17,1033,1,1051
BIHAR,PURBI CHAMPARAN,2021-03-01,1,1017,1,1019
BIHAR,PURBI CHAMPARAN,2021-03-02,0,1263,1,1264
BIHAR,PURBI CHAMPARAN,2021-03-03,0,1010,0,1010
BIHAR,PURBI CHAMPARAN,2021-03-04,1,835,19,855
BIHAR,PURBI CHAMPARAN,2021-03-05,0,483,0,483
BIHAR,PURNIA,2021-03-01,0,864,0,864
BIHAR,PURNIA,2021-03-02,1,492,0,493
BIHAR,PURNIA,2021-03-03,0,684,65,749
BIHAR,PURNIA,2021-03-04,0,396,122,518
BIHAR,PURNIA,2021-03-05,1,754,0,755
BIHAR,ROHTAS,2021-03-01,0,1602,26,1628
BIHAR,ROHTAS,2021-03-02,0,1714,1,1715
BIHAR,ROHTAS,2021-03-03,1,1003,1,1005
BIHAR,ROHTAS,2021-03-04,0,1300,1,1301
BIHAR,ROHTAS,2021-03-05,0,622,4,626
BIHAR,SAHARSA,2021-03-01,0,486,0,486
BIHAR,SAHARSA,2021-03-02,0,495,0,495
BIHAR,SAHARSA,2021-03-03,0,327,0,327
BIHAR,SAHARSA,2021-03-04,2,1066,0,1068
BIHAR,SAHARSA,2021-03-05,0,23,0,23
BIHAR,SAMASTIPUR,2021-03-01,0,478,40,518
BIHAR,SAMASTIPUR,2021-03-02,3,1754,20,1777
BIHAR,SAMASTIPUR,2021-03-03,0,950,8,958
BIHAR,SAMASTIPUR,2021-03-04,3,1048,16,1067
BIHAR,SAMASTIPUR,2021-03-05,0,1012,29,1041
BIHAR,SARAN,2021-03-01,1,1114,0,1115
BIHAR,SARAN,2021-03-02,2,852,2,856
BIHAR,SARAN,2021-03-03,0,1406,0,1406
BIHAR,SARAN,2021-03-04,0,469,1,470
BIHAR,SARAN,2021-03-05,0,191,1,192
BIHAR,SHEIKHPURA,2021-03-01,0,190,4,194
BIHAR,SHEIKHPURA,2021-03-02,1,188,2,191
BIHAR,SHEIKHPURA,2021-03-03,0,124,1,125
BIHAR,SHEIKHPURA,2021-03-04,0,245,0,245
BIHAR,SHEIKHPURA,2021-03-05,0,286,3,289
BIHAR,SHEOHAR,2021-03-01,0,141,0,141
BIHAR,SHEOHAR,2021-03-02,0,270,0,270
BIHAR,SHEOHAR,2021-03-03,0,780,0,780
BIHAR,SHEOHAR,2021-03-04,0,512,0,512
BIHAR,SHEOHAR,2021-03-05,0,462,0,462
BIHAR,SITAMARHI,2021-03-01,2,2449,0,2451
BIHAR,SITAMARHI,2021-03-02,0,2335,6,2341
BIHAR,SITAMARHI,2021-03-03,1,1847,2,1850
BIHAR,SITAMARHI,2021-03-04,1,989,0,990
BIHAR,SITAMARHI,2021-03-05,0,295,0,295
BIHAR,SIWAN,2021-03-01,8,5649,0,5657
BIHAR,SIWAN,2021-03-02,4,6823,0,6827
BIHAR,SIWAN,2021-03-03,5,6119,0,6124
BIHAR,SIWAN,2021-03-04,3,4489,0,4492
BIHAR,SIWAN,2021-03-05,0,648,0,648
BIHAR,SUPAUL,2021-03-01,1,425,7,433
BIHAR,SUPAUL,2021-03-02,0,847,0,847
BIHAR,SUPAUL,2021-03-03,2,1173,50,1225
BIHAR,SUPAUL,2021-03-04,1,967,0,968
BIHAR,SUPAUL,2021-03-05,1,586,14,601
BIHAR,VAISHALI,2021-03-01,2,1282,32,1316
BIHAR,VAISHALI,2021-03-02,1,1943,45,1989
BIHAR,VAISHALI,2021-03-03,0,1701,17,1718
BIHAR,VAISHALI,2021-03-04,1,926,202,1129
BIHAR,VAISHALI,2021-03-05,0,1468,98,1566
CHANDIGARH,CHANDIGARH,2021-03-01,83,1933,12,2028
CHANDIGARH,CHANDIGARH,2021-03-02,76,1809,9,1894
CHANDIGARH,CHANDIGARH,2021-03-03,79,1556,10,1645
CHANDIGARH,CHANDIGARH,2021-03-04,105,1808,12,1925
CHANDIGARH,CHANDIGARH,2021-03-05,118,1942,7,2067
CHHATTISGARH,BALOD,2021-03-01,4,1149,0,1153
CHHATTISGARH,BALOD,2021-03-02,0,1903,0,1903
CHHATTISGARH,BALOD,2021-03-03,1,1177,2,1180
CHHATTISGARH,BALOD,2021-03-04,0,1015,1,1016
CHHATTISGARH,BALOD,2021-03-05,1,967,1,969
CHHATTISGARH,BALODA BAZAR,2021-03-01,7,692,3,702
CHHATTISGARH,BALODA BAZAR,2021-03-02,6,529,0,535
CHHATTISGARH,BALODA BAZAR,2021-03-03,8,500,0,508
CHHATTISGARH,BALODA BAZAR,2021-03-04,10,632,1,643
CHHATTISGARH,BALODA BAZAR,2021-03-05,2,358,0,360
CHHATTISGARH,BALRAMPUR,2021-03-01,1,209,0,210
CHHATTISGARH,BALRAMPUR,2021-03-02,1,175,0,176
CHHATTISGARH,BALRAMPUR,2021-03-03,0,210,3,213
CHHATTISGARH,BALRAMPUR,2021-03-04,1,150,0,151
CHHATTISGARH,BALRAMPUR,2021-03-05,3,578,5,586
CHHATTISGARH,BASTAR,2021-03-01,1,438,0,439
CHHATTISGARH,BASTAR,2021-03-02,2,675,0,677
CHHATTISGARH,BASTAR,2021-03-03,6,855,0,861
CHHATTISGARH,BASTAR,2021-03-04,4,855,0,859
CHHATTISGARH,BASTAR,2021-03-05,3,837,0,840
CHHATTISGARH,BEMETARA,2021-03-01,2,753,0,755
CHHATTISGARH,BEMETARA,2021-03-02,5,361,0,366
CHHATTISGARH,BEMETARA,2021-03-03,3,1051,0,1054
CHHATTISGARH,BEMETARA,2021-03-04,3,956,0,959
CHHATTISGARH,BEMETARA,2021-03-05,8,778,0,786
CHHATTISGARH,BIJAPUR,2021-03-01,0,231,0,231
CHHATTISGARH,BIJAPUR,2021-03-02,0,271,1,272
CHHATTISGARH,BIJAPUR,2021-03-03,0,127,0,127
CHHATTISGARH,BIJAPUR,2021-03-04,1,277,1,279
CHHATTISGARH,BIJAPUR,2021-03-05,0,152,0,152
CHHATTISGARH,BILASPUR,2021-03-01,37,1351,3,1391
CHHATTISGARH,BILASPUR,2021-03-02,15,1391,21,1427
CHHATTISGARH,BILASPUR,2021-03-03,24,632,20,676
CHHATTISGARH,BILASPUR,2021-03-04,38,1331,26,1395
CHHATTISGARH,BILASPUR,2021-03-05,13,1173,11,1197
CHHATTISGARH,DANTEWADA,2021-03-01,3,296,0,299
CHHATTISGARH,DANTEWADA,2021-03-02,6,254,0,260
CHHATTISGARH,DANTEWADA,2021-03-03,2,424,0,426
CHHATTISGARH,DANTEWADA,2021-03-04,2,281,0,283
CHHATTISGARH,DANTEWADA,2021-03-05,4,345,0,349
CHHATTISGARH,DHAMTARI,2021-03-01,4,857,15,876
CHHATTISGARH,DHAMTARI,2021-03-02,20,992,22,1034
CHHATTISGARH,DHAMTARI,2021-03-03,12,952,28,992
CHHATTISGARH,DHAMTARI,2021-03-04,8,603,29,640
CHHATTISGARH,DHAMTARI,2021-03-05,5,1094,8,1107
CHHATTISGARH,DURG,2021-03-01,35,1438,6,1479
CHHATTISGARH,DURG,2021-03-02,23,1438,0,1461
CHHATTISGARH,DURG,2021-03-03,36,1864,0,1900
CHHATTISGARH,DURG,2021-03-04,26,1316,0,1342
CHHATTISGARH,DURG,2021-03-05,49,2046,1,2096
CHHATTISGARH,GARIYABAND,2021-03-01,0,199,0,199
CHHATTISGARH,GARIYABAND,2021-03-02,1,320,3,324
CHHATTISGARH,GARIYABAND,2021-03-03,6,248,10,264
CHHATTISGARH,GARIYABAND,2021-03-04,3,268,1,272
CHHATTISGARH,GARIYABAND,2021-03-05,1,150,0,151
CHHATTISGARH,GAURELLA PENDRA MARWAHI,2021-03-01,1,211,0,212
CHHATTISGARH,GAURELLA PENDRA MARWAHI,2021-03-02,0,361,0,361
CHHATTISGARH,GAURELLA PENDRA MARWAHI,2021-03-03,0,254,0,254
CHHATTISGARH,GAURELLA PENDRA MARWAHI,2021-03-04,1,119,0,120
CHHATTISGARH,GAURELLA PENDRA MARWAHI,2021-03-05,5,270,4,279
CHHATTISGARH,JANJGIR CHAMPA,2021-03-01,9,1037,0,1046
CHHATTISGARH,JANJGIR CHAMPA,2021-03-02,4,1624,2,1630
CHHATTISGARH,JANJGIR CHAMPA,2021-03-03,3,1602,0,1605
CHHATTISGARH,JANJGIR CHAMPA,2021-03-04,7,1439,0,1446
CHHATTISGARH,JANJGIR CHAMPA,2021-03-05,5,1670,0,1675
CHHATTISGARH,JASHPUR,2021-03-01,11,287,0,298
CHHATTISGARH,JASHPUR,2021-03-02,8,263,0,271
CHHATTISGARH,JASHPUR,2021-03-03,20,388,1,409
CHHATTISGARH,JASHPUR,2021-03-04,15,365,0,380
CHHATTISGARH,JASHPUR,2021-03-05,8,381,0,389
CHHATTISGARH,KABIRDHAM,2021-03-01,1,294,0,295
CHHATTISGARH,KABIRDHAM,2021-03-02,4,759,1,764
CHHATTISGARH,KABIRDHAM,2021-03-03,2,694,0,696
CHHATTISGARH,KABIRDHAM,2021-03-04,2,563,0,565
CHHATTISGARH,KABIRDHAM,2021-03-05,2,614,0,616
CHHATTISGARH,KANKER,2021-03-01,6,589,0,595
CHHATTISGARH,KANKER,2021-03-02,6,613,0,619
CHHATTISGARH,KANKER,2021-03-03,4,859,0,863
CHHATTISGARH,KANKER,2021-03-04,4,639,0,643
CHHATTISGARH,KANKER,2021-03-05,4,1103,0,1107
CHHATTISGARH,KONDAGAON,2021-03-01,3,774,0,777
CHHATTISGARH,KONDAGAON,2021-03-02,0,454,0,454
CHHATTISGARH,KONDAGAON,2021-03-03,1,411,0,412
CHHATTISGARH,KONDAGAON,2021-03-04,0,564,0,564
CHHATTISGARH,KONDAGAON,2021-03-05,0,660,0,660
CHHATTISGARH,KORBA,2021-03-01,9,1043,0,1052
CHHATTISGARH,KORBA,2021-03-02,11,682,0,693
CHHATTISGARH,KORBA,2021-03-03,12,1015,4,1031
CHHATTISGARH,KORBA,2021-03-04,3,1159,0,1162
CHHATTISGARH,KORBA,2021-03-05,16,1216,0,1232
CHHATTISGARH,KOREA,2021-03-01,7,667,0,674
CHHATTISGARH,KOREA,2021-03-02,2,729,0,731
CHHATTISGARH,KOREA,2021-03-03,3,690,4,697
CHHATTISGARH,KOREA,2021-03-04,8,388,0,396
CHHATTISGARH,KOREA,2021-03-05,5,557,0,562
CHHATTISGARH,MAHASAMUND,2021-03-01,2,963,9,974
CHHATTISGARH,MAHASAMUND,2021-03-02,2,1025,0,1027
CHHATTISGARH,MAHASAMUND,2021-03-03,7,1052,10,1069
CHHATTISGARH,MAHASAMUND,2021-03-04,2,984,34,1020
CHHATTISGARH,MAHASAMUND,2021-03-05,7,1292,11,1310
CHHATTISGARH,MUNGELI,2021-03-01,2,287,0,289
CHHATTISGARH,MUNGELI,2021-03-02,7,570,0,577
CHHATTISGARH,MUNGELI,2021-03-03,0,531,2,533
CHHATTISGARH,MUNGELI,2021-03-04,5,470,6,481
CHHATTISGARH,MUNGELI,2021-03-05,3,375,0,378
CHHATTISGARH,NARAYANPUR,2021-03-01,0,135,0,135
CHHATTISGARH,NARAYANPUR,2021-03-02,0,20,0,20
CHHATTISGARH,NARAYANPUR,2021-03-03,0,235,0,235
CHHATTISGARH,NARAYANPUR,2021-03-04,0,129,0,129
CHHATTISGARH,NARAYANPUR,2021-03-05,0,315,0,315
CHHATTISGARH,RAIGARH,2021-03-01,6,1364,0,1370
CHHATTISGARH,RAIGARH,2021-03-02,4,1412,2,1418
CHHATTISGARH,RAIGARH,2021-03-03,9,1357,2,1368
CHHATTISGARH,RAIGARH,2021-03-04,6,926,0,932
CHHATTISGARH,RAIGARH,2021-03-05,6,1214,3,1223
CHHATTISGARH,RAIPUR,2021-03-01,79,2399,31,2509
CHHATTISGARH,RAIPUR,2021-03-02,98,2267,8,2373
CHHATTISGARH,RAIPUR,2021-03-03,103,2505,21,2629
CHHATTISGARH,RAIPUR,2021-03-04,98,2403,30,2531
CHHATTISGARH,RAIPUR,2021-03-05,92,2749,31,2872
CHHATTISGARH,RAJNANDGAON,2021-03-01,21,792,20,833
CHHATTISGARH,RAJNANDGAON,2021-03-02,16,1227,10,1253
CHHATTISGARH,RAJNANDGAON,2021-03-03,14,1218,34,1266
CHHATTISGARH,RAJNANDGAON,2021-03-04,19,1430,51,1500
CHHATTISGARH,RAJNANDGAON,2021-03-05,27,1706,18,1751
CHHATTISGARH,SUKMA,2021-03-01,0,400,0,400
CHHATTISGARH,SUKMA,2021-03-02,0,155,0,155
CHHATTISGARH,SUKMA,2021-03-03,0,320,7,327
CHHATTISGARH,SUKMA,2021-03-04,0,174,0,174
CHHATTISGARH,SUKMA,2021-03-05,0,334,0,334
CHHATTISGARH,SURAJPUR,2021-03-01,4,896,10,910
CHHATTISGARH,SURAJPUR,2021-03-02,8,799,0,807
CHHATTISGARH,SURAJPUR,2021-03-03,3,834,1,838
CHHATTISGARH,SURAJPUR,2021-03-04,1,798,0,799
CHHATTISGARH,SURAJPUR,2021-03-05,4,781,4,789
CHHATTISGARH,SURGUJA,2021-03-01,5,885,0,890
CHHATTISGARH,SURGUJA,2021-03-02,5,694,0,699
CHHATTISGARH,SURGUJA,2021-03-03,12,617,0,629
CHHATTISGARH,SURGUJA,2021-03-04,8,799,0,807
CHHATTISGARH,SURGUJA,2021-03-05,13,1073,3,1089
DADRA AND NAGAR HAVELI,DADRA AND NAGAR HAVELI,2021-03-01,1,576,0,577
DADRA AND NAGAR HAVELI,DADRA AND NAGAR HAVELI,2021-03-02,0,656,0,656
DADRA AND NAGAR HAVELI,DADRA AND NAGAR HAVELI,2021-03-03,0,444,0,444
DADRA AND NAGAR HAVELI,DADRA AND NAGAR HAVELI,2021-03-04,2,280,0,282
DADRA AND NAGAR HAVELI,DADRA AND NAGAR HAVELI,2021-03-05,0,217,0,217
DAMAN AND DIU,DAMAN,2021-03-01,0,136,0,136
DAMAN AND DIU,DAMAN,2021-03-02,0,59,0,59
DAMAN AND DIU,DAMAN,2021-03-03,1,84,0,85
DAMAN AND DIU,DAMAN,2021-03-04,0,209,0,209
DAMAN AND DIU,DAMAN,2021-03-05,0,77,0,77
DAMAN AND DIU,DIU,2021-03-01,0,51,0,51
DAMAN AND DIU,DIU,2021-03-02,0,6,0,6
DAMAN AND DIU,DIU,2021-03-03,0,51,0,51
DAMAN AND DIU,DIU,2021-03-04,0,59,0,59
DAMAN AND DIU,DIU,2021-03-05,0,30,0,30
DELHI,CENTRAL,2021-03-01,16,5527,4,5547
DELHI,CENTRAL,2021-03-02,14,5408,3,5425
DELHI,CENTRAL,2021-03-03,21,4654,12,4687
DELHI,CENTRAL,2021-03-04,31,3119,4,3154
DELHI,CENTRAL,2021-03-05,18,3394,18,3430
DELHI,EAST,2021-03-01,17,2409,2,2428
DELHI,EAST,2021-03-02,16,3281,5,3302
DELHI,EAST,2021-03-03,13,3073,3,3089
DELHI,EAST,2021-03-04,15,3165,1,3181
DELHI,EAST,2021-03-05,37,3070,2,3109
DELHI,NEW DELHI,2021-03-01,26,7093,8,7127
DELHI,NEW DELHI,2021-03-02,41,5771,9,5821
DELHI,NEW DELHI,2021-03-03,38,7670,6,7714
DELHI,NEW DELHI,2021-03-04,68,9105,5,9178
DELHI,NEW DELHI,2021-03-05,62,6073,10,6145
DELHI,NORTH,2021-03-01,14,8696,0,8710
DELHI,NORTH,2021-03-02,22,7475,1,7498
DELHI,NORTH,2021-03-03,5,7986,3,7994
DELHI,NORTH,2021-03-04,9,6759,12,6780
DELHI,NORTH,2021-03-05,9,6468,10,6487
DELHI,NORTH EAST,2021-03-01,4,5636,0,5640
DELHI,NORTH EAST,2021-03-02,4,5452,2,5458
DELHI,NORTH EAST,2021-03-03,1,3356,0,3357
DELHI,NORTH EAST,2021-03-04,2,5377,1,5380
DELHI,NORTH EAST,2021-03-05,6,4075,3,4084
DELHI,NORTH WEST,2021-03-01,22,6100,15,6137
DELHI,NORTH WEST,2021-03-02,28,6752,104,6884
DELHI,NORTH WEST,2021-03-03,32,4853,2,4887
DELHI,NORTH WEST,2021-03-04,40,4824,3,4867
DELHI,NORTH WEST,2021-03-05,36,4660,117,4813
DELHI,SHAHDARA,2021-03-01,7,6031,1,6039
DELHI,SHAHDARA,2021-03-02,10,9057,4,9071
DELHI,SHAHDARA,2021-03-03,8,6883,2,6893
DELHI,SHAHDARA,2021-03-04,9,5554,2,5565
DELHI,SHAHDARA,2021-03-05,5,4608,0,4613
DELHI,SOUTH,2021-03-01,50,6853,13,6916
DELHI,SOUTH,2021-03-02,54,4450,40,4544
DELHI,SOUTH,2021-03-03,78,6862,6,6946
DELHI,SOUTH,2021-03-04,80,5828,16,5924
DELHI,SOUTH,2021-03-05,68,5019,29,5116
DELHI,SOUTH EAST,2021-03-01,9,5978,2,5989
DELHI,SOUTH EAST,2021-03-02,22,6428,15,6465
DELHI,SOUTH EAST,2021-03-03,13,6123,4,6140
DELHI,SOUTH EAST,2021-03-04,15,3809,4,3828
DELHI,SOUTH EAST,2021-03-05,17,4673,2,4692
DELHI,SOUTH WEST,2021-03-01,29,3206,2,3237
DELHI,SOUTH WEST,2021-03-02,24,4615,14,4653
DELHI,SOUTH WEST,2021-03-03,27,4280,4,4311
DELHI,SOUTH WEST,2021-03-04,24,3058,2,3084
DELHI,SOUTH WEST,2021-03-05,40,2934,2,2976
DELHI,WEST,2021-03-01,40,8799,1,8840
DELHI,WEST,2021-03-02,43,9526,2,9571
DELHI,WEST,2021-03-03,39,10346,2,10387
DELHI,WEST,2021-03-04,67,8038,4,8109
DELHI,WEST,2021-03-05,47,7523,6,7576
GOA,NORTH GOA,2021-03-01,30,523,1,554
GOA,NORTH GOA,2021-03-02,30,923,0,953
GOA,NORTH GOA,2021-03-03,36,842,0,878
GOA,NORTH GOA,2021-03-04,60,615,0,675
GOA,NORTH GOA,2021-03-05,53,856,0,909
GOA,SOUTH GOA,2021-03-01,23,900,1,924
GOA,SOUTH GOA,2021-03-02,32,831,0,863
GOA,SOUTH GOA,2021-03-03,28,859,1,888
GOA,SOUTH GOA,2021-03-04,30,764,0,794
GOA,SOUTH GOA,2021-03-05,41,898,4,943
GUJARAT,AHMADABAD,2021-03-01,117,3032,48,3197
GUJARAT,AHMADABAD,2021-03-02,158,3128,99,3385
GUJARAT,AHMADABAD,2021-03-03,139,3863,114,4116
GUJARAT,AHMADABAD,2021-03-04,153,3892,97,4142
GUJARAT,AHMADABAD,2021-03-05,172,3867,49,4088
GUJARAT,AMRELI,2021-03-01,3,392,5,400
GUJARAT,AMRELI,2021-03-02,6,725,43,774
GUJARAT,AMRELI,2021-03-03,2,1138,1,1141
GUJARAT,AMRELI,2021-03-04,14,790,0,804
GUJARAT,AMRELI,2021-03-05,1,791,0,792
GUJARAT,ANAND,2021-03-01,11,130,0,141
GUJARAT,ANAND,2021-03-02,13,247,1,261
GUJARAT,ANAND,2021-03-03,15,418,1,434
GUJARAT,ANAND,2021-03-04,18,389,10,417
GUJARAT,ANAND,2021-03-05,21,477,1,499
GUJARAT,ARVALLI,2021-03-01,7,241,0,248
GUJARAT,ARVALLI,2021-03-02,2,402,0,404
GUJARAT,ARVALLI,2021-03-03,6,719,1,726
GUJARAT,ARVALLI,2021-03-04,4,417,0,421
GUJARAT,ARVALLI,2021-03-05,1,485,0,486
GUJARAT,BANAS KANTHA,2021-03-01,3,290,0,293
GUJARAT,BANAS KANTHA,2021-03-02,10,400,0,410
GUJARAT,BANAS KANTHA,2021-03-03,2,408,0,410
GUJARAT,BANAS KANTHA,2021-03-04,0,416,1,417
GUJARAT,BANAS KANTHA,2021-03-05,3,491,0,494
GUJARAT,BHARUCH,2021-03-01,5,497,1,503
GUJARAT,BHARUCH,2021-03-02,22,273,0,295
GUJARAT,BHARUCH,2021-03-03,17,328,7,352
GUJARAT,BHARUCH,2021-03-04,36,333,1,370
GUJARAT,BHARUCH,2021-03-05,22,285,1,308
GUJARAT,BHAVNAGAR,2021-03-01,1,825,0,826
GUJARAT,BHAVNAGAR,2021-03-02,18,359,1,378
GUJARAT,BHAVNAGAR,2021-03-03,7,834,0,841
GUJARAT,BHAVNAGAR,2021-03-04,4,497,0,501
GUJARAT,BHAVNAGAR,2021-03-05,6,371,0,377
GUJARAT,BOTAD,2021-03-01,0,193,0,193
GUJARAT,BOTAD,2021-03-02,1,149,0,150
GUJARAT,BOTAD,2021-03-03,4,168,0,172
GUJARAT,BOTAD,2021-03-04,0,218,0,218
GUJARAT,BOTAD,2021-03-05,0,99,0,99
GUJARAT,CHHOTAUDEPUR,2021-03-01,1,118,0,119
GUJARAT,CHHOTAUDEPUR,2021-03-02,0,79,0,79
GUJARAT,CHHOTAUDEPUR,2021-03-03,1,199,1,201
GUJARAT,CHHOTAUDEPUR,2021-03-04,1,185,1,187
GUJARAT,CHHOTAUDEPUR,2021-03-05,0,219,1,220
GUJARAT,DANG,2021-03-01,1,30,0,31
GUJARAT,DANG,2021-03-02,0,89,0,89
GUJARAT,DANG,2021-03-03,0,81,0,81
GUJARAT,DANG,2021-03-04,3,93,0,96
GUJARAT,DANG,2021-03-05,1,55,0,56
GUJARAT,DEVBHUMI DWARKA,2021-03-01,3,94,0,97
GUJARAT,DEVBHUMI DWARKA,2021-03-02,2,205,0,207
GUJARAT,DEVBHUMI DWARKA,2021-03-03,3,179,1,183
GUJARAT,DEVBHUMI DWARKA,2021-03-04,13,187,0,200
GUJARAT,DEVBHUMI DWARKA,2021-03-05,12,175,0,187
GUJARAT,DOHAD,2021-03-01,5,240,0,245
GUJARAT,DOHAD,2021-03-02,3,370,0,373
GUJARAT,DOHAD,2021-03-03,2,446,2,450
GUJARAT,DOHAD,2021-03-04,1,387,0,388
GUJARAT,DOHAD,2021-03-05,8,595,0,603
GUJARAT,GANDHINAGAR,2021-03-01,10,707,8,725
GUJARAT,GANDHINAGAR,2021-03-02,12,604,25,641
GUJARAT,GANDHINAGAR,2021-03-03,13,874,1,888
GUJARAT,GANDHINAGAR,2021-03-04,17,742,6,765
GUJARAT,GANDHINAGAR,2021-03-05,15,683,9,707
GUJARAT,GIR SOMNATH,2021-03-01,4,311,0,315
GUJARAT,GIR SOMNATH,2021-03-02,4,179,0,183
GUJARAT,GIR SOMNATH,2021-03-03,0,208,1,209
GUJARAT,GIR SOMNATH,2021-03-04,1,184,0,185
GUJARAT,GIR SOMNATH,2021-03-05,10,216,1,227
GUJARAT,JAMNAGAR,2021-03-01,8,900,1,909
GUJARAT,JAMNAGAR,2021-03-02,23,998,2,1023
GUJARAT,JAMNAGAR,2021-03-03,19,985,1,1005
GUJARAT,JAMNAGAR,2021-03-04,28,1085,2,1115
GUJARAT,JAMNAGAR,2021-03-05,13,848,3,864
GUJARAT,JUNAGADH,2021-03-01,17,609,1,627
GUJARAT,JUNAGADH,2021-03-02,5,470,0,475
GUJARAT,JUNAGADH,2021-03-03,3,598,0,601
GUJARAT,JUNAGADH,2021-03-04,10,567,0,577
GUJARAT,JUNAGADH,2021-03-05,11,745,0,756
GUJARAT,KACHCHH,2021-03-01,22,532,49,603
GUJARAT,KACHCHH,2021-03-02,15,562,11,588
GUJARAT,KACHCHH,2021-03-03,23,636,28,687
GUJARAT,KACHCHH,2021-03-04,20,611,18,649
GUJARAT,KACHCHH,2021-03-05,25,694,39,758
GUJARAT,KHEDA,2021-03-01,6,503,32,541
GUJARAT,KHEDA,2021-03-02,7,519,28,554
GUJARAT,KHEDA,2021-03-03,10,758,10,778
GUJARAT,KHEDA,2021-03-04,28,770,18,816
GUJARAT,KHEDA,2021-03-05,17,788,50,855
GUJARAT,MAHESANA,2021-03-01,3,195,0,198
GUJARAT,MAHESANA,2021-03-02,6,213,7,226
GUJARAT,MAHESANA,2021-03-03,9,192,0,201
GUJARAT,MAHESANA,2021-03-04,6,298,2,306
GUJARAT,MAHESANA,2021-03-05,20,369,0,389
GUJARAT,MAHISAGAR,2021-03-01,3,441,0,444
GUJARAT,MAHISAGAR,2021-03-02,3,281,1,285
GUJARAT,MAHISAGAR,2021-03-03,2,506,0,508
GUJARAT,MAHISAGAR,2021-03-04,3,442,0,445
GUJARAT,MAHISAGAR,2021-03-05,10,622,0,632
GUJARAT,MORBI,2021-03-01,2,172,5,179
GUJARAT,MORBI,2021-03-02,6,259,15,280
GUJARAT,MORBI,2021-03-03,3,325,0,328
GUJARAT,MORBI,2021-03-04,5,252,0,257
GUJARAT,MORBI,2021-03-05,2,325,0,327
GUJARAT,NARMADA,2021-03-01,1,24,0,25
GUJARAT,NARMADA,2021-03-02,3,45,0,48
GUJARAT,NARMADA,2021-03-03,2,382,0,384
GUJARAT,NARMADA,2021-03-04,4,482,0,486
GUJARAT,NARMADA,2021-03-05,2,276,0,278
GUJARAT,NAVSARI,2021-03-01,2,323,0,325
GUJARAT,NAVSARI,2021-03-02,1,395,0,396
GUJARAT,NAVSARI,2021-03-03,6,495,3,504
GUJARAT,NAVSARI,2021-03-04,4,311,0,315
GUJARAT,NAVSARI,2021-03-05,5,351,0,356
GUJARAT,PANCH MAHALS,2021-03-01,10,170,0,180
GUJARAT,PANCH MAHALS,2021-03-02,14,377,0,391
GUJARAT,PANCH MAHALS,2021-03-03,12,392,0,404
GUJARAT,PANCH MAHALS,2021-03-04,15,278,0,293
GUJARAT,PANCH MAHALS,2021-03-05,23,313,3,339
GUJARAT,PATAN,2021-03-01,0,356,1,357
GUJARAT,PATAN,2021-03-02,1,328,0,329
GUJARAT,PATAN,2021-03-03,2,402,0,404
GUJARAT,PATAN,2021-03-04,2,325,0,327
GUJARAT,PATAN,2021-03-05,1,277,0,278
GUJARAT,PORBANDAR,2021-03-01,0,269,0,269
GUJARAT,PORBANDAR,2021-03-02,1,207,0,208
GUJARAT,PORBANDAR,2021-03-03,0,250,0,250
GUJARAT,PORBANDAR,2021-03-04,0,235,0,235
GUJARAT,PORBANDAR,2021-03-05,1,239,0,240
GUJARAT,RAJKOT,2021-03-01,58,1057,25,1140
GUJARAT,RAJKOT,2021-03-02,44,1425,27,1496
GUJARAT,RAJKOT,2021-03-03,57,1313,5,1375
GUJARAT,RAJKOT,2021-03-04,48,1236,1,1285
GUJARAT,RAJKOT,2021-03-05,61,1495,7,1563
GUJARAT,SABAR KANTHA,2021-03-01,6,72,0,78
GUJARAT,SABAR KANTHA,2021-03-02,17,139,14,170
GUJARAT,SABAR KANTHA,2021-03-03,9,72,0,81
GUJARAT,SABAR KANTHA,2021-03-04,12,87,0,99
GUJARAT,SABAR KANTHA,2021-03-05,11,74,0,85
GUJARAT,SURAT,2021-03-01,68,1758,0,1826
GUJARAT,SURAT,2021-03-02,82,1981,1,2064
GUJARAT,SURAT,2021-03-03,70,1597,1,1668
GUJARAT,SURAT,2021-03-04,107,2189,5,2301
GUJARAT,SURAT,2021-03-05,135,1820,1,1956
GUJARAT,SURENDRANAGAR,2021-03-01,1,506,1,508
GUJARAT,SURENDRANAGAR,2021-03-02,1,772,3,776
GUJARAT,SURENDRANAGAR,2021-03-03,1,927,5,933
GUJARAT,SURENDRANAGAR,2021-03-04,0,647,0,647
GUJARAT,SURENDRANAGAR,2021-03-05,4,493,2,499
GUJARAT,TAPI,2021-03-01,3,326,0,329
GUJARAT,TAPI,2021-03-02,4,347,0,351
GUJARAT,TAPI,2021-03-03,2,335,9,346
GUJARAT,TAPI,2021-03-04,5,305,1,311
GUJARAT,TAPI,2021-03-05,2,275,8,285
GUJARAT,VADODARA,2021-03-01,71,1408,53,1532
GUJARAT,VADODARA,2021-03-02,123,1532,89,1744
GUJARAT,VADODARA,2021-03-03,87,1486,113,1686
GUJARAT,VADODARA,2021-03-04,102,1331,76,1509
GUJARAT,VADODARA,2021-03-05,123,1608,111,1842
GUJARAT,VALSAD,2021-03-01,4,372,0,376
GUJARAT,VALSAD,2021-03-02,6,445,0,451
GUJARAT,VALSAD,2021-03-03,6,440,1,447
GUJARAT,VALSAD,2021-03-04,4,323,0,327
GUJARAT,VALSAD,2021-03-05,2,359,2,363
HARYANA,AMBALA,2021-03-01,29,720,13,762
HARYANA,AMBALA,2021-03-02,50,1663,38,1751
HARYANA,AMBALA,2021-03-03,34,1050,11,1095
HARYANA,AMBALA,2021-03-04,45,1278,52,1375
HARYANA,AMBALA,2021-03-05,53,1440,37,1530
HARYANA,BHIWANI,2021-03-01,1,409,1,411
HARYANA,BHIWANI,2021-03-02,2,461,0,463
HARYANA,BHIWANI,2021-03-03,3,585,0,588
HARYANA,BHIWANI,2021-03-04,4,806,2,812
HARYANA,BHIWANI,2021-03-05,1,691,0,692
HARYANA,CHARKI DADRI,2021-03-01,0,145,1,146
HARYANA,CHARKI DADRI,2021-03-02,0,458,1,459
HARYANA,CHARKI DADRI,2021-03-03,0,471,0,471
HARYANA,CHARKI DADRI,2021-03-04,1,392,0,393
HARYANA,CHARKI DADRI,2021-03-05,0,490,0,490
HARYANA,FARIDABAD,2021-03-01,16,1027,1,1044
HARYANA,FARIDABAD,2021-03-02,22,682,1,705
HARYANA,FARIDABAD,2021-03-03,19,921,0,940
HARYANA,FARIDABAD,2021-03-04,15,887,1,903
HARYANA,FARIDABAD,2021-03-05,31,1201,1,1233
HARYANA,FATEHABAD,2021-03-01,0,129,0,129
HARYANA,FATEHABAD,2021-03-02,1,83,0,84
HARYANA,FATEHABAD,2021-03-03,2,212,0,214
HARYANA,FATEHABAD,2021-03-04,1,233,0,234
HARYANA,FATEHABAD,2021-03-05,0,247,0,247
HARYANA,GURUGRAM,2021-03-01,57,2793,9,2859
HARYANA,GURUGRAM,2021-03-02,44,3336,4,3384
HARYANA,GURUGRAM,2021-03-03,68,3433,10,3511
HARYANA,GURUGRAM,2021-03-04,62,3738,10,3810
HARYANA,GURUGRAM,2021-03-05,77,3560,13,3650
HARYANA,HISAR,2021-03-01,2,904,1,907
HARYANA,HISAR,2021-03-02,3,1330,0,1333
HARYANA,HISAR,2021-03-03,2,987,0,989
HARYANA,HISAR,2021-03-04,3,1335,0,1338
HARYANA,HISAR,2021-03-05,5,1407,0,1412
HARYANA,JHAJJAR,2021-03-01,1,706,0,707
HARYANA,JHAJJAR,2021-03-02,4,907,1,912
HARYANA,JHAJJAR,2021-03-03,0,747,0,747
HARYANA,JHAJJAR,2021-03-04,2,1325,2,1329
HARYANA,JHAJJAR,2021-03-05,1,912,0,913
HARYANA,JIND,2021-03-01,2,64,0,66
HARYANA,JIND,2021-03-02,6,258,3,267
HARYANA,JIND,2021-03-03,5,645,3,653
HARYANA,JIND,2021-03-04,7,637,18,662
HARYANA,JIND,2021-03-05,7,924,11,942
HARYANA,KAITHAL,2021-03-01,10,353,1,364
HARYANA,KAITHAL,2021-03-02,14,539,17,570
HARYANA,KAITHAL,2021-03-03,6,423,2,431
HARYANA,KAITHAL,2021-03-04,6,334,1,341
HARYANA,KAITHAL,2021-03-05,18,357,5,380
HARYANA,KARNAL,2021-03-01,51,282,1,334
HARYANA,KARNAL,2021-03-02,56,558,1,615
HARYANA,KARNAL,2021-03-03,46,896,1,943
HARYANA,KARNAL,2021-03-04,66,693,2,761
HARYANA,KARNAL,2021-03-05,18,954,2,974
HARYANA,KURUKSHETRA,2021-03-01,31,432,1,464
HARYANA,KURUKSHETRA,2021-03-02,46,908,10,964
HARYANA,KURUKSHETRA,2021-03-03,41,829,3,873
HARYANA,KURUKSHETRA,2021-03-04,42,1203,26,1271
HARYANA,KURUKSHETRA,2021-03-05,27,1142,24,1193
HARYANA,MAHENDRAGARH,2021-03-01,1,45,1,47
HARYANA,MAHENDRAGARH,2021-03-02,8,43,0,51
HARYANA,MAHENDRAGARH,2021-03-03,0,249,2,251
HARYANA,MAHENDRAGARH,2021-03-04,0,175,0,175
HARYANA,MAHENDRAGARH,2021-03-05,0,282,0,282
HARYANA,NUH,2021-03-01,0,286,0,286
HARYANA,NUH,2021-03-02,0,24,0,24
HARYANA,NUH,2021-03-03,0,86,0,86
HARYANA,NUH,2021-03-04,1,123,0,124
HARYANA,NUH,2021-03-05,1,192,1,194
HARYANA,PALWAL,2021-03-01,0,160,0,160
HARYANA,PALWAL,2021-03-02,0,48,0,48
HARYANA,PALWAL,2021-03-03,0,58,0,58
HARYANA,PALWAL,2021-03-04,1,267,1,269
HARYANA,PALWAL,2021-03-05,1,50,0,51
HARYANA,PANCHKULA,2021-03-01,21,493,5,519
HARYANA,PANCHKULA,2021-03-02,53,754,13,820
HARYANA,PANCHKULA,2021-03-03,60,602,13,675
HARYANA,PANCHKULA,2021-03-04,45,924,8,977
HARYANA,PANCHKULA,2021-03-05,40,909,18,967
HARYANA,PANIPAT,2021-03-01,6,404,1,411
HARYANA,PANIPAT,2021-03-02,18,558,0,576
HARYANA,PANIPAT,2021-03-03,12,530,0,542
HARYANA,PANIPAT,2021-03-04,32,493,0,525
HARYANA,PANIPAT,2021-03-05,16,636,1,653
HARYANA,REWARI,2021-03-01,0,430,1,431
HARYANA,REWARI,2021-03-02,3,346,0,349
HARYANA,REWARI,2021-03-03,1,815,1,817
HARYANA,REWARI,2021-03-04,3,939,5,947
HARYANA,REWARI,2021-03-05,1,787,1,789
HARYANA,ROHTAK,2021-03-01,3,917,1,921
HARYANA,ROHTAK,2021-03-02,9,880,0,889
HARYANA,ROHTAK,2021-03-03,11,575,0,586
HARYANA,ROHTAK,2021-03-04,4,993,1,998
HARYANA,ROHTAK,2021-03-05,2,686,0,688
HARYANA,SIRSA,2021-03-01,2,665,18,685
HARYANA,SIRSA,2021-03-02,1,1502,40,1543
HARYANA,SIRSA,2021-03-03,2,846,18,866
HARYANA,SIRSA,2021-03-04,3,1188,5,1196
HARYANA,SIRSA,2021-03-05,0,1316,16,1332
HARYANA,SONIPAT,2021-03-01,2,816,0,818
HARYANA,SONIPAT,2021-03-02,5,968,1,974
HARYANA,SONIPAT,2021-03-03,5,966,0,971
HARYANA,SONIPAT,2021-03-04,6,706,1,713
HARYANA,SONIPAT,2021-03-05,5,1073,3,1081
HARYANA,YAMUNANAGAR,2021-03-01,12,997,0,1009
HARYANA,YAMUNANAGAR,2021-03-02,7,1379,2,1388
HARYANA,YAMUNANAGAR,2021-03-03,21,1001,2,1024
HARYANA,YAMUNANAGAR,2021-03-04,16,505,7,528
HARYANA,YAMUNANAGAR,2021-03-05,18,860,2,880
HIMACHAL PRADESH,BILASPUR,2021-03-01,1,225,0,226
HIMACHAL PRADESH,BILASPUR,2021-03-02,2,277,1,280
HIMACHAL PRADESH,BILASPUR,2021-03-03,17,467,0,484
HIMACHAL PRADESH,BILASPUR,2021-03-04,4,415,0,419
HIMACHAL PRADESH,BILASPUR,2021-03-05,2,282,0,284
HIMACHAL PRADESH,CHAMBA,2021-03-01,1,436,1,438
HIMACHAL PRADESH,CHAMBA,2021-03-02,5,599,1,605
HIMACHAL PRADESH,CHAMBA,2021-03-03,3,306,0,309
HIMACHAL PRADESH,CHAMBA,2021-03-04,0,595,2,597
HIMACHAL PRADESH,CHAMBA,2021-03-05,0,366,5,371
HIMACHAL PRADESH,HAMIRPUR,2021-03-01,5,172,1,178
HIMACHAL PRADESH,HAMIRPUR,2021-03-02,2,409,1,412
HIMACHAL PRADESH,HAMIRPUR,2021-03-03,5,288,1,294
HIMACHAL PRADESH,HAMIRPUR,2021-03-04,8,281,0,289
HIMACHAL PRADESH,HAMIRPUR,2021-03-05,3,475,1,479
HIMACHAL PRADESH,KANGRA,2021-03-01,24,606,0,630
HIMACHAL PRADESH,KANGRA,2021-03-02,16,591,0,607
HIMACHAL PRADESH,KANGRA,2021-03-03,8,595,3,606
HIMACHAL PRADESH,KANGRA,2021-03-04,20,669,3,692
HIMACHAL PRADESH,KANGRA,2021-03-05,24,881,2,907
HIMACHAL PRADESH,KINNAUR,2021-03-01,0,12,0,12
HIMACHAL PRADESH,KINNAUR,2021-03-02,1,13,0,14
HIMACHAL PRADESH,KINNAUR,2021-03-03,0,6,0,6
HIMACHAL PRADESH,KINNAUR,2021-03-04,1,12,0,13
HIMACHAL PRADESH,KINNAUR,2021-03-05,11,7,0,18
HIMACHAL PRADESH,KULLU,2021-03-01,1,91,2,94
HIMACHAL PRADESH,KULLU,2021-03-02,1,109,7,117
HIMACHAL PRADESH,KULLU,2021-03-03,4,240,29,273
HIMACHAL PRADESH,KULLU,2021-03-04,1,298,1,300
HIMACHAL PRADESH,KULLU,2021-03-05,1,95,5,101
HIMACHAL PRADESH,LAHUL AND SPITI,2021-03-01,0,3,0,3
HIMACHAL PRADESH,LAHUL AND SPITI,2021-03-02,0,1,0,1
HIMACHAL PRADESH,LAHUL AND SPITI,2021-03-03,1,0,1,2
HIMACHAL PRADESH,LAHUL AND SPITI,2021-03-04,0,3,0,3
HIMACHAL PRADESH,LAHUL AND SPITI,2021-03-05,0,1,0,1
HIMACHAL PRADESH,MANDI,2021-03-01,1,1024,4,1029
HIMACHAL PRADESH,MANDI,2021-03-02,6,1151,10,1167
HIMACHAL PRADESH,MANDI,2021-03-03,2,752,7,761
HIMACHAL PRADESH,MANDI,2021-03-04,4,522,19,545
HIMACHAL PRADESH,MANDI,2021-03-05,4,296,12,312
HIMACHAL PRADESH,SHIMLA,2021-03-01,2,470,3,475
HIMACHAL PRADESH,SHIMLA,2021-03-02,4,779,23,806
HIMACHAL PRADESH,SHIMLA,2021-03-03,6,591,14,611
HIMACHAL PRADESH,SHIMLA,2021-03-04,4,763,11,778
HIMACHAL PRADESH,SHIMLA,2021-03-05,3,531,12,546
HIMACHAL PRADESH,SIRMAUR,2021-03-01,1,138,0,139
HIMACHAL PRADESH,SIRMAUR,2021-03-02,13,661,7,681
HIMACHAL PRADESH,SIRMAUR,2021-03-03,8,562,6,576
HIMACHAL PRADESH,SIRMAUR,2021-03-04,28,584,5,617
HIMACHAL PRADESH,SIRMAUR,2021-03-05,7,372,2,381
HIMACHAL PRADESH,SOLAN,2021-03-01,3,381,0,384
HIMACHAL PRADESH,SOLAN,2021-03-02,8,741,4,753
HIMACHAL PRADESH,SOLAN,2021-03-03,24,626,0,650
HIMACHAL PRADESH,SOLAN,2021-03-04,10,476,0,486
HIMACHAL PRADESH,SOLAN,2021-03-05,3,788,1,792
HIMACHAL PRADESH,UNA,2021-03-01,10,215,3,228
HIMACHAL PRADESH,UNA,2021-03-02,4,147,0,151
HIMACHAL PRADESH,UNA,2021-03-03,3,387,0,390
HIMACHAL PRADESH,UNA,2021-03-04,4,231,0,235
HIMACHAL PRADESH,UNA,2021-03-05,24,523,2,549
INDIA,INDIA,2021-03-01,4,4,0,8
INDIA,INDIA,2021-03-02,10,4,0,14
INDIA,INDIA,2021-03-03,9,1,0,10
INDIA,INDIA,2021-03-04,3,0,0,3
INDIA,INDIA,2021-03-05,5,3,0,8
JAMMU AND KASHMIR,ANANTNAG,2021-03-01,10,345,1,356
JAMMU AND KASHMIR,ANANTNAG,2021-03-02,10,231,0,241
JAMMU AND KASHMIR,ANANTNAG,2021-03-03,3,257,0,260
JAMMU AND KASHMIR,ANANTNAG,2021-03-04,3,253,0,256
JAMMU AND KASHMIR,ANANTNAG,2021-03-05,9,269,0,278
JAMMU AND KASHMIR,BANDIPORA,2021-03-01,0,96,3,99
JAMMU AND KASHMIR,BANDIPORA,2021-03-02,1,91,2,94
JAMMU AND KASHMIR,BANDIPORA,2021-03-03,0,72,2,74
JAMMU AND KASHMIR,BANDIPORA,2021-03-04,1,121,2,124
JAMMU AND KASHMIR,BANDIPORA,2021-03-05,0,83,9,92
JAMMU AND KASHMIR,BARAMULLA,2021-03-01,6,349,0,355
JAMMU AND KASHMIR,BARAMULLA,2021-03-02,8,328,0,336
JAMMU AND KASHMIR,BARAMULLA,2021-03-03,5,332,0,337
JAMMU AND KASHMIR,BARAMULLA,2021-03-04,0,316,0,316
JAMMU AND KASHMIR,BARAMULLA,2021-03-05,2,330,0,332
JAMMU AND KASHMIR,BUDGAM,2021-03-01,5,909,0,914
JAMMU AND KASHMIR,BUDGAM,2021-03-02,7,1238,0,1245
JAMMU AND KASHMIR,BUDGAM,2021-03-03,4,1358,0,1362
JAMMU AND KASHMIR,BUDGAM,2021-03-04,7,1101,0,1108
JAMMU AND KASHMIR,BUDGAM,2021-03-05,4,1135,0,1139
JAMMU AND KASHMIR,DODA,2021-03-01,3,20,0,23
JAMMU AND KASHMIR,DODA,2021-03-02,0,14,1,15
JAMMU AND KASHMIR,DODA,2021-03-03,0,15,0,15
JAMMU AND KASHMIR,DODA,2021-03-04,0,20,0,20
JAMMU AND KASHMIR,DODA,2021-03-05,0,11,0,11
JAMMU AND KASHMIR,GANDERBAL,2021-03-01,0,114,0,114
JAMMU AND KASHMIR,GANDERBAL,2021-03-02,2,85,0,87
JAMMU AND KASHMIR,GANDERBAL,2021-03-03,1,76,0,77
JAMMU AND KASHMIR,GANDERBAL,2021-03-04,2,157,0,159
JAMMU AND KASHMIR,GANDERBAL,2021-03-05,0,149,0,149
JAMMU AND KASHMIR,JAMMU,2021-03-01,3,710,3,716
JAMMU AND KASHMIR,JAMMU,2021-03-02,32,669,2,703
JAMMU AND KASHMIR,JAMMU,2021-03-03,27,1004,0,1031
JAMMU AND KASHMIR,JAMMU,2021-03-04,19,1061,3,1083
JAMMU AND KASHMIR,JAMMU,2021-03-05,14,823,1,838
JAMMU AND KASHMIR,KATHUA,2021-03-01,1,310,0,311
JAMMU AND KASHMIR,KATHUA,2021-03-02,2,475,0,477
JAMMU AND KASHMIR,KATHUA,2021-03-03,0,344,0,344
JAMMU AND KASHMIR,KATHUA,2021-03-04,1,267,0,268
JAMMU AND KASHMIR,KATHUA,2021-03-05,0,370,0,370
JAMMU AND KASHMIR,KISHTWAR,2021-03-01,0,43,0,43
JAMMU AND KASHMIR,KISHTWAR,2021-03-02,0,16,0,16
JAMMU AND KASHMIR,KISHTWAR,2021-03-03,0,31,0,31
JAMMU AND KASHMIR,KISHTWAR,2021-03-04,0,34,0,34
JAMMU AND KASHMIR,KISHTWAR,2021-03-05,0,71,0,71
JAMMU AND KASHMIR,KULGAM,2021-03-01,4,128,0,132
JAMMU AND KASHMIR,KULGAM,2021-03-02,4,84,0,88
JAMMU AND KASHMIR,KULGAM,2021-03-03,3,161,0,164
JAMMU AND KASHMIR,KULGAM,2021-03-04,3,113,0,116
JAMMU AND KASHMIR,KULGAM,2021-03-05,1,133,0,134
JAMMU AND KASHMIR,KUPWARA,2021-03-01,1,379,0,380
JAMMU AND KASHMIR,KUPWARA,2021-03-02,0,110,0,110
JAMMU AND KASHMIR,KUPWARA,2021-03-03,1,333,0,334
JAMMU AND KASHMIR,KUPWARA,2021-03-04,1,270,0,271
JAMMU AND KASHMIR,KUPWARA,2021-03-05,0,231,0,231
JAMMU AND KASHMIR,POONCH,2021-03-01,1,223,0,224
JAMMU AND KASHMIR,POONCH,2021-03-02,3,211,0,214
JAMMU AND KASHMIR,POONCH,2021-03-03,0,252,0,252
JAMMU AND KASHMIR,POONCH,2021-03-04,0,301,0,301
JAMMU AND KASHMIR,POONCH,2021-03-05,6,376,0,382
JAMMU AND KASHMIR,PULWAMA,2021-03-01,17,611,4,632
JAMMU AND KASHMIR,PULWAMA,2021-03-02,12,408,2,422
JAMMU AND KASHMIR,PULWAMA,2021-03-03,9,414,1,424
JAMMU AND KASHMIR,PULWAMA,2021-03-04,2,303,0,305
JAMMU AND KASHMIR,PULWAMA,2021-03-05,3,347,0,350
JAMMU AND KASHMIR,RAJOURI,2021-03-01,0,141,0,141
JAMMU AND KASHMIR,RAJOURI,2021-03-02,0,78,0,78
JAMMU AND KASHMIR,RAJOURI,2021-03-03,0,123,0,123
JAMMU AND KASHMIR,RAJOURI,2021-03-04,0,190,0,190
JAMMU AND KASHMIR,RAJOURI,2021-03-05,0,100,0,100
JAMMU AND KASHMIR,RAMBAN,2021-03-01,0,185,0,185
JAMMU AND KASHMIR,RAMBAN,2021-03-02,4,258,0,262
JAMMU AND KASHMIR,RAMBAN,2021-03-03,0,176,0,176
JAMMU AND KASHMIR,RAMBAN,2021-03-04,1,208,0,209
JAMMU AND KASHMIR,RAMBAN,2021-03-05,0,206,0,206
JAMMU AND KASHMIR,REASI,2021-03-01,1,54,0,55
JAMMU AND KASHMIR,REASI,2021-03-02,0,103,1,104
JAMMU AND KASHMIR,REASI,2021-03-03,0,61,0,61
JAMMU AND KASHMIR,REASI,2021-03-04,0,77,0,77
JAMMU AND KASHMIR,REASI,2021-03-05,0,51,0,51
JAMMU AND KASHMIR,SAMBA,2021-03-01,0,30,0,30
JAMMU AND KASHMIR,SAMBA,2021-03-02,0,22,0,22
JAMMU AND KASHMIR,SAMBA,2021-03-03,1,214,0,215
JAMMU AND KASHMIR,SAMBA,2021-03-04,0,250,0,250
JAMMU AND KASHMIR,SAMBA,2021-03-05,0,95,0,95
JAMMU AND KASHMIR,SHOPIAN,2021-03-01,1,61,0,62
JAMMU AND KASHMIR,SHOPIAN,2021-03-02,1,97,0,98
JAMMU AND KASHMIR,SHOPIAN,2021-03-03,0,96,1,97
JAMMU AND KASHMIR,SHOPIAN,2021-03-04,0,110,0,110
JAMMU AND KASHMIR,SHOPIAN,2021-03-05,2,77,0,79
JAMMU AND KASHMIR,SRINAGAR,2021-03-01,55,3358,3,3416
JAMMU AND KASHMIR,SRINAGAR,2021-03-02,58,3854,1,3913
JAMMU AND KASHMIR,SRINAGAR,2021-03-03,41,3628,4,3673
JAMMU AND KASHMIR,SRINAGAR,2021-03-04,24,3746,0,3770
JAMMU AND KASHMIR,SRINAGAR,2021-03-05,19,3369,0,3388
JAMMU AND KASHMIR,UDHAMPUR,2021-03-01,1,523,0,524
JAMMU AND KASHMIR,UDHAMPUR,2021-03-02,14,572,0,586
JAMMU AND KASHMIR,UDHAMPUR,2021-03-03,9,727,0,736
JAMMU AND KASHMIR,UDHAMPUR,2021-03-04,49,528,0,577
JAMMU AND KASHMIR,UDHAMPUR,2021-03-05,5,708,0,713
JHARKHAND,BOKARO,2021-03-01,6,960,2,968
JHARKHAND,BOKARO,2021-03-02,3,1466,4,1473
JHARKHAND,BOKARO,2021-03-03,2,1064,11,1077
JHARKHAND,BOKARO,2021-03-04,3,691,1,695
JHARKHAND,BOKARO,2021-03-05,9,1036,2,1047
JHARKHAND,CHATRA,2021-03-01,0,492,0,492
JHARKHAND,CHATRA,2021-03-02,0,23,0,23
JHARKHAND,CHATRA,2021-03-03,1,90,0,91
JHARKHAND,CHATRA,2021-03-04,0,53,0,53
JHARKHAND,CHATRA,2021-03-05,0,202,15,217
JHARKHAND,DEOGHAR,2021-03-01,0,473,0,473
JHARKHAND,DEOGHAR,2021-03-02,1,299,0,300
JHARKHAND,DEOGHAR,2021-03-03,2,955,10,967
JHARKHAND,DEOGHAR,2021-03-04,2,589,12,603
JHARKHAND,DEOGHAR,2021-03-05,2,1045,2,1049
JHARKHAND,DHANBAD,2021-03-01,0,293,0,293
JHARKHAND,DHANBAD,2021-03-02,1,313,0,314
JHARKHAND,DHANBAD,2021-03-03,0,142,0,142
JHARKHAND,DHANBAD,2021-03-04,0,193,0,193
JHARKHAND,DHANBAD,2021-03-05,1,332,0,333
JHARKHAND,DUMKA,2021-03-01,0,636,39,675
JHARKHAND,DUMKA,2021-03-02,1,550,7,558
JHARKHAND,DUMKA,2021-03-03,1,167,13,181
JHARKHAND,DUMKA,2021-03-04,0,416,10,426
JHARKHAND,DUMKA,2021-03-05,0,457,8,465
JHARKHAND,EAST SINGHBUM,2021-03-01,12,1347,0,1359
JHARKHAND,EAST SINGHBUM,2021-03-02,10,1403,2,1415
JHARKHAND,EAST SINGHBUM,2021-03-03,7,1401,0,1408
JHARKHAND,EAST SINGHBUM,2021-03-04,10,799,0,809
JHARKHAND,EAST SINGHBUM,2021-03-05,15,1114,1,1130
JHARKHAND,GARHWA,2021-03-01,0,1023,0,1023
JHARKHAND,GARHWA,2021-03-02,0,448,0,448
JHARKHAND,GARHWA,2021-03-03,0,372,0,372
JHARKHAND,GARHWA,2021-03-04,1,857,0,858
JHARKHAND,GARHWA,2021-03-05,0,79,0,79
JHARKHAND,GIRIDIH,2021-03-01,2,1153,0,1155
JHARKHAND,GIRIDIH,2021-03-02,0,1094,0,1094
JHARKHAND,GIRIDIH,2021-03-03,0,1378,0,1378
JHARKHAND,GIRIDIH,2021-03-04,3,1586,0,1589
JHARKHAND,GIRIDIH,2021-03-05,1,1395,0,1396
JHARKHAND,GODDA,2021-03-01,0,105,0,105
JHARKHAND,GODDA,2021-03-02,0,135,0,135
JHARKHAND,GODDA,2021-03-03,0,165,0,165
JHARKHAND,GODDA,2021-03-04,0,155,0,155
JHARKHAND,GODDA,2021-03-05,0,131,0,131
JHARKHAND,GUMLA,2021-03-01,4,802,0,806
JHARKHAND,GUMLA,2021-03-02,0,872,0,872
JHARKHAND,GUMLA,2021-03-03,2,496,0,498
JHARKHAND,GUMLA,2021-03-04,0,362,0,362
JHARKHAND,GUMLA,2021-03-05,0,592,0,592
JHARKHAND,HAZARIBAGH,2021-03-01,2,611,0,613
JHARKHAND,HAZARIBAGH,2021-03-02,0,277,0,277
JHARKHAND,HAZARIBAGH,2021-03-03,1,514,0,515
JHARKHAND,HAZARIBAGH,2021-03-04,3,403,0,406
JHARKHAND,HAZARIBAGH,2021-03-05,0,402,0,402
JHARKHAND,JAMTARA,2021-03-01,0,108,0,108
JHARKHAND,JAMTARA,2021-03-02,2,163,0,165
JHARKHAND,JAMTARA,2021-03-03,2,147,0,149
JHARKHAND,JAMTARA,2021-03-04,3,97,0,100
JHARKHAND,JAMTARA,2021-03-05,0,155,0,155
JHARKHAND,KHUNTI,2021-03-01,0,103,22,125
JHARKHAND,KHUNTI,2021-03-02,0,108,0,108
JHARKHAND,KHUNTI,2021-03-03,0,93,1,94
JHARKHAND,KHUNTI,2021-03-04,0,104,0,104
JHARKHAND,KHUNTI,2021-03-05,0,157,0,157
JHARKHAND,KODERMA,2021-03-01,1,383,0,384
JHARKHAND,KODERMA,2021-03-02,1,80,0,81
JHARKHAND,KODERMA,2021-03-03,1,187,0,188
JHARKHAND,KODERMA,2021-03-04,4,764,1,769
JHARKHAND,KODERMA,2021-03-05,1,592,7,600
JHARKHAND,LATEHAR,2021-03-01,3,515,0,518
JHARKHAND,LATEHAR,2021-03-02,0,539,0,539
JHARKHAND,LATEHAR,2021-03-03,1,759,2,762
JHARKHAND,LATEHAR,2021-03-04,1,410,1,412
JHARKHAND,LATEHAR,2021-03-05,0,835,3,838
JHARKHAND,LOHARDAGA,2021-03-01,0,79,0,79
JHARKHAND,LOHARDAGA,2021-03-02,0,169,0,169
JHARKHAND,LOHARDAGA,2021-03-03,2,138,0,140
JHARKHAND,LOHARDAGA,2021-03-04,0,73,0,73
JHARKHAND,LOHARDAGA,2021-03-05,0,170,0,170
JHARKHAND,PAKUR,2021-03-01,0,315,0,315
JHARKHAND,PAKUR,2021-03-02,0,18,0,18
JHARKHAND,PAKUR,2021-03-03,0,8,0,8
JHARKHAND,PAKUR,2021-03-04,0,5,0,5
JHARKHAND,PAKUR,2021-03-05,1,371,0,372
JHARKHAND,PALAMU,2021-03-01,0,668,0,668
JHARKHAND,PALAMU,2021-03-02,0,750,1,751
JHARKHAND,PALAMU,2021-03-03,0,745,0,745
JHARKHAND,PALAMU,2021-03-04,1,482,0,483
JHARKHAND,PALAMU,2021-03-05,0,540,0,540
JHARKHAND,RAMGARH,2021-03-01,0,318,1,319
JHARKHAND,RAMGARH,2021-03-02,1,58,0,59
JHARKHAND,RAMGARH,2021-03-03,1,159,0,160
JHARKHAND,RAMGARH,2021-03-04,2,246,0,248
JHARKHAND,RAMGARH,2021-03-05,0,177,0,177
JHARKHAND,RANCHI,2021-03-01,45,624,1,670
JHARKHAND,RANCHI,2021-03-02,50,696,0,746
JHARKHAND,RANCHI,2021-03-03,41,953,0,994
JHARKHAND,RANCHI,2021-03-04,41,754,3,798
JHARKHAND,RANCHI,2021-03-05,54,872,4,930
JHARKHAND,SAHEBGANJ,2021-03-01,0,92,0,92
JHARKHAND,SAHEBGANJ,2021-03-02,0,102,0,102
JHARKHAND,SAHEBGANJ,2021-03-03,0,63,0,63
JHARKHAND,SAHEBGANJ,2021-03-04,1,138,0,139
JHARKHAND,SAHEBGANJ,2021-03-05,0,74,0,74
JHARKHAND,SARAIKELA KHARSAWAN,2021-03-01,2,235,0,237
JHARKHAND,SARAIKELA KHARSAWAN,2021-03-02,2,509,0,511
JHARKHAND,SARAIKELA KHARSAWAN,2021-03-03,0,76,0,76
JHARKHAND,SARAIKELA KHARSAWAN,2021-03-04,0,185,0,185
JHARKHAND,SARAIKELA KHARSAWAN,2021-03-05,1,475,0,476
JHARKHAND,SIMDEGA,2021-03-01,4,610,0,614
JHARKHAND,SIMDEGA,2021-03-02,0,849,0,849
JHARKHAND,SIMDEGA,2021-03-03,0,1020,0,1020
JHARKHAND,SIMDEGA,2021-03-04,1,1014,0,1015
JHARKHAND,SIMDEGA,2021-03-05,0,909,1,910
JHARKHAND,WEST SINGHBHUM,2021-03-01,0,912,0,912
JHARKHAND,WEST SINGHBHUM,2021-03-02,0,644,0,644
JHARKHAND,WEST SINGHBHUM,2021-03-03,0,786,0,786
JHARKHAND,WEST SINGHBHUM,2021-03-04,0,1105,0,1105
JHARKHAND,WEST SINGHBHUM,2021-03-05,3,1050,0,1053
KARNATAKA,BAGALKOTE,2021-03-01,0,1539,7,1546
KARNATAKA,BAGALKOTE,2021-03-02,1,1367,2,1370
KARNATAKA,BAGALKOTE,2021-03-03,0,1359,2,1361
KARNATAKA,BAGALKOTE,2021-03-04,0,1043,0,1043
KARNATAKA,BAGALKOTE,2021-03-05,2,1249,1,1252
KARNATAKA,BALLARI,2021-03-01,6,1263,8,1277
KARNATAKA,BALLARI,2021-03-02,5,1671,5,1681
KARNATAKA,BALLARI,2021-03-03,8,2280,28,2316
KARNATAKA,BALLARI,2021-03-04,8,2372,13,2393
KARNATAKA,BALLARI,2021-03-05,8,2330,41,2379
KARNATAKA,BELAGAVI,2021-03-01,10,1803,1,1814
KARNATAKA,BELAGAVI,2021-03-02,10,1076,0,1086
KARNATAKA,BELAGAVI,2021-03-03,11,1230,0,1241
KARNATAKA,BELAGAVI,2021-03-04,14,1679,1,1694
KARNATAKA,BELAGAVI,2021-03-05,6,2346,0,2352
KARNATAKA,BENGALURU RURAL,2021-03-01,4,770,20,794
KARNATAKA,BENGALURU RURAL,2021-03-02,12,782,4,798
KARNATAKA,BENGALURU RURAL,2021-03-03,11,1242,1,1254
KARNATAKA,BENGALURU RURAL,2021-03-04,20,731,2,753
KARNATAKA,BENGALURU RURAL,2021-03-05,16,1015,1,1032
KARNATAKA,BENGALURU URBAN,2021-03-01,324,33483,263,34070
KARNATAKA,BENGALURU URBAN,2021-03-02,344,29828,341,30513
KARNATAKA,BENGALURU URBAN,2021-03-03,414,39322,125,39861
KARNATAKA,BENGALURU URBAN,2021-03-04,471,37342,204,38017
KARNATAKA,BENGALURU URBAN,2021-03-05,396,39630,101,40127
KARNATAKA,BIDAR,2021-03-01,17,221,0,238
KARNATAKA,BIDAR,2021-03-02,24,948,0,972
KARNATAKA,BIDAR,2021-03-03,13,1042,0,1055
KARNATAKA,BIDAR,2021-03-04,17,985,0,1002
KARNATAKA,BIDAR,2021-03-05,24,887,0,911
KARNATAKA,CHAMARAJANAGARA,2021-03-01,2,137,0,139
KARNATAKA,CHAMARAJANAGARA,2021-03-02,12,824,4,840
KARNATAKA,CHAMARAJANAGARA,2021-03-03,3,634,2,639
KARNATAKA,CHAMARAJANAGARA,2021-03-04,2,638,1,641
KARNATAKA,CHAMARAJANAGARA,2021-03-05,3,540,0,543
KARNATAKA,CHIKKABALLAPURA,2021-03-01,6,1100,2,1108
KARNATAKA,CHIKKABALLAPURA,2021-03-02,15,1431,5,1451
KARNATAKA,CHIKKABALLAPURA,2021-03-03,7,1490,0,1497
KARNATAKA,CHIKKABALLAPURA,2021-03-04,0,1551,2,1553
KARNATAKA,CHIKKABALLAPURA,2021-03-05,7,1540,2,1549
KARNATAKA,CHIKKAMAGALURU,2021-03-01,1,627,3,631
KARNATAKA,CHIKKAMAGALURU,2021-03-02,1,933,7,941
KARNATAKA,CHIKKAMAGALURU,2021-03-03,1,735,7,743
KARNATAKA,CHIKKAMAGALURU,2021-03-04,2,961,7,970
KARNATAKA,CHIKKAMAGALURU,2021-03-05,3,669,3,675
KARNATAKA,CHITRADURGA,2021-03-01,12,1026,4,1042
KARNATAKA,CHITRADURGA,2021-03-02,7,552,3,562
KARNATAKA,CHITRADURGA,2021-03-03,5,1074,0,1079
KARNATAKA,CHITRADURGA,2021-03-04,4,777,0,781
KARNATAKA,CHITRADURGA,2021-03-05,7,1509,0,1516
KARNATAKA,DAKSHINA KANNADA,2021-03-01,30,1871,3,1904
KARNATAKA,DAKSHINA KANNADA,2021-03-02,24,1246,1,1271
KARNATAKA,DAKSHINA KANNADA,2021-03-03,17,1548,8,1573
KARNATAKA,DAKSHINA KANNADA,2021-03-04,22,1911,2,1935
KARNATAKA,DAKSHINA KANNADA,2021-03-05,28,2579,6,2613
KARNATAKA,DAVANGERE,2021-03-01,3,2162,40,2205
KARNATAKA,DAVANGERE,2021-03-02,4,2823,81,2908
KARNATAKA,DAVANGERE,2021-03-03,5,1053,18,1076
KARNATAKA,DAVANGERE,2021-03-04,5,2072,101,2178
KARNATAKA,DAVANGERE,2021-03-05,5,2375,158,2538
KARNATAKA,DHARWAD,2021-03-01,2,1820,24,1846
KARNATAKA,DHARWAD,2021-03-02,21,1885,12,1918
KARNATAKA,DHARWAD,2021-03-03,7,2223,26,2256
KARNATAKA,DHARWAD,2021-03-04,9,1885,13,1907
KARNATAKA,DHARWAD,2021-03-05,7,2472,25,2504
KARNATAKA,GADAG,2021-03-01,0,1230,21,1251
KARNATAKA,GADAG,2021-03-02,1,1036,57,1094
KARNATAKA,GADAG,2021-03-03,0,1015,48,1063
KARNATAKA,GADAG,2021-03-04,2,1008,62,1072
KARNATAKA,GADAG,2021-03-05,20,749,40,809
KARNATAKA,HASSAN,2021-03-01,8,1360,60,1428
KARNATAKA,HASSAN,2021-03-02,13,1832,118,1963
KARNATAKA,HASSAN,2021-03-03,13,2464,93,2570
KARNATAKA,HASSAN,2021-03-04,8,2301,20,2329
KARNATAKA,HASSAN,2021-03-05,10,912,146,1068
KARNATAKA,HAVERI,2021-03-01,1,73,0,74
KARNATAKA,HAVERI,2021-03-02,1,92,0,93
KARNATAKA,HAVERI,2021-03-03,1,830,0,831
KARNATAKA,HAVERI,2021-03-04,1,1236,1,1238
KARNATAKA,HAVERI,2021-03-05,0,1267,3,1270
KARNATAKA,KALABURAGI,2021-03-01,19,1051,1,1071
KARNATAKA,KALABURAGI,2021-03-02,14,1333,3,1350
KARNATAKA,KALABURAGI,2021-03-03,30,2332,7,2369
KARNATAKA,KALABURAGI,2021-03-04,55,1383,4,1442
KARNATAKA,KALABURAGI,2021-03-05,18,2294,11,2323
KARNATAKA,KODAGU,2021-03-01,2,533,11,546
KARNATAKA,KODAGU,2021-03-02,7,468,8,483
KARNATAKA,KODAGU,2021-03-03,6,569,2,577
KARNATAKA,KODAGU,2021-03-04,7,903,25,935
KARNATAKA,KODAGU,2021-03-05,4,547,9,560
KARNATAKA,KOLAR,2021-03-01,0,971,14,985
KARNATAKA,KOLAR,2021-03-02,6,1909,2,1917
KARNATAKA,KOLAR,2021-03-03,5,1514,1,1520
KARNATAKA,KOLAR,2021-03-04,3,1703,9,1715
KARNATAKA,KOLAR,2021-03-05,6,1431,4,1441
KARNATAKA,KOPPAL,2021-03-01,1,268,0,269
KARNATAKA,KOPPAL,2021-03-02,1,994,3,998
KARNATAKA,KOPPAL,2021-03-03,0,876,2,878
KARNATAKA,KOPPAL,2021-03-04,1,764,0,765
KARNATAKA,KOPPAL,2021-03-05,0,741,0,741
KARNATAKA,MANDYA,2021-03-01,5,888,0,893
KARNATAKA,MANDYA,2021-03-02,5,1841,5,1851
KARNATAKA,MANDYA,2021-03-03,3,1377,3,1383
KARNATAKA,MANDYA,2021-03-04,3,1475,5,1483
KARNATAKA,MANDYA,2021-03-05,5,1668,1,1674
KARNATAKA,MYSURU,2021-03-01,12,827,0,839
KARNATAKA,MYSURU,2021-03-02,27,3240,1,3268
KARNATAKA,MYSURU,2021-03-03,15,1890,8,1913
KARNATAKA,MYSURU,2021-03-04,16,2527,5,2548
KARNATAKA,MYSURU,2021-03-05,21,3076,11,3108
KARNATAKA,RAICHUR,2021-03-01,6,537,1,544
KARNATAKA,RAICHUR,2021-03-02,6,805,35,846
KARNATAKA,RAICHUR,2021-03-03,3,910,3,916
KARNATAKA,RAICHUR,2021-03-04,3,898,2,903
KARNATAKA,RAICHUR,2021-03-05,1,625,6,632
KARNATAKA,RAMANAGARA,2021-03-01,2,565,1,568
KARNATAKA,RAMANAGARA,2021-03-02,1,1156,0,1157
KARNATAKA,RAMANAGARA,2021-03-03,3,700,0,703
KARNATAKA,RAMANAGARA,2021-03-04,0,771,0,771
KARNATAKA,RAMANAGARA,2021-03-05,0,256,0,256
KARNATAKA,SHIVAMOGGA,2021-03-01,5,830,36,871
KARNATAKA,SHIVAMOGGA,2021-03-02,3,1294,0,1297
KARNATAKA,SHIVAMOGGA,2021-03-03,5,946,33,984
KARNATAKA,SHIVAMOGGA,2021-03-04,3,1735,0,1738
KARNATAKA,SHIVAMOGGA,2021-03-05,1,1318,10,1329
KARNATAKA,TUMAKURU,2021-03-01,21,1975,0,1996
KARNATAKA,TUMAKURU,2021-03-02,8,1138,2,1148
KARNATAKA,TUMAKURU,2021-03-03,12,1822,14,1848
KARNATAKA,TUMAKURU,2021-03-04,32,1844,15,1891
KARNATAKA,TUMAKURU,2021-03-05,12,1873,2,1887
KARNATAKA,UDUPI,2021-03-01,6,1376,0,1382
KARNATAKA,UDUPI,2021-03-02,25,1535,0,1560
KARNATAKA,UDUPI,2021-03-03,11,1361,0,1372
KARNATAKA,UDUPI,2021-03-04,20,1239,0,1259
KARNATAKA,UDUPI,2021-03-05,12,991,0,1003
KARNATAKA,UTTARA KANNADA,2021-03-01,1,1370,218,1589
KARNATAKA,UTTARA KANNADA,2021-03-02,5,1334,206,1545
KARNATAKA,UTTARA KANNADA,2021-03-03,8,1387,161,1556
KARNATAKA,UTTARA KANNADA,2021-03-04,17,1244,113,1374
KARNATAKA,UTTARA KANNADA,2021-03-05,2,1360,75,1437
KARNATAKA,VIJAYAPURA,2021-03-01,6,658,0,664
KARNATAKA,VIJAYAPURA,2021-03-02,8,738,2,748
KARNATAKA,VIJAYAPURA,2021-03-03,12,1517,0,1529
KARNATAKA,VIJAYAPURA,2021-03-04,9,1312,0,1321
KARNATAKA,VIJAYAPURA,2021-03-05,6,1758,0,1764
KARNATAKA,YADGIR,2021-03-01,6,765,0,771
KARNATAKA,YADGIR,2021-03-02,2,879,0,881
KARNATAKA,YADGIR,2021-03-03,0,739,1,740
KARNATAKA,YADGIR,2021-03-04,1,1237,0,1238
KARNATAKA,YADGIR,2021-03-05,3,1057,1,1061
KERALA,ALAPPUZHA,2021-03-01,179,2806,2,2987
KERALA,ALAPPUZHA,2021-03-02,192,3349,8,3549
KERALA,ALAPPUZHA,2021-03-03,212,3169,6,3387
KERALA,ALAPPUZHA,2021-03-04,237,2878,6,3121
KERALA,ALAPPUZHA,2021-03-05,212,3104,12,3328
KERALA,ERNAKULAM,2021-03-01,298,5868,51,6217
KERALA,ERNAKULAM,2021-03-02,410,7061,52,7523
KERALA,ERNAKULAM,2021-03-03,325,6261,49,6635
KERALA,ERNAKULAM,2021-03-04,394,7129,47,7570
KERALA,ERNAKULAM,2021-03-05,248,6951,20,7219
KERALA,IDUKKI,2021-03-01,34,1288,1,1323
KERALA,IDUKKI,2021-03-02,137,1768,3,1908
KERALA,IDUKKI,2021-03-03,89,1339,3,1431
KERALA,IDUKKI,2021-03-04,85,1402,4,1491
KERALA,IDUKKI,2021-03-05,109,1436,3,1548
KERALA,KANNUR,2021-03-01,248,2611,2,2861
KERALA,KANNUR,2021-03-02,211,2406,5,2622
KERALA,KANNUR,2021-03-03,194,2430,22,2646
KERALA,KANNUR,2021-03-04,171,2137,9,2317
KERALA,KANNUR,2021-03-05,244,3180,10,3434
KERALA,KASARAGOD,2021-03-01,120,1436,5,1561
KERALA,KASARAGOD,2021-03-02,110,1194,0,1304
KERALA,KASARAGOD,2021-03-03,150,1530,3,1683
KERALA,KASARAGOD,2021-03-04,116,2274,7,2397
KERALA,KASARAGOD,2021-03-05,139,1745,2,1886
KERALA,KOLLAM,2021-03-01,220,6075,41,6336
KERALA,KOLLAM,2021-03-02,339,6773,12,7124
KERALA,KOLLAM,2021-03-03,328,5979,37,6344
KERALA,KOLLAM,2021-03-04,317,5181,19,5517
KERALA,KOLLAM,2021-03-05,285,4180,14,4479
KERALA,KOTTAYAM,2021-03-01,170,3533,18,3721
KERALA,KOTTAYAM,2021-03-02,258,3625,23,3906
KERALA,KOTTAYAM,2021-03-03,259,3060,46,3365
KERALA,KOTTAYAM,2021-03-04,307,3628,55,3990
KERALA,KOTTAYAM,2021-03-05,230,3300,34,3564
KERALA,KOZHIKODE,2021-03-01,369,4529,63,4961
KERALA,KOZHIKODE,2021-03-02,446,4331,35,4812
KERALA,KOZHIKODE,2021-03-03,481,4991,79,5551
KERALA,KOZHIKODE,2021-03-04,387,4169,64,4620
KERALA,KOZHIKODE,2021-03-05,542,4658,49,5249
KERALA,MALAPPURAM,2021-03-01,262,4330,5,4597
KERALA,MALAPPURAM,2021-03-02,302,3853,12,4167
KERALA,MALAPPURAM,2021-03-03,258,3867,2,4127
KERALA,MALAPPURAM,2021-03-04,193,3059,4,3256
KERALA,MALAPPURAM,2021-03-05,286,3197,4,3487
KERALA,PALAKKAD,2021-03-01,98,2350,3,2451
KERALA,PALAKKAD,2021-03-02,123,2976,0,3099
KERALA,PALAKKAD,2021-03-03,123,2871,3,2997
KERALA,PALAKKAD,2021-03-04,86,3931,3,4020
KERALA,PALAKKAD,2021-03-05,107,4519,0,4626
KERALA,PATHANAMTHITTA,2021-03-01,219,2678,7,2904
KERALA,PATHANAMTHITTA,2021-03-02,222,2702,2,2926
KERALA,PATHANAMTHITTA,2021-03-03,184,2410,1,2595
KERALA,PATHANAMTHITTA,2021-03-04,164,3294,3,3461
KERALA,PATHANAMTHITTA,2021-03-05,251,2907,4,3162
KERALA,THIRUVANANTHAPURAM,2021-03-01,207,4300,28,4535
KERALA,THIRUVANANTHAPURAM,2021-03-02,303,5779,11,6093
KERALA,THIRUVANANTHAPURAM,2021-03-03,216,5914,14,6144
KERALA,THIRUVANANTHAPURAM,2021-03-04,314,7335,18,7667
KERALA,THIRUVANANTHAPURAM,2021-03-05,246,5081,21,5348
KERALA,THRISSUR,2021-03-01,258,3843,4,4105
KERALA,THRISSUR,2021-03-02,405,3699,2,4106
KERALA,THRISSUR,2021-03-03,261,3978,3,4242
KERALA,THRISSUR,2021-03-04,276,4445,4,4725
KERALA,THRISSUR,2021-03-05,322,4517,3,4842
KERALA,WAYANAD,2021-03-01,97,917,9,1023
KERALA,WAYANAD,2021-03-02,57,1128,18,1203
KERALA,WAYANAD,2021-03-03,123,780,9,912
KERALA,WAYANAD,2021-03-04,84,1135,11,1230
KERALA,WAYANAD,2021-03-05,89,782,2,873
LADAKH,KARGIL,2021-03-01,0,71,0,71
LADAKH,KARGIL,2021-03-02,3,143,0,146
LADAKH,KARGIL,2021-03-03,1,141,0,142
LADAKH,KARGIL,2021-03-04,0,152,0,152
LADAKH,KARGIL,2021-03-05,0,62,0,62
LADAKH,LEH LADAKH,2021-03-01,2,147,0,149
LADAKH,LEH LADAKH,2021-03-02,2,293,4,299
LADAKH,LEH LADAKH,2021-03-03,2,143,2,147
LADAKH,LEH LADAKH,2021-03-04,2,203,1,206
LADAKH,LEH LADAKH,2021-03-05,2,270,3,275
LAKSHADWEEP,LAKSHADWEEP DISTRICT,2021-03-01,0,227,0,227
LAKSHADWEEP,LAKSHADWEEP DISTRICT,2021-03-02,19,640,0,659
LAKSHADWEEP,LAKSHADWEEP DISTRICT,2021-03-03,3,84,0,87
LAKSHADWEEP,LAKSHADWEEP DISTRICT,2021-03-04,1,142,0,143
LAKSHADWEEP,LAKSHADWEEP DISTRICT,2021-03-05,2,185,0,187
MADHYA PRADESH,AGAR MALWA,2021-03-01,5,137,0,142
MADHYA PRADESH,AGAR MALWA,2021-03-02,2,54,0,56
MADHYA PRADESH,AGAR MALWA,2021-03-03,0,162,0,162
MADHYA PRADESH,AGAR MALWA,2021-03-04,3,122,0,125
MADHYA PRADESH,AGAR MALWA,2021-03-05,1,121,1,123
MADHYA PRADESH,ALIRAJPUR,2021-03-01,0,171,0,171
MADHYA PRADESH,ALIRAJPUR,2021-03-02,0,180,0,180
MADHYA PRADESH,ALIRAJPUR,2021-03-03,0,104,0,104
MADHYA PRADESH,ALIRAJPUR,2021-03-04,4,103,0,107
MADHYA PRADESH,ALIRAJPUR,2021-03-05,3,90,0,93
MADHYA PRADESH,ANUPPUR,2021-03-01,2,271,16,289
MADHYA PRADESH,ANUPPUR,2021-03-02,4,207,2,213
MADHYA PRADESH,ANUPPUR,2021-03-03,5,144,3,152
MADHYA PRADESH,ANUPPUR,2021-03-04,1,198,9,208
MADHYA PRADESH,ANUPPUR,2021-03-05,0,169,6,175
MADHYA PRADESH,ASHOKNAGAR,2021-03-01,0,38,0,38
MADHYA PRADESH,ASHOKNAGAR,2021-03-02,0,80,0,80
MADHYA PRADESH,ASHOKNAGAR,2021-03-03,0,123,0,123
MADHYA PRADESH,ASHOKNAGAR,2021-03-04,0,59,0,59
MADHYA PRADESH,ASHOKNAGAR,2021-03-05,0,227,0,227
MADHYA PRADESH,BALAGHAT,2021-03-01,5,181,0,186
MADHYA PRADESH,BALAGHAT,2021-03-02,1,229,0,230
MADHYA PRADESH,BALAGHAT,2021-03-03,3,318,0,321
MADHYA PRADESH,BALAGHAT,2021-03-04,2,323,0,325
MADHYA PRADESH,BALAGHAT,2021-03-05,2,270,0,272
MADHYA PRADESH,BARWANI,2021-03-01,1,228,0,229
MADHYA PRADESH,BARWANI,2021-03-02,2,258,0,260
MADHYA PRADESH,BARWANI,2021-03-03,6,73,0,79
MADHYA PRADESH,BARWANI,2021-03-04,4,150,0,154
MADHYA PRADESH,BARWANI,2021-03-05,7,204,0,211
MADHYA PRADESH,BETUL,2021-03-01,21,307,0,328
MADHYA PRADESH,BETUL,2021-03-02,9,277,0,286
MADHYA PRADESH,BETUL,2021-03-03,15,283,0,298
MADHYA PRADESH,BETUL,2021-03-04,17,266,3,286
MADHYA PRADESH,BETUL,2021-03-05,15,288,1,304
MADHYA PRADESH,BHIND,2021-03-01,1,182,0,183
MADHYA PRADESH,BHIND,2021-03-02,0,100,0,100
MADHYA PRADESH,BHIND,2021-03-03,0,285,0,285
MADHYA PRADESH,BHIND,2021-03-04,2,156,0,158
MADHYA PRADESH,BHIND,2021-03-05,0,219,0,219
MADHYA PRADESH,BHOPAL,2021-03-01,85,1181,5,1271
MADHYA PRADESH,BHOPAL,2021-03-02,164,1912,4,2080
MADHYA PRADESH,BHOPAL,2021-03-03,105,1426,5,1536
MADHYA PRADESH,BHOPAL,2021-03-04,127,1616,9,1752
MADHYA PRADESH,BHOPAL,2021-03-05,108,1808,9,1925
MADHYA PRADESH,BURHANPUR,2021-03-01,3,263,0,266
MADHYA PRADESH,BURHANPUR,2021-03-02,9,404,0,413
MADHYA PRADESH,BURHANPUR,2021-03-03,4,223,0,227
MADHYA PRADESH,BURHANPUR,2021-03-04,15,306,0,321
MADHYA PRADESH,BURHANPUR,2021-03-05,29,316,0,345
MADHYA PRADESH,CHHATARPUR,2021-03-01,0,124,0,124
MADHYA PRADESH,CHHATARPUR,2021-03-02,0,227,0,227
MADHYA PRADESH,CHHATARPUR,2021-03-03,1,177,0,178
MADHYA PRADESH,CHHATARPUR,2021-03-04,0,161,0,161
MADHYA PRADESH,CHHATARPUR,2021-03-05,0,178,0,178
MADHYA PRADESH,CHHINDWARA,2021-03-01,14,333,6,353
MADHYA PRADESH,CHHINDWARA,2021-03-02,18,326,4,348
MADHYA PRADESH,CHHINDWARA,2021-03-03,19,392,1,412
MADHYA PRADESH,CHHINDWARA,2021-03-04,33,291,1,325
MADHYA PRADESH,CHHINDWARA,2021-03-05,24,316,3,343
MADHYA PRADESH,DAMOH,2021-03-01,9,167,0,176
MADHYA PRADESH,DAMOH,2021-03-02,1,67,0,68
MADHYA PRADESH,DAMOH,2021-03-03,3,205,1,209
MADHYA PRADESH,DAMOH,2021-03-04,2,218,0,220
MADHYA PRADESH,DAMOH,2021-03-05,3,271,1,275
MADHYA PRADESH,DATIA,2021-03-01,1,370,9,380
MADHYA PRADESH,DATIA,2021-03-02,0,126,16,142
MADHYA PRADESH,DATIA,2021-03-03,0,176,10,186
MADHYA PRADESH,DATIA,2021-03-04,0,174,24,198
MADHYA PRADESH,DATIA,2021-03-05,0,162,0,162
MADHYA PRADESH,DEWAS,2021-03-01,6,107,0,113
MADHYA PRADESH,DEWAS,2021-03-02,5,124,0,129
MADHYA PRADESH,DEWAS,2021-03-03,24,173,0,197
MADHYA PRADESH,DEWAS,2021-03-04,12,98,0,110
MADHYA PRADESH,DEWAS,2021-03-05,15,62,0,77
MADHYA PRADESH,DHAR,2021-03-01,4,200,0,204
MADHYA PRADESH,DHAR,2021-03-02,7,273,0,280
MADHYA PRADESH,DHAR,2021-03-03,2,352,0,354
MADHYA PRADESH,DHAR,2021-03-04,6,357,0,363
MADHYA PRADESH,DHAR,2021-03-05,2,201,11,214
MADHYA PRADESH,DINDORI,2021-03-01,0,423,0,423
MADHYA PRADESH,DINDORI,2021-03-02,0,262,0,262
MADHYA PRADESH,DINDORI,2021-03-03,0,363,0,363
MADHYA PRADESH,DINDORI,2021-03-04,2,510,0,512
MADHYA PRADESH,DINDORI,2021-03-05,1,385,1,387
MADHYA PRADESH,EAST NIMAR,2021-03-01,0,222,0,222
MADHYA PRADESH,EAST NIMAR,2021-03-02,3,272,6,281
MADHYA PRADESH,EAST NIMAR,2021-03-03,0,205,0,205
MADHYA PRADESH,EAST NIMAR,2021-03-04,5,296,3,304
MADHYA PRADESH,EAST NIMAR,2021-03-05,1,175,0,176
MADHYA PRADESH,GUNA,2021-03-01,4,166,0,170
MADHYA PRADESH,GUNA,2021-03-02,8,223,0,231
MADHYA PRADESH,GUNA,2021-03-03,0,121,1,122
MADHYA PRADESH,GUNA,2021-03-04,3,221,0,224
MADHYA PRADESH,GUNA,2021-03-05,1,224,1,226
MADHYA PRADESH,GWALIOR,2021-03-01,7,800,2,809
MADHYA PRADESH,GWALIOR,2021-03-02,11,815,2,828
MADHYA PRADESH,GWALIOR,2021-03-03,6,883,1,890
MADHYA PRADESH,GWALIOR,2021-03-04,10,739,1,750
MADHYA PRADESH,GWALIOR,2021-03-05,8,845,2,855
MADHYA PRADESH,HARDA,2021-03-01,1,196,0,197
MADHYA PRADESH,HARDA,2021-03-02,2,184,4,190
MADHYA PRADESH,HARDA,2021-03-03,8,231,0,239
MADHYA PRADESH,HARDA,2021-03-04,0,172,2,174
MADHYA PRADESH,HARDA,2021-03-05,1,198,0,199
MADHYA PRADESH,HOSHANGABAD,2021-03-01,10,294,0,304
MADHYA PRADESH,HOSHANGABAD,2021-03-02,6,305,0,311
MADHYA PRADESH,HOSHANGABAD,2021-03-03,4,323,0,327
MADHYA PRADESH,HOSHANGABAD,2021-03-04,3,318,0,321
MADHYA PRADESH,HOSHANGABAD,2021-03-05,6,326,0,332
MADHYA PRADESH,INDORE,2021-03-01,208,1287,0,1495
MADHYA PRADESH,INDORE,2021-03-02,418,1933,0,2351
MADHYA PRADESH,INDORE,2021-03-03,360,1568,1,1929
MADHYA PRADESH,INDORE,2021-03-04,388,2533,6,2927
MADHYA PRADESH,INDORE,2021-03-05,305,1701,0,2006
MADHYA PRADESH,JABALPUR,2021-03-01,14,1506,2,1522
MADHYA PRADESH,JABALPUR,2021-03-02,35,1354,2,1391
MADHYA PRADESH,JABALPUR,2021-03-03,35,943,1,979
MADHYA PRADESH,JABALPUR,2021-03-04,21,1069,1,1091
MADHYA PRADESH,JABALPUR,2021-03-05,20,1005,0,1025
MADHYA PRADESH,JHABUA,2021-03-01,3,246,0,249
MADHYA PRADESH,JHABUA,2021-03-02,4,239,0,243
MADHYA PRADESH,JHABUA,2021-03-03,5,111,0,116
MADHYA PRADESH,JHABUA,2021-03-04,4,212,0,216
MADHYA PRADESH,JHABUA,2021-03-05,1,129,0,130
MADHYA PRADESH,KATNI,2021-03-01,0,10,0,10
MADHYA PRADESH,KATNI,2021-03-02,1,62,0,63
MADHYA PRADESH,KATNI,2021-03-03,1,163,1,165
MADHYA PRADESH,KATNI,2021-03-04,5,246,2,253
MADHYA PRADESH,KATNI,2021-03-05,1,121,0,122
MADHYA PRADESH,KHARGONE,2021-03-01,8,256,0,264
MADHYA PRADESH,KHARGONE,2021-03-02,9,398,1,408
MADHYA PRADESH,KHARGONE,2021-03-03,5,178,0,183
MADHYA PRADESH,KHARGONE,2021-03-04,4,249,0,253
MADHYA PRADESH,KHARGONE,2021-03-05,16,320,0,336
MADHYA PRADESH,MANDLA,2021-03-01,1,105,0,106
MADHYA PRADESH,MANDLA,2021-03-02,1,569,1,571
MADHYA PRADESH,MANDLA,2021-03-03,0,399,0,399
MADHYA PRADESH,MANDLA,2021-03-04,1,80,0,81
MADHYA PRADESH,MANDLA,2021-03-05,0,260,0,260
MADHYA PRADESH,MANDSAUR,2021-03-01,7,142,0,149
MADHYA PRADESH,MANDSAUR,2021-03-02,13,160,0,173
MADHYA PRADESH,MANDSAUR,2021-03-03,9,120,3,132
MADHYA PRADESH,MANDSAUR,2021-03-04,18,122,2,142
MADHYA PRADESH,MANDSAUR,2021-03-05,11,133,0,144
MADHYA PRADESH,MORENA,2021-03-01,0,337,1,338
MADHYA PRADESH,MORENA,2021-03-02,2,234,0,236
MADHYA PRADESH,MORENA,2021-03-03,0,392,0,392
MADHYA PRADESH,MORENA,2021-03-04,0,156,0,156
MADHYA PRADESH,MORENA,2021-03-05,0,406,1,407
MADHYA PRADESH,NARSINGHPUR,2021-03-01,0,243,2,245
MADHYA PRADESH,NARSINGHPUR,2021-03-02,2,465,2,469
MADHYA PRADESH,NARSINGHPUR,2021-03-03,1,396,0,397
MADHYA PRADESH,NARSINGHPUR,2021-03-04,0,299,0,299
MADHYA PRADESH,NARSINGHPUR,2021-03-05,1,410,1,412
MADHYA PRADESH,NEEMUCH,2021-03-01,2,267,0,269
MADHYA PRADESH,NEEMUCH,2021-03-02,5,416,1,422
MADHYA PRADESH,NEEMUCH,2021-03-03,12,263,2,277
MADHYA PRADESH,NEEMUCH,2021-03-04,4,170,0,174
MADHYA PRADESH,NEEMUCH,2021-03-05,1,207,0,208
MADHYA PRADESH,NIWARI,2021-03-01,0,28,0,28
MADHYA PRADESH,NIWARI,2021-03-02,0,35,0,35
MADHYA PRADESH,NIWARI,2021-03-03,0,21,0,21
MADHYA PRADESH,NIWARI,2021-03-04,0,51,0,51
MADHYA PRADESH,NIWARI,2021-03-05,0,34,0,34
MADHYA PRADESH,PANNA,2021-03-01,2,133,1,136
MADHYA PRADESH,PANNA,2021-03-02,3,152,0,155
MADHYA PRADESH,PANNA,2021-03-03,12,60,0,72
MADHYA PRADESH,PANNA,2021-03-04,1,124,0,125
MADHYA PRADESH,PANNA,2021-03-05,3,86,0,89
MADHYA PRADESH,RAISEN,2021-03-01,2,131,0,133
MADHYA PRADESH,RAISEN,2021-03-02,0,104,0,104
MADHYA PRADESH,RAISEN,2021-03-03,8,111,0,119
MADHYA PRADESH,RAISEN,2021-03-04,1,149,0,150
MADHYA PRADESH,RAISEN,2021-03-05,6,174,0,180
MADHYA PRADESH,RAJGARH,2021-03-01,3,133,0,136
MADHYA PRADESH,RAJGARH,2021-03-02,2,113,1,116
MADHYA PRADESH,RAJGARH,2021-03-03,1,149,0,150
MADHYA PRADESH,RAJGARH,2021-03-04,2,169,0,171
MADHYA PRADESH,RAJGARH,2021-03-05,5,156,0,161
MADHYA PRADESH,RATLAM,2021-03-01,3,184,1,188
MADHYA PRADESH,RATLAM,2021-03-02,2,177,3,182
MADHYA PRADESH,RATLAM,2021-03-03,8,180,0,188
MADHYA PRADESH,RATLAM,2021-03-04,6,174,3,183
MADHYA PRADESH,RATLAM,2021-03-05,11,169,0,180
MADHYA PRADESH,REWA,2021-03-01,3,210,0,213
MADHYA PRADESH,REWA,2021-03-02,6,711,3,720
MADHYA PRADESH,REWA,2021-03-03,4,656,1,661
MADHYA PRADESH,REWA,2021-03-04,15,481,1,497
MADHYA PRADESH,REWA,2021-03-05,10,635,0,645
MADHYA PRADESH,SAGAR,2021-03-01,5,321,0,326
MADHYA PRADESH,SAGAR,2021-03-02,5,671,1,677
MADHYA PRADESH,SAGAR,2021-03-03,2,603,0,605
MADHYA PRADESH,SAGAR,2021-03-04,15,666,2,683
MADHYA PRADESH,SAGAR,2021-03-05,8,542,1,551
MADHYA PRADESH,SATNA,2021-03-01,2,239,1,242
MADHYA PRADESH,SATNA,2021-03-02,1,216,0,217
MADHYA PRADESH,SATNA,2021-03-03,2,169,0,171
MADHYA PRADESH,SATNA,2021-03-04,9,538,0,547
MADHYA PRADESH,SATNA,2021-03-05,1,193,0,194
MADHYA PRADESH,SEHORE,2021-03-01,2,247,1,250
MADHYA PRADESH,SEHORE,2021-03-02,1,233,0,234
MADHYA PRADESH,SEHORE,2021-03-03,3,208,0,211
MADHYA PRADESH,SEHORE,2021-03-04,2,273,1,276
MADHYA PRADESH,SEHORE,2021-03-05,4,351,0,355
MADHYA PRADESH,SEONI,2021-03-01,1,202,0,203
MADHYA PRADESH,SEONI,2021-03-02,1,225,6,232
MADHYA PRADESH,SEONI,2021-03-03,3,304,2,309
MADHYA PRADESH,SEONI,2021-03-04,1,240,0,241
MADHYA PRADESH,SEONI,2021-03-05,3,235,1,239
MADHYA PRADESH,SHAHDOL,2021-03-01,1,80,0,81
MADHYA PRADESH,SHAHDOL,2021-03-02,0,66,0,66
MADHYA PRADESH,SHAHDOL,2021-03-03,0,82,0,82
MADHYA PRADESH,SHAHDOL,2021-03-04,0,74,0,74
MADHYA PRADESH,SHAHDOL,2021-03-05,2,38,0,40
MADHYA PRADESH,SHAJAPUR,2021-03-01,3,208,0,211
MADHYA PRADESH,SHAJAPUR,2021-03-02,1,151,0,152
MADHYA PRADESH,SHAJAPUR,2021-03-03,0,184,0,184
MADHYA PRADESH,SHAJAPUR,2021-03-04,3,169,0,172
MADHYA PRADESH,SHAJAPUR,2021-03-05,4,167,1,172
MADHYA PRADESH,SHEOPUR,2021-03-01,4,136,1,141
MADHYA PRADESH,SHEOPUR,2021-03-02,2,210,0,212
MADHYA PRADESH,SHEOPUR,2021-03-03,1,70,0,71
MADHYA PRADESH,SHEOPUR,2021-03-04,6,148,1,155
MADHYA PRADESH,SHEOPUR,2021-03-05,4,154,0,158
MADHYA PRADESH,SHIVPURI,2021-03-01,1,117,0,118
MADHYA PRADESH,SHIVPURI,2021-03-02,0,225,0,225
MADHYA PRADESH,SHIVPURI,2021-03-03,1,190,2,193
MADHYA PRADESH,SHIVPURI,2021-03-04,5,240,10,255
MADHYA PRADESH,SHIVPURI,2021-03-05,1,95,0,96
MADHYA PRADESH,SIDHI,2021-03-01,0,35,0,35
MADHYA PRADESH,SIDHI,2021-03-02,1,70,1,72
MADHYA PRADESH,SIDHI,2021-03-03,20,63,0,83
MADHYA PRADESH,SIDHI,2021-03-04,2,154,0,156
MADHYA PRADESH,SIDHI,2021-03-05,3,231,0,234
MADHYA PRADESH,SINGRAULI,2021-03-01,8,146,0,154
MADHYA PRADESH,SINGRAULI,2021-03-02,4,21,0,25
MADHYA PRADESH,SINGRAULI,2021-03-03,2,199,0,201
MADHYA PRADESH,SINGRAULI,2021-03-04,4,49,0,53
MADHYA PRADESH,SINGRAULI,2021-03-05,0,118,0,118
MADHYA PRADESH,TIKAMGARH,2021-03-01,2,127,0,129
MADHYA PRADESH,TIKAMGARH,2021-03-02,0,221,0,221
MADHYA PRADESH,TIKAMGARH,2021-03-03,1,194,0,195
MADHYA PRADESH,TIKAMGARH,2021-03-04,2,235,0,237
MADHYA PRADESH,TIKAMGARH,2021-03-05,0,137,0,137
MADHYA PRADESH,UJJAIN,2021-03-01,1,78,0,79
MADHYA PRADESH,UJJAIN,2021-03-02,36,29,0,65
MADHYA PRADESH,UJJAIN,2021-03-03,1,42,1,44
MADHYA PRADESH,UJJAIN,2021-03-04,23,500,1,524
MADHYA PRADESH,UJJAIN,2021-03-05,23,377,1,401
MADHYA PRADESH,UMARIA,2021-03-01,0,410,72,482
MADHYA PRADESH,UMARIA,2021-03-02,0,197,34,231
MADHYA PRADESH,UMARIA,2021-03-03,1,202,13,216
MADHYA PRADESH,UMARIA,2021-03-04,0,333,56,389
MADHYA PRADESH,UMARIA,2021-03-05,1,415,64,480
MADHYA PRADESH,VIDISHA,2021-03-01,8,116,2,126
MADHYA PRADESH,VIDISHA,2021-03-02,11,149,7,167
MADHYA PRADESH,VIDISHA,2021-03-03,1,188,6,195
MADHYA PRADESH,VIDISHA,2021-03-04,5,88,1,94
MADHYA PRADESH,VIDISHA,2021-03-05,4,215,3,222
MAHARASHTRA,AHMEDNAGAR,2021-03-01,226,904,1,1131
MAHARASHTRA,AHMEDNAGAR,2021-03-02,213,1371,4,1588
MAHARASHTRA,AHMEDNAGAR,2021-03-03,273,1388,4,1665
MAHARASHTRA,AHMEDNAGAR,2021-03-04,298,1360,2,1660
MAHARASHTRA,AHMEDNAGAR,2021-03-05,324,1593,2,1919
MAHARASHTRA,AKOLA,2021-03-01,451,1472,2,1925
MAHARASHTRA,AKOLA,2021-03-02,454,949,2,1405
MAHARASHTRA,AKOLA,2021-03-03,249,934,3,1186
MAHARASHTRA,AKOLA,2021-03-04,267,1392,9,1668
MAHARASHTRA,AKOLA,2021-03-05,341,1092,2,1435
MAHARASHTRA,AMRAVATI,2021-03-01,830,2105,8,2943
MAHARASHTRA,AMRAVATI,2021-03-02,616,2570,10,3196
MAHARASHTRA,AMRAVATI,2021-03-03,749,3389,3,4141
MAHARASHTRA,AMRAVATI,2021-03-04,692,3334,34,4060
MAHARASHTRA,AMRAVATI,2021-03-05,618,3126,9,3753
MAHARASHTRA,AURANGABAD,2021-03-01,138,558,1,697
MAHARASHTRA,AURANGABAD,2021-03-02,540,465,0,1005
MAHARASHTRA,AURANGABAD,2021-03-03,331,455,3,789
MAHARASHTRA,AURANGABAD,2021-03-04,372,873,0,1245
MAHARASHTRA,AURANGABAD,2021-03-05,381,992,5,1378
MAHARASHTRA,BEED,2021-03-01,54,954,0,1008
MAHARASHTRA,BEED,2021-03-02,85,959,1,1045
MAHARASHTRA,BEED,2021-03-03,63,883,1,947
MAHARASHTRA,BEED,2021-03-04,98,723,0,821
MAHARASHTRA,BEED,2021-03-05,105,816,0,921
MAHARASHTRA,BHANDARA,2021-03-01,45,968,0,1013
MAHARASHTRA,BHANDARA,2021-03-02,23,1179,0,1202
MAHARASHTRA,BHANDARA,2021-03-03,42,1561,0,1603
MAHARASHTRA,BHANDARA,2021-03-04,31,1330,0,1361
MAHARASHTRA,BHANDARA,2021-03-05,47,1512,1,1560
MAHARASHTRA,BULDHANA,2021-03-01,186,594,4,784
MAHARASHTRA,BULDHANA,2021-03-02,199,680,9,888
MAHARASHTRA,BULDHANA,2021-03-03,188,653,15,856
MAHARASHTRA,BULDHANA,2021-03-04,73,663,7,743
MAHARASHTRA,BULDHANA,2021-03-05,191,729,6,926
MAHARASHTRA,CHANDRAPUR,2021-03-01,82,779,2,863
MAHARASHTRA,CHANDRAPUR,2021-03-02,54,979,5,1038
MAHARASHTRA,CHANDRAPUR,2021-03-03,76,941,0,1017
MAHARASHTRA,CHANDRAPUR,2021-03-04,134,1155,2,1291
MAHARASHTRA,CHANDRAPUR,2021-03-05,163,1234,9,1406
MAHARASHTRA,DHULE,2021-03-01,110,268,0,378
MAHARASHTRA,DHULE,2021-03-02,116,258,0,374
MAHARASHTRA,DHULE,2021-03-03,111,204,11,326
MAHARASHTRA,DHULE,2021-03-04,82,76,0,158
MAHARASHTRA,DHULE,2021-03-05,93,72,0,165
MAHARASHTRA,GADCHIROLI,2021-03-01,11,458,0,469
MAHARASHTRA,GADCHIROLI,2021-03-02,10,490,0,500
MAHARASHTRA,GADCHIROLI,2021-03-03,17,605,1,623
MAHARASHTRA,GADCHIROLI,2021-03-04,17,761,2,780
MAHARASHTRA,GADCHIROLI,2021-03-05,22,1374,1,1397
MAHARASHTRA,GONDIA,2021-03-01,13,347,1,361
MAHARASHTRA,GONDIA,2021-03-02,26,455,2,483
MAHARASHTRA,GONDIA,2021-03-03,25,331,0,356
MAHARASHTRA,GONDIA,2021-03-04,9,393,0,402
MAHARASHTRA,GONDIA,2021-03-05,17,565,0,582
MAHARASHTRA,HINGOLI,2021-03-01,15,23,0,38
MAHARASHTRA,HINGOLI,2021-03-02,61,280,0,341
MAHARASHTRA,HINGOLI,2021-03-03,15,225,0,240
MAHARASHTRA,HINGOLI,2021-03-04,33,129,0,162
MAHARASHTRA,HINGOLI,2021-03-05,62,210,0,272
MAHARASHTRA,JALGAON,2021-03-01,409,1640,1,2050
MAHARASHTRA,JALGAON,2021-03-02,538,1621,0,2159
MAHARASHTRA,JALGAON,2021-03-03,503,1789,4,2296
MAHARASHTRA,JALGAON,2021-03-04,559,1985,0,2544
MAHARASHTRA,JALGAON,2021-03-05,498,1407,2,1907
MAHARASHTRA,JALNA,2021-03-01,176,377,0,553
MAHARASHTRA,JALNA,2021-03-02,48,652,0,700
MAHARASHTRA,JALNA,2021-03-03,67,636,0,703
MAHARASHTRA,JALNA,2021-03-04,88,720,0,808
MAHARASHTRA,JALNA,2021-03-05,125,936,0,1061
MAHARASHTRA,KOLHAPUR,2021-03-01,24,796,15,835
MAHARASHTRA,KOLHAPUR,2021-03-02,42,1084,5,1131
MAHARASHTRA,KOLHAPUR,2021-03-03,40,1312,4,1356
MAHARASHTRA,KOLHAPUR,2021-03-04,27,1196,7,1230
MAHARASHTRA,KOLHAPUR,2021-03-05,33,1145,2,1180
MAHARASHTRA,LATUR,2021-03-01,48,892,0,940
MAHARASHTRA,LATUR,2021-03-02,79,1338,10,1427
MAHARASHTRA,LATUR,2021-03-03,108,1727,3,1838
MAHARASHTRA,LATUR,2021-03-04,103,2021,5,2129
MAHARASHTRA,LATUR,2021-03-05,77,1603,9,1689
MAHARASHTRA,MUMBAI,2021-03-01,720,14858,103,15681
MAHARASHTRA,MUMBAI,2021-03-02,935,17004,28,17967
MAHARASHTRA,MUMBAI,2021-03-03,922,16517,44,17483
MAHARASHTRA,MUMBAI,2021-03-04,1065,15118,23,16206
MAHARASHTRA,MUMBAI,2021-03-05,988,15770,27,16785
MAHARASHTRA,MUMBAI SUBURBAN,2021-03-01,249,2969,4,3222
MAHARASHTRA,MUMBAI SUBURBAN,2021-03-02,323,3457,17,3797
MAHARASHTRA,MUMBAI SUBURBAN,2021-03-03,324,3492,72,3888
MAHARASHTRA,MUMBAI SUBURBAN,2021-03-04,278,3361,9,3648
MAHARASHTRA,MUMBAI SUBURBAN,2021-03-05,360,3433,9,3802
MAHARASHTRA,NAGPUR,2021-03-01,1107,6084,69,7260
MAHARASHTRA,NAGPUR,2021-03-02,1215,6643,47,7905
MAHARASHTRA,NAGPUR,2021-03-03,1282,6309,30,7621
MAHARASHTRA,NAGPUR,2021-03-04,1337,6657,53,8047
MAHARASHTRA,NAGPUR,2021-03-05,1305,6003,30,7338
MAHARASHTRA,NANDED,2021-03-01,70,625,5,700
MAHARASHTRA,NANDED,2021-03-02,90,1319,16,1425
MAHARASHTRA,NANDED,2021-03-03,74,1358,11,1443
MAHARASHTRA,NANDED,2021-03-04,166,1457,10,1633
MAHARASHTRA,NANDED,2021-03-05,195,1447,17,1659
MAHARASHTRA,NANDURBAR,2021-03-01,44,88,2,134
MAHARASHTRA,NANDURBAR,2021-03-02,110,19,0,129
MAHARASHTRA,NANDURBAR,2021-03-03,23,127,2,152
MAHARASHTRA,NANDURBAR,2021-03-04,126,236,0,362
MAHARASHTRA,NANDURBAR,2021-03-05,46,709,1,756
MAHARASHTRA,NASHIK,2021-03-01,253,902,14,1169
MAHARASHTRA,NASHIK,2021-03-02,778,2426,31,3235
MAHARASHTRA,NASHIK,2021-03-03,346,2024,18,2388
MAHARASHTRA,NASHIK,2021-03-04,577,1290,15,1882
MAHARASHTRA,NASHIK,2021-03-05,512,1830,16,2358
MAHARASHTRA,OSMANABAD,2021-03-01,35,190,7,232
MAHARASHTRA,OSMANABAD,2021-03-02,38,322,0,360
MAHARASHTRA,OSMANABAD,2021-03-03,30,306,1,337
MAHARASHTRA,OSMANABAD,2021-03-04,43,472,4,519
MAHARASHTRA,OSMANABAD,2021-03-05,31,514,4,549
MAHARASHTRA,PALGHAR,2021-03-01,49,813,3,865
MAHARASHTRA,PALGHAR,2021-03-02,89,898,5,992
MAHARASHTRA,PALGHAR,2021-03-03,61,661,7,729
MAHARASHTRA,PALGHAR,2021-03-04,75,971,1,1047
MAHARASHTRA,PALGHAR,2021-03-05,57,658,2,717
MAHARASHTRA,PARBHANI,2021-03-01,22,488,1,511
MAHARASHTRA,PARBHANI,2021-03-02,53,1122,1,1176
MAHARASHTRA,PARBHANI,2021-03-03,24,915,0,939
MAHARASHTRA,PARBHANI,2021-03-04,53,1649,2,1704
MAHARASHTRA,PARBHANI,2021-03-05,72,535,2,609
MAHARASHTRA,PUNE,2021-03-01,1460,6181,218,7859
MAHARASHTRA,PUNE,2021-03-02,1801,7690,219,9710
MAHARASHTRA,PUNE,2021-03-03,1939,8216,140,10295
MAHARASHTRA,PUNE,2021-03-04,1993,9233,127,11353
MAHARASHTRA,PUNE,2021-03-05,2156,9336,219,11711
MAHARASHTRA,RAIGAD,2021-03-01,115,1330,10,1455
MAHARASHTRA,RAIGAD,2021-03-02,191,1731,2,1924
MAHARASHTRA,RAIGAD,2021-03-03,187,1655,8,1850
MAHARASHTRA,RAIGAD,2021-03-04,130,1379,0,1509
MAHARASHTRA,RAIGAD,2021-03-05,187,1251,3,1441
MAHARASHTRA,RATNAGIRI,2021-03-01,5,125,0,130
MAHARASHTRA,RATNAGIRI,2021-03-02,35,124,0,159
MAHARASHTRA,RATNAGIRI,2021-03-03,7,91,0,98
MAHARASHTRA,RATNAGIRI,2021-03-04,11,262,0,273
MAHARASHTRA,RATNAGIRI,2021-03-05,2,391,1,394
MAHARASHTRA,SANGLI,2021-03-01,32,1280,0,1312
MAHARASHTRA,SANGLI,2021-03-02,30,1166,5,1201
MAHARASHTRA,SANGLI,2021-03-03,34,1105,3,1142
MAHARASHTRA,SANGLI,2021-03-04,34,979,4,1017
MAHARASHTRA,SANGLI,2021-03-05,42,1051,6,1099
MAHARASHTRA,SATARA,2021-03-01,60,795,1,856
MAHARASHTRA,SATARA,2021-03-02,132,458,2,592
MAHARASHTRA,SATARA,2021-03-03,95,621,0,716
MAHARASHTRA,SATARA,2021-03-04,224,894,3,1121
MAHARASHTRA,SATARA,2021-03-05,185,1207,1,1393
MAHARASHTRA,SINDHUDURG,2021-03-01,8,385,0,393
MAHARASHTRA,SINDHUDURG,2021-03-02,7,292,0,299
MAHARASHTRA,SINDHUDURG,2021-03-03,20,177,0,197
MAHARASHTRA,SINDHUDURG,2021-03-04,13,199,0,212
MAHARASHTRA,SINDHUDURG,2021-03-05,9,205,0,214
MAHARASHTRA,SOLAPUR,2021-03-01,112,1819,13,1944
MAHARASHTRA,SOLAPUR,2021-03-02,112,2100,18,2230
MAHARASHTRA,SOLAPUR,2021-03-03,174,2193,34,2401
MAHARASHTRA,SOLAPUR,2021-03-04,81,2299,1,2381
MAHARASHTRA,SOLAPUR,2021-03-05,110,2114,7,2231
MAHARASHTRA,THANE,2021-03-01,709,8948,45,9702
MAHARASHTRA,THANE,2021-03-02,928,9439,33,10400
MAHARASHTRA,THANE,2021-03-03,867,8731,35,9633
MAHARASHTRA,THANE,2021-03-04,861,8921,39,9821
MAHARASHTRA,THANE,2021-03-05,875,7962,28,8865
MAHARASHTRA,WARDHA,2021-03-01,227,901,0,1128
MAHARASHTRA,WARDHA,2021-03-02,91,809,0,900
MAHARASHTRA,WARDHA,2021-03-03,168,997,1,1166
MAHARASHTRA,WARDHA,2021-03-04,281,959,13,1253
MAHARASHTRA,WARDHA,2021-03-05,240,665,4,909
MAHARASHTRA,WASHIM,2021-03-01,189,1595,17,1801
MAHARASHTRA,WASHIM,2021-03-02,149,1070,13,1232
MAHARASHTRA,WASHIM,2021-03-03,181,838,0,1019
MAHARASHTRA,WASHIM,2021-03-04,207,1185,28,1420
MAHARASHTRA,WASHIM,2021-03-05,251,1106,8,1365
MAHARASHTRA,YAVATMAL,2021-03-01,205,858,1,1064
MAHARASHTRA,YAVATMAL,2021-03-02,223,1215,1,1439
MAHARASHTRA,YAVATMAL,2021-03-03,256,1141,0,1397
MAHARASHTRA,YAVATMAL,2021-03-04,257,1136,1,1394
MAHARASHTRA,YAVATMAL,2021-03-05,202,1252,1,1455
MANIPUR,BISHNUPUR,2021-03-01,0,76,0,76
MANIPUR,BISHNUPUR,2021-03-02,0,101,0,101
MANIPUR,BISHNUPUR,2021-03-03,0,75,0,75
MANIPUR,BISHNUPUR,2021-03-04,0,103,0,103
MANIPUR,BISHNUPUR,2021-03-05,0,52,0,52
MANIPUR,CHANDEL,2021-03-01,0,23,0,23
MANIPUR,CHANDEL,2021-03-02,0,20,0,20
MANIPUR,CHANDEL,2021-03-03,0,23,0,23
MANIPUR,CHANDEL,2021-03-04,0,22,0,22
MANIPUR,CHANDEL,2021-03-05,0,19,0,19
MANIPUR,CHURACHANDPUR,2021-03-01,0,170,1,171
MANIPUR,CHURACHANDPUR,2021-03-02,0,121,0,121
MANIPUR,CHURACHANDPUR,2021-03-03,0,105,0,105
MANIPUR,CHURACHANDPUR,2021-03-04,0,109,0,109
MANIPUR,CHURACHANDPUR,2021-03-05,1,65,0,66
MANIPUR,IMPHAL EAST,2021-03-01,0,138,0,138
MANIPUR,IMPHAL EAST,2021-03-02,3,114,0,117
MANIPUR,IMPHAL EAST,2021-03-03,1,207,0,208
MANIPUR,IMPHAL EAST,2021-03-04,0,180,0,180
MANIPUR,IMPHAL EAST,2021-03-05,1,87,0,88
MANIPUR,IMPHAL WEST,2021-03-01,0,279,0,279
MANIPUR,IMPHAL WEST,2021-03-02,8,384,0,392
MANIPUR,IMPHAL WEST,2021-03-03,3,354,0,357
MANIPUR,IMPHAL WEST,2021-03-04,5,462,0,467
MANIPUR,IMPHAL WEST,2021-03-05,3,451,0,454
MANIPUR,JIRIBAM,2021-03-01,0,2,0,2
MANIPUR,JIRIBAM,2021-03-02,0,3,0,3
MANIPUR,JIRIBAM,2021-03-03,0,2,0,2
MANIPUR,JIRIBAM,2021-03-04,0,1,0,1
MANIPUR,JIRIBAM,2021-03-05,1,3,0,4
MANIPUR,KAKCHING,2021-03-01,2,59,0,61
MANIPUR,KAKCHING,2021-03-02,9,78,0,87
MANIPUR,KAKCHING,2021-03-03,2,61,0,63
MANIPUR,KAKCHING,2021-03-04,8,77,0,85
MANIPUR,KAKCHING,2021-03-05,0,23,0,23
MANIPUR,KAMJONG,2021-03-01,0,3,0,3
MANIPUR,KAMJONG,2021-03-02,0,41,0,41
MANIPUR,KAMJONG,2021-03-03,0,3,0,3
MANIPUR,KAMJONG,2021-03-04,1,1,0,2
MANIPUR,KAMJONG,2021-03-05,0,44,0,44
MANIPUR,KANGPOKPI,2021-03-01,0,16,0,16
MANIPUR,KANGPOKPI,2021-03-02,0,21,0,21
MANIPUR,KANGPOKPI,2021-03-03,0,27,0,27
MANIPUR,KANGPOKPI,2021-03-04,0,41,0,41
MANIPUR,KANGPOKPI,2021-03-05,0,21,0,21
MANIPUR,NONEY,2021-03-01,0,1,0,1
MANIPUR,NONEY,2021-03-02,0,4,0,4
MANIPUR,NONEY,2021-03-03,0,2,0,2
MANIPUR,NONEY,2021-03-04,0,3,0,3
MANIPUR,PHERZAWL,2021-03-02,0,12,0,12
MANIPUR,PHERZAWL,2021-03-03,0,30,0,30
MANIPUR,PHERZAWL,2021-03-04,0,123,0,123
MANIPUR,PHERZAWL,2021-03-05,0,119,0,119
MANIPUR,SENAPATI,2021-03-01,0,32,0,32
MANIPUR,SENAPATI,2021-03-02,0,17,0,17
MANIPUR,SENAPATI,2021-03-03,1,19,0,20
MANIPUR,SENAPATI,2021-03-04,0,26,0,26
MANIPUR,SENAPATI,2021-03-05,0,18,0,18
MANIPUR,TAMENGLONG,2021-03-01,0,62,0,62
MANIPUR,TAMENGLONG,2021-03-02,0,87,0,87
MANIPUR,TAMENGLONG,2021-03-03,2,109,0,111
MANIPUR,TAMENGLONG,2021-03-04,0,67,0,67
MANIPUR,TAMENGLONG,2021-03-05,0,121,0,121
MANIPUR,TENGNOUPAL,2021-03-01,0,2,0,2
MANIPUR,TENGNOUPAL,2021-03-02,0,2,0,2
MANIPUR,TENGNOUPAL,2021-03-03,0,10,0,10
MANIPUR,TENGNOUPAL,2021-03-04,0,2,0,2
MANIPUR,TENGNOUPAL,2021-03-05,0,6,0,6
MANIPUR,THOUBAL,2021-03-01,2,162,0,164
MANIPUR,THOUBAL,2021-03-02,1,180,0,181
MANIPUR,THOUBAL,2021-03-03,2,177,0,179
MANIPUR,THOUBAL,2021-03-04,8,152,0,160
MANIPUR,THOUBAL,2021-03-05,2,75,0,77
MANIPUR,UKHRUL,2021-03-01,4,48,0,52
MANIPUR,UKHRUL,2021-03-02,0,98,0,98
MANIPUR,UKHRUL,2021-03-03,0,67,0,67
MANIPUR,UKHRUL,2021-03-04,0,30,0,30
MANIPUR,UKHRUL,2021-03-05,3,83,0,86
MEGHALAYA,EAST GARO HILLS,2021-03-01,0,51,0,51
MEGHALAYA,EAST GARO HILLS,2021-03-02,0,21,0,21
MEGHALAYA,EAST GARO HILLS,2021-03-03,0,21,0,21
MEGHALAYA,EAST GARO HILLS,2021-03-04,0,18,0,18
MEGHALAYA,EAST GARO HILLS,2021-03-05,0,20,0,20
MEGHALAYA,EAST JAINTIA HILLS,2021-03-01,0,154,0,154
MEGHALAYA,EAST JAINTIA HILLS,2021-03-02,0,21,0,21
MEGHALAYA,EAST JAINTIA HILLS,2021-03-03,0,112,0,112
MEGHALAYA,EAST JAINTIA HILLS,2021-03-04,0,54,0,54
MEGHALAYA,EAST JAINTIA HILLS,2021-03-05,0,43,0,43
MEGHALAYA,EAST KHASI HILLS,2021-03-01,3,849,0,852
MEGHALAYA,EAST KHASI HILLS,2021-03-02,0,790,0,790
MEGHALAYA,EAST KHASI HILLS,2021-03-03,1,689,1,691
MEGHALAYA,EAST KHASI HILLS,2021-03-04,2,904,0,906
MEGHALAYA,EAST KHASI HILLS,2021-03-05,0,805,1,806
MEGHALAYA,NORTH GARO HILLS,2021-03-01,0,36,0,36
MEGHALAYA,NORTH GARO HILLS,2021-03-02,0,121,0,121
MEGHALAYA,NORTH GARO HILLS,2021-03-03,0,43,0,43
MEGHALAYA,NORTH GARO HILLS,2021-03-04,0,5,0,5
MEGHALAYA,NORTH GARO HILLS,2021-03-05,0,5,0,5
MEGHALAYA,RI BHOI,2021-03-01,0,180,0,180
MEGHALAYA,RI BHOI,2021-03-02,0,107,0,107
MEGHALAYA,RI BHOI,2021-03-03,0,88,0,88
MEGHALAYA,RI BHOI,2021-03-04,0,84,0,84
MEGHALAYA,RI BHOI,2021-03-05,1,80,0,81
MEGHALAYA,SOUTH GARO HILLS,2021-03-01,0,10,0,10
MEGHALAYA,SOUTH GARO HILLS,2021-03-02,0,9,0,9
MEGHALAYA,SOUTH GARO HILLS,2021-03-03,0,10,0,10
MEGHALAYA,SOUTH GARO HILLS,2021-03-04,0,10,0,10
MEGHALAYA,SOUTH GARO HILLS,2021-03-05,0,9,0,9
MEGHALAYA,SOUTH WEST GARO HILLS,2021-03-01,0,50,0,50
MEGHALAYA,SOUTH WEST GARO HILLS,2021-03-02,0,19,0,19
MEGHALAYA,SOUTH WEST GARO HILLS,2021-03-03,0,42,0,42
MEGHALAYA,SOUTH WEST GARO HILLS,2021-03-04,0,31,0,31
MEGHALAYA,SOUTH WEST GARO HILLS,2021-03-05,0,24,0,24
MEGHALAYA,SOUTH WEST KHASI HILLS,2021-03-01,0,6,0,6
MEGHALAYA,SOUTH WEST KHASI HILLS,2021-03-02,0,4,0,4
MEGHALAYA,SOUTH WEST KHASI HILLS,2021-03-03,0,6,0,6
MEGHALAYA,SOUTH WEST KHASI HILLS,2021-03-04,0,16,0,16
MEGHALAYA,SOUTH WEST KHASI HILLS,2021-03-05,0,5,0,5
MEGHALAYA,WEST GARO HILLS,2021-03-01,0,110,0,110
MEGHALAYA,WEST GARO HILLS,2021-03-02,0,132,0,132
MEGHALAYA,WEST GARO HILLS,2021-03-03,0,50,0,50
MEGHALAYA,WEST GARO HILLS,2021-03-04,0,123,0,123
MEGHALAYA,WEST GARO HILLS,2021-03-05,3,49,0,52
MEGHALAYA,WEST JAINTIA HILLS,2021-03-01,0,74,0,74
MEGHALAYA,WEST JAINTIA HILLS,2021-03-02,0,74,0,74
MEGHALAYA,WEST JAINTIA HILLS,2021-03-03,0,54,0,54
MEGHALAYA,WEST JAINTIA HILLS,2021-03-04,0,63,0,63
MEGHALAYA,WEST JAINTIA HILLS,2021-03-05,0,68,0,68
MEGHALAYA,WEST KHASI HILLS,2021-03-01,0,92,0,92
MEGHALAYA,WEST KHASI HILLS,2021-03-02,0,48,0,48
MEGHALAYA,WEST KHASI HILLS,2021-03-03,0,35,0,35
MEGHALAYA,WEST KHASI HILLS,2021-03-04,0,33,0,33
MEGHALAYA,WEST KHASI HILLS,2021-03-05,0,37,0,37
MIZORAM,AIZAWL,2021-03-01,3,530,0,533
MIZORAM,AIZAWL,2021-03-02,0,463,0,463
MIZORAM,AIZAWL,2021-03-03,0,494,0,494
MIZORAM,AIZAWL,2021-03-04,1,360,0,361
MIZORAM,AIZAWL,2021-03-05,0,407,0,407
MIZORAM,CHAMPHAI,2021-03-01,0,30,0,30
MIZORAM,CHAMPHAI,2021-03-02,0,15,0,15
MIZORAM,CHAMPHAI,2021-03-03,0,9,0,9
MIZORAM,CHAMPHAI,2021-03-04,0,28,0,28
MIZORAM,HNAHTHIAL,2021-03-01,0,10,0,10
MIZORAM,HNAHTHIAL,2021-03-02,0,5,0,5
MIZORAM,HNAHTHIAL,2021-03-03,0,1,0,1
MIZORAM,HNAHTHIAL,2021-03-04,0,4,0,4
MIZORAM,KHAWZAWL,2021-03-01,0,3,0,3
MIZORAM,KHAWZAWL,2021-03-03,0,2,0,2
MIZORAM,KHAWZAWL,2021-03-04,0,1,0,1
MIZORAM,KHAWZAWL,2021-03-05,0,5,0,5
MIZORAM,KOLASIB,2021-03-01,0,159,0,159
MIZORAM,KOLASIB,2021-03-02,0,109,0,109
MIZORAM,KOLASIB,2021-03-03,0,41,0,41
MIZORAM,KOLASIB,2021-03-04,0,184,1,185
MIZORAM,KOLASIB,2021-03-05,0,170,0,170
MIZORAM,LAWNGTLAI,2021-03-01,0,46,0,46
MIZORAM,LAWNGTLAI,2021-03-02,0,12,0,12
MIZORAM,LAWNGTLAI,2021-03-03,0,16,0,16
MIZORAM,LAWNGTLAI,2021-03-04,0,37,0,37
MIZORAM,LAWNGTLAI,2021-03-05,0,53,0,53
MIZORAM,LUNGLEI,2021-03-01,0,115,0,115
MIZORAM,LUNGLEI,2021-03-02,0,41,0,41
MIZORAM,LUNGLEI,2021-03-03,0,22,0,22
MIZORAM,LUNGLEI,2021-03-04,0,64,0,64
MIZORAM,LUNGLEI,2021-03-05,0,1,0,1
MIZORAM,MAMIT,2021-03-01,0,126,0,126
MIZORAM,MAMIT,2021-03-02,0,143,0,143
MIZORAM,MAMIT,2021-03-03,0,70,0,70
MIZORAM,MAMIT,2021-03-04,0,69,0,69
MIZORAM,MAMIT,2021-03-05,0,81,0,81
MIZORAM,SAIHA,2021-03-01,0,14,0,14
MIZORAM,SAIHA,2021-03-02,0,9,0,9
MIZORAM,SAIHA,2021-03-03,0,19,0,19
MIZORAM,SAIHA,2021-03-04,0,14,0,14
MIZORAM,SAIHA,2021-03-05,0,3,0,3
MIZORAM,SAITUAL,2021-03-01,0,2,0,2
MIZORAM,SAITUAL,2021-03-02,1,76,0,77
MIZORAM,SAITUAL,2021-03-03,0,23,0,23
MIZORAM,SAITUAL,2021-03-04,0,66,0,66
MIZORAM,SAITUAL,2021-03-05,0,40,0,40
MIZORAM,SERCHHIP,2021-03-01,0,23,0,23
MIZORAM,SERCHHIP,2021-03-02,0,10,0,10
MIZORAM,SERCHHIP,2021-03-03,0,24,0,24
MIZORAM,SERCHHIP,2021-03-04,0,7,0,7
MIZORAM,SERCHHIP,2021-03-05,0,10,0,10
NAGALAND,DIMAPUR,2021-03-01,22,115,0,137
NAGALAND,DIMAPUR,2021-03-02,0,149,0,149
NAGALAND,DIMAPUR,2021-03-03,8,117,0,125
NAGALAND,DIMAPUR,2021-03-04,24,78,0,102
NAGALAND,DIMAPUR,2021-03-05,46,91,0,137
NAGALAND,KIPHIRE,2021-03-01,0,1,0,1
NAGALAND,KIPHIRE,2021-03-02,0,1,0,1
NAGALAND,KIPHIRE,2021-03-03,0,1,0,1
NAGALAND,KIPHIRE,2021-03-04,0,7,0,7
NAGALAND,KOHIMA,2021-03-01,16,28,0,44
NAGALAND,KOHIMA,2021-03-02,0,101,0,101
NAGALAND,KOHIMA,2021-03-03,6,132,0,138
NAGALAND,KOHIMA,2021-03-04,15,100,0,115
NAGALAND,KOHIMA,2021-03-05,0,182,0,182
NAGALAND,LONGLENG,2021-03-01,0,1,0,1
NAGALAND,LONGLENG,2021-03-02,0,4,0,4
NAGALAND,LONGLENG,2021-03-03,0,39,0,39
NAGALAND,LONGLENG,2021-03-04,0,26,0,26
NAGALAND,LONGLENG,2021-03-05,0,1,0,1
NAGALAND,MOKOKCHUNG,2021-03-01,0,27,0,27
NAGALAND,MOKOKCHUNG,2021-03-02,0,17,0,17
NAGALAND,MOKOKCHUNG,2021-03-03,0,11,0,11
NAGALAND,MOKOKCHUNG,2021-03-04,0,26,0,26
NAGALAND,MOKOKCHUNG,2021-03-05,0,12,0,12
NAGALAND,MON,2021-03-01,0,7,0,7
NAGALAND,MON,2021-03-02,0,9,0,9
NAGALAND,PEREN,2021-03-01,0,3,0,3
NAGALAND,PEREN,2021-03-02,0,2,0,2
NAGALAND,PEREN,2021-03-04,0,1,0,1
NAGALAND,PHEK,2021-03-01,0,2,0,2
NAGALAND,PHEK,2021-03-02,0,3,0,3
NAGALAND,PHEK,2021-03-03,0,2,0,2
NAGALAND,PHEK,2021-03-04,0,3,0,3
NAGALAND,PHEK,2021-03-05,0,4,0,4
NAGALAND,TUENSANG,2021-03-03,0,1,0,1
NAGALAND,TUENSANG,2021-03-04,0,53,0,53
NAGALAND,WOKHA,2021-03-01,0,6,0,6
NAGALAND,WOKHA,2021-03-02,0,1,0,1
NAGALAND,WOKHA,2021-03-03,0,19,0,19
NAGALAND,WOKHA,2021-03-04,0,3,0,3
NAGALAND,ZUNHEBOTO,2021-03-02,0,2,0,2
NAGALAND,ZUNHEBOTO,2021-03-05,0,1,0,1
ODISHA,ANUGUL,2021-03-01,1,534,0,535
ODISHA,ANUGUL,2021-03-02,2,756,0,758
ODISHA,ANUGUL,2021-03-03,1,587,0,588
ODISHA,ANUGUL,2021-03-04,4,741,0,745
ODISHA,ANUGUL,2021-03-05,2,666,0,668
ODISHA,BALANGIR,2021-03-01,1,843,2,846
ODISHA,BALANGIR,2021-03-02,0,781,0,781
ODISHA,BALANGIR,2021-03-03,1,1056,0,1057
ODISHA,BALANGIR,2021-03-04,0,889,1,890
ODISHA,BALANGIR,2021-03-05,3,875,0,878
ODISHA,BALESHWAR,2021-03-01,14,2484,4,2502
ODISHA,BALESHWAR,2021-03-02,12,2146,0,2158
ODISHA,BALESHWAR,2021-03-03,5,2163,1,2169
ODISHA,BALESHWAR,2021-03-04,8,2027,0,2035
ODISHA,BALESHWAR,2021-03-05,8,2048,3,2059
ODISHA,BARGARH,2021-03-01,3,458,0,461
ODISHA,BARGARH,2021-03-02,2,428,1,431
ODISHA,BARGARH,2021-03-03,0,535,0,535
ODISHA,BARGARH,2021-03-04,1,414,0,415
ODISHA,BARGARH,2021-03-05,0,618,0,618
ODISHA,BHADRAK,2021-03-01,2,661,0,663
ODISHA,BHADRAK,2021-03-02,0,342,0,342
ODISHA,BHADRAK,2021-03-03,4,371,0,375
ODISHA,BHADRAK,2021-03-04,9,399,0,408
ODISHA,BHADRAK,2021-03-05,1,398,0,399
ODISHA,BOUDH,2021-03-01,0,204,0,204
ODISHA,BOUDH,2021-03-02,0,152,0,152
ODISHA,BOUDH,2021-03-03,0,238,0,238
ODISHA,BOUDH,2021-03-04,0,88,0,88
ODISHA,BOUDH,2021-03-05,1,292,0,293
ODISHA,CUTTACK,2021-03-01,3,1701,0,1704
ODISHA,CUTTACK,2021-03-02,4,1539,3,1546
ODISHA,CUTTACK,2021-03-03,1,1578,1,1580
ODISHA,CUTTACK,2021-03-04,3,1661,0,1664
ODISHA,CUTTACK,2021-03-05,6,1165,0,1171
ODISHA,DEOGARH,2021-03-01,0,131,0,131
ODISHA,DEOGARH,2021-03-02,0,224,0,224
ODISHA,DEOGARH,2021-03-03,2,256,0,258
ODISHA,DEOGARH,2021-03-04,1,197,0,198
ODISHA,DEOGARH,2021-03-05,1,107,0,108
ODISHA,DHENKANAL,2021-03-01,0,898,0,898
ODISHA,DHENKANAL,2021-03-02,0,1073,0,1073
ODISHA,DHENKANAL,2021-03-03,0,486,1,487
ODISHA,DHENKANAL,2021-03-04,1,841,0,842
ODISHA,DHENKANAL,2021-03-05,1,482,1,484
ODISHA,GAJAPATI,2021-03-01,0,163,0,163
ODISHA,GAJAPATI,2021-03-02,1,389,1,391
ODISHA,GAJAPATI,2021-03-03,0,156,0,156
ODISHA,GAJAPATI,2021-03-04,0,339,0,339
ODISHA,GAJAPATI,2021-03-05,0,175,0,175
ODISHA,GANJAM,2021-03-01,2,950,6,958
ODISHA,GANJAM,2021-03-02,0,841,10,851
ODISHA,GANJAM,2021-03-03,1,724,2,727
ODISHA,GANJAM,2021-03-04,1,975,2,978
ODISHA,GANJAM,2021-03-05,2,781,7,790
ODISHA,JAGATSINGHAPUR,2021-03-01,2,870,0,872
ODISHA,JAGATSINGHAPUR,2021-03-02,4,668,1,673
ODISHA,JAGATSINGHAPUR,2021-03-03,1,677,0,678
ODISHA,JAGATSINGHAPUR,2021-03-04,1,484,0,485
ODISHA,JAGATSINGHAPUR,2021-03-05,3,634,0,637
ODISHA,JAJAPUR,2021-03-01,15,525,0,540
ODISHA,JAJAPUR,2021-03-02,24,394,0,418
ODISHA,JAJAPUR,2021-03-03,8,241,0,249
ODISHA,JAJAPUR,2021-03-04,47,351,0,398
ODISHA,JAJAPUR,2021-03-05,5,376,0,381
ODISHA,JHARSUGUDA,2021-03-01,7,445,1,453
ODISHA,JHARSUGUDA,2021-03-02,1,492,2,495
ODISHA,JHARSUGUDA,2021-03-03,2,384,1,387
ODISHA,JHARSUGUDA,2021-03-04,1,471,3,475
ODISHA,JHARSUGUDA,2021-03-05,3,487,4,494
ODISHA,KALAHANDI,2021-03-01,0,22,0,22
ODISHA,KALAHANDI,2021-03-02,1,101,0,102
ODISHA,KALAHANDI,2021-03-03,0,146,0,146
ODISHA,KALAHANDI,2021-03-04,0,183,0,183
ODISHA,KALAHANDI,2021-03-05,0,213,0,213
ODISHA,KANDHAMAL,2021-03-01,0,661,0,661
ODISHA,KANDHAMAL,2021-03-02,0,771,0,771
ODISHA,KANDHAMAL,2021-03-03,0,609,0,609
ODISHA,KANDHAMAL,2021-03-04,1,660,0,661
ODISHA,KANDHAMAL,2021-03-05,0,638,0,638
ODISHA,KENDRAPARA,2021-03-01,1,1235,0,1236
ODISHA,KENDRAPARA,2021-03-02,1,1573,1,1575
ODISHA,KENDRAPARA,2021-03-03,0,1276,0,1276
ODISHA,KENDRAPARA,2021-03-04,0,1167,0,1167
ODISHA,KENDRAPARA,2021-03-05,0,1208,0,1208
ODISHA,KENDUJHAR,2021-03-01,0,607,0,607
ODISHA,KENDUJHAR,2021-03-02,0,569,0,569
ODISHA,KENDUJHAR,2021-03-03,1,828,0,829
ODISHA,KENDUJHAR,2021-03-04,0,825,0,825
ODISHA,KENDUJHAR,2021-03-05,0,466,0,466
ODISHA,KHORDHA,2021-03-01,18,1833,6,1857
ODISHA,KHORDHA,2021-03-02,10,1546,4,1560
ODISHA,KHORDHA,2021-03-03,13,1552,2,1567
ODISHA,KHORDHA,2021-03-04,16,2044,3,2063
ODISHA,KHORDHA,2021-03-05,10,1485,2,1497
ODISHA,KORAPUT,2021-03-01,0,1145,0,1145
ODISHA,KORAPUT,2021-03-02,0,1235,0,1235
ODISHA,KORAPUT,2021-03-03,0,1282,0,1282
ODISHA,KORAPUT,2021-03-04,0,1284,0,1284
ODISHA,KORAPUT,2021-03-05,0,1363,0,1363
ODISHA,MALKANGIRI,2021-03-01,0,159,0,159
ODISHA,MALKANGIRI,2021-03-02,1,430,0,431
ODISHA,MALKANGIRI,2021-03-03,0,268,0,268
ODISHA,MALKANGIRI,2021-03-04,0,442,0,442
ODISHA,MALKANGIRI,2021-03-05,0,238,0,238
ODISHA,MAYURBHANJ,2021-03-01,6,1529,0,1535
ODISHA,MAYURBHANJ,2021-03-02,6,1530,0,1536
ODISHA,MAYURBHANJ,2021-03-03,9,1773,0,1782
ODISHA,MAYURBHANJ,2021-03-04,6,1565,0,1571
ODISHA,MAYURBHANJ,2021-03-05,4,1258,0,1262
ODISHA,NABARANGPUR,2021-03-01,4,928,1,933
ODISHA,NABARANGPUR,2021-03-02,1,770,0,771
ODISHA,NABARANGPUR,2021-03-03,2,742,0,744
ODISHA,NABARANGPUR,2021-03-04,2,905,0,907
ODISHA,NABARANGPUR,2021-03-05,0,810,0,810
ODISHA,NAYAGARH,2021-03-01,0,758,7,765
ODISHA,NAYAGARH,2021-03-02,0,601,0,601
ODISHA,NAYAGARH,2021-03-03,0,864,0,864
ODISHA,NAYAGARH,2021-03-04,0,553,0,553
ODISHA,NAYAGARH,2021-03-05,0,598,1,599
ODISHA,NUAPADA,2021-03-01,0,126,0,126
ODISHA,NUAPADA,2021-03-02,0,144,0,144
ODISHA,NUAPADA,2021-03-03,1,104,0,105
ODISHA,NUAPADA,2021-03-04,1,107,0,108
ODISHA,NUAPADA,2021-03-05,0,174,0,174
ODISHA,PURI,2021-03-01,5,707,0,712
ODISHA,PURI,2021-03-02,2,692,0,694
ODISHA,PURI,2021-03-03,3,705,0,708
ODISHA,PURI,2021-03-04,1,698,0,699
ODISHA,PURI,2021-03-05,0,699,0,699
ODISHA,RAYAGADA,2021-03-01,0,582,0,582
ODISHA,RAYAGADA,2021-03-02,2,579,0,581
ODISHA,RAYAGADA,2021-03-03,1,898,0,899
ODISHA,RAYAGADA,2021-03-04,2,387,0,389
ODISHA,RAYAGADA,2021-03-05,3,520,0,523
ODISHA,SAMBALPUR,2021-03-01,27,561,0,588
ODISHA,SAMBALPUR,2021-03-02,5,539,0,544
ODISHA,SAMBALPUR,2021-03-03,5,489,0,494
ODISHA,SAMBALPUR,2021-03-04,1,542,0,543
ODISHA,SAMBALPUR,2021-03-05,3,480,0,483
ODISHA,SONEPUR,2021-03-01,0,297,0,297
ODISHA,SONEPUR,2021-03-02,0,376,0,376
ODISHA,SONEPUR,2021-03-03,0,323,0,323
ODISHA,SONEPUR,2021-03-04,1,189,0,190
ODISHA,SONEPUR,2021-03-05,0,320,0,320
ODISHA,SUNDARGARH,2021-03-01,5,569,1,575
ODISHA,SUNDARGARH,2021-03-02,18,567,0,585
ODISHA,SUNDARGARH,2021-03-03,10,526,0,536
ODISHA,SUNDARGARH,2021-03-04,7,583,0,590
ODISHA,SUNDARGARH,2021-03-05,13,439,0,452
PUDUCHERRY,KARAIKAL,2021-03-01,5,183,0,188
PUDUCHERRY,KARAIKAL,2021-03-02,7,498,0,505
PUDUCHERRY,KARAIKAL,2021-03-03,10,430,0,440
PUDUCHERRY,KARAIKAL,2021-03-04,10,343,0,353
PUDUCHERRY,KARAIKAL,2021-03-05,6,285,0,291
PUDUCHERRY,MAHE,2021-03-01,9,37,0,46
PUDUCHERRY,MAHE,2021-03-02,3,91,0,94
PUDUCHERRY,MAHE,2021-03-03,2,158,0,160
PUDUCHERRY,MAHE,2021-03-04,6,143,7,156
PUDUCHERRY,MAHE,2021-03-05,1,189,0,190
PUDUCHERRY,PONDICHERRY,2021-03-01,11,349,3,363
PUDUCHERRY,PONDICHERRY,2021-03-02,8,398,0,406
PUDUCHERRY,PONDICHERRY,2021-03-03,13,330,3,346
PUDUCHERRY,PONDICHERRY,2021-03-04,11,328,1,340
PUDUCHERRY,PONDICHERRY,2021-03-05,21,309,1,331
PUDUCHERRY,YANAM,2021-03-01,0,181,0,181
PUDUCHERRY,YANAM,2021-03-02,0,206,0,206
PUDUCHERRY,YANAM,2021-03-03,0,220,0,220
PUDUCHERRY,YANAM,2021-03-04,0,77,0,77
PUDUCHERRY,YANAM,2021-03-05,0,122,0,122
PUNJAB,AMRITSAR,2021-03-01,74,1269,0,1343
PUNJAB,AMRITSAR,2021-03-02,98,2354,5,2457
PUNJAB,AMRITSAR,2021-03-03,74,1142,4,1220
PUNJAB,AMRITSAR,2021-03-04,80,1983,8,2071
PUNJAB,AMRITSAR,2021-03-05,215,1632,4,1851
PUNJAB,BARNALA,2021-03-01,0,194,11,205
PUNJAB,BARNALA,2021-03-02,1,313,0,314
PUNJAB,BARNALA,2021-03-03,3,156,10,169
PUNJAB,BARNALA,2021-03-04,1,336,0,337
PUNJAB,BARNALA,2021-03-05,4,38,0,42
PUNJAB,BATHINDA,2021-03-01,6,669,5,680
PUNJAB,BATHINDA,2021-03-02,3,1290,7,1300
PUNJAB,BATHINDA,2021-03-03,28,312,7,347
PUNJAB,BATHINDA,2021-03-04,41,1111,10,1162
PUNJAB,BATHINDA,2021-03-05,18,1214,3,1235
PUNJAB,FARIDKOT,2021-03-01,9,240,0,249
PUNJAB,FARIDKOT,2021-03-02,0,454,1,455
PUNJAB,FARIDKOT,2021-03-03,15,122,0,137
PUNJAB,FARIDKOT,2021-03-04,32,603,11,646
PUNJAB,FARIDKOT,2021-03-05,4,568,5,577
PUNJAB,FATEHGARH SAHIB,2021-03-01,3,169,1,173
PUNJAB,FATEHGARH SAHIB,2021-03-02,14,142,1,157
PUNJAB,FATEHGARH SAHIB,2021-03-03,5,300,0,305
PUNJAB,FATEHGARH SAHIB,2021-03-04,9,497,1,507
PUNJAB,FATEHGARH SAHIB,2021-03-05,21,412,2,435
PUNJAB,FAZILKA,2021-03-01,7,364,34,405
PUNJAB,FAZILKA,2021-03-02,0,502,0,502
PUNJAB,FAZILKA,2021-03-03,1,425,3,429
PUNJAB,FAZILKA,2021-03-04,3,373,4,380
PUNJAB,FAZILKA,2021-03-05,3,80,0,83
PUNJAB,FIROZEPUR,2021-03-01,14,429,31,474
PUNJAB,FIROZEPUR,2021-03-02,2,324,2,328
PUNJAB,FIROZEPUR,2021-03-03,18,1880,5,1903
PUNJAB,FIROZEPUR,2021-03-04,14,317,8,339
PUNJAB,FIROZEPUR,2021-03-05,1,745,9,755
PUNJAB,GURDASPUR,2021-03-01,16,766,4,786
PUNJAB,GURDASPUR,2021-03-02,25,751,0,776
PUNJAB,GURDASPUR,2021-03-03,60,812,1,873
PUNJAB,GURDASPUR,2021-03-04,18,1833,4,1855
PUNJAB,GURDASPUR,2021-03-05,68,332,0,400
PUNJAB,HOSHIARPUR,2021-03-01,59,1077,4,1140
PUNJAB,HOSHIARPUR,2021-03-02,97,1649,19,1765
PUNJAB,HOSHIARPUR,2021-03-03,113,1043,21,1177
PUNJAB,HOSHIARPUR,2021-03-04,62,1150,190,1402
PUNJAB,HOSHIARPUR,2021-03-05,199,2217,9,2425
PUNJAB,JALANDHAR,2021-03-01,100,3668,16,3784
PUNJAB,JALANDHAR,2021-03-02,120,2753,3,2876
PUNJAB,JALANDHAR,2021-03-03,141,3866,81,4088
PUNJAB,JALANDHAR,2021-03-04,206,2869,20,3095
PUNJAB,JALANDHAR,2021-03-05,301,3376,92,3769
PUNJAB,KAPURTHALA,2021-03-01,22,1216,12,1250
PUNJAB,KAPURTHALA,2021-03-02,43,405,1,449
PUNJAB,KAPURTHALA,2021-03-03,69,1193,16,1278
PUNJAB,KAPURTHALA,2021-03-04,54,419,4,477
PUNJAB,KAPURTHALA,2021-03-05,122,381,1,504
PUNJAB,LUDHIANA,2021-03-01,83,2024,9,2116
PUNJAB,LUDHIANA,2021-03-02,103,2104,11,2218
PUNJAB,LUDHIANA,2021-03-03,115,2932,14,3061
PUNJAB,LUDHIANA,2021-03-04,154,3528,3,3685
PUNJAB,LUDHIANA,2021-03-05,153,3100,14,3267
PUNJAB,MANSA,2021-03-01,7,327,1,335
PUNJAB,MANSA,2021-03-02,1,572,0,573
PUNJAB,MANSA,2021-03-03,2,433,0,435
PUNJAB,MANSA,2021-03-04,0,475,0,475
PUNJAB,MANSA,2021-03-05,10,431,0,441
PUNJAB,MOGA,2021-03-01,11,635,1,647
PUNJAB,MOGA,2021-03-02,7,532,1,540
PUNJAB,MOGA,2021-03-03,29,145,6,180
PUNJAB,MOGA,2021-03-04,8,546,0,554
PUNJAB,MOGA,2021-03-05,30,462,1,493
PUNJAB,PATHANKOT,2021-03-01,10,427,4,441
PUNJAB,PATHANKOT,2021-03-02,3,101,0,104
PUNJAB,PATHANKOT,2021-03-03,12,176,0,188
PUNJAB,PATHANKOT,2021-03-04,16,61,0,77
PUNJAB,PATHANKOT,2021-03-05,15,90,0,105
PUNJAB,PATIALA,2021-03-01,58,1234,1,1293
PUNJAB,PATIALA,2021-03-02,77,1789,0,1866
PUNJAB,PATIALA,2021-03-03,103,1705,0,1808
PUNJAB,PATIALA,2021-03-04,61,1770,5,1836
PUNJAB,PATIALA,2021-03-05,135,2703,1,2839
PUNJAB,RUPNAGAR,2021-03-01,5,518,15,538
PUNJAB,RUPNAGAR,2021-03-02,24,1035,1,1060
PUNJAB,RUPNAGAR,2021-03-03,26,673,1,700
PUNJAB,RUPNAGAR,2021-03-04,32,915,1,948
PUNJAB,RUPNAGAR,2021-03-05,31,1448,2,1481
PUNJAB,S.A.S NAGAR,2021-03-01,62,1127,10,1199
PUNJAB,S.A.S NAGAR,2021-03-02,77,1061,7,1145
PUNJAB,S.A.S NAGAR,2021-03-03,127,1288,15,1430
PUNJAB,S.A.S NAGAR,2021-03-04,100,1075,7,1182
PUNJAB,S.A.S NAGAR,2021-03-05,106,1295,5,1406
PUNJAB,SANGRUR,2021-03-01,16,1474,2,1492
PUNJAB,SANGRUR,2021-03-02,17,1468,0,1485
PUNJAB,SANGRUR,2021-03-03,22,1550,1,1573
PUNJAB,SANGRUR,2021-03-04,25,1656,1,1682
PUNJAB,SANGRUR,2021-03-05,12,1631,0,1643
PUNJAB,SHAHID BHAGAT SINGH NAGAR,2021-03-01,48,388,1,437
PUNJAB,SHAHID BHAGAT SINGH NAGAR,2021-03-02,125,606,2,733
PUNJAB,SHAHID BHAGAT SINGH NAGAR,2021-03-03,116,1023,1,1140
PUNJAB,SHAHID BHAGAT SINGH NAGAR,2021-03-04,146,1083,0,1229
PUNJAB,SHAHID BHAGAT SINGH NAGAR,2021-03-05,69,1095,0,1164
PUNJAB,SRI MUKTSAR SAHIB,2021-03-01,4,91,0,95
PUNJAB,SRI MUKTSAR SAHIB,2021-03-02,4,539,0,543
PUNJAB,SRI MUKTSAR SAHIB,2021-03-03,1,85,0,86
PUNJAB,SRI MUKTSAR SAHIB,2021-03-04,5,641,3,649
PUNJAB,SRI MUKTSAR SAHIB,2021-03-05,7,453,4,464
PUNJAB,TARN TARAN,2021-03-01,8,426,0,434
PUNJAB,TARN TARAN,2021-03-02,11,655,1,667
PUNJAB,TARN TARAN,2021-03-03,15,812,0,827
PUNJAB,TARN TARAN,2021-03-04,3,682,2,687
PUNJAB,TARN TARAN,2021-03-05,26,179,0,205
RAJASTHAN,AJMER,2021-03-01,2,69,625,696
RAJASTHAN,AJMER,2021-03-02,3,104,586,693
RAJASTHAN,AJMER,2021-03-03,3,105,614,722
RAJASTHAN,AJMER,2021-03-04,9,94,592,695
RAJASTHAN,AJMER,2021-03-05,2,47,642,691
RAJASTHAN,ALWAR,2021-03-01,5,2758,64,2827
RAJASTHAN,ALWAR,2021-03-02,4,2564,42,2610
RAJASTHAN,ALWAR,2021-03-03,3,2999,59,3061
RAJASTHAN,ALWAR,2021-03-04,6,2488,50,2544
RAJASTHAN,ALWAR,2021-03-05,0,2429,25,2454
RAJASTHAN,BANSWARA,2021-03-01,1,43,0,44
RAJASTHAN,BANSWARA,2021-03-02,2,9,2,13
RAJASTHAN,BANSWARA,2021-03-03,1,30,0,31
RAJASTHAN,BANSWARA,2021-03-04,4,27,0,31
RAJASTHAN,BANSWARA,2021-03-05,3,37,0,40
RAJASTHAN,BARAN,2021-03-01,3,107,0,110
RAJASTHAN,BARAN,2021-03-02,0,107,0,107
RAJASTHAN,BARAN,2021-03-03,0,28,0,28
RAJASTHAN,BARAN,2021-03-04,2,82,0,84
RAJASTHAN,BARAN,2021-03-05,0,212,0,212
RAJASTHAN,BARMER,2021-03-01,0,220,1,221
RAJASTHAN,BARMER,2021-03-02,8,88,0,96
RAJASTHAN,BARMER,2021-03-03,1,271,2,274
RAJASTHAN,BARMER,2021-03-04,0,129,0,129
RAJASTHAN,BARMER,2021-03-05,1,292,1,294
RAJASTHAN,BHARATPUR,2021-03-01,1,232,1,234
RAJASTHAN,BHARATPUR,2021-03-02,0,323,2,325
RAJASTHAN,BHARATPUR,2021-03-03,1,399,0,400
RAJASTHAN,BHARATPUR,2021-03-04,0,203,3,206
RAJASTHAN,BHARATPUR,2021-03-05,1,321,2,324
RAJASTHAN,BHILWARA,2021-03-01,10,214,3,227
RAJASTHAN,BHILWARA,2021-03-02,7,521,1,529
RAJASTHAN,BHILWARA,2021-03-03,6,461,7,474
RAJASTHAN,BHILWARA,2021-03-04,8,466,1,475
RAJASTHAN,BHILWARA,2021-03-05,8,318,0,326
RAJASTHAN,BIKANER,2021-03-01,0,1249,1,1250
RAJASTHAN,BIKANER,2021-03-02,1,1298,1,1300
RAJASTHAN,BIKANER,2021-03-03,9,1135,4,1148
RAJASTHAN,BIKANER,2021-03-04,0,1125,1,1126
RAJASTHAN,BIKANER,2021-03-05,1,1104,0,1105
RAJASTHAN,BUNDI,2021-03-01,3,120,2,125
RAJASTHAN,BUNDI,2021-03-02,0,199,1,200
RAJASTHAN,BUNDI,2021-03-03,0,155,0,155
RAJASTHAN,BUNDI,2021-03-04,0,182,1,183
RAJASTHAN,BUNDI,2021-03-05,0,148,3,151
RAJASTHAN,CHITTORGARH,2021-03-01,1,925,3,929
RAJASTHAN,CHITTORGARH,2021-03-02,7,796,2,805
RAJASTHAN,CHITTORGARH,2021-03-03,2,1022,1,1025
RAJASTHAN,CHITTORGARH,2021-03-04,6,508,1,515
RAJASTHAN,CHITTORGARH,2021-03-05,5,637,1,643
RAJASTHAN,CHURU,2021-03-01,0,123,0,123
RAJASTHAN,CHURU,2021-03-02,0,363,1,364
RAJASTHAN,CHURU,2021-03-03,0,297,2,299
RAJASTHAN,CHURU,2021-03-04,0,294,1,295
RAJASTHAN,CHURU,2021-03-05,0,241,4,245
RAJASTHAN,DAUSA,2021-03-01,1,69,5,75
RAJASTHAN,DAUSA,2021-03-02,1,439,7,447
RAJASTHAN,DAUSA,2021-03-03,0,390,5,395
RAJASTHAN,DAUSA,2021-03-04,0,331,13,344
RAJASTHAN,DAUSA,2021-03-05,0,316,8,324
RAJASTHAN,DHOLPUR,2021-03-01,4,136,2,142
RAJASTHAN,DHOLPUR,2021-03-02,3,32,2,37
RAJASTHAN,DHOLPUR,2021-03-03,5,75,1,81
RAJASTHAN,DHOLPUR,2021-03-04,1,44,0,45
RAJASTHAN,DHOLPUR,2021-03-05,0,46,1,47
RAJASTHAN,DUNGARPUR,2021-03-01,3,148,0,151
RAJASTHAN,DUNGARPUR,2021-03-02,48,273,0,321
RAJASTHAN,DUNGARPUR,2021-03-03,10,120,1,131
RAJASTHAN,DUNGARPUR,2021-03-04,52,272,1,325
RAJASTHAN,DUNGARPUR,2021-03-05,55,138,1,194
RAJASTHAN,GANGANAGAR,2021-03-01,108,132,23,263
RAJASTHAN,GANGANAGAR,2021-03-02,79,184,3,266
RAJASTHAN,GANGANAGAR,2021-03-03,99,369,18,486
RAJASTHAN,GANGANAGAR,2021-03-04,117,348,23,488
RAJASTHAN,GANGANAGAR,2021-03-05,144,312,28,484
RAJASTHAN,HANUMANGARH,2021-03-01,3,161,0,164
RAJASTHAN,HANUMANGARH,2021-03-02,5,607,0,612
RAJASTHAN,HANUMANGARH,2021-03-03,1,865,1,867
RAJASTHAN,HANUMANGARH,2021-03-04,2,480,1,483
RAJASTHAN,HANUMANGARH,2021-03-05,9,348,1,358
RAJASTHAN,JAIPUR,2021-03-01,57,1758,312,2127
RAJASTHAN,JAIPUR,2021-03-02,141,1996,198,2335
RAJASTHAN,JAIPUR,2021-03-03,67,2274,394,2735
RAJASTHAN,JAIPUR,2021-03-04,76,2173,284,2533
RAJASTHAN,JAIPUR,2021-03-05,92,2458,338,2888
RAJASTHAN,JAISALMER,2021-03-01,0,66,0,66
RAJASTHAN,JAISALMER,2021-03-02,1,135,0,136
RAJASTHAN,JAISALMER,2021-03-03,1,140,0,141
RAJASTHAN,JAISALMER,2021-03-04,5,72,0,77
RAJASTHAN,JAISALMER,2021-03-05,1,191,0,192
RAJASTHAN,JALORE,2021-03-01,1,315,0,316
RAJASTHAN,JALORE,2021-03-02,0,455,1,456
RAJASTHAN,JALORE,2021-03-03,4,348,0,352
RAJASTHAN,JALORE,2021-03-04,0,218,0,218
RAJASTHAN,JALORE,2021-03-05,0,310,1,311
RAJASTHAN,JHALAWAR,2021-03-01,3,332,0,335
RAJASTHAN,JHALAWAR,2021-03-02,1,270,0,271
RAJASTHAN,JHALAWAR,2021-03-03,5,122,0,127
RAJASTHAN,JHALAWAR,2021-03-04,3,373,7,383
RAJASTHAN,JHALAWAR,2021-03-05,10,180,0,190
RAJASTHAN,JHUNJHUNU,2021-03-01,0,53,7,60
RAJASTHAN,JHUNJHUNU,2021-03-02,0,86,2,88
RAJASTHAN,JHUNJHUNU,2021-03-03,0,65,6,71
RAJASTHAN,JHUNJHUNU,2021-03-04,1,96,2,99
RAJASTHAN,JHUNJHUNU,2021-03-05,1,53,3,57
RAJASTHAN,JODHPUR,2021-03-01,12,774,1,787
RAJASTHAN,JODHPUR,2021-03-02,26,813,0,839
RAJASTHAN,JODHPUR,2021-03-03,6,801,2,809
RAJASTHAN,JODHPUR,2021-03-04,17,850,0,867
RAJASTHAN,JODHPUR,2021-03-05,30,908,23,961
RAJASTHAN,KARAULI,2021-03-01,7,573,3,583
RAJASTHAN,KARAULI,2021-03-02,17,838,11,866
RAJASTHAN,KARAULI,2021-03-03,17,547,14,578
RAJASTHAN,KARAULI,2021-03-04,3,549,3,555
RAJASTHAN,KARAULI,2021-03-05,7,553,5,565
RAJASTHAN,KOTA,2021-03-01,61,1071,2,1134
RAJASTHAN,KOTA,2021-03-02,53,1351,3,1407
RAJASTHAN,KOTA,2021-03-03,15,1229,0,1244
RAJASTHAN,KOTA,2021-03-04,26,1225,1,1252
RAJASTHAN,KOTA,2021-03-05,5,1030,0,1035
RAJASTHAN,NAGAUR,2021-03-01,0,180,18,198
RAJASTHAN,NAGAUR,2021-03-02,0,491,115,606
RAJASTHAN,NAGAUR,2021-03-03,0,308,91,399
RAJASTHAN,NAGAUR,2021-03-04,3,295,85,383
RAJASTHAN,NAGAUR,2021-03-05,1,169,73,243
RAJASTHAN,PALI,2021-03-01,0,698,18,716
RAJASTHAN,PALI,2021-03-02,2,897,8,907
RAJASTHAN,PALI,2021-03-03,2,287,56,345
RAJASTHAN,PALI,2021-03-04,0,13,2,15
RAJASTHAN,PALI,2021-03-05,1,15,4,20
RAJASTHAN,PRATAPGARH,2021-03-01,4,11,0,15
RAJASTHAN,PRATAPGARH,2021-03-02,0,15,0,15
RAJASTHAN,PRATAPGARH,2021-03-03,0,5,0,5
RAJASTHAN,PRATAPGARH,2021-03-04,8,1,0,9
RAJASTHAN,PRATAPGARH,2021-03-05,0,4,0,4
RAJASTHAN,RAJSAMAND,2021-03-01,8,68,0,76
RAJASTHAN,RAJSAMAND,2021-03-02,5,41,3,49
RAJASTHAN,RAJSAMAND,2021-03-03,22,321,2,345
RAJASTHAN,RAJSAMAND,2021-03-04,6,376,0,382
RAJASTHAN,RAJSAMAND,2021-03-05,17,147,1,165
RAJASTHAN,SAWAI MADHOPUR,2021-03-01,2,107,7,116
RAJASTHAN,SAWAI MADHOPUR,2021-03-02,3,982,8,993
RAJASTHAN,SAWAI MADHOPUR,2021-03-03,0,275,15,290
RAJASTHAN,SAWAI MADHOPUR,2021-03-04,0,246,6,252
RAJASTHAN,SAWAI MADHOPUR,2021-03-05,1,412,6,419
RAJASTHAN,SIKAR,2021-03-01,1,302,7,310
RAJASTHAN,SIKAR,2021-03-02,2,309,6,317
RAJASTHAN,SIKAR,2021-03-03,1,409,10,420
RAJASTHAN,SIKAR,2021-03-04,1,339,5,345
RAJASTHAN,SIKAR,2021-03-05,0,275,2,277
RAJASTHAN,SIROHI,2021-03-01,2,344,0,346
RAJASTHAN,SIROHI,2021-03-02,1,77,0,78
RAJASTHAN,SIROHI,2021-03-03,0,90,0,90
RAJASTHAN,SIROHI,2021-03-04,0,209,0,209
RAJASTHAN,SIROHI,2021-03-05,0,76,1,77
RAJASTHAN,TONK,2021-03-01,0,262,13,275
RAJASTHAN,TONK,2021-03-02,0,156,14,170
RAJASTHAN,TONK,2021-03-03,2,25,6,33
RAJASTHAN,TONK,2021-03-04,0,350,6,356
RAJASTHAN,TONK,2021-03-05,1,114,1,116
RAJASTHAN,UDAIPUR,2021-03-01,43,632,0,675
RAJASTHAN,UDAIPUR,2021-03-02,50,740,2,792
RAJASTHAN,UDAIPUR,2021-03-03,62,718,1,781
RAJASTHAN,UDAIPUR,2021-03-04,57,621,2,680
RAJASTHAN,UDAIPUR,2021-03-05,83,679,1,763
SIKKIM,EAST DISTRICT,2021-03-01,1,78,0,79
SIKKIM,EAST DISTRICT,2021-03-02,2,181,0,183
SIKKIM,EAST DISTRICT,2021-03-03,0,60,0,60
SIKKIM,EAST DISTRICT,2021-03-04,6,150,0,156
SIKKIM,EAST DISTRICT,2021-03-05,1,94,0,95
SIKKIM,NORTH DISTRICT,2021-03-01,0,2,0,2
SIKKIM,NORTH DISTRICT,2021-03-02,0,2,0,2
SIKKIM,NORTH DISTRICT,2021-03-03,0,3,0,3
SIKKIM,NORTH DISTRICT,2021-03-04,0,5,0,5
SIKKIM,SOUTH DISTRICT,2021-03-01,0,2,0,2
SIKKIM,SOUTH DISTRICT,2021-03-02,1,30,0,31
SIKKIM,SOUTH DISTRICT,2021-03-03,0,5,0,5
SIKKIM,SOUTH DISTRICT,2021-03-04,0,9,0,9
SIKKIM,SOUTH DISTRICT,2021-03-05,9,32,0,41
SIKKIM,WEST DISTRICT,2021-03-02,0,4,0,4
SIKKIM,WEST DISTRICT,2021-03-03,0,6,0,6
SIKKIM,WEST DISTRICT,2021-03-04,0,7,0,7
SIKKIM,WEST DISTRICT,2021-03-05,0,3,0,3
TAMIL NADU,ARIYALUR,2021-03-01,0,188,0,188
TAMIL NADU,ARIYALUR,2021-03-02,1,348,0,349
TAMIL NADU,ARIYALUR,2021-03-03,2,438,0,440
TAMIL NADU,ARIYALUR,2021-03-04,0,318,0,318
TAMIL NADU,ARIYALUR,2021-03-05,0,555,0,555
TAMIL NADU,CHENGALPATTU,2021-03-01,30,2611,0,2641
TAMIL NADU,CHENGALPATTU,2021-03-02,40,2534,0,2574
TAMIL NADU,CHENGALPATTU,2021-03-03,31,2923,0,2954
TAMIL NADU,CHENGALPATTU,2021-03-04,34,2405,0,2439
TAMIL NADU,CHENGALPATTU,2021-03-05,52,3083,0,3135
TAMIL NADU,CHENNAI,2021-03-01,177,9296,11,9484
TAMIL NADU,CHENNAI,2021-03-02,277,9926,7,10210
TAMIL NADU,CHENNAI,2021-03-03,238,10902,10,11150
TAMIL NADU,CHENNAI,2021-03-04,304,9836,39,10179
TAMIL NADU,CHENNAI,2021-03-05,345,11734,43,12122
TAMIL NADU,COIMBATORE,2021-03-01,42,1038,4,1084
TAMIL NADU,COIMBATORE,2021-03-02,47,2034,0,2081
TAMIL NADU,COIMBATORE,2021-03-03,59,1737,0,1796
TAMIL NADU,COIMBATORE,2021-03-04,74,1682,1,1757
TAMIL NADU,COIMBATORE,2021-03-05,63,1582,0,1645
TAMIL NADU,CUDDALORE,2021-03-01,8,1253,0,1261
TAMIL NADU,CUDDALORE,2021-03-02,20,1316,1,1337
TAMIL NADU,CUDDALORE,2021-03-03,5,1081,0,1086
TAMIL NADU,CUDDALORE,2021-03-04,10,1431,0,1441
TAMIL NADU,CUDDALORE,2021-03-05,10,1362,1,1373
TAMIL NADU,DHARMAPURI,2021-03-01,0,508,0,508
TAMIL NADU,DHARMAPURI,2021-03-02,2,604,0,606
TAMIL NADU,DHARMAPURI,2021-03-03,1,462,0,463
TAMIL NADU,DHARMAPURI,2021-03-04,5,616,0,621
TAMIL NADU,DHARMAPURI,2021-03-05,1,814,0,815
TAMIL NADU,DINDIGUL,2021-03-01,5,125,0,130
TAMIL NADU,DINDIGUL,2021-03-02,10,129,0,139
TAMIL NADU,DINDIGUL,2021-03-03,9,176,2,187
TAMIL NADU,DINDIGUL,2021-03-04,8,175,4,187
TAMIL NADU,DINDIGUL,2021-03-05,7,277,1,285
TAMIL NADU,ERODE,2021-03-01,4,448,0,452
TAMIL NADU,ERODE,2021-03-02,13,1024,0,1037
TAMIL NADU,ERODE,2021-03-03,7,1219,1,1227
TAMIL NADU,ERODE,2021-03-04,17,1289,0,1306
TAMIL NADU,ERODE,2021-03-05,11,1172,0,1183
TAMIL NADU,KALLAKURICHI,2021-03-01,1,30,0,31
TAMIL NADU,KALLAKURICHI,2021-03-02,1,309,0,310
TAMIL NADU,KALLAKURICHI,2021-03-03,1,297,1,299
TAMIL NADU,KALLAKURICHI,2021-03-04,0,622,2,624
TAMIL NADU,KALLAKURICHI,2021-03-05,0,322,0,322
TAMIL NADU,KANCHIPURAM,2021-03-01,13,1708,4,1725
TAMIL NADU,KANCHIPURAM,2021-03-02,24,1641,0,1665
TAMIL NADU,KANCHIPURAM,2021-03-03,20,1489,2,1511
TAMIL NADU,KANCHIPURAM,2021-03-04,18,2026,3,2047
TAMIL NADU,KANCHIPURAM,2021-03-05,18,2932,1,2951
TAMIL NADU,KANNIYAKUMARI,2021-03-01,6,1016,14,1036
TAMIL NADU,KANNIYAKUMARI,2021-03-02,10,1039,6,1055
TAMIL NADU,KANNIYAKUMARI,2021-03-03,6,1511,2,1519
TAMIL NADU,KANNIYAKUMARI,2021-03-04,10,1898,3,1911
TAMIL NADU,KANNIYAKUMARI,2021-03-05,9,1570,1,1580
TAMIL NADU,KARUR,2021-03-01,1,756,0,757
TAMIL NADU,KARUR,2021-03-02,3,899,0,902
TAMIL NADU,KARUR,2021-03-03,2,897,0,899
TAMIL NADU,KARUR,2021-03-04,4,987,2,993
TAMIL NADU,KARUR,2021-03-05,2,876,0,878
TAMIL NADU,KRISHNAGIRI,2021-03-01,1,509,0,510
TAMIL NADU,KRISHNAGIRI,2021-03-02,2,525,0,527
TAMIL NADU,KRISHNAGIRI,2021-03-03,7,734,1,742
TAMIL NADU,KRISHNAGIRI,2021-03-04,4,507,0,511
TAMIL NADU,KRISHNAGIRI,2021-03-05,3,667,1,671
TAMIL NADU,MADURAI,2021-03-01,12,1795,3,1810
TAMIL NADU,MADURAI,2021-03-02,14,2492,1,2507
TAMIL NADU,MADURAI,2021-03-03,7,2053,0,2060
TAMIL NADU,MADURAI,2021-03-04,11,2275,1,2287
TAMIL NADU,MADURAI,2021-03-05,5,2519,1,2525
TAMIL NADU,NAGAPATTINAM,2021-03-01,7,148,0,155
TAMIL NADU,NAGAPATTINAM,2021-03-02,4,564,3,571
TAMIL NADU,NAGAPATTINAM,2021-03-03,4,498,0,502
TAMIL NADU,NAGAPATTINAM,2021-03-04,5,503,0,508
TAMIL NADU,NAGAPATTINAM,2021-03-05,6,535,2,543
TAMIL NADU,NAMAKKAL,2021-03-01,3,1134,1,1138
TAMIL NADU,NAMAKKAL,2021-03-02,1,1093,1,1095
TAMIL NADU,NAMAKKAL,2021-03-03,5,659,0,664
TAMIL NADU,NAMAKKAL,2021-03-04,9,1072,0,1081
TAMIL NADU,NAMAKKAL,2021-03-05,9,966,0,975
TAMIL NADU,PERAMBALUR,2021-03-01,0,177,0,177
TAMIL NADU,PERAMBALUR,2021-03-02,1,220,0,221
TAMIL NADU,PERAMBALUR,2021-03-03,3,244,0,247
TAMIL NADU,PERAMBALUR,2021-03-04,1,232,0,233
TAMIL NADU,PERAMBALUR,2021-03-05,0,258,0,258
TAMIL NADU,PUDUKKOTTAI,2021-03-01,6,107,0,113
TAMIL NADU,PUDUKKOTTAI,2021-03-02,0,553,1,554
TAMIL NADU,PUDUKKOTTAI,2021-03-03,7,510,0,517
TAMIL NADU,PUDUKKOTTAI,2021-03-04,4,453,1,458
TAMIL NADU,PUDUKKOTTAI,2021-03-05,2,533,0,535
TAMIL NADU,RAMANATHAPURAM,2021-03-01,1,852,0,853
TAMIL NADU,RAMANATHAPURAM,2021-03-02,1,911,0,912
TAMIL NADU,RAMANATHAPURAM,2021-03-03,2,729,0,731
TAMIL NADU,RAMANATHAPURAM,2021-03-04,1,989,0,990
TAMIL NADU,RAMANATHAPURAM,2021-03-05,3,816,0,819
TAMIL NADU,RANIPET,2021-03-01,1,62,0,63
TAMIL NADU,RANIPET,2021-03-02,2,165,0,167
TAMIL NADU,RANIPET,2021-03-03,4,290,0,294
TAMIL NADU,RANIPET,2021-03-04,2,414,1,417
TAMIL NADU,RANIPET,2021-03-05,3,277,0,280
TAMIL NADU,SALEM,2021-03-01,5,361,0,366
TAMIL NADU,SALEM,2021-03-02,5,259,0,264
TAMIL NADU,SALEM,2021-03-03,4,210,0,214
TAMIL NADU,SALEM,2021-03-04,1,870,2,873
TAMIL NADU,SALEM,2021-03-05,5,1018,1,1024
TAMIL NADU,SIVAGANGA,2021-03-01,1,279,0,280
TAMIL NADU,SIVAGANGA,2021-03-02,3,557,0,560
TAMIL NADU,SIVAGANGA,2021-03-03,5,565,0,570
TAMIL NADU,SIVAGANGA,2021-03-04,2,443,0,445
TAMIL NADU,SIVAGANGA,2021-03-05,2,562,0,564
TAMIL NADU,TENKASI,2021-03-01,6,284,3,293
TAMIL NADU,TENKASI,2021-03-02,2,459,2,463
TAMIL NADU,TENKASI,2021-03-03,5,418,2,425
TAMIL NADU,TENKASI,2021-03-04,3,455,1,459
TAMIL NADU,TENKASI,2021-03-05,2,517,1,520
TAMIL NADU,THANJAVUR,2021-03-01,26,904,0,930
TAMIL NADU,THANJAVUR,2021-03-02,17,820,33,870
TAMIL NADU,THANJAVUR,2021-03-03,17,448,3,468
TAMIL NADU,THANJAVUR,2021-03-04,15,705,0,720
TAMIL NADU,THANJAVUR,2021-03-05,25,612,3,640
TAMIL NADU,THE NILGIRIS,2021-03-01,6,1643,47,1696
TAMIL NADU,THE NILGIRIS,2021-03-02,7,1722,6,1735
TAMIL NADU,THE NILGIRIS,2021-03-03,3,1038,3,1044
TAMIL NADU,THE NILGIRIS,2021-03-04,4,966,12,982
TAMIL NADU,THE NILGIRIS,2021-03-05,5,954,4,963
TAMIL NADU,THENI,2021-03-01,2,117,0,119
TAMIL NADU,THENI,2021-03-02,5,470,0,475
TAMIL NADU,THENI,2021-03-03,2,516,0,518
TAMIL NADU,THENI,2021-03-04,2,456,0,458
TAMIL NADU,THENI,2021-03-05,3,461,0,464
TAMIL NADU,THIRUVALLUR,2021-03-01,11,1747,1,1759
TAMIL NADU,THIRUVALLUR,2021-03-02,43,1833,19,1895
TAMIL NADU,THIRUVALLUR,2021-03-03,36,1702,3,1741
TAMIL NADU,THIRUVALLUR,2021-03-04,54,1492,3,1549
TAMIL NADU,THIRUVALLUR,2021-03-05,50,1806,0,1856
TAMIL NADU,THIRUVARUR,2021-03-01,6,926,0,932
TAMIL NADU,THIRUVARUR,2021-03-02,10,775,7,792
TAMIL NADU,THIRUVARUR,2021-03-03,5,602,0,607
TAMIL NADU,THIRUVARUR,2021-03-04,10,786,0,796
TAMIL NADU,THIRUVARUR,2021-03-05,9,752,0,761
TAMIL NADU,TIRUCHIRAPPALLI,2021-03-01,12,1314,0,1326
TAMIL NADU,TIRUCHIRAPPALLI,2021-03-02,9,1402,2,1413
TAMIL NADU,TIRUCHIRAPPALLI,2021-03-03,12,1420,1,1433
TAMIL NADU,TIRUCHIRAPPALLI,2021-03-04,16,1502,0,1518
TAMIL NADU,TIRUCHIRAPPALLI,2021-03-05,9,1824,0,1833
TAMIL NADU,TIRUNELVELI,2021-03-01,8,941,1,950
TAMIL NADU,TIRUNELVELI,2021-03-02,7,817,33,857
TAMIL NADU,TIRUNELVELI,2021-03-03,8,972,2,982
TAMIL NADU,TIRUNELVELI,2021-03-04,5,630,0,635
TAMIL NADU,TIRUNELVELI,2021-03-05,7,961,0,968
TAMIL NADU,TIRUPATHUR,2021-03-01,0,2046,0,2046
TAMIL NADU,TIRUPATHUR,2021-03-02,4,2166,22,2192
TAMIL NADU,TIRUPATHUR,2021-03-03,0,1995,1,1996
TAMIL NADU,TIRUPATHUR,2021-03-04,2,2235,0,2237
TAMIL NADU,TIRUPATHUR,2021-03-05,2,2139,3,2144
TAMIL NADU,TIRUPPUR,2021-03-01,7,947,0,954
TAMIL NADU,TIRUPPUR,2021-03-02,25,1537,0,1562
TAMIL NADU,TIRUPPUR,2021-03-03,22,1338,0,1360
TAMIL NADU,TIRUPPUR,2021-03-04,27,2228,0,2255
TAMIL NADU,TIRUPPUR,2021-03-05,20,1015,0,1035
TAMIL NADU,TIRUVANNAMALAI,2021-03-01,2,704,0,706
TAMIL NADU,TIRUVANNAMALAI,2021-03-02,6,826,1,833
TAMIL NADU,TIRUVANNAMALAI,2021-03-03,4,482,2,488
TAMIL NADU,TIRUVANNAMALAI,2021-03-04,0,572,0,572
TAMIL NADU,TIRUVANNAMALAI,2021-03-05,3,456,0,459
TAMIL NADU,TUTICORIN,2021-03-01,1,200,1,202
TAMIL NADU,TUTICORIN,2021-03-02,1,423,0,424
TAMIL NADU,TUTICORIN,2021-03-03,2,461,0,463
TAMIL NADU,TUTICORIN,2021-03-04,1,635,0,636
TAMIL NADU,TUTICORIN,2021-03-05,1,547,1,549
TAMIL NADU,VELLORE,2021-03-01,7,1546,0,1553
TAMIL NADU,VELLORE,2021-03-02,7,1469,0,1476
TAMIL NADU,VELLORE,2021-03-03,10,1084,0,1094
TAMIL NADU,VELLORE,2021-03-04,19,1144,0,1163
TAMIL NADU,VELLORE,2021-03-05,6,1142,0,1148
TAMIL NADU,VILLUPURAM,2021-03-01,1,593,1,595
TAMIL NADU,VILLUPURAM,2021-03-02,5,738,0,743
TAMIL NADU,VILLUPURAM,2021-03-03,2,803,0,805
TAMIL NADU,VILLUPURAM,2021-03-04,2,859,0,861
TAMIL NADU,VILLUPURAM,2021-03-05,6,846,1,853
TAMIL NADU,VIRUDHUNAGAR,2021-03-01,1,980,1,982
TAMIL NADU,VIRUDHUNAGAR,2021-03-02,1,1373,3,1377
TAMIL NADU,VIRUDHUNAGAR,2021-03-03,4,1194,1,1199
TAMIL NADU,VIRUDHUNAGAR,2021-03-04,3,1375,6,1384
TAMIL NADU,VIRUDHUNAGAR,2021-03-05,5,810,0,815
TELANGANA,ADILABAD,2021-03-01,1,449,1,451
TELANGANA,ADILABAD,2021-03-02,1,363,0,364
TELANGANA,ADILABAD,2021-03-03,0,292,0,292
TELANGANA,ADILABAD,2021-03-04,0,350,1,351
TELANGANA,ADILABAD,2021-03-05,1,396,0,397
TELANGANA,BHADRADRI KOTHAGUDEM,2021-03-01,0,605,0,605
TELANGANA,BHADRADRI KOTHAGUDEM,2021-03-02,0,576,0,576
TELANGANA,BHADRADRI KOTHAGUDEM,2021-03-03,0,589,0,589
TELANGANA,BHADRADRI KOTHAGUDEM,2021-03-04,0,487,0,487
TELANGANA,BHADRADRI KOTHAGUDEM,2021-03-05,1,483,0,484
TELANGANA,HYDERABAD,2021-03-01,27,7541,14,7582
TELANGANA,HYDERABAD,2021-03-02,22,7180,13,7215
TELANGANA,HYDERABAD,2021-03-03,27,7490,6,7523
TELANGANA,HYDERABAD,2021-03-04,32,7289,9,7330
TELANGANA,HYDERABAD,2021-03-05,30,7213,6,7249
TELANGANA,JAGITIAL,2021-03-01,0,921,0,921
TELANGANA,JAGITIAL,2021-03-02,0,779,0,779
TELANGANA,JAGITIAL,2021-03-03,0,764,0,764
TELANGANA,JAGITIAL,2021-03-04,0,666,0,666
TELANGANA,JAGITIAL,2021-03-05,0,609,0,609
TELANGANA,JANGOAN,2021-03-01,0,592,0,592
TELANGANA,JANGOAN,2021-03-02,0,707,0,707
TELANGANA,JANGOAN,2021-03-03,0,602,0,602
TELANGANA,JANGOAN,2021-03-04,0,592,0,592
TELANGANA,JANGOAN,2021-03-05,0,608,0,608
TELANGANA,JAYASHANKAR BHUPALAPALLY,2021-03-01,0,379,0,379
TELANGANA,JAYASHANKAR BHUPALAPALLY,2021-03-02,0,295,0,295
TELANGANA,JAYASHANKAR BHUPALAPALLY,2021-03-03,0,268,0,268
TELANGANA,JAYASHANKAR BHUPALAPALLY,2021-03-04,0,183,0,183
TELANGANA,JAYASHANKAR BHUPALAPALLY,2021-03-05,0,354,0,354
TELANGANA,JOGULAMBA GADWAL,2021-03-01,0,495,0,495
TELANGANA,JOGULAMBA GADWAL,2021-03-02,0,526,0,526
TELANGANA,JOGULAMBA GADWAL,2021-03-03,0,753,0,753
TELANGANA,JOGULAMBA GADWAL,2021-03-04,0,711,0,711
TELANGANA,JOGULAMBA GADWAL,2021-03-05,0,546,0,546
TELANGANA,KAMAREDDY,2021-03-01,0,664,0,664
TELANGANA,KAMAREDDY,2021-03-02,0,687,0,687
TELANGANA,KAMAREDDY,2021-03-03,0,524,0,524
TELANGANA,KAMAREDDY,2021-03-04,0,658,0,658
TELANGANA,KAMAREDDY,2021-03-05,0,609,0,609
TELANGANA,KARIMNAGAR,2021-03-01,0,1526,0,1526
TELANGANA,KARIMNAGAR,2021-03-02,1,1191,0,1192
TELANGANA,KARIMNAGAR,2021-03-03,0,1248,0,1248
TELANGANA,KARIMNAGAR,2021-03-04,1,1323,0,1324
TELANGANA,KARIMNAGAR,2021-03-05,0,1163,0,1163
TELANGANA,KHAMMAM,2021-03-01,1,999,0,1000
TELANGANA,KHAMMAM,2021-03-02,1,751,0,752
TELANGANA,KHAMMAM,2021-03-03,1,605,0,606
TELANGANA,KHAMMAM,2021-03-04,0,705,0,705
TELANGANA,KHAMMAM,2021-03-05,0,832,0,832
TELANGANA,KUMURAM BHEEM ASIFABAD,2021-03-01,0,246,0,246
TELANGANA,KUMURAM BHEEM ASIFABAD,2021-03-02,0,287,0,287
TELANGANA,KUMURAM BHEEM ASIFABAD,2021-03-03,0,193,0,193
TELANGANA,KUMURAM BHEEM ASIFABAD,2021-03-04,0,213,0,213
TELANGANA,KUMURAM BHEEM ASIFABAD,2021-03-05,0,302,0,302
TELANGANA,MAHABUBABAD,2021-03-01,0,415,0,415
TELANGANA,MAHABUBABAD,2021-03-02,0,338,0,338
TELANGANA,MAHABUBABAD,2021-03-03,0,352,0,352
TELANGANA,MAHABUBABAD,2021-03-04,0,468,0,468
TELANGANA,MAHABUBABAD,2021-03-05,0,310,0,310
TELANGANA,MAHABUBNAGAR,2021-03-01,0,996,0,996
TELANGANA,MAHABUBNAGAR,2021-03-02,0,885,0,885
TELANGANA,MAHABUBNAGAR,2021-03-03,0,795,0,795
TELANGANA,MAHABUBNAGAR,2021-03-04,0,866,0,866
TELANGANA,MAHABUBNAGAR,2021-03-05,0,643,0,643
TELANGANA,MANCHERIAL,2021-03-01,0,974,0,974
TELANGANA,MANCHERIAL,2021-03-02,0,1039,0,1039
TELANGANA,MANCHERIAL,2021-03-03,0,763,0,763
TELANGANA,MANCHERIAL,2021-03-04,0,838,0,838
TELANGANA,MANCHERIAL,2021-03-05,0,698,0,698
TELANGANA,MEDAK,2021-03-01,0,439,0,439
TELANGANA,MEDAK,2021-03-02,0,397,1,398
TELANGANA,MEDAK,2021-03-03,2,351,0,353
TELANGANA,MEDAK,2021-03-04,3,435,0,438
TELANGANA,MEDAK,2021-03-05,1,550,0,551
TELANGANA,MEDCHAL MALKAJGIRI,2021-03-01,2,2053,0,2055
TELANGANA,MEDCHAL MALKAJGIRI,2021-03-02,0,2047,1,2048
TELANGANA,MEDCHAL MALKAJGIRI,2021-03-03,0,1878,0,1878
TELANGANA,MEDCHAL MALKAJGIRI,2021-03-04,1,2078,1,2080
TELANGANA,MEDCHAL MALKAJGIRI,2021-03-05,1,1985,0,1986
TELANGANA,MULUGU,2021-03-01,0,208,0,208
TELANGANA,MULUGU,2021-03-02,0,248,0,248
TELANGANA,MULUGU,2021-03-03,0,158,0,158
TELANGANA,MULUGU,2021-03-04,0,177,0,177
TELANGANA,MULUGU,2021-03-05,0,115,0,115
TELANGANA,NAGARKURNOOL,2021-03-01,0,1591,0,1591
TELANGANA,NAGARKURNOOL,2021-03-02,0,1452,0,1452
TELANGANA,NAGARKURNOOL,2021-03-03,0,1500,0,1500
TELANGANA,NAGARKURNOOL,2021-03-04,0,1421,0,1421
TELANGANA,NAGARKURNOOL,2021-03-05,0,1572,0,1572
TELANGANA,NALGONDA,2021-03-01,0,1566,0,1566
TELANGANA,NALGONDA,2021-03-02,1,1528,0,1529
TELANGANA,NALGONDA,2021-03-03,0,1166,0,1166
TELANGANA,NALGONDA,2021-03-04,2,1886,0,1888
TELANGANA,NALGONDA,2021-03-05,1,1432,0,1433
TELANGANA,NARAYANPET,2021-03-01,0,429,0,429
TELANGANA,NARAYANPET,2021-03-02,0,249,0,249
TELANGANA,NARAYANPET,2021-03-03,0,199,0,199
TELANGANA,NARAYANPET,2021-03-04,0,319,0,319
TELANGANA,NARAYANPET,2021-03-05,0,197,0,197
TELANGANA,NIRMAL,2021-03-01,0,525,0,525
TELANGANA,NIRMAL,2021-03-02,0,376,0,376
TELANGANA,NIRMAL,2021-03-03,0,568,0,568
TELANGANA,NIRMAL,2021-03-04,0,492,0,492
TELANGANA,NIRMAL,2021-03-05,0,534,0,534
TELANGANA,NIZAMABAD,2021-03-01,0,859,0,859
TELANGANA,NIZAMABAD,2021-03-02,1,760,0,761
TELANGANA,NIZAMABAD,2021-03-03,0,740,0,740
TELANGANA,NIZAMABAD,2021-03-04,0,807,0,807
TELANGANA,NIZAMABAD,2021-03-05,0,791,0,791
TELANGANA,PEDDAPALLI,2021-03-01,0,1201,0,1201
TELANGANA,PEDDAPALLI,2021-03-02,0,1170,0,1170
TELANGANA,PEDDAPALLI,2021-03-03,0,1141,0,1141
TELANGANA,PEDDAPALLI,2021-03-04,0,924,0,924
TELANGANA,PEDDAPALLI,2021-03-05,0,1054,0,1054
TELANGANA,RAJANNA SIRCILLA,2021-03-01,0,340,0,340
TELANGANA,RAJANNA SIRCILLA,2021-03-02,1,302,0,303
TELANGANA,RAJANNA SIRCILLA,2021-03-03,0,460,0,460
TELANGANA,RAJANNA SIRCILLA,2021-03-04,0,291,0,291
TELANGANA,RAJANNA SIRCILLA,2021-03-05,0,275,0,275
TELANGANA,RANGA REDDY,2021-03-01,3,2955,1,2959
TELANGANA,RANGA REDDY,2021-03-02,7,2937,6,2950
TELANGANA,RANGA REDDY,2021-03-03,1,2669,0,2670
TELANGANA,RANGA REDDY,2021-03-04,4,2625,2,2631
TELANGANA,RANGA REDDY,2021-03-05,7,2910,0,2917
TELANGANA,SANGAREDDY,2021-03-01,0,1191,0,1191
TELANGANA,SANGAREDDY,2021-03-02,1,1002,0,1003
TELANGANA,SANGAREDDY,2021-03-03,0,733,0,733
TELANGANA,SANGAREDDY,2021-03-04,0,752,0,752
TELANGANA,SANGAREDDY,2021-03-05,0,1039,0,1039
TELANGANA,SIDDIPET,2021-03-01,0,1688,0,1688
TELANGANA,SIDDIPET,2021-03-02,0,1473,0,1473
TELANGANA,SIDDIPET,2021-03-03,1,1091,0,1092
TELANGANA,SIDDIPET,2021-03-04,0,1128,0,1128
TELANGANA,SIDDIPET,2021-03-05,0,1546,0,1546
TELANGANA,SURYAPET,2021-03-01,0,960,0,960
TELANGANA,SURYAPET,2021-03-02,0,762,0,762
TELANGANA,SURYAPET,2021-03-03,0,1029,0,1029
TELANGANA,SURYAPET,2021-03-04,0,858,0,858
TELANGANA,SURYAPET,2021-03-05,0,736,0,736
TELANGANA,VIKARABAD,2021-03-01,0,692,0,692
TELANGANA,VIKARABAD,2021-03-02,0,743,0,743
TELANGANA,VIKARABAD,2021-03-03,0,1242,1,1243
TELANGANA,VIKARABAD,2021-03-04,0,881,0,881
TELANGANA,VIKARABAD,2021-03-05,0,465,0,465
TELANGANA,WANAPARTHY,2021-03-01,0,602,0,602
TELANGANA,WANAPARTHY,2021-03-02,0,492,0,492
TELANGANA,WANAPARTHY,2021-03-03,0,472,0,472
TELANGANA,WANAPARTHY,2021-03-04,0,372,0,372
TELANGANA,WANAPARTHY,2021-03-05,0,427,0,427
TELANGANA,WARANGAL RURAL,2021-03-01,0,444,0,444
TELANGANA,WARANGAL RURAL,2021-03-02,0,301,0,301
TELANGANA,WARANGAL RURAL,2021-03-03,1,359,0,360
TELANGANA,WARANGAL RURAL,2021-03-04,0,490,0,490
TELANGANA,WARANGAL RURAL,2021-03-05,3,790,0,793
TELANGANA,WARANGAL URBAN,2021-03-01,0,2161,0,2161
TELANGANA,WARANGAL URBAN,2021-03-02,0,1553,0,1553
TELANGANA,WARANGAL URBAN,2021-03-03,0,1684,0,1684
TELANGANA,WARANGAL URBAN,2021-03-04,0,1766,0,1766
TELANGANA,WARANGAL URBAN,2021-03-05,0,1934,0,1934
TELANGANA,YADADRI BHUVANAGIRI,2021-03-01,0,303,0,303
TELANGANA,YADADRI BHUVANAGIRI,2021-03-02,0,241,0,241
TELANGANA,YADADRI BHUVANAGIRI,2021-03-03,0,247,0,247
TELANGANA,YADADRI BHUVANAGIRI,2021-03-04,0,661,0,661
TELANGANA,YADADRI BHUVANAGIRI,2021-03-05,0,337,0,337
TRIPURA,DHALAI,2021-03-01,0,17,0,17
TRIPURA,DHALAI,2021-03-02,0,38,0,38
TRIPURA,DHALAI,2021-03-03,0,7,0,7
TRIPURA,DHALAI,2021-03-04,0,9,0,9
TRIPURA,DHALAI,2021-03-05,0,43,0,43
TRIPURA,GOMATI,2021-03-01,0,41,0,41
TRIPURA,GOMATI,2021-03-02,0,49,0,49
TRIPURA,GOMATI,2021-03-03,0,26,0,26
TRIPURA,GOMATI,2021-03-04,0,41,0,41
TRIPURA,GOMATI,2021-03-05,0,35,0,35
TRIPURA,KHOWAI,2021-03-01,0,23,0,23
TRIPURA,KHOWAI,2021-03-02,0,19,0,19
TRIPURA,KHOWAI,2021-03-03,0,17,0,17
TRIPURA,KHOWAI,2021-03-04,0,18,0,18
TRIPURA,KHOWAI,2021-03-05,0,48,0,48
TRIPURA,NORTH TRIPURA,2021-03-01,0,96,0,96
TRIPURA,NORTH TRIPURA,2021-03-02,0,73,0,73
TRIPURA,NORTH TRIPURA,2021-03-03,0,114,0,114
TRIPURA,NORTH TRIPURA,2021-03-04,0,62,0,62
TRIPURA,NORTH TRIPURA,2021-03-05,0,63,0,63
TRIPURA,SEPAHIJALA,2021-03-01,0,39,0,39
TRIPURA,SEPAHIJALA,2021-03-02,0,70,0,70
TRIPURA,SEPAHIJALA,2021-03-03,1,50,0,51
TRIPURA,SEPAHIJALA,2021-03-04,0,41,0,41
TRIPURA,SEPAHIJALA,2021-03-05,0,38,0,38
TRIPURA,SOUTH TRIPURA,2021-03-01,0,51,0,51
TRIPURA,SOUTH TRIPURA,2021-03-02,0,70,0,70
TRIPURA,SOUTH TRIPURA,2021-03-03,0,32,0,32
TRIPURA,SOUTH TRIPURA,2021-03-04,0,85,0,85
TRIPURA,SOUTH TRIPURA,2021-03-05,0,51,0,51
TRIPURA,UNAKOTI,2021-03-01,0,1,0,1
TRIPURA,UNAKOTI,2021-03-02,0,7,0,7
TRIPURA,UNAKOTI,2021-03-03,0,12,0,12
TRIPURA,UNAKOTI,2021-03-04,0,33,0,33
TRIPURA,UNAKOTI,2021-03-05,0,11,0,11
TRIPURA,WEST TRIPURA,2021-03-01,2,270,0,272
TRIPURA,WEST TRIPURA,2021-03-02,0,266,0,266
TRIPURA,WEST TRIPURA,2021-03-03,3,215,0,218
TRIPURA,WEST TRIPURA,2021-03-04,2,206,0,208
TRIPURA,WEST TRIPURA,2021-03-05,0,235,0,235
UTTAR PRADESH,AGRA,2021-03-01,1,3475,54,3530
UTTAR PRADESH,AGRA,2021-03-02,2,7539,1,7542
UTTAR PRADESH,AGRA,2021-03-03,0,5196,3,5199
UTTAR PRADESH,AGRA,2021-03-04,4,5172,2,5178
UTTAR PRADESH,AGRA,2021-03-05,1,4348,3,4352
UTTAR PRADESH,ALIGARH,2021-03-01,0,2393,0,2393
UTTAR PRADESH,ALIGARH,2021-03-02,2,2643,1,2646
UTTAR PRADESH,ALIGARH,2021-03-03,2,2076,2,2080
UTTAR PRADESH,ALIGARH,2021-03-04,5,2533,8,2546
UTTAR PRADESH,ALIGARH,2021-03-05,9,2495,4,2508
UTTAR PRADESH,AMBEDKAR NAGAR,2021-03-01,0,1301,44,1345
UTTAR PRADESH,AMBEDKAR NAGAR,2021-03-02,1,1537,36,1574
UTTAR PRADESH,AMBEDKAR NAGAR,2021-03-03,0,1403,3,1406
UTTAR PRADESH,AMBEDKAR NAGAR,2021-03-04,2,992,1,995
UTTAR PRADESH,AMBEDKAR NAGAR,2021-03-05,0,831,0,831
UTTAR PRADESH,AMETHI,2021-03-01,0,770,0,770
UTTAR PRADESH,AMETHI,2021-03-02,0,1302,20,1322
UTTAR PRADESH,AMETHI,2021-03-03,3,985,0,988
UTTAR PRADESH,AMETHI,2021-03-04,1,1382,30,1413
UTTAR PRADESH,AMETHI,2021-03-05,1,618,12,631
UTTAR PRADESH,AMROHA,2021-03-01,0,599,0,599
UTTAR PRADESH,AMROHA,2021-03-02,0,773,0,773
UTTAR PRADESH,AMROHA,2021-03-03,2,991,0,993
UTTAR PRADESH,AMROHA,2021-03-04,4,822,1,827
UTTAR PRADESH,AMROHA,2021-03-05,1,49,0,50
UTTAR PRADESH,AURAIYA,2021-03-01,0,759,39,798
UTTAR PRADESH,AURAIYA,2021-03-02,0,892,66,958
UTTAR PRADESH,AURAIYA,2021-03-03,1,763,22,786
UTTAR PRADESH,AURAIYA,2021-03-04,0,887,80,967
UTTAR PRADESH,AURAIYA,2021-03-05,0,713,107,820
UTTAR PRADESH,AYODHYA,2021-03-01,0,934,1,935
UTTAR PRADESH,AYODHYA,2021-03-02,0,1413,1,1414
UTTAR PRADESH,AYODHYA,2021-03-03,1,1641,0,1642
UTTAR PRADESH,AYODHYA,2021-03-04,0,1364,2,1366
UTTAR PRADESH,AYODHYA,2021-03-05,4,1087,0,1091
UTTAR PRADESH,AZAMGARH,2021-03-01,0,207,1,208
UTTAR PRADESH,AZAMGARH,2021-03-02,1,774,1,776
UTTAR PRADESH,AZAMGARH,2021-03-03,1,915,0,916
UTTAR PRADESH,AZAMGARH,2021-03-04,0,795,5,800
UTTAR PRADESH,AZAMGARH,2021-03-05,1,619,5,625
UTTAR PRADESH,BAGHPAT,2021-03-01,0,422,18,440
UTTAR PRADESH,BAGHPAT,2021-03-02,1,1826,65,1892
UTTAR PRADESH,BAGHPAT,2021-03-03,2,1521,54,1577
UTTAR PRADESH,BAGHPAT,2021-03-04,2,1249,7,1258
UTTAR PRADESH,BAGHPAT,2021-03-05,0,1424,17,1441
UTTAR PRADESH,BAHRAICH,2021-03-01,0,1745,45,1790
UTTAR PRADESH,BAHRAICH,2021-03-02,0,1874,21,1895
UTTAR PRADESH,BAHRAICH,2021-03-03,0,1749,42,1791
UTTAR PRADESH,BAHRAICH,2021-03-04,1,1769,0,1770
UTTAR PRADESH,BAHRAICH,2021-03-05,1,1732,4,1737
UTTAR PRADESH,BALLIA,2021-03-01,2,1602,3,1607
UTTAR PRADESH,BALLIA,2021-03-02,1,1338,0,1339
UTTAR PRADESH,BALLIA,2021-03-03,4,1837,31,1872
UTTAR PRADESH,BALLIA,2021-03-04,2,1764,31,1797
UTTAR PRADESH,BALLIA,2021-03-05,1,1946,4,1951
UTTAR PRADESH,BALRAMPUR,2021-03-01,0,936,0,936
UTTAR PRADESH,BALRAMPUR,2021-03-02,0,903,1,904
UTTAR PRADESH,BALRAMPUR,2021-03-03,0,661,0,661
UTTAR PRADESH,BALRAMPUR,2021-03-04,1,736,0,737
UTTAR PRADESH,BALRAMPUR,2021-03-05,0,828,0,828
UTTAR PRADESH,BANDA,2021-03-01,0,1830,44,1874
UTTAR PRADESH,BANDA,2021-03-02,1,1760,10,1771
UTTAR PRADESH,BANDA,2021-03-03,0,1640,26,1666
UTTAR PRADESH,BANDA,2021-03-04,0,1696,7,1703
UTTAR PRADESH,BANDA,2021-03-05,2,1617,18,1637
UTTAR PRADESH,BARABANKI,2021-03-01,2,962,0,964
UTTAR PRADESH,BARABANKI,2021-03-02,0,1310,2,1312
UTTAR PRADESH,BARABANKI,2021-03-03,1,1273,1,1275
UTTAR PRADESH,BARABANKI,2021-03-04,1,1268,12,1281
UTTAR PRADESH,BARABANKI,2021-03-05,0,1377,3,1380
UTTAR PRADESH,BAREILLY,2021-03-01,8,3361,2,3371
UTTAR PRADESH,BAREILLY,2021-03-02,2,2172,1,2175
UTTAR PRADESH,BAREILLY,2021-03-03,3,2478,19,2500
UTTAR PRADESH,BAREILLY,2021-03-04,11,3368,4,3383
UTTAR PRADESH,BAREILLY,2021-03-05,16,1443,10,1469
UTTAR PRADESH,BASTI,2021-03-01,2,722,0,724
UTTAR PRADESH,BASTI,2021-03-02,0,839,1,840
UTTAR PRADESH,BASTI,2021-03-03,0,876,0,876
UTTAR PRADESH,BASTI,2021-03-04,1,905,0,906
UTTAR PRADESH,BASTI,2021-03-05,2,482,2,486
UTTAR PRADESH,BHADOHI,2021-03-01,0,1482,0,1482
UTTAR PRADESH,BHADOHI,2021-03-02,0,1761,1,1762
UTTAR PRADESH,BHADOHI,2021-03-03,0,1358,1,1359
UTTAR PRADESH,BHADOHI,2021-03-04,1,842,0,843
UTTAR PRADESH,BHADOHI,2021-03-05,0,850,0,850
UTTAR PRADESH,BIJNOR,2021-03-01,1,926,1,928
UTTAR PRADESH,BIJNOR,2021-03-02,3,1555,0,1558
UTTAR PRADESH,BIJNOR,2021-03-03,2,1429,0,1431
UTTAR PRADESH,BIJNOR,2021-03-04,0,1289,0,1289
UTTAR PRADESH,BIJNOR,2021-03-05,5,1277,1,1283
UTTAR PRADESH,BUDAUN,2021-03-01,2,1127,39,1168
UTTAR PRADESH,BUDAUN,2021-03-02,0,3022,30,3052
UTTAR PRADESH,BUDAUN,2021-03-03,0,393,29,422
UTTAR PRADESH,BUDAUN,2021-03-04,0,2403,57,2460
UTTAR PRADESH,BUDAUN,2021-03-05,1,2001,35,2037
UTTAR PRADESH,BULANDSHAHR,2021-03-01,2,420,0,422
UTTAR PRADESH,BULANDSHAHR,2021-03-02,0,1568,1,1569
UTTAR PRADESH,BULANDSHAHR,2021-03-03,1,2048,85,2134
UTTAR PRADESH,BULANDSHAHR,2021-03-04,0,1991,8,1999
UTTAR PRADESH,BULANDSHAHR,2021-03-05,0,1912,5,1917
UTTAR PRADESH,CHANDAULI,2021-03-01,0,301,8,309
UTTAR PRADESH,CHANDAULI,2021-03-02,0,1210,5,1215
UTTAR PRADESH,CHANDAULI,2021-03-03,1,780,6,787
UTTAR PRADESH,CHANDAULI,2021-03-04,0,901,8,909
UTTAR PRADESH,CHANDAULI,2021-03-05,1,973,0,974
UTTAR PRADESH,CHITRAKOOT,2021-03-01,0,935,8,943
UTTAR PRADESH,CHITRAKOOT,2021-03-02,0,1382,0,1382
UTTAR PRADESH,CHITRAKOOT,2021-03-03,0,1133,25,1158
UTTAR PRADESH,CHITRAKOOT,2021-03-04,0,1302,0,1302
UTTAR PRADESH,CHITRAKOOT,2021-03-05,2,1005,26,1033
UTTAR PRADESH,DEORIA,2021-03-01,0,1240,4,1244
UTTAR PRADESH,DEORIA,2021-03-02,0,327,2,329
UTTAR PRADESH,DEORIA,2021-03-03,1,711,164,876
UTTAR PRADESH,DEORIA,2021-03-04,1,1207,1,1209
UTTAR PRADESH,DEORIA,2021-03-05,1,1149,1,1151
UTTAR PRADESH,ETAH,2021-03-01,0,707,12,719
UTTAR PRADESH,ETAH,2021-03-02,1,847,3,851
UTTAR PRADESH,ETAH,2021-03-03,0,1123,179,1302
UTTAR PRADESH,ETAH,2021-03-04,1,655,18,674
UTTAR PRADESH,ETAH,2021-03-05,0,1204,12,1216
UTTAR PRADESH,ETAWAH,2021-03-01,1,1074,18,1093
UTTAR PRADESH,ETAWAH,2021-03-02,1,1524,68,1593
UTTAR PRADESH,ETAWAH,2021-03-03,0,1505,85,1590
UTTAR PRADESH,ETAWAH,2021-03-04,0,1598,83,1681
UTTAR PRADESH,ETAWAH,2021-03-05,0,1265,21,1286
UTTAR PRADESH,FARRUKHABAD,2021-03-01,1,658,35,694
UTTAR PRADESH,FARRUKHABAD,2021-03-02,0,776,76,852
UTTAR PRADESH,FARRUKHABAD,2021-03-03,1,767,10,778
UTTAR PRADESH,FARRUKHABAD,2021-03-04,0,690,52,742
UTTAR PRADESH,FARRUKHABAD,2021-03-05,1,654,5,660
UTTAR PRADESH,FATEHPUR,2021-03-01,1,948,51,1000
UTTAR PRADESH,FATEHPUR,2021-03-02,2,736,103,841
UTTAR PRADESH,FATEHPUR,2021-03-03,0,1416,114,1530
UTTAR PRADESH,FATEHPUR,2021-03-04,1,992,49,1042
UTTAR PRADESH,FATEHPUR,2021-03-05,0,1064,190,1254
UTTAR PRADESH,FIROZABAD,2021-03-01,2,1969,0,1971
UTTAR PRADESH,FIROZABAD,2021-03-02,0,2160,0,2160
UTTAR PRADESH,FIROZABAD,2021-03-03,0,2278,8,2286
UTTAR PRADESH,FIROZABAD,2021-03-04,0,1910,9,1919
UTTAR PRADESH,FIROZABAD,2021-03-05,1,1749,21,1771
UTTAR PRADESH,GAUTAM BUDDHA NAGAR,2021-03-01,37,2505,24,2566
UTTAR PRADESH,GAUTAM BUDDHA NAGAR,2021-03-02,27,1939,71,2037
UTTAR PRADESH,GAUTAM BUDDHA NAGAR,2021-03-03,42,2168,40,2250
UTTAR PRADESH,GAUTAM BUDDHA NAGAR,2021-03-04,25,2674,13,2712
UTTAR PRADESH,GAUTAM BUDDHA NAGAR,2021-03-05,31,2710,8,2749
UTTAR PRADESH,GHAZIABAD,2021-03-01,25,1842,68,1935
UTTAR PRADESH,GHAZIABAD,2021-03-02,12,3966,143,4121
UTTAR PRADESH,GHAZIABAD,2021-03-03,14,3189,63,3266
UTTAR PRADESH,GHAZIABAD,2021-03-04,21,3035,77,3133
UTTAR PRADESH,GHAZIABAD,2021-03-05,33,3364,18,3415
UTTAR PRADESH,GHAZIPUR,2021-03-01,1,419,0,420
UTTAR PRADESH,GHAZIPUR,2021-03-02,3,952,56,1011
UTTAR PRADESH,GHAZIPUR,2021-03-03,3,589,5,597
UTTAR PRADESH,GHAZIPUR,2021-03-04,4,935,8,947
UTTAR PRADESH,GHAZIPUR,2021-03-05,1,708,1,710
UTTAR PRADESH,GONDA,2021-03-01,0,1438,0,1438
UTTAR PRADESH,GONDA,2021-03-02,1,1392,33,1426
UTTAR PRADESH,GONDA,2021-03-03,1,1470,91,1562
UTTAR PRADESH,GONDA,2021-03-04,0,1226,1,1227
UTTAR PRADESH,GONDA,2021-03-05,0,1178,1,1179
UTTAR PRADESH,GORAKHPUR,2021-03-01,4,971,2,977
UTTAR PRADESH,GORAKHPUR,2021-03-02,3,1488,0,1491
UTTAR PRADESH,GORAKHPUR,2021-03-03,4,1800,99,1903
UTTAR PRADESH,GORAKHPUR,2021-03-04,0,1730,72,1802
UTTAR PRADESH,GORAKHPUR,2021-03-05,4,2163,35,2202
UTTAR PRADESH,HAMIRPUR,2021-03-01,1,589,35,625
UTTAR PRADESH,HAMIRPUR,2021-03-02,0,880,0,880
UTTAR PRADESH,HAMIRPUR,2021-03-03,0,811,31,842
UTTAR PRADESH,HAMIRPUR,2021-03-04,1,782,7,790
UTTAR PRADESH,HAMIRPUR,2021-03-05,0,836,40,876
UTTAR PRADESH,HAPUR,2021-03-01,0,527,55,582
UTTAR PRADESH,HAPUR,2021-03-02,1,1297,108,1406
UTTAR PRADESH,HAPUR,2021-03-03,0,511,28,539
UTTAR PRADESH,HAPUR,2021-03-04,0,2338,82,2420
UTTAR PRADESH,HAPUR,2021-03-05,0,1368,119,1487
UTTAR PRADESH,HARDOI,2021-03-01,1,837,138,976
UTTAR PRADESH,HARDOI,2021-03-02,0,1410,47,1457
UTTAR PRADESH,HARDOI,2021-03-03,0,1429,2,1431
UTTAR PRADESH,HARDOI,2021-03-04,0,1498,82,1580
UTTAR PRADESH,HARDOI,2021-03-05,1,1505,3,1509
UTTAR PRADESH,HATHRAS,2021-03-01,0,634,0,634
UTTAR PRADESH,HATHRAS,2021-03-02,0,943,0,943
UTTAR PRADESH,HATHRAS,2021-03-03,1,1125,0,1126
UTTAR PRADESH,HATHRAS,2021-03-04,0,1749,0,1749
UTTAR PRADESH,HATHRAS,2021-03-05,0,367,0,367
UTTAR PRADESH,JALAUN,2021-03-01,3,892,0,895
UTTAR PRADESH,JALAUN,2021-03-02,3,1067,2,1072
UTTAR PRADESH,JALAUN,2021-03-03,2,1041,0,1043
UTTAR PRADESH,JALAUN,2021-03-04,3,1051,0,1054
UTTAR PRADESH,JALAUN,2021-03-05,2,1159,7,1168
UTTAR PRADESH,JAUNPUR,2021-03-01,0,1576,38,1614
UTTAR PRADESH,JAUNPUR,2021-03-02,4,2318,30,2352
UTTAR PRADESH,JAUNPUR,2021-03-03,0,582,1,583
UTTAR PRADESH,JAUNPUR,2021-03-04,2,1065,5,1072
UTTAR PRADESH,JAUNPUR,2021-03-05,4,1308,97,1409
UTTAR PRADESH,JHANSI,2021-03-01,2,2031,6,2039
UTTAR PRADESH,JHANSI,2021-03-02,1,2172,1,2174
UTTAR PRADESH,JHANSI,2021-03-03,0,1985,0,1985
UTTAR PRADESH,JHANSI,2021-03-04,2,2138,1,2141
UTTAR PRADESH,JHANSI,2021-03-05,3,1633,0,1636
UTTAR PRADESH,KANNAUJ,2021-03-01,0,1373,0,1373
UTTAR PRADESH,KANNAUJ,2021-03-02,0,1681,0,1681
UTTAR PRADESH,KANNAUJ,2021-03-03,0,1532,0,1532
UTTAR PRADESH,KANNAUJ,2021-03-04,0,1754,1,1755
UTTAR PRADESH,KANNAUJ,2021-03-05,1,1607,0,1608
UTTAR PRADESH,KANPUR DEHAT,2021-03-01,0,956,0,956
UTTAR PRADESH,KANPUR DEHAT,2021-03-02,0,905,32,937
UTTAR PRADESH,KANPUR DEHAT,2021-03-03,0,1124,0,1124
UTTAR PRADESH,KANPUR DEHAT,2021-03-04,0,1423,30,1453
UTTAR PRADESH,KANPUR DEHAT,2021-03-05,1,1358,0,1359
UTTAR PRADESH,KANPUR NAGAR,2021-03-01,7,1679,2,1688
UTTAR PRADESH,KANPUR NAGAR,2021-03-02,5,2173,1,2179
UTTAR PRADESH,KANPUR NAGAR,2021-03-03,11,2166,8,2185
UTTAR PRADESH,KANPUR NAGAR,2021-03-04,3,1958,0,1961
UTTAR PRADESH,KANPUR NAGAR,2021-03-05,4,1844,2,1850
UTTAR PRADESH,KASGANJ,2021-03-01,0,782,1,783
UTTAR PRADESH,KASGANJ,2021-03-02,0,791,9,800
UTTAR PRADESH,KASGANJ,2021-03-03,0,2201,8,2209
UTTAR PRADESH,KASGANJ,2021-03-04,0,673,2,675
UTTAR PRADESH,KASGANJ,2021-03-05,0,283,27,310
UTTAR PRADESH,KAUSHAMBI,2021-03-01,0,1745,1,1746
UTTAR PRADESH,KAUSHAMBI,2021-03-02,0,1578,0,1578
UTTAR PRADESH,KAUSHAMBI,2021-03-03,0,1060,0,1060
UTTAR PRADESH,KAUSHAMBI,2021-03-04,0,888,0,888
UTTAR PRADESH,KAUSHAMBI,2021-03-05,0,912,0,912
UTTAR PRADESH,KHERI,2021-03-01,1,2002,5,2008
UTTAR PRADESH,KHERI,2021-03-02,0,2663,35,2698
UTTAR PRADESH,KHERI,2021-03-03,7,1608,0,1615
UTTAR PRADESH,KHERI,2021-03-04,12,1646,61,1719
UTTAR PRADESH,KHERI,2021-03-05,0,2235,18,2253
UTTAR PRADESH,KUSHI NAGAR,2021-03-01,2,629,0,631
UTTAR PRADESH,KUSHI NAGAR,2021-03-02,0,862,5,867
UTTAR PRADESH,KUSHI NAGAR,2021-03-03,2,834,36,872
UTTAR PRADESH,KUSHI NAGAR,2021-03-04,3,917,1,921
UTTAR PRADESH,KUSHI NAGAR,2021-03-05,0,813,37,850
UTTAR PRADESH,LALITPUR,2021-03-01,0,1574,0,1574
UTTAR PRADESH,LALITPUR,2021-03-02,4,1902,2,1908
UTTAR PRADESH,LALITPUR,2021-03-03,0,1153,0,1153
UTTAR PRADESH,LALITPUR,2021-03-04,0,1273,0,1273
UTTAR PRADESH,LALITPUR,2021-03-05,0,1616,0,1616
UTTAR PRADESH,LUCKNOW,2021-03-01,24,5747,52,5823
UTTAR PRADESH,LUCKNOW,2021-03-02,30,6429,121,6580
UTTAR PRADESH,LUCKNOW,2021-03-03,18,7252,76,7346
UTTAR PRADESH,LUCKNOW,2021-03-04,14,6737,100,6851
UTTAR PRADESH,LUCKNOW,2021-03-05,17,6121,33,6171
UTTAR PRADESH,MAHARAJGANJ,2021-03-01,0,491,1,492
UTTAR PRADESH,MAHARAJGANJ,2021-03-02,0,720,88,808
UTTAR PRADESH,MAHARAJGANJ,2021-03-03,0,672,108,780
UTTAR PRADESH,MAHARAJGANJ,2021-03-04,0,892,90,982
UTTAR PRADESH,MAHARAJGANJ,2021-03-05,1,737,46,784
UTTAR PRADESH,MAHOBA,2021-03-01,0,339,27,366
UTTAR PRADESH,MAHOBA,2021-03-02,0,448,30,478
UTTAR PRADESH,MAHOBA,2021-03-03,0,565,17,582
UTTAR PRADESH,MAHOBA,2021-03-04,0,543,0,543
UTTAR PRADESH,MAHOBA,2021-03-05,0,594,35,629
UTTAR PRADESH,MAINPURI,2021-03-01,1,1253,0,1254
UTTAR PRADESH,MAINPURI,2021-03-02,0,1539,0,1539
UTTAR PRADESH,MAINPURI,2021-03-03,0,1388,0,1388
UTTAR PRADESH,MAINPURI,2021-03-04,0,1482,0,1482
UTTAR PRADESH,MAINPURI,2021-03-05,1,1407,0,1408
UTTAR PRADESH,MATHURA,2021-03-01,3,4066,61,4130
UTTAR PRADESH,MATHURA,2021-03-02,1,837,4,842
UTTAR PRADESH,MATHURA,2021-03-03,1,1159,22,1182
UTTAR PRADESH,MATHURA,2021-03-04,5,1212,0,1217
UTTAR PRADESH,MATHURA,2021-03-05,6,1130,3,1139
UTTAR PRADESH,MAU,2021-03-01,0,903,5,908
UTTAR PRADESH,MAU,2021-03-02,0,739,1,740
UTTAR PRADESH,MAU,2021-03-03,0,1319,5,1324
UTTAR PRADESH,MAU,2021-03-04,1,548,99,648
UTTAR PRADESH,MAU,2021-03-05,1,984,0,985
UTTAR PRADESH,MEERUT,2021-03-01,6,3072,3,3081
UTTAR PRADESH,MEERUT,2021-03-02,14,3827,9,3850
UTTAR PRADESH,MEERUT,2021-03-03,2,4203,2,4207
UTTAR PRADESH,MEERUT,2021-03-04,4,3144,4,3152
UTTAR PRADESH,MEERUT,2021-03-05,2,3287,0,3289
UTTAR PRADESH,MIRZAPUR,2021-03-01,2,1259,2,1263
UTTAR PRADESH,MIRZAPUR,2021-03-02,0,1295,0,1295
UTTAR PRADESH,MIRZAPUR,2021-03-03,2,1762,0,1764
UTTAR PRADESH,MIRZAPUR,2021-03-04,0,1519,3,1522
UTTAR PRADESH,MIRZAPUR,2021-03-05,0,1156,0,1156
UTTAR PRADESH,MORADABAD,2021-03-01,0,1777,0,1777
UTTAR PRADESH,MORADABAD,2021-03-02,3,1846,1,1850
UTTAR PRADESH,MORADABAD,2021-03-03,4,2309,0,2313
UTTAR PRADESH,MORADABAD,2021-03-04,2,2179,1,2182
UTTAR PRADESH,MORADABAD,2021-03-05,1,2085,0,2086
UTTAR PRADESH,MUZAFFARNAGAR,2021-03-01,3,1137,0,1140
UTTAR PRADESH,MUZAFFARNAGAR,2021-03-02,6,1493,1,1500
UTTAR PRADESH,MUZAFFARNAGAR,2021-03-03,1,1279,0,1280
UTTAR PRADESH,MUZAFFARNAGAR,2021-03-04,1,1810,0,1811
UTTAR PRADESH,MUZAFFARNAGAR,2021-03-05,4,1972,1,1977
UTTAR PRADESH,PILIBHIT,2021-03-01,0,1306,14,1320
UTTAR PRADESH,PILIBHIT,2021-03-02,1,1118,20,1139
UTTAR PRADESH,PILIBHIT,2021-03-03,0,1366,29,1395
UTTAR PRADESH,PILIBHIT,2021-03-04,0,1230,0,1230
UTTAR PRADESH,PILIBHIT,2021-03-05,0,1327,20,1347
UTTAR PRADESH,PRATAPGARH,2021-03-01,0,1493,63,1556
UTTAR PRADESH,PRATAPGARH,2021-03-02,0,1507,48,1555
UTTAR PRADESH,PRATAPGARH,2021-03-03,0,1552,51,1603
UTTAR PRADESH,PRATAPGARH,2021-03-04,4,1299,35,1338
UTTAR PRADESH,PRATAPGARH,2021-03-05,0,1266,35,1301
UTTAR PRADESH,PRAYAGRAJ,2021-03-01,1,11235,108,11344
UTTAR PRADESH,PRAYAGRAJ,2021-03-02,1,4418,1,4420
UTTAR PRADESH,PRAYAGRAJ,2021-03-03,2,3756,3,3761
UTTAR PRADESH,PRAYAGRAJ,2021-03-04,6,4048,2,4056
UTTAR PRADESH,PRAYAGRAJ,2021-03-05,5,2796,0,2801
UTTAR PRADESH,RAE BARELI,2021-03-01,4,1785,83,1872
UTTAR PRADESH,RAE BARELI,2021-03-02,1,2425,6,2432
UTTAR PRADESH,RAE BARELI,2021-03-03,7,2147,54,2208
UTTAR PRADESH,RAE BARELI,2021-03-04,7,1950,5,1962
UTTAR PRADESH,RAE BARELI,2021-03-05,16,1720,4,1740
UTTAR PRADESH,RAMPUR,2021-03-01,0,1381,39,1420
UTTAR PRADESH,RAMPUR,2021-03-02,0,1478,25,1503
UTTAR PRADESH,RAMPUR,2021-03-03,1,1488,49,1538
UTTAR PRADESH,RAMPUR,2021-03-04,0,1567,22,1589
UTTAR PRADESH,RAMPUR,2021-03-05,1,1438,6,1445
UTTAR PRADESH,SAHARANPUR,2021-03-01,5,1400,1,1406
UTTAR PRADESH,SAHARANPUR,2021-03-02,2,2751,102,2855
UTTAR PRADESH,SAHARANPUR,2021-03-03,1,1935,55,1991
UTTAR PRADESH,SAHARANPUR,2021-03-04,4,2416,72,2492
UTTAR PRADESH,SAHARANPUR,2021-03-05,3,1355,54,1412
UTTAR PRADESH,SAMBHAL,2021-03-01,0,1412,183,1595
UTTAR PRADESH,SAMBHAL,2021-03-02,0,1377,11,1388
UTTAR PRADESH,SAMBHAL,2021-03-03,0,1534,245,1779
UTTAR PRADESH,SAMBHAL,2021-03-04,0,1085,161,1246
UTTAR PRADESH,SAMBHAL,2021-03-05,0,1554,29,1583
UTTAR PRADESH,SANT KABEER NAGAR,2021-03-01,4,1648,0,1652
UTTAR PRADESH,SANT KABEER NAGAR,2021-03-02,0,1222,2,1224
UTTAR PRADESH,SANT KABEER NAGAR,2021-03-03,3,944,0,947
UTTAR PRADESH,SANT KABEER NAGAR,2021-03-04,6,1549,1,1556
UTTAR PRADESH,SANT KABEER NAGAR,2021-03-05,2,1786,0,1788
UTTAR PRADESH,SHAHJAHANPUR,2021-03-01,17,1273,0,1290
UTTAR PRADESH,SHAHJAHANPUR,2021-03-02,1,757,6,764
UTTAR PRADESH,SHAHJAHANPUR,2021-03-03,0,1516,47,1563
UTTAR PRADESH,SHAHJAHANPUR,2021-03-04,2,664,41,707
UTTAR PRADESH,SHAHJAHANPUR,2021-03-05,12,1409,45,1466
UTTAR PRADESH,SHAMLI,2021-03-01,3,1262,3,1268
UTTAR PRADESH,SHAMLI,2021-03-02,3,206,6,215
UTTAR PRADESH,SHAMLI,2021-03-03,5,3003,1,3009
UTTAR PRADESH,SHAMLI,2021-03-04,1,1387,1,1389
UTTAR PRADESH,SHAMLI,2021-03-05,3,1783,0,1786
UTTAR PRADESH,SHRAVASTI,2021-03-01,0,610,0,610
UTTAR PRADESH,SHRAVASTI,2021-03-02,0,770,0,770
UTTAR PRADESH,SHRAVASTI,2021-03-03,0,768,1,769
UTTAR PRADESH,SHRAVASTI,2021-03-04,0,766,0,766
UTTAR PRADESH,SHRAVASTI,2021-03-05,0,696,10,706
UTTAR PRADESH,SIDDHARTH NAGAR,2021-03-01,0,583,25,608
UTTAR PRADESH,SIDDHARTH NAGAR,2021-03-02,1,677,52,730
UTTAR PRADESH,SIDDHARTH NAGAR,2021-03-03,1,1014,0,1015
UTTAR PRADESH,SIDDHARTH NAGAR,2021-03-04,0,846,96,942
UTTAR PRADESH,SIDDHARTH NAGAR,2021-03-05,0,924,27,951
UTTAR PRADESH,SITAPUR,2021-03-01,1,1382,3,1386
UTTAR PRADESH,SITAPUR,2021-03-02,1,1463,4,1468
UTTAR PRADESH,SITAPUR,2021-03-03,0,1447,9,1456
UTTAR PRADESH,SITAPUR,2021-03-04,2,933,47,982
UTTAR PRADESH,SITAPUR,2021-03-05,1,1309,18,1328
UTTAR PRADESH,SONBHADRA,2021-03-01,2,1263,46,1311
UTTAR PRADESH,SONBHADRA,2021-03-02,1,1301,22,1324
UTTAR PRADESH,SONBHADRA,2021-03-03,0,1768,23,1791
UTTAR PRADESH,SONBHADRA,2021-03-04,3,1738,3,1744
UTTAR PRADESH,SONBHADRA,2021-03-05,1,1889,0,1890
UTTAR PRADESH,SULTANPUR,2021-03-01,1,1424,3,1428
UTTAR PRADESH,SULTANPUR,2021-03-02,3,1839,8,1850
UTTAR PRADESH,SULTANPUR,2021-03-03,0,1617,12,1629
UTTAR PRADESH,SULTANPUR,2021-03-04,0,1480,0,1480
UTTAR PRADESH,SULTANPUR,2021-03-05,1,1344,4,1349
UTTAR PRADESH,UNNAO,2021-03-01,0,1634,24,1658
UTTAR PRADESH,UNNAO,2021-03-02,0,1802,30,1832
UTTAR PRADESH,UNNAO,2021-03-03,1,1875,25,1901
UTTAR PRADESH,UNNAO,2021-03-04,0,1715,68,1783
UTTAR PRADESH,UNNAO,2021-03-05,0,1668,50,1718
UTTAR PRADESH,VARANASI,2021-03-01,7,2549,2,2558
UTTAR PRADESH,VARANASI,2021-03-02,5,3627,31,3663
UTTAR PRADESH,VARANASI,2021-03-03,11,3020,36,3067
UTTAR PRADESH,VARANASI,2021-03-04,5,3175,85,3265
UTTAR PRADESH,VARANASI,2021-03-05,4,2439,2,2445
UTTARAKHAND,ALMORA,2021-03-01,0,143,0,143
UTTARAKHAND,ALMORA,2021-03-02,1,141,1,143
UTTARAKHAND,ALMORA,2021-03-03,0,66,0,66
UTTARAKHAND,ALMORA,2021-03-04,1,117,1,119
UTTARAKHAND,ALMORA,2021-03-05,0,144,0,144
UTTARAKHAND,BAGESHWAR,2021-03-01,0,46,0,46
UTTARAKHAND,BAGESHWAR,2021-03-02,0,66,0,66
UTTARAKHAND,BAGESHWAR,2021-03-03,0,227,2,229
UTTARAKHAND,BAGESHWAR,2021-03-04,0,298,3,301
UTTARAKHAND,BAGESHWAR,2021-03-05,1,130,2,133
UTTARAKHAND,CHAMOLI,2021-03-01,0,48,0,48
UTTARAKHAND,CHAMOLI,2021-03-02,0,195,2,197
UTTARAKHAND,CHAMOLI,2021-03-03,0,73,1,74
UTTARAKHAND,CHAMOLI,2021-03-04,2,201,8,211
UTTARAKHAND,CHAMOLI,2021-03-05,0,51,6,57
UTTARAKHAND,CHAMPAWAT,2021-03-01,0,73,0,73
UTTARAKHAND,CHAMPAWAT,2021-03-02,0,16,0,16
UTTARAKHAND,CHAMPAWAT,2021-03-03,0,107,0,107
UTTARAKHAND,CHAMPAWAT,2021-03-04,0,56,0,56
UTTARAKHAND,CHAMPAWAT,2021-03-05,0,103,0,103
UTTARAKHAND,DEHRADUN,2021-03-01,2,1208,6,1216
UTTARAKHAND,DEHRADUN,2021-03-02,12,1732,8,1752
UTTARAKHAND,DEHRADUN,2021-03-03,22,1620,10,1652
UTTARAKHAND,DEHRADUN,2021-03-04,24,1464,3,1491
UTTARAKHAND,DEHRADUN,2021-03-05,25,1644,1,1670
UTTARAKHAND,HARIDWAR,2021-03-01,11,1914,3,1928
UTTARAKHAND,HARIDWAR,2021-03-02,22,3212,14,3248
UTTARAKHAND,HARIDWAR,2021-03-03,9,3488,3,3500
UTTARAKHAND,HARIDWAR,2021-03-04,12,2393,17,2422
UTTARAKHAND,HARIDWAR,2021-03-05,18,2400,11,2429
UTTARAKHAND,NAINITAL,2021-03-01,16,1189,3,1208
UTTARAKHAND,NAINITAL,2021-03-02,39,1435,0,1474
UTTARAKHAND,NAINITAL,2021-03-03,14,1723,2,1739
UTTARAKHAND,NAINITAL,2021-03-04,53,1327,3,1383
UTTARAKHAND,NAINITAL,2021-03-05,16,1462,8,1486
UTTARAKHAND,PAURI GARHWAL,2021-03-01,0,250,0,250
UTTARAKHAND,PAURI GARHWAL,2021-03-02,1,261,5,267
UTTARAKHAND,PAURI GARHWAL,2021-03-03,4,494,4,502
UTTARAKHAND,PAURI GARHWAL,2021-03-04,0,125,0,125
UTTARAKHAND,PAURI GARHWAL,2021-03-05,0,437,65,502
UTTARAKHAND,PITHORAGARH,2021-03-01,0,154,0,154
UTTARAKHAND,PITHORAGARH,2021-03-02,0,235,0,235
UTTARAKHAND,PITHORAGARH,2021-03-03,0,148,0,148
UTTARAKHAND,PITHORAGARH,2021-03-04,3,193,1,197
UTTARAKHAND,PITHORAGARH,2021-03-05,2,256,0,258
UTTARAKHAND,RUDRA PRAYAG,2021-03-01,0,32,0,32
UTTARAKHAND,RUDRA PRAYAG,2021-03-02,1,49,0,50
UTTARAKHAND,RUDRA PRAYAG,2021-03-03,1,162,1,164
UTTARAKHAND,RUDRA PRAYAG,2021-03-04,0,86,2,88
UTTARAKHAND,RUDRA PRAYAG,2021-03-05,0,81,0,81
UTTARAKHAND,TEHRI GARHWAL,2021-03-01,2,218,0,220
UTTARAKHAND,TEHRI GARHWAL,2021-03-02,0,81,0,81
UTTARAKHAND,TEHRI GARHWAL,2021-03-03,0,251,1,252
UTTARAKHAND,TEHRI GARHWAL,2021-03-04,0,93,0,93
UTTARAKHAND,TEHRI GARHWAL,2021-03-05,1,80,0,81
UTTARAKHAND,UDAM SINGH NAGAR,2021-03-01,3,2303,68,2374
UTTARAKHAND,UDAM SINGH NAGAR,2021-03-02,1,1492,143,1636
UTTARAKHAND,UDAM SINGH NAGAR,2021-03-03,9,1636,101,1746
UTTARAKHAND,UDAM SINGH NAGAR,2021-03-04,2,1524,293,1819
UTTARAKHAND,UDAM SINGH NAGAR,2021-03-05,6,1664,91,1761
UTTARAKHAND,UTTAR KASHI,2021-03-01,0,184,11,195
UTTARAKHAND,UTTAR KASHI,2021-03-02,0,199,17,216
UTTARAKHAND,UTTAR KASHI,2021-03-03,0,201,8,209
UTTARAKHAND,UTTAR KASHI,2021-03-04,0,41,0,41
UTTARAKHAND,UTTAR KASHI,2021-03-05,1,68,1,70
WEST BENGAL,24 PARAGANAS NORTH,2021-03-01,30,2575,13,2618
WEST BENGAL,24 PARAGANAS NORTH,2021-03-02,51,2993,16,3060
WEST BENGAL,24 PARAGANAS NORTH,2021-03-03,36,3363,13,3412
WEST BENGAL,24 PARAGANAS NORTH,2021-03-04,73,3381,20,3474
WEST BENGAL,24 PARAGANAS NORTH,2021-03-05,53,3593,9,3655
WEST BENGAL,24 PARAGANAS SOUTH,2021-03-01,4,2399,4,2407
WEST BENGAL,24 PARAGANAS SOUTH,2021-03-02,10,2514,26,2550
WEST BENGAL,24 PARAGANAS SOUTH,2021-03-03,10,2613,7,2630
WEST BENGAL,24 PARAGANAS SOUTH,2021-03-04,12,2345,7,2364
WEST BENGAL,24 PARAGANAS SOUTH,2021-03-05,10,2102,5,2117
WEST BENGAL,ALIPURDUAR,2021-03-01,3,921,0,924
WEST BENGAL,ALIPURDUAR,2021-03-02,1,814,0,815
WEST BENGAL,ALIPURDUAR,2021-03-03,0,512,0,512
WEST BENGAL,ALIPURDUAR,2021-03-04,0,1272,0,1272
WEST BENGAL,ALIPURDUAR,2021-03-05,0,667,43,710
WEST BENGAL,BANKURA,2021-03-01,14,451,0,465
WEST BENGAL,BANKURA,2021-03-02,4,390,0,394
WEST BENGAL,BANKURA,2021-03-03,2,421,2,425
WEST BENGAL,BANKURA,2021-03-04,7,367,1,375
WEST BENGAL,BANKURA,2021-03-05,3,206,0,209
WEST BENGAL,BIRBHUM,2021-03-01,2,517,3,522
WEST BENGAL,BIRBHUM,2021-03-02,7,663,1,671
WEST BENGAL,BIRBHUM,2021-03-03,1,578,8,587
WEST BENGAL,BIRBHUM,2021-03-04,5,562,6,573
WEST BENGAL,BIRBHUM,2021-03-05,5,672,5,682
WEST BENGAL,COOCHBEHAR,2021-03-01,0,974,0,974
WEST BENGAL,COOCHBEHAR,2021-03-02,0,851,1,852
WEST BENGAL,COOCHBEHAR,2021-03-03,2,891,0,893
WEST BENGAL,COOCHBEHAR,2021-03-04,2,976,0,978
WEST BENGAL,COOCHBEHAR,2021-03-05,1,905,0,906
WEST BENGAL,DARJEELING,2021-03-01,5,710,1,716
WEST BENGAL,DARJEELING,2021-03-02,5,560,0,565
WEST BENGAL,DARJEELING,2021-03-03,7,260,0,267
WEST BENGAL,DARJEELING,2021-03-04,4,870,2,876
WEST BENGAL,DARJEELING,2021-03-05,4,604,2,610
WEST BENGAL,DINAJPUR DAKSHIN,2021-03-01,0,446,8,454
WEST BENGAL,DINAJPUR DAKSHIN,2021-03-02,0,637,3,640
WEST BENGAL,DINAJPUR DAKSHIN,2021-03-03,0,392,4,396
WEST BENGAL,DINAJPUR DAKSHIN,2021-03-04,1,520,8,529
WEST BENGAL,DINAJPUR DAKSHIN,2021-03-05,0,499,5,504
WEST BENGAL,DINAJPUR UTTAR,2021-03-01,3,221,0,224
WEST BENGAL,DINAJPUR UTTAR,2021-03-02,1,111,0,112
WEST BENGAL,DINAJPUR UTTAR,2021-03-03,4,313,1,318
WEST BENGAL,DINAJPUR UTTAR,2021-03-04,3,243,0,246
WEST BENGAL,DINAJPUR UTTAR,2021-03-05,7,219,0,226
WEST BENGAL,HOOGHLY,2021-03-01,1,649,1,651
WEST BENGAL,HOOGHLY,2021-03-02,7,615,2,624
WEST BENGAL,HOOGHLY,2021-03-03,6,609,22,637
WEST BENGAL,HOOGHLY,2021-03-04,6,574,4,584
WEST BENGAL,HOOGHLY,2021-03-05,13,619,9,641
WEST BENGAL,HOWRAH,2021-03-01,5,885,41,931
WEST BENGAL,HOWRAH,2021-03-02,16,1024,52,1092
WEST BENGAL,HOWRAH,2021-03-03,12,922,45,979
WEST BENGAL,HOWRAH,2021-03-04,13,977,36,1026
WEST BENGAL,HOWRAH,2021-03-05,23,870,47,940
WEST BENGAL,JALPAIGURI,2021-03-01,3,571,0,574
WEST BENGAL,JALPAIGURI,2021-03-02,4,428,0,432
WEST BENGAL,JALPAIGURI,2021-03-03,2,348,0,350
WEST BENGAL,JALPAIGURI,2021-03-04,5,274,0,279
WEST BENGAL,JALPAIGURI,2021-03-05,10,338,0,348
WEST BENGAL,JHARGRAM,2021-03-01,0,24,0,24
WEST BENGAL,JHARGRAM,2021-03-02,2,7,0,9
WEST BENGAL,JHARGRAM,2021-03-03,1,16,0,17
WEST BENGAL,JHARGRAM,2021-03-04,2,10,0,12
WEST BENGAL,JHARGRAM,2021-03-05,1,46,0,47
WEST BENGAL,KALIMPONG,2021-03-01,0,46,0,46
WEST BENGAL,KALIMPONG,2021-03-02,0,117,0,117
WEST BENGAL,KALIMPONG,2021-03-03,0,165,0,165
WEST BENGAL,KALIMPONG,2021-03-04,0,111,0,111
WEST BENGAL,KALIMPONG,2021-03-05,0,150,0,150
WEST BENGAL,KOLKATA,2021-03-01,97,3302,8,3407
WEST BENGAL,KOLKATA,2021-03-02,110,3465,9,3584
WEST BENGAL,KOLKATA,2021-03-03,102,3250,9,3361
WEST BENGAL,KOLKATA,2021-03-04,97,2991,8,3096
WEST BENGAL,KOLKATA,2021-03-05,123,3153,13,3289
WEST BENGAL,MALDAH,2021-03-01,0,358,0,358
WEST BENGAL,MALDAH,2021-03-02,2,510,6,518
WEST BENGAL,MALDAH,2021-03-03,2,463,2,467
WEST BENGAL,MALDAH,2021-03-04,3,401,7,411
WEST BENGAL,MALDAH,2021-03-05,5,426,1,432
WEST BENGAL,MEDINIPUR EAST,2021-03-01,1,569,0,570
WEST BENGAL,MEDINIPUR EAST,2021-03-02,7,669,1,677
WEST BENGAL,MEDINIPUR EAST,2021-03-03,2,685,0,687
WEST BENGAL,MEDINIPUR EAST,2021-03-04,6,592,0,598
WEST BENGAL,MEDINIPUR EAST,2021-03-05,2,673,1,676
WEST BENGAL,MEDINIPUR WEST,2021-03-01,2,281,2,285
WEST BENGAL,MEDINIPUR WEST,2021-03-02,4,238,0,242
WEST BENGAL,MEDINIPUR WEST,2021-03-03,1,332,7,340
WEST BENGAL,MEDINIPUR WEST,2021-03-04,9,416,7,432
WEST BENGAL,MEDINIPUR WEST,2021-03-05,3,339,3,345
WEST BENGAL,MURSHIDABAD,2021-03-01,2,883,4,889
WEST BENGAL,MURSHIDABAD,2021-03-02,0,1001,2,1003
WEST BENGAL,MURSHIDABAD,2021-03-03,2,860,2,864
WEST BENGAL,MURSHIDABAD,2021-03-04,2,916,3,921
WEST BENGAL,MURSHIDABAD,2021-03-05,2,925,3,930
WEST BENGAL,NADIA,2021-03-01,6,645,12,663
WEST BENGAL,NADIA,2021-03-02,3,693,2,698
WEST BENGAL,NADIA,2021-03-03,8,463,1,472
WEST BENGAL,NADIA,2021-03-04,5,756,17,778
WEST BENGAL,NADIA,2021-03-05,9,594,9,612
WEST BENGAL,PASCHIM BARDHAMAN,2021-03-01,6,512,2,520
WEST BENGAL,PASCHIM BARDHAMAN,2021-03-02,11,470,1,482
WEST BENGAL,PASCHIM BARDHAMAN,2021-03-03,10,736,1,747
WEST BENGAL,PASCHIM BARDHAMAN,2021-03-04,26,529,4,559
WEST BENGAL,PASCHIM BARDHAMAN,2021-03-05,4,615,1,620
WEST BENGAL,PURBA BARDHAMAN,2021-03-01,1,528,1,530
WEST BENGAL,PURBA BARDHAMAN,2021-03-02,2,624,0,626
WEST BENGAL,PURBA BARDHAMAN,2021-03-03,3,533,0,536
WEST BENGAL,PURBA BARDHAMAN,2021-03-04,2,831,1,834
WEST BENGAL,PURBA BARDHAMAN,2021-03-05,5,553,1,559
WEST BENGAL,PURULIA,2021-03-01,0,213,0,213
WEST BENGAL,PURULIA,2021-03-02,9,555,0,564
WEST BENGAL,PURULIA,2021-03-03,1,428,0,429
WEST BENGAL,PURULIA,2021-03-04,0,519,0,519
WEST BENGAL,PURULIA,2021-03-05,1,455,0,456
ANDAMAN AND NICOBAR ISLANDS,NICOBARS,2021-03-06,0,9,0,9
ANDAMAN AND NICOBAR ISLANDS,NICOBARS,2021-03-07,0,8,0,8
ANDAMAN AND NICOBAR ISLANDS,NICOBARS,2021-03-08,0,22,0,22
ANDAMAN AND NICOBAR ISLANDS,NICOBARS,2021-03-09,0,7,0,7
ANDAMAN AND NICOBAR ISLANDS,NICOBARS,2021-03-10,0,20,0,20
ANDAMAN AND NICOBAR ISLANDS,NORTH AND MIDDLE ANDAMAN,2021-03-06,0,10,0,10
ANDAMAN AND NICOBAR ISLANDS,NORTH AND MIDDLE ANDAMAN,2021-03-07,0,4,0,4
ANDAMAN AND NICOBAR ISLANDS,NORTH AND MIDDLE ANDAMAN,2021-03-08,0,9,0,9
ANDAMAN AND NICOBAR ISLANDS,NORTH AND MIDDLE ANDAMAN,2021-03-09,0,13,0,13
ANDAMAN AND NICOBAR ISLANDS,NORTH AND MIDDLE ANDAMAN,2021-03-10,1,10,0,11
ANDAMAN AND NICOBAR ISLANDS,SOUTH ANDAMANS,2021-03-06,0,88,1,89
ANDAMAN AND NICOBAR ISLANDS,SOUTH ANDAMANS,2021-03-07,0,131,0,131
ANDAMAN AND NICOBAR ISLANDS,SOUTH ANDAMANS,2021-03-08,0,512,0,512
ANDAMAN AND NICOBAR ISLANDS,SOUTH ANDAMANS,2021-03-09,0,260,2,262
ANDAMAN AND NICOBAR ISLANDS,SOUTH ANDAMANS,2021-03-10,2,502,0,504
ANDHRA PRADESH,ANANTAPUR,2021-03-06,14,3105,2,3121
ANDHRA PRADESH,ANANTAPUR,2021-03-07,8,3679,0,3687
ANDHRA PRADESH,ANANTAPUR,2021-03-08,5,4236,0,4241
ANDHRA PRADESH,ANANTAPUR,2021-03-09,7,3085,0,3092
ANDHRA PRADESH,ANANTAPUR,2021-03-10,7,4529,0,4536
ANDHRA PRADESH,CHITTOOR,2021-03-06,58,5039,2,5099
ANDHRA PRADESH,CHITTOOR,2021-03-07,64,4540,0,4604
ANDHRA PRADESH,CHITTOOR,2021-03-08,36,5814,0,5850
ANDHRA PRADESH,CHITTOOR,2021-03-09,37,3901,0,3938
ANDHRA PRADESH,CHITTOOR,2021-03-10,56,4337,0,4393
ANDHRA PRADESH,EAST GODAVARI,2021-03-06,4,329,0,333
ANDHRA PRADESH,EAST GODAVARI,2021-03-07,7,4142,0,4149
ANDHRA PRADESH,EAST GODAVARI,2021-03-08,13,3927,0,3940
ANDHRA PRADESH,EAST GODAVARI,2021-03-09,7,4042,0,4049
ANDHRA PRADESH,EAST GODAVARI,2021-03-10,14,2785,1,2800
ANDHRA PRADESH,GUNTUR,2021-03-06,15,2550,0,2565
ANDHRA PRADESH,GUNTUR,2021-03-07,4,2295,0,2299
ANDHRA PRADESH,GUNTUR,2021-03-08,17,2656,0,2673
ANDHRA PRADESH,GUNTUR,2021-03-09,7,2323,0,2330
ANDHRA PRADESH,GUNTUR,2021-03-10,12,3287,0,3299
ANDHRA PRADESH,KRISHNA,2021-03-06,21,3895,0,3916
ANDHRA PRADESH,KRISHNA,2021-03-07,16,13517,0,13533
ANDHRA PRADESH,KRISHNA,2021-03-08,23,2632,0,2655
ANDHRA PRADESH,KRISHNA,2021-03-09,31,2179,0,2210
ANDHRA PRADESH,KRISHNA,2021-03-10,30,3659,0,3689
ANDHRA PRADESH,KURNOOL,2021-03-06,3,2893,0,2896
ANDHRA PRADESH,KURNOOL,2021-03-07,15,1553,0,1568
ANDHRA PRADESH,KURNOOL,2021-03-08,5,2589,0,2594
ANDHRA PRADESH,KURNOOL,2021-03-09,3,4019,1,4023
ANDHRA PRADESH,KURNOOL,2021-03-10,11,2555,0,2566
ANDHRA PRADESH,PRAKASAM,2021-03-06,9,3296,0,3305
ANDHRA PRADESH,PRAKASAM,2021-03-07,6,4720,0,4726
ANDHRA PRADESH,PRAKASAM,2021-03-08,3,5840,0,5843
ANDHRA PRADESH,PRAKASAM,2021-03-09,8,4076,0,4084
ANDHRA PRADESH,PRAKASAM,2021-03-10,4,3573,0,3577
ANDHRA PRADESH,SPSR NELLORE,2021-03-06,8,2061,0,2069
ANDHRA PRADESH,SPSR NELLORE,2021-03-07,6,2526,0,2532
ANDHRA PRADESH,SPSR NELLORE,2021-03-08,4,1471,0,1475
ANDHRA PRADESH,SPSR NELLORE,2021-03-09,8,2011,0,2019
ANDHRA PRADESH,SPSR NELLORE,2021-03-10,5,3020,0,3025
ANDHRA PRADESH,SRIKAKULAM,2021-03-06,3,2488,0,2491
ANDHRA PRADESH,SRIKAKULAM,2021-03-07,5,2831,0,2836
ANDHRA PRADESH,SRIKAKULAM,2021-03-08,3,2549,0,2552
ANDHRA PRADESH,SRIKAKULAM,2021-03-09,4,2864,0,2868
ANDHRA PRADESH,SRIKAKULAM,2021-03-10,1,3171,0,3172
ANDHRA PRADESH,VISAKHAPATANAM,2021-03-06,11,2566,2,2579
ANDHRA PRADESH,VISAKHAPATANAM,2021-03-07,8,895,0,903
ANDHRA PRADESH,VISAKHAPATANAM,2021-03-08,17,2584,2,2603
ANDHRA PRADESH,VISAKHAPATANAM,2021-03-09,23,2019,0,2042
ANDHRA PRADESH,VISAKHAPATANAM,2021-03-10,38,1259,1,1298
ANDHRA PRADESH,VIZIANAGARAM,2021-03-06,1,1936,0,1937
ANDHRA PRADESH,VIZIANAGARAM,2021-03-07,1,1019,0,1020
ANDHRA PRADESH,VIZIANAGARAM,2021-03-08,0,2102,0,2102
ANDHRA PRADESH,VIZIANAGARAM,2021-03-09,2,2104,0,2106
ANDHRA PRADESH,VIZIANAGARAM,2021-03-10,1,2071,0,2072
ANDHRA PRADESH,WEST GODAVARI,2021-03-06,4,1732,0,1736
ANDHRA PRADESH,WEST GODAVARI,2021-03-07,3,723,0,726
ANDHRA PRADESH,WEST GODAVARI,2021-03-08,6,2750,0,2756
ANDHRA PRADESH,WEST GODAVARI,2021-03-09,4,2288,0,2292
ANDHRA PRADESH,WEST GODAVARI,2021-03-10,1,2418,0,2419
ANDHRA PRADESH,Y.S.R.,2021-03-06,11,5076,0,5087
ANDHRA PRADESH,Y.S.R.,2021-03-07,5,6611,0,6616
ANDHRA PRADESH,Y.S.R.,2021-03-08,10,2482,0,2492
ANDHRA PRADESH,Y.S.R.,2021-03-09,16,3046,0,3062
ANDHRA PRADESH,Y.S.R.,2021-03-10,6,2953,0,2959
ARUNACHAL PRADESH,ANJAW,2021-03-07,0,2,0,2
ARUNACHAL PRADESH,ANJAW,2021-03-08,0,16,0,16
ARUNACHAL PRADESH,ANJAW,2021-03-09,0,1,0,1
ARUNACHAL PRADESH,ANJAW,2021-03-10,0,2,0,2
ARUNACHAL PRADESH,CHANGLANG,2021-03-07,0,8,0,8
ARUNACHAL PRADESH,CHANGLANG,2021-03-09,0,3,0,3
ARUNACHAL PRADESH,CHANGLANG,2021-03-10,0,4,0,4
ARUNACHAL PRADESH,EAST KAMENG,2021-03-07,0,4,0,4
ARUNACHAL PRADESH,EAST SIANG,2021-03-06,0,23,0,23
ARUNACHAL PRADESH,EAST SIANG,2021-03-08,0,12,0,12
ARUNACHAL PRADESH,EAST SIANG,2021-03-09,0,19,0,19
ARUNACHAL PRADESH,EAST SIANG,2021-03-10,0,20,0,20
ARUNACHAL PRADESH,KAMLE,2021-03-09,0,1,0,1
ARUNACHAL PRADESH,KURUNG KUMEY,2021-03-08,0,1,0,1
ARUNACHAL PRADESH,LEPARADA,2021-03-08,8,1,0,9
ARUNACHAL PRADESH,LEPARADA,2021-03-09,18,0,0,18
ARUNACHAL PRADESH,LOHIT,2021-03-07,0,1,0,1
ARUNACHAL PRADESH,LOHIT,2021-03-08,0,2,0,2
ARUNACHAL PRADESH,LOHIT,2021-03-09,0,1,0,1
ARUNACHAL PRADESH,LOHIT,2021-03-10,0,1,0,1
ARUNACHAL PRADESH,LONGDING,2021-03-09,0,1,0,1
ARUNACHAL PRADESH,LOWER DIBANG VALLEY,2021-03-10,0,2,0,2
ARUNACHAL PRADESH,LOWER SIANG,2021-03-06,0,11,1,12
ARUNACHAL PRADESH,LOWER SIANG,2021-03-07,0,9,0,9
ARUNACHAL PRADESH,LOWER SIANG,2021-03-08,0,6,0,6
ARUNACHAL PRADESH,LOWER SIANG,2021-03-09,1,22,0,23
ARUNACHAL PRADESH,LOWER SIANG,2021-03-10,0,12,0,12
ARUNACHAL PRADESH,LOWER SUBANSIRI,2021-03-06,0,10,0,10
ARUNACHAL PRADESH,LOWER SUBANSIRI,2021-03-07,0,1,0,1
ARUNACHAL PRADESH,LOWER SUBANSIRI,2021-03-08,0,18,0,18
ARUNACHAL PRADESH,LOWER SUBANSIRI,2021-03-10,0,2,0,2
ARUNACHAL PRADESH,NAMSAI,2021-03-07,0,3,0,3
ARUNACHAL PRADESH,NAMSAI,2021-03-09,0,1,0,1
ARUNACHAL PRADESH,PAKKE KESSANG,2021-03-10,0,2,0,2
ARUNACHAL PRADESH,PAPUM PARE,2021-03-06,0,21,0,21
ARUNACHAL PRADESH,PAPUM PARE,2021-03-07,0,1,0,1
ARUNACHAL PRADESH,PAPUM PARE,2021-03-08,0,37,0,37
ARUNACHAL PRADESH,PAPUM PARE,2021-03-09,1,36,0,37
ARUNACHAL PRADESH,PAPUM PARE,2021-03-10,0,15,0,15
ARUNACHAL PRADESH,SHI YOMI,2021-03-06,0,1,0,1
ARUNACHAL PRADESH,TAWANG,2021-03-09,0,2,0,2
ARUNACHAL PRADESH,TAWANG,2021-03-10,0,1,0,1
ARUNACHAL PRADESH,TIRAP,2021-03-06,0,1,0,1
ARUNACHAL PRADESH,TIRAP,2021-03-07,0,1,0,1
ARUNACHAL PRADESH,UPPER SUBANSIRI,2021-03-09,0,2,0,2
ARUNACHAL PRADESH,UPPER SUBANSIRI,2021-03-10,0,2,0,2
ARUNACHAL PRADESH,WEST KAMENG,2021-03-06,0,51,0,51
ARUNACHAL PRADESH,WEST KAMENG,2021-03-07,0,40,0,40
ARUNACHAL PRADESH,WEST KAMENG,2021-03-08,0,61,0,61
ARUNACHAL PRADESH,WEST KAMENG,2021-03-09,0,18,0,18
ARUNACHAL PRADESH,WEST KAMENG,2021-03-10,0,95,0,95
ARUNACHAL PRADESH,WEST SIANG,2021-03-08,0,5,0,5
ARUNACHAL PRADESH,WEST SIANG,2021-03-10,0,1,0,1
ASSAM,BAKSA,2021-03-06,0,44,0,44
ASSAM,BAKSA,2021-03-07,0,16,0,16
ASSAM,BAKSA,2021-03-08,0,47,0,47
ASSAM,BAKSA,2021-03-09,1,53,0,54
ASSAM,BAKSA,2021-03-10,0,98,0,98
ASSAM,BARPETA,2021-03-06,0,124,0,124
ASSAM,BARPETA,2021-03-07,0,3,0,3
ASSAM,BARPETA,2021-03-08,0,164,0,164
ASSAM,BARPETA,2021-03-09,0,138,0,138
ASSAM,BARPETA,2021-03-10,0,141,0,141
ASSAM,BISWANATH,2021-03-06,0,69,0,69
ASSAM,BISWANATH,2021-03-07,0,6,0,6
ASSAM,BISWANATH,2021-03-08,0,34,0,34
ASSAM,BISWANATH,2021-03-09,0,22,0,22
ASSAM,BISWANATH,2021-03-10,0,18,0,18
ASSAM,BONGAIGAON,2021-03-06,0,86,0,86
ASSAM,BONGAIGAON,2021-03-07,0,19,0,19
ASSAM,BONGAIGAON,2021-03-08,0,214,0,214
ASSAM,BONGAIGAON,2021-03-09,1,180,0,181
ASSAM,BONGAIGAON,2021-03-10,1,137,0,138
ASSAM,CACHAR,2021-03-06,3,248,5,256
ASSAM,CACHAR,2021-03-07,3,96,0,99
ASSAM,CACHAR,2021-03-08,0,2940,2,2942
ASSAM,CACHAR,2021-03-09,0,188,9,197
ASSAM,CACHAR,2021-03-10,1,2696,2,2699
ASSAM,CHARAIDEO,2021-03-06,0,97,0,97
ASSAM,CHARAIDEO,2021-03-07,0,52,0,52
ASSAM,CHARAIDEO,2021-03-08,0,73,0,73
ASSAM,CHARAIDEO,2021-03-09,0,57,0,57
ASSAM,CHARAIDEO,2021-03-10,0,45,0,45
ASSAM,CHIRANG,2021-03-06,0,75,0,75
ASSAM,CHIRANG,2021-03-07,0,23,0,23
ASSAM,CHIRANG,2021-03-08,0,72,0,72
ASSAM,CHIRANG,2021-03-09,1,45,0,46
ASSAM,CHIRANG,2021-03-10,0,100,0,100
ASSAM,DARRANG,2021-03-06,0,368,0,368
ASSAM,DARRANG,2021-03-07,0,109,0,109
ASSAM,DARRANG,2021-03-08,1,430,1,432
ASSAM,DARRANG,2021-03-09,0,397,0,397
ASSAM,DARRANG,2021-03-10,0,374,0,374
ASSAM,DHEMAJI,2021-03-06,0,24,0,24
ASSAM,DHEMAJI,2021-03-07,1,74,0,75
ASSAM,DHEMAJI,2021-03-08,0,41,0,41
ASSAM,DHEMAJI,2021-03-09,0,17,0,17
ASSAM,DHEMAJI,2021-03-10,0,49,0,49
ASSAM,DHUBRI,2021-03-06,0,193,0,193
ASSAM,DHUBRI,2021-03-07,0,17,0,17
ASSAM,DHUBRI,2021-03-08,0,292,0,292
ASSAM,DHUBRI,2021-03-09,0,217,0,217
ASSAM,DHUBRI,2021-03-10,0,197,0,197
ASSAM,DIBRUGARH,2021-03-06,2,172,0,174
ASSAM,DIBRUGARH,2021-03-07,1,206,1,208
ASSAM,DIBRUGARH,2021-03-08,2,321,1,324
ASSAM,DIBRUGARH,2021-03-09,5,374,2,381
ASSAM,DIBRUGARH,2021-03-10,2,252,2,256
ASSAM,DIMA HASAO,2021-03-06,0,24,0,24
ASSAM,DIMA HASAO,2021-03-07,0,9,0,9
ASSAM,DIMA HASAO,2021-03-08,0,24,0,24
ASSAM,DIMA HASAO,2021-03-09,0,39,0,39
ASSAM,DIMA HASAO,2021-03-10,0,17,0,17
ASSAM,GOALPARA,2021-03-06,0,263,0,263
ASSAM,GOALPARA,2021-03-07,0,133,0,133
ASSAM,GOALPARA,2021-03-08,0,332,0,332
ASSAM,GOALPARA,2021-03-09,0,279,0,279
ASSAM,GOALPARA,2021-03-10,0,277,0,277
ASSAM,GOLAGHAT,2021-03-06,0,147,0,147
ASSAM,GOLAGHAT,2021-03-07,1,28,0,29
ASSAM,GOLAGHAT,2021-03-08,0,154,0,154
ASSAM,GOLAGHAT,2021-03-09,1,116,0,117
ASSAM,GOLAGHAT,2021-03-10,1,132,0,133
ASSAM,HAILAKANDI,2021-03-06,0,363,0,363
ASSAM,HAILAKANDI,2021-03-07,0,56,0,56
ASSAM,HAILAKANDI,2021-03-08,0,338,8,346
ASSAM,HAILAKANDI,2021-03-09,0,226,0,226
ASSAM,HAILAKANDI,2021-03-10,0,322,0,322
ASSAM,HOJAI,2021-03-06,0,91,0,91
ASSAM,HOJAI,2021-03-07,0,13,0,13
ASSAM,HOJAI,2021-03-08,0,181,0,181
ASSAM,HOJAI,2021-03-09,0,102,0,102
ASSAM,HOJAI,2021-03-10,0,109,0,109
ASSAM,JORHAT,2021-03-06,2,225,0,227
ASSAM,JORHAT,2021-03-07,0,74,0,74
ASSAM,JORHAT,2021-03-08,2,222,0,224
ASSAM,JORHAT,2021-03-09,1,232,0,233
ASSAM,JORHAT,2021-03-10,6,249,0,255
ASSAM,KAMRUP,2021-03-06,1,636,0,637
ASSAM,KAMRUP,2021-03-07,0,201,0,201
ASSAM,KAMRUP,2021-03-08,0,629,0,629
ASSAM,KAMRUP,2021-03-09,0,548,1,549
ASSAM,KAMRUP,2021-03-10,1,367,0,368
ASSAM,KAMRUP METRO,2021-03-06,9,1478,1,1488
ASSAM,KAMRUP METRO,2021-03-07,5,1139,0,1144
ASSAM,KAMRUP METRO,2021-03-08,3,1421,2,1426
ASSAM,KAMRUP METRO,2021-03-09,15,1572,1,1588
ASSAM,KAMRUP METRO,2021-03-10,13,1456,0,1469
ASSAM,KARBI ANGLONG,2021-03-06,0,30,0,30
ASSAM,KARBI ANGLONG,2021-03-07,0,1,0,1
ASSAM,KARBI ANGLONG,2021-03-08,0,17,0,17
ASSAM,KARBI ANGLONG,2021-03-09,0,41,0,41
ASSAM,KARBI ANGLONG,2021-03-10,0,19,0,19
ASSAM,KARIMGANJ,2021-03-06,0,127,1,128
ASSAM,KARIMGANJ,2021-03-07,1,75,0,76
ASSAM,KARIMGANJ,2021-03-08,1,163,0,164
ASSAM,KARIMGANJ,2021-03-09,0,144,1,145
ASSAM,KARIMGANJ,2021-03-10,0,133,0,133
ASSAM,KOKRAJHAR,2021-03-06,0,15,0,15
ASSAM,KOKRAJHAR,2021-03-07,0,1,0,1
ASSAM,KOKRAJHAR,2021-03-08,0,26,0,26
ASSAM,KOKRAJHAR,2021-03-09,0,19,0,19
ASSAM,KOKRAJHAR,2021-03-10,0,40,0,40
ASSAM,LAKHIMPUR,2021-03-06,0,229,0,229
ASSAM,LAKHIMPUR,2021-03-07,0,88,0,88
ASSAM,LAKHIMPUR,2021-03-08,0,201,0,201
ASSAM,LAKHIMPUR,2021-03-09,0,267,0,267
ASSAM,LAKHIMPUR,2021-03-10,0,169,0,169
ASSAM,MAJULI,2021-03-06,0,1,0,1
ASSAM,MAJULI,2021-03-07,0,1,0,1
ASSAM,MAJULI,2021-03-08,0,3,0,3
ASSAM,MAJULI,2021-03-09,0,8,0,8
ASSAM,MAJULI,2021-03-10,0,7,0,7
ASSAM,MARIGAON,2021-03-06,0,61,0,61
ASSAM,MARIGAON,2021-03-07,0,103,0,103
ASSAM,MARIGAON,2021-03-08,0,132,0,132
ASSAM,MARIGAON,2021-03-09,0,63,0,63
ASSAM,MARIGAON,2021-03-10,0,64,0,64
ASSAM,NAGAON,2021-03-06,0,238,0,238
ASSAM,NAGAON,2021-03-07,0,88,0,88
ASSAM,NAGAON,2021-03-08,0,345,0,345
ASSAM,NAGAON,2021-03-09,0,259,0,259
ASSAM,NAGAON,2021-03-10,0,296,0,296
ASSAM,NALBARI,2021-03-06,0,52,0,52
ASSAM,NALBARI,2021-03-07,0,9,0,9
ASSAM,NALBARI,2021-03-08,0,55,0,55
ASSAM,NALBARI,2021-03-09,0,69,0,69
ASSAM,NALBARI,2021-03-10,0,23,0,23
ASSAM,SIVASAGAR,2021-03-06,0,61,0,61
ASSAM,SIVASAGAR,2021-03-07,0,23,0,23
ASSAM,SIVASAGAR,2021-03-08,0,172,0,172
ASSAM,SIVASAGAR,2021-03-09,0,127,0,127
ASSAM,SIVASAGAR,2021-03-10,1,146,0,147
ASSAM,SONITPUR,2021-03-06,2,92,0,94
ASSAM,SONITPUR,2021-03-07,0,23,0,23
ASSAM,SONITPUR,2021-03-08,0,205,0,205
ASSAM,SONITPUR,2021-03-09,0,149,0,149
ASSAM,SONITPUR,2021-03-10,0,108,0,108
ASSAM,SOUTH SALMARA MANCACHAR,2021-03-06,0,11,0,11
ASSAM,SOUTH SALMARA MANCACHAR,2021-03-07,0,7,0,7
ASSAM,SOUTH SALMARA MANCACHAR,2021-03-08,0,24,0,24
ASSAM,SOUTH SALMARA MANCACHAR,2021-03-09,0,27,0,27
ASSAM,SOUTH SALMARA MANCACHAR,2021-03-10,0,18,0,18
ASSAM,TINSUKIA,2021-03-06,2,210,0,212
ASSAM,TINSUKIA,2021-03-07,2,180,1,183
ASSAM,TINSUKIA,2021-03-08,6,70,1,77
ASSAM,TINSUKIA,2021-03-09,5,52,0,57
ASSAM,TINSUKIA,2021-03-10,0,367,0,367
ASSAM,UDALGURI,2021-03-06,0,7,0,7
ASSAM,UDALGURI,2021-03-07,0,2,0,2
ASSAM,UDALGURI,2021-03-08,0,7,0,7
ASSAM,UDALGURI,2021-03-09,0,4,1,5
ASSAM,UDALGURI,2021-03-10,0,8,0,8
ASSAM,WEST KARBI ANGLONG,2021-03-06,0,4,0,4
ASSAM,WEST KARBI ANGLONG,2021-03-07,0,2,0,2
ASSAM,WEST KARBI ANGLONG,2021-03-08,0,6,0,6
ASSAM,WEST KARBI ANGLONG,2021-03-09,0,3,0,3
ASSAM,WEST KARBI ANGLONG,2021-03-10,0,6,0,6
BIHAR,ARARIA,2021-03-06,0,507,0,507
BIHAR,ARARIA,2021-03-07,0,47,0,47
BIHAR,ARARIA,2021-03-08,0,850,2,852
BIHAR,ARARIA,2021-03-09,1,498,0,499
BIHAR,ARARIA,2021-03-10,2,685,1,688
BIHAR,ARWAL,2021-03-06,0,208,0,208
BIHAR,ARWAL,2021-03-07,0,113,0,113
BIHAR,ARWAL,2021-03-08,0,353,8,361
BIHAR,ARWAL,2021-03-09,0,374,3,377
BIHAR,ARWAL,2021-03-10,0,294,1,295
BIHAR,AURANGABAD,2021-03-06,2,625,0,627
BIHAR,AURANGABAD,2021-03-07,3,15,0,18
BIHAR,AURANGABAD,2021-03-08,0,105,0,105
BIHAR,AURANGABAD,2021-03-09,6,675,0,681
BIHAR,AURANGABAD,2021-03-10,1,1447,0,1448
BIHAR,BANKA,2021-03-06,0,453,0,453
BIHAR,BANKA,2021-03-07,1,920,129,1050
BIHAR,BANKA,2021-03-08,0,500,0,500
BIHAR,BANKA,2021-03-09,0,528,0,528
BIHAR,BANKA,2021-03-10,1,806,0,807
BIHAR,BEGUSARAI,2021-03-06,3,1395,0,1398
BIHAR,BEGUSARAI,2021-03-07,0,660,0,660
BIHAR,BEGUSARAI,2021-03-08,1,370,0,371
BIHAR,BEGUSARAI,2021-03-09,0,1057,1,1058
BIHAR,BEGUSARAI,2021-03-10,0,966,0,966
BIHAR,BHAGALPUR,2021-03-06,2,848,1,851
BIHAR,BHAGALPUR,2021-03-07,1,328,0,329
BIHAR,BHAGALPUR,2021-03-08,0,193,0,193
BIHAR,BHAGALPUR,2021-03-09,0,753,1,754
BIHAR,BHAGALPUR,2021-03-10,3,305,0,308
BIHAR,BHOJPUR,2021-03-06,0,648,22,670
BIHAR,BHOJPUR,2021-03-07,2,204,0,206
BIHAR,BHOJPUR,2021-03-08,0,552,8,560
BIHAR,BHOJPUR,2021-03-09,0,1253,5,1258
BIHAR,BHOJPUR,2021-03-10,1,1493,0,1494
BIHAR,BUXAR,2021-03-06,1,388,0,389
BIHAR,BUXAR,2021-03-07,0,150,0,150
BIHAR,BUXAR,2021-03-08,0,240,0,240
BIHAR,BUXAR,2021-03-09,0,173,0,173
BIHAR,BUXAR,2021-03-10,0,617,1,618
BIHAR,DARBHANGA,2021-03-06,4,610,0,614
BIHAR,DARBHANGA,2021-03-07,2,669,0,671
BIHAR,DARBHANGA,2021-03-08,3,487,0,490
BIHAR,DARBHANGA,2021-03-09,2,185,1,188
BIHAR,DARBHANGA,2021-03-10,2,278,0,280
BIHAR,GAYA,2021-03-06,0,405,2,407
BIHAR,GAYA,2021-03-07,1,173,1,175
BIHAR,GAYA,2021-03-08,1,1440,6,1447
BIHAR,GAYA,2021-03-09,0,432,5,437
BIHAR,GAYA,2021-03-10,1,1158,1,1160
BIHAR,GOPALGANJ,2021-03-06,0,364,0,364
BIHAR,GOPALGANJ,2021-03-07,0,376,0,376
BIHAR,GOPALGANJ,2021-03-08,2,313,0,315
BIHAR,GOPALGANJ,2021-03-09,0,772,0,772
BIHAR,GOPALGANJ,2021-03-10,1,224,11,236
BIHAR,JAMUI,2021-03-06,0,61,1,62
BIHAR,JAMUI,2021-03-07,0,292,0,292
BIHAR,JAMUI,2021-03-08,0,365,0,365
BIHAR,JAMUI,2021-03-09,0,536,0,536
BIHAR,JAMUI,2021-03-10,1,507,0,508
BIHAR,JEHANABAD,2021-03-06,0,159,0,159
BIHAR,JEHANABAD,2021-03-07,0,178,0,178
BIHAR,JEHANABAD,2021-03-08,0,83,0,83
BIHAR,JEHANABAD,2021-03-09,0,98,0,98
BIHAR,JEHANABAD,2021-03-10,0,102,0,102
BIHAR,KAIMUR (BHABUA),2021-03-06,0,629,1,630
BIHAR,KAIMUR (BHABUA),2021-03-07,0,401,0,401
BIHAR,KAIMUR (BHABUA),2021-03-08,0,199,0,199
BIHAR,KAIMUR (BHABUA),2021-03-09,0,476,0,476
BIHAR,KAIMUR (BHABUA),2021-03-10,0,276,0,276
BIHAR,KATIHAR,2021-03-06,0,1007,0,1007
BIHAR,KATIHAR,2021-03-07,0,455,0,455
BIHAR,KATIHAR,2021-03-08,5,421,0,426
BIHAR,KATIHAR,2021-03-09,2,627,0,629
BIHAR,KATIHAR,2021-03-10,5,527,0,532
BIHAR,KHAGARIA,2021-03-06,0,634,0,634
BIHAR,KHAGARIA,2021-03-07,0,323,1,324
BIHAR,KHAGARIA,2021-03-08,0,1222,0,1222
BIHAR,KHAGARIA,2021-03-09,1,339,0,340
BIHAR,KHAGARIA,2021-03-10,0,554,0,554
BIHAR,KISHANGANJ,2021-03-06,0,295,0,295
BIHAR,KISHANGANJ,2021-03-07,0,121,0,121
BIHAR,KISHANGANJ,2021-03-08,0,239,0,239
BIHAR,KISHANGANJ,2021-03-09,0,357,0,357
BIHAR,KISHANGANJ,2021-03-10,0,292,0,292
BIHAR,LAKHISARAI,2021-03-06,0,420,0,420
BIHAR,LAKHISARAI,2021-03-07,0,151,0,151
BIHAR,LAKHISARAI,2021-03-08,0,541,0,541
BIHAR,LAKHISARAI,2021-03-09,0,217,0,217
BIHAR,LAKHISARAI,2021-03-10,0,903,0,903
BIHAR,MADHEPURA,2021-03-06,2,1350,0,1352
BIHAR,MADHEPURA,2021-03-07,1,333,0,334
BIHAR,MADHEPURA,2021-03-08,0,386,0,386
BIHAR,MADHEPURA,2021-03-09,2,576,0,578
BIHAR,MADHEPURA,2021-03-10,0,2464,0,2464
BIHAR,MADHUBANI,2021-03-06,2,473,0,475
BIHAR,MADHUBANI,2021-03-07,2,76,0,78
BIHAR,MADHUBANI,2021-03-08,1,317,0,318
BIHAR,MADHUBANI,2021-03-09,3,775,4,782
BIHAR,MADHUBANI,2021-03-10,0,949,6,955
BIHAR,MUNGER,2021-03-06,1,789,11,801
BIHAR,MUNGER,2021-03-07,0,424,0,424
BIHAR,MUNGER,2021-03-08,1,657,34,692
BIHAR,MUNGER,2021-03-09,0,599,9,608
BIHAR,MUNGER,2021-03-10,1,594,78,673
BIHAR,MUZAFFARPUR,2021-03-06,0,215,0,215
BIHAR,MUZAFFARPUR,2021-03-07,0,172,0,172
BIHAR,MUZAFFARPUR,2021-03-08,5,247,0,252
BIHAR,MUZAFFARPUR,2021-03-09,1,1250,0,1251
BIHAR,MUZAFFARPUR,2021-03-10,4,932,1,937
BIHAR,NALANDA,2021-03-06,0,1365,0,1365
BIHAR,NALANDA,2021-03-07,1,750,0,751
BIHAR,NALANDA,2021-03-08,1,1361,0,1362
BIHAR,NALANDA,2021-03-09,3,1833,5,1841
BIHAR,NALANDA,2021-03-10,1,970,0,971
BIHAR,NAWADA,2021-03-06,0,738,0,738
BIHAR,NAWADA,2021-03-07,0,39,0,39
BIHAR,NAWADA,2021-03-08,3,491,0,494
BIHAR,NAWADA,2021-03-09,1,429,0,430
BIHAR,NAWADA,2021-03-10,0,292,0,292
BIHAR,PASHCHIM CHAMPARAN,2021-03-06,0,278,0,278
BIHAR,PASHCHIM CHAMPARAN,2021-03-07,0,91,0,91
BIHAR,PASHCHIM CHAMPARAN,2021-03-08,0,402,0,402
BIHAR,PASHCHIM CHAMPARAN,2021-03-09,1,944,0,945
BIHAR,PASHCHIM CHAMPARAN,2021-03-10,1,660,0,661
BIHAR,PATNA,2021-03-06,14,1025,1,1040
BIHAR,PATNA,2021-03-07,16,686,2,704
BIHAR,PATNA,2021-03-08,27,1510,0,1537
BIHAR,PATNA,2021-03-09,22,1949,2,1973
BIHAR,PATNA,2021-03-10,148,1877,4,2029
BIHAR,PURBI CHAMPARAN,2021-03-06,2,694,1,697
BIHAR,PURBI CHAMPARAN,2021-03-07,1,363,0,364
BIHAR,PURBI CHAMPARAN,2021-03-08,2,474,0,476
BIHAR,PURBI CHAMPARAN,2021-03-09,2,881,1,884
BIHAR,PURBI CHAMPARAN,2021-03-10,4,1194,0,1198
BIHAR,PURNIA,2021-03-06,1,886,0,887
BIHAR,PURNIA,2021-03-07,0,256,4,260
BIHAR,PURNIA,2021-03-08,0,505,83,588
BIHAR,PURNIA,2021-03-09,0,583,0,583
BIHAR,PURNIA,2021-03-10,0,489,0,489
BIHAR,ROHTAS,2021-03-06,1,223,0,224
BIHAR,ROHTAS,2021-03-07,0,740,0,740
BIHAR,ROHTAS,2021-03-08,1,221,0,222
BIHAR,ROHTAS,2021-03-09,2,698,0,700
BIHAR,ROHTAS,2021-03-10,0,805,0,805
BIHAR,SAHARSA,2021-03-06,0,61,0,61
BIHAR,SAHARSA,2021-03-07,0,241,0,241
BIHAR,SAHARSA,2021-03-08,0,349,0,349
BIHAR,SAHARSA,2021-03-09,1,132,0,133
BIHAR,SAHARSA,2021-03-10,1,437,0,438
BIHAR,SAMASTIPUR,2021-03-06,0,294,7,301
BIHAR,SAMASTIPUR,2021-03-07,0,277,8,285
BIHAR,SAMASTIPUR,2021-03-08,1,1394,0,1395
BIHAR,SAMASTIPUR,2021-03-09,1,838,11,850
BIHAR,SAMASTIPUR,2021-03-10,1,1645,24,1670
BIHAR,SARAN,2021-03-06,0,244,2,246
BIHAR,SARAN,2021-03-07,0,249,1,250
BIHAR,SARAN,2021-03-08,0,249,0,249
BIHAR,SARAN,2021-03-09,0,111,0,111
BIHAR,SARAN,2021-03-10,0,574,1,575
BIHAR,SHEIKHPURA,2021-03-06,0,16,0,16
BIHAR,SHEIKHPURA,2021-03-07,0,1,0,1
BIHAR,SHEIKHPURA,2021-03-08,0,39,0,39
BIHAR,SHEIKHPURA,2021-03-09,0,52,0,52
BIHAR,SHEIKHPURA,2021-03-10,0,116,1,117
BIHAR,SHEOHAR,2021-03-06,0,157,0,157
BIHAR,SHEOHAR,2021-03-07,0,424,0,424
BIHAR,SHEOHAR,2021-03-08,0,55,0,55
BIHAR,SHEOHAR,2021-03-09,0,409,0,409
BIHAR,SHEOHAR,2021-03-10,0,228,0,228
BIHAR,SITAMARHI,2021-03-06,0,354,4,358
BIHAR,SITAMARHI,2021-03-07,0,189,0,189
BIHAR,SITAMARHI,2021-03-08,0,386,2,388
BIHAR,SITAMARHI,2021-03-09,0,358,0,358
BIHAR,SITAMARHI,2021-03-10,0,885,2,887
BIHAR,SIWAN,2021-03-06,2,577,0,579
BIHAR,SIWAN,2021-03-07,1,330,0,331
BIHAR,SIWAN,2021-03-08,1,443,0,444
BIHAR,SIWAN,2021-03-09,1,1121,0,1122
BIHAR,SIWAN,2021-03-10,2,1882,0,1884
BIHAR,SUPAUL,2021-03-06,0,879,1,880
BIHAR,SUPAUL,2021-03-07,1,374,5,380
BIHAR,SUPAUL,2021-03-08,0,649,30,679
BIHAR,SUPAUL,2021-03-09,2,753,0,755
BIHAR,SUPAUL,2021-03-10,0,812,47,859
BIHAR,VAISHALI,2021-03-06,2,557,0,559
BIHAR,VAISHALI,2021-03-07,0,215,0,215
BIHAR,VAISHALI,2021-03-08,1,1203,4,1208
BIHAR,VAISHALI,2021-03-09,2,1078,0,1080
BIHAR,VAISHALI,2021-03-10,1,641,0,642
CHANDIGARH,CHANDIGARH,2021-03-06,109,1654,5,1768
CHANDIGARH,CHANDIGARH,2021-03-07,70,759,4,833
CHANDIGARH,CHANDIGARH,2021-03-08,105,1733,4,1842
CHANDIGARH,CHANDIGARH,2021-03-09,131,1843,2,1976
CHANDIGARH,CHANDIGARH,2021-03-10,109,1725,7,1841
CHHATTISGARH,BALOD,2021-03-06,3,1194,0,1197
CHHATTISGARH,BALOD,2021-03-07,0,781,0,781
CHHATTISGARH,BALOD,2021-03-08,3,1053,0,1056
CHHATTISGARH,BALOD,2021-03-09,4,1023,0,1027
CHHATTISGARH,BALOD,2021-03-10,3,936,0,939
CHHATTISGARH,BALODA BAZAR,2021-03-06,12,520,3,535
CHHATTISGARH,BALODA BAZAR,2021-03-07,10,351,0,361
CHHATTISGARH,BALODA BAZAR,2021-03-08,11,537,2,550
CHHATTISGARH,BALODA BAZAR,2021-03-09,6,422,1,429
CHHATTISGARH,BALODA BAZAR,2021-03-10,13,450,3,466
CHHATTISGARH,BALRAMPUR,2021-03-06,4,541,0,545
CHHATTISGARH,BALRAMPUR,2021-03-07,1,207,0,208
CHHATTISGARH,BALRAMPUR,2021-03-08,6,307,0,313
CHHATTISGARH,BALRAMPUR,2021-03-09,0,398,0,398
CHHATTISGARH,BALRAMPUR,2021-03-10,5,337,0,342
CHHATTISGARH,BASTAR,2021-03-06,16,1212,0,1228
CHHATTISGARH,BASTAR,2021-03-07,7,632,0,639
CHHATTISGARH,BASTAR,2021-03-08,3,1414,0,1417
CHHATTISGARH,BASTAR,2021-03-09,1,579,0,580
CHHATTISGARH,BASTAR,2021-03-10,1,923,0,924
CHHATTISGARH,BEMETARA,2021-03-06,9,662,1,672
CHHATTISGARH,BEMETARA,2021-03-07,0,320,0,320
CHHATTISGARH,BEMETARA,2021-03-08,2,430,0,432
CHHATTISGARH,BEMETARA,2021-03-09,4,620,0,624
CHHATTISGARH,BEMETARA,2021-03-10,3,492,0,495
CHHATTISGARH,BIJAPUR,2021-03-06,1,285,0,286
CHHATTISGARH,BIJAPUR,2021-03-07,0,163,0,163
CHHATTISGARH,BIJAPUR,2021-03-08,0,221,0,221
CHHATTISGARH,BIJAPUR,2021-03-09,2,249,0,251
CHHATTISGARH,BIJAPUR,2021-03-10,0,367,0,367
CHHATTISGARH,BILASPUR,2021-03-06,16,1297,11,1324
CHHATTISGARH,BILASPUR,2021-03-07,22,878,20,920
CHHATTISGARH,BILASPUR,2021-03-08,23,1681,15,1719
CHHATTISGARH,BILASPUR,2021-03-09,19,1358,23,1400
CHHATTISGARH,BILASPUR,2021-03-10,31,1278,8,1317
CHHATTISGARH,DANTEWADA,2021-03-06,1,320,0,321
CHHATTISGARH,DANTEWADA,2021-03-07,0,484,0,484
CHHATTISGARH,DANTEWADA,2021-03-08,0,455,0,455
CHHATTISGARH,DANTEWADA,2021-03-09,3,166,0,169
CHHATTISGARH,DANTEWADA,2021-03-10,4,368,1,373
CHHATTISGARH,DHAMTARI,2021-03-06,11,943,6,960
CHHATTISGARH,DHAMTARI,2021-03-07,2,202,9,213
CHHATTISGARH,DHAMTARI,2021-03-08,5,638,10,653
CHHATTISGARH,DHAMTARI,2021-03-09,9,838,8,855
CHHATTISGARH,DHAMTARI,2021-03-10,5,496,3,504
CHHATTISGARH,DURG,2021-03-06,41,1553,0,1594
CHHATTISGARH,DURG,2021-03-07,60,853,0,913
CHHATTISGARH,DURG,2021-03-08,66,1697,2,1765
CHHATTISGARH,DURG,2021-03-09,83,1602,0,1685
CHHATTISGARH,DURG,2021-03-10,120,1617,4,1741
CHHATTISGARH,GARIYABAND,2021-03-06,1,351,9,361
CHHATTISGARH,GARIYABAND,2021-03-07,0,261,20,281
CHHATTISGARH,GARIYABAND,2021-03-08,2,277,10,289
CHHATTISGARH,GARIYABAND,2021-03-09,6,265,5,276
CHHATTISGARH,GARIYABAND,2021-03-10,2,216,14,232
CHHATTISGARH,GAURELLA PENDRA MARWAHI,2021-03-06,0,448,0,448
CHHATTISGARH,GAURELLA PENDRA MARWAHI,2021-03-07,1,414,0,415
CHHATTISGARH,GAURELLA PENDRA MARWAHI,2021-03-08,0,672,0,672
CHHATTISGARH,GAURELLA PENDRA MARWAHI,2021-03-09,1,628,0,629
CHHATTISGARH,GAURELLA PENDRA MARWAHI,2021-03-10,2,706,0,708
CHHATTISGARH,JANJGIR CHAMPA,2021-03-06,4,1672,2,1678
CHHATTISGARH,JANJGIR CHAMPA,2021-03-07,6,1367,0,1373
CHHATTISGARH,JANJGIR CHAMPA,2021-03-08,8,1661,1,1670
CHHATTISGARH,JANJGIR CHAMPA,2021-03-09,2,2037,0,2039
CHHATTISGARH,JANJGIR CHAMPA,2021-03-10,2,1927,0,1929
CHHATTISGARH,JASHPUR,2021-03-06,7,316,0,323
CHHATTISGARH,JASHPUR,2021-03-07,6,21,0,27
CHHATTISGARH,JASHPUR,2021-03-08,15,338,0,353
CHHATTISGARH,JASHPUR,2021-03-09,6,244,0,250
CHHATTISGARH,JASHPUR,2021-03-10,20,272,1,293
CHHATTISGARH,KABIRDHAM,2021-03-06,6,571,1,578
CHHATTISGARH,KABIRDHAM,2021-03-07,7,503,0,510
CHHATTISGARH,KABIRDHAM,2021-03-08,0,280,0,280
CHHATTISGARH,KABIRDHAM,2021-03-09,0,765,0,765
CHHATTISGARH,KABIRDHAM,2021-03-10,0,466,0,466
CHHATTISGARH,KANKER,2021-03-06,1,934,0,935
CHHATTISGARH,KANKER,2021-03-07,1,517,0,518
CHHATTISGARH,KANKER,2021-03-08,3,790,0,793
CHHATTISGARH,KANKER,2021-03-09,1,1206,0,1207
CHHATTISGARH,KANKER,2021-03-10,2,1120,0,1122
CHHATTISGARH,KONDAGAON,2021-03-06,1,773,0,774
CHHATTISGARH,KONDAGAON,2021-03-07,0,395,0,395
CHHATTISGARH,KONDAGAON,2021-03-08,1,502,0,503
CHHATTISGARH,KONDAGAON,2021-03-09,3,973,0,976
CHHATTISGARH,KONDAGAON,2021-03-10,0,965,0,965
CHHATTISGARH,KORBA,2021-03-06,17,1055,0,1072
CHHATTISGARH,KORBA,2021-03-07,6,992,1,999
CHHATTISGARH,KORBA,2021-03-08,10,1176,0,1186
CHHATTISGARH,KORBA,2021-03-09,23,1239,0,1262
CHHATTISGARH,KORBA,2021-03-10,21,1179,1,1201
CHHATTISGARH,KOREA,2021-03-06,9,286,0,295
CHHATTISGARH,KOREA,2021-03-07,3,605,0,608
CHHATTISGARH,KOREA,2021-03-08,2,326,0,328
CHHATTISGARH,KOREA,2021-03-09,13,199,0,212
CHHATTISGARH,KOREA,2021-03-10,17,212,0,229
CHHATTISGARH,MAHASAMUND,2021-03-06,4,1181,3,1188
CHHATTISGARH,MAHASAMUND,2021-03-07,7,504,11,522
CHHATTISGARH,MAHASAMUND,2021-03-08,3,1118,12,1133
CHHATTISGARH,MAHASAMUND,2021-03-09,1,1308,0,1309
CHHATTISGARH,MAHASAMUND,2021-03-10,6,1009,13,1028
CHHATTISGARH,MUNGELI,2021-03-06,1,416,1,418
CHHATTISGARH,MUNGELI,2021-03-07,1,335,0,336
CHHATTISGARH,MUNGELI,2021-03-08,3,574,1,578
CHHATTISGARH,MUNGELI,2021-03-09,0,483,0,483
CHHATTISGARH,MUNGELI,2021-03-10,0,449,0,449
CHHATTISGARH,NARAYANPUR,2021-03-06,1,243,1,245
CHHATTISGARH,NARAYANPUR,2021-03-08,0,131,0,131
CHHATTISGARH,NARAYANPUR,2021-03-09,0,310,0,310
CHHATTISGARH,NARAYANPUR,2021-03-10,0,131,0,131
CHHATTISGARH,RAIGARH,2021-03-06,6,1134,29,1169
CHHATTISGARH,RAIGARH,2021-03-07,6,606,15,627
CHHATTISGARH,RAIGARH,2021-03-08,4,896,0,900
CHHATTISGARH,RAIGARH,2021-03-09,9,1045,8,1062
CHHATTISGARH,RAIGARH,2021-03-10,2,823,2,827
CHHATTISGARH,RAIPUR,2021-03-06,102,2162,55,2319
CHHATTISGARH,RAIPUR,2021-03-07,85,1763,13,1861
CHHATTISGARH,RAIPUR,2021-03-08,139,1792,25,1956
CHHATTISGARH,RAIPUR,2021-03-09,210,2613,37,2860
CHHATTISGARH,RAIPUR,2021-03-10,200,1989,52,2241
CHHATTISGARH,RAJNANDGAON,2021-03-06,27,1095,13,1135
CHHATTISGARH,RAJNANDGAON,2021-03-07,10,781,4,795
CHHATTISGARH,RAJNANDGAON,2021-03-08,19,999,53,1071
CHHATTISGARH,RAJNANDGAON,2021-03-09,18,1294,31,1343
CHHATTISGARH,RAJNANDGAON,2021-03-10,13,1104,36,1153
CHHATTISGARH,SUKMA,2021-03-06,0,545,0,545
CHHATTISGARH,SUKMA,2021-03-07,0,23,0,23
CHHATTISGARH,SUKMA,2021-03-08,0,285,0,285
CHHATTISGARH,SUKMA,2021-03-09,0,578,0,578
CHHATTISGARH,SUKMA,2021-03-10,0,453,0,453
CHHATTISGARH,SURAJPUR,2021-03-06,6,917,29,952
CHHATTISGARH,SURAJPUR,2021-03-07,3,370,0,373
CHHATTISGARH,SURAJPUR,2021-03-08,19,873,1,893
CHHATTISGARH,SURAJPUR,2021-03-09,40,618,0,658
CHHATTISGARH,SURAJPUR,2021-03-10,35,896,4,935
CHHATTISGARH,SURGUJA,2021-03-06,9,714,2,725
CHHATTISGARH,SURGUJA,2021-03-07,11,247,0,258
CHHATTISGARH,SURGUJA,2021-03-08,18,848,1,867
CHHATTISGARH,SURGUJA,2021-03-09,19,964,0,983
CHHATTISGARH,SURGUJA,2021-03-10,34,932,1,967
DADRA AND NAGAR HAVELI,DADRA AND NAGAR HAVELI,2021-03-06,0,152,1,153
DADRA AND NAGAR HAVELI,DADRA AND NAGAR HAVELI,2021-03-07,5,73,0,78
DADRA AND NAGAR HAVELI,DADRA AND NAGAR HAVELI,2021-03-08,0,182,0,182
DADRA AND NAGAR HAVELI,DADRA AND NAGAR HAVELI,2021-03-09,2,216,0,218
DADRA AND NAGAR HAVELI,DADRA AND NAGAR HAVELI,2021-03-10,0,244,0,244
DAMAN AND DIU,DAMAN,2021-03-06,2,106,0,108
DAMAN AND DIU,DAMAN,2021-03-07,8,66,0,74
DAMAN AND DIU,DAMAN,2021-03-08,0,50,0,50
DAMAN AND DIU,DAMAN,2021-03-09,0,83,2,85
DAMAN AND DIU,DAMAN,2021-03-10,2,98,0,100
DAMAN AND DIU,DIU,2021-03-06,0,24,0,24
DAMAN AND DIU,DIU,2021-03-07,0,19,0,19
DAMAN AND DIU,DIU,2021-03-08,0,29,0,29
DAMAN AND DIU,DIU,2021-03-09,0,25,0,25
DAMAN AND DIU,DIU,2021-03-10,0,24,0,24
DELHI,CENTRAL,2021-03-06,26,4992,25,5043
DELHI,CENTRAL,2021-03-07,25,2578,26,2629
DELHI,CENTRAL,2021-03-08,26,6812,47,6885
DELHI,CENTRAL,2021-03-09,19,5049,15,5083
DELHI,CENTRAL,2021-03-10,17,4580,39,4636
DELHI,EAST,2021-03-06,21,3871,4,3896
DELHI,EAST,2021-03-07,37,2436,1,2474
DELHI,EAST,2021-03-08,39,2624,2,2665
DELHI,EAST,2021-03-09,27,3313,1,3341
DELHI,EAST,2021-03-10,37,3408,4,3449
DELHI,NEW DELHI,2021-03-06,51,13810,17,13878
DELHI,NEW DELHI,2021-03-07,30,5441,7,5478
DELHI,NEW DELHI,2021-03-08,61,9278,6,9345
DELHI,NEW DELHI,2021-03-09,55,8495,19,8569
DELHI,NEW DELHI,2021-03-10,69,7526,14,7609
DELHI,NORTH,2021-03-06,16,8858,5,8879
DELHI,NORTH,2021-03-07,8,5951,1,5960
DELHI,NORTH,2021-03-08,6,6672,4,6682
DELHI,NORTH,2021-03-09,16,6912,12,6940
DELHI,NORTH,2021-03-10,17,5711,256,5984
DELHI,NORTH EAST,2021-03-06,3,7411,2,7416
DELHI,NORTH EAST,2021-03-07,4,3597,4,3605
DELHI,NORTH EAST,2021-03-08,10,5141,3,5154
DELHI,NORTH EAST,2021-03-09,4,5572,5,5581
DELHI,NORTH EAST,2021-03-10,7,4474,9,4490
DELHI,NORTH WEST,2021-03-06,40,7711,102,7853
DELHI,NORTH WEST,2021-03-07,40,5110,2,5152
DELHI,NORTH WEST,2021-03-08,47,5640,139,5826
DELHI,NORTH WEST,2021-03-09,74,7015,44,7133
DELHI,NORTH WEST,2021-03-10,62,7578,9,7649
DELHI,SHAHDARA,2021-03-06,13,9427,2,9442
DELHI,SHAHDARA,2021-03-07,4,3063,1,3068
DELHI,SHAHDARA,2021-03-08,7,6901,2,6910
DELHI,SHAHDARA,2021-03-09,9,7051,4,7064
DELHI,SHAHDARA,2021-03-10,5,7200,46,7251
DELHI,SOUTH,2021-03-06,54,8617,45,8716
DELHI,SOUTH,2021-03-07,48,4412,7,4467
DELHI,SOUTH,2021-03-08,74,6733,103,6910
DELHI,SOUTH,2021-03-09,90,6154,111,6355
DELHI,SOUTH,2021-03-10,100,6306,8,6414
DELHI,SOUTH EAST,2021-03-06,22,8601,1,8624
DELHI,SOUTH EAST,2021-03-07,10,3544,0,3554
DELHI,SOUTH EAST,2021-03-08,9,4853,2,4864
DELHI,SOUTH EAST,2021-03-09,24,5250,4,5278
DELHI,SOUTH EAST,2021-03-10,25,5856,6,5887
DELHI,SOUTH WEST,2021-03-06,22,6461,2,6485
DELHI,SOUTH WEST,2021-03-07,22,3228,1,3251
DELHI,SOUTH WEST,2021-03-08,29,3366,1,3396
DELHI,SOUTH WEST,2021-03-09,47,4974,2,5023
DELHI,SOUTH WEST,2021-03-10,30,6298,0,6328
DELHI,WEST,2021-03-06,49,11309,6,11364
DELHI,WEST,2021-03-07,27,8003,9,8039
DELHI,WEST,2021-03-08,45,8045,4,8094
DELHI,WEST,2021-03-09,51,10728,9,10788
DELHI,WEST,2021-03-10,70,9979,4,10053
GOA,NORTH GOA,2021-03-06,52,718,4,774
GOA,NORTH GOA,2021-03-07,23,616,1,640
GOA,NORTH GOA,2021-03-08,20,557,0,577
GOA,NORTH GOA,2021-03-09,33,931,0,964
GOA,NORTH GOA,2021-03-10,25,710,0,735
GOA,SOUTH GOA,2021-03-06,40,708,0,748
GOA,SOUTH GOA,2021-03-07,25,408,0,433
GOA,SOUTH GOA,2021-03-08,51,815,0,866
GOA,SOUTH GOA,2021-03-09,52,837,2,891
GOA,SOUTH GOA,2021-03-10,21,810,1,832
GUJARAT,AHMADABAD,2021-03-06,190,3298,45,3533
GUJARAT,AHMADABAD,2021-03-07,144,984,13,1141
GUJARAT,AHMADABAD,2021-03-08,180,3337,121,3638
GUJARAT,AHMADABAD,2021-03-09,175,4327,159,4661
GUJARAT,AHMADABAD,2021-03-10,202,4195,173,4570
GUJARAT,AMRELI,2021-03-06,2,905,0,907
GUJARAT,AMRELI,2021-03-07,0,175,0,175
GUJARAT,AMRELI,2021-03-08,2,581,0,583
GUJARAT,AMRELI,2021-03-09,7,958,1,966
GUJARAT,AMRELI,2021-03-10,10,934,1,945
GUJARAT,ANAND,2021-03-06,23,418,5,446
GUJARAT,ANAND,2021-03-07,16,216,0,232
GUJARAT,ANAND,2021-03-08,17,439,5,461
GUJARAT,ANAND,2021-03-09,36,933,0,969
GUJARAT,ANAND,2021-03-10,32,719,3,754
GUJARAT,ARVALLI,2021-03-06,7,356,0,363
GUJARAT,ARVALLI,2021-03-07,2,145,0,147
GUJARAT,ARVALLI,2021-03-08,4,301,1,306
GUJARAT,ARVALLI,2021-03-09,2,438,0,440
GUJARAT,ARVALLI,2021-03-10,1,471,0,472
GUJARAT,BANAS KANTHA,2021-03-06,6,377,0,383
GUJARAT,BANAS KANTHA,2021-03-07,2,44,0,46
GUJARAT,BANAS KANTHA,2021-03-08,4,350,0,354
GUJARAT,BANAS KANTHA,2021-03-09,2,460,0,462
GUJARAT,BANAS KANTHA,2021-03-10,2,488,1,491
GUJARAT,BHARUCH,2021-03-06,30,382,6,418
GUJARAT,BHARUCH,2021-03-07,19,176,0,195
GUJARAT,BHARUCH,2021-03-08,20,472,1,493
GUJARAT,BHARUCH,2021-03-09,40,422,0,462
GUJARAT,BHARUCH,2021-03-10,29,512,2,543
GUJARAT,BHAVNAGAR,2021-03-06,9,305,1,315
GUJARAT,BHAVNAGAR,2021-03-07,8,298,0,306
GUJARAT,BHAVNAGAR,2021-03-08,34,769,0,803
GUJARAT,BHAVNAGAR,2021-03-09,14,905,4,923
GUJARAT,BHAVNAGAR,2021-03-10,6,808,0,814
GUJARAT,BOTAD,2021-03-06,0,46,0,46
GUJARAT,BOTAD,2021-03-07,0,32,0,32
GUJARAT,BOTAD,2021-03-08,1,196,0,197
GUJARAT,BOTAD,2021-03-09,18,181,0,199
GUJARAT,BOTAD,2021-03-10,1,136,0,137
GUJARAT,CHHOTAUDEPUR,2021-03-06,3,265,1,269
GUJARAT,CHHOTAUDEPUR,2021-03-07,1,38,0,39
GUJARAT,CHHOTAUDEPUR,2021-03-08,7,183,0,190
GUJARAT,CHHOTAUDEPUR,2021-03-09,2,211,0,213
GUJARAT,CHHOTAUDEPUR,2021-03-10,2,208,0,210
GUJARAT,DANG,2021-03-06,1,47,0,48
GUJARAT,DANG,2021-03-07,0,16,0,16
GUJARAT,DANG,2021-03-08,0,21,0,21
GUJARAT,DANG,2021-03-09,0,67,0,67
GUJARAT,DANG,2021-03-10,1,40,0,41
GUJARAT,DEVBHUMI DWARKA,2021-03-06,1,184,0,185
GUJARAT,DEVBHUMI DWARKA,2021-03-07,4,105,0,109
GUJARAT,DEVBHUMI DWARKA,2021-03-08,9,123,0,132
GUJARAT,DEVBHUMI DWARKA,2021-03-09,5,146,0,151
GUJARAT,DEVBHUMI DWARKA,2021-03-10,10,213,0,223
GUJARAT,DOHAD,2021-03-06,2,580,2,584
GUJARAT,DOHAD,2021-03-07,7,471,1,479
GUJARAT,DOHAD,2021-03-08,8,287,0,295
GUJARAT,DOHAD,2021-03-09,1,378,3,382
GUJARAT,DOHAD,2021-03-10,10,682,0,692
GUJARAT,GANDHINAGAR,2021-03-06,25,605,3,633
GUJARAT,GANDHINAGAR,2021-03-07,13,318,12,343
GUJARAT,GANDHINAGAR,2021-03-08,19,728,7,754
GUJARAT,GANDHINAGAR,2021-03-09,21,894,13,928
GUJARAT,GANDHINAGAR,2021-03-10,24,1037,7,1068
GUJARAT,GIR SOMNATH,2021-03-06,7,113,0,120
GUJARAT,GIR SOMNATH,2021-03-07,12,35,0,47
GUJARAT,GIR SOMNATH,2021-03-08,8,289,0,297
GUJARAT,GIR SOMNATH,2021-03-09,4,145,0,149
GUJARAT,GIR SOMNATH,2021-03-10,5,196,0,201
GUJARAT,JAMNAGAR,2021-03-06,13,735,2,750
GUJARAT,JAMNAGAR,2021-03-07,11,379,1,391
GUJARAT,JAMNAGAR,2021-03-08,21,821,1,843
GUJARAT,JAMNAGAR,2021-03-09,11,1107,3,1121
GUJARAT,JAMNAGAR,2021-03-10,11,881,0,892
GUJARAT,JUNAGADH,2021-03-06,4,495,1,500
GUJARAT,JUNAGADH,2021-03-07,25,330,0,355
GUJARAT,JUNAGADH,2021-03-08,1,428,0,429
GUJARAT,JUNAGADH,2021-03-09,8,463,1,472
GUJARAT,JUNAGADH,2021-03-10,6,644,1,651
GUJARAT,KACHCHH,2021-03-06,57,705,17,779
GUJARAT,KACHCHH,2021-03-07,29,563,7,599
GUJARAT,KACHCHH,2021-03-08,29,733,23,785
GUJARAT,KACHCHH,2021-03-09,32,737,30,799
GUJARAT,KACHCHH,2021-03-10,37,644,21,702
GUJARAT,KHEDA,2021-03-06,13,790,117,920
GUJARAT,KHEDA,2021-03-07,14,226,42,282
GUJARAT,KHEDA,2021-03-08,22,839,42,903
GUJARAT,KHEDA,2021-03-09,10,1197,30,1237
GUJARAT,KHEDA,2021-03-10,22,1083,14,1119
GUJARAT,MAHESANA,2021-03-06,15,271,0,286
GUJARAT,MAHESANA,2021-03-07,12,252,0,264
GUJARAT,MAHESANA,2021-03-08,5,83,9,97
GUJARAT,MAHESANA,2021-03-09,19,262,0,281
GUJARAT,MAHESANA,2021-03-10,6,317,0,323
GUJARAT,MAHISAGAR,2021-03-06,10,495,0,505
GUJARAT,MAHISAGAR,2021-03-07,12,169,0,181
GUJARAT,MAHISAGAR,2021-03-08,12,419,0,431
GUJARAT,MAHISAGAR,2021-03-09,6,675,0,681
GUJARAT,MAHISAGAR,2021-03-10,10,511,0,521
GUJARAT,MORBI,2021-03-06,0,222,0,222
GUJARAT,MORBI,2021-03-07,3,104,0,107
GUJARAT,MORBI,2021-03-08,3,216,0,219
GUJARAT,MORBI,2021-03-09,4,260,3,267
GUJARAT,MORBI,2021-03-10,7,272,3,282
GUJARAT,NARMADA,2021-03-06,2,17,1,20
GUJARAT,NARMADA,2021-03-07,0,21,0,21
GUJARAT,NARMADA,2021-03-08,1,10,0,11
GUJARAT,NARMADA,2021-03-09,3,48,1,52
GUJARAT,NARMADA,2021-03-10,4,40,2,46
GUJARAT,NAVSARI,2021-03-06,7,293,0,300
GUJARAT,NAVSARI,2021-03-07,2,103,0,105
GUJARAT,NAVSARI,2021-03-08,4,447,0,451
GUJARAT,NAVSARI,2021-03-09,4,309,0,313
GUJARAT,NAVSARI,2021-03-10,15,392,1,408
GUJARAT,PANCH MAHALS,2021-03-06,12,311,3,326
GUJARAT,PANCH MAHALS,2021-03-07,14,151,0,165
GUJARAT,PANCH MAHALS,2021-03-08,8,182,0,190
GUJARAT,PANCH MAHALS,2021-03-09,21,319,2,342
GUJARAT,PANCH MAHALS,2021-03-10,24,465,1,490
GUJARAT,PATAN,2021-03-06,4,157,0,161
GUJARAT,PATAN,2021-03-07,2,39,0,41
GUJARAT,PATAN,2021-03-08,2,363,1,366
GUJARAT,PATAN,2021-03-09,2,361,0,363
GUJARAT,PATAN,2021-03-10,2,454,0,456
GUJARAT,PORBANDAR,2021-03-06,0,210,0,210
GUJARAT,PORBANDAR,2021-03-07,0,161,0,161
GUJARAT,PORBANDAR,2021-03-08,0,314,3,317
GUJARAT,PORBANDAR,2021-03-09,1,215,0,216
GUJARAT,PORBANDAR,2021-03-10,0,218,1,219
GUJARAT,RAJKOT,2021-03-06,56,1236,21,1313
GUJARAT,RAJKOT,2021-03-07,32,446,10,488
GUJARAT,RAJKOT,2021-03-08,67,1334,0,1401
GUJARAT,RAJKOT,2021-03-09,61,1586,2,1649
GUJARAT,RAJKOT,2021-03-10,80,1675,8,1763
GUJARAT,SABAR KANTHA,2021-03-06,10,112,0,122
GUJARAT,SABAR KANTHA,2021-03-07,18,93,2,113
GUJARAT,SABAR KANTHA,2021-03-08,9,157,2,168
GUJARAT,SABAR KANTHA,2021-03-09,7,184,1,192
GUJARAT,SABAR KANTHA,2021-03-10,16,248,31,295
GUJARAT,SURAT,2021-03-06,135,1625,4,1764
GUJARAT,SURAT,2021-03-07,51,686,1,738
GUJARAT,SURAT,2021-03-08,144,2175,0,2319
GUJARAT,SURAT,2021-03-09,162,2016,0,2178
GUJARAT,SURAT,2021-03-10,161,1924,0,2085
GUJARAT,SURENDRANAGAR,2021-03-06,0,326,1,327
GUJARAT,SURENDRANAGAR,2021-03-07,1,56,0,57
GUJARAT,SURENDRANAGAR,2021-03-08,1,475,4,480
GUJARAT,SURENDRANAGAR,2021-03-09,3,679,2,684
GUJARAT,SURENDRANAGAR,2021-03-10,2,643,0,645
GUJARAT,TAPI,2021-03-06,1,242,0,243
GUJARAT,TAPI,2021-03-07,2,63,1,66
GUJARAT,TAPI,2021-03-08,10,274,0,284
GUJARAT,TAPI,2021-03-09,7,229,0,236
GUJARAT,TAPI,2021-03-10,9,283,0,292
GUJARAT,VADODARA,2021-03-06,108,1274,107,1489
GUJARAT,VADODARA,2021-03-07,62,627,49,738
GUJARAT,VADODARA,2021-03-08,108,1457,106,1671
GUJARAT,VADODARA,2021-03-09,151,1520,161,1832
GUJARAT,VADODARA,2021-03-10,161,1610,131,1902
GUJARAT,VALSAD,2021-03-06,5,269,0,274
GUJARAT,VALSAD,2021-03-07,9,325,0,334
GUJARAT,VALSAD,2021-03-08,2,247,0,249
GUJARAT,VALSAD,2021-03-09,4,567,1,572
GUJARAT,VALSAD,2021-03-10,4,538,0,542
HARYANA,AMBALA,2021-03-06,31,1069,14,1114
HARYANA,AMBALA,2021-03-07,59,898,46,1003
HARYANA,AMBALA,2021-03-08,53,754,10,817
HARYANA,AMBALA,2021-03-09,54,917,22,993
HARYANA,AMBALA,2021-03-10,55,1042,35,1132
HARYANA,BHIWANI,2021-03-06,1,481,0,482
HARYANA,BHIWANI,2021-03-07,7,324,0,331
HARYANA,BHIWANI,2021-03-08,1,552,0,553
HARYANA,BHIWANI,2021-03-09,3,515,0,518
HARYANA,BHIWANI,2021-03-10,1,829,0,830
HARYANA,CHARKI DADRI,2021-03-06,5,16,0,21
HARYANA,CHARKI DADRI,2021-03-07,0,479,0,479
HARYANA,CHARKI DADRI,2021-03-08,0,504,0,504
HARYANA,CHARKI DADRI,2021-03-09,0,189,0,189
HARYANA,CHARKI DADRI,2021-03-10,0,198,1,199
HARYANA,FARIDABAD,2021-03-06,13,819,0,832
HARYANA,FARIDABAD,2021-03-07,33,416,2,451
HARYANA,FARIDABAD,2021-03-08,31,720,3,754
HARYANA,FARIDABAD,2021-03-09,22,1266,4,1292
HARYANA,FARIDABAD,2021-03-10,28,914,0,942
HARYANA,FATEHABAD,2021-03-06,4,739,2,745
HARYANA,FATEHABAD,2021-03-07,7,332,0,339
HARYANA,FATEHABAD,2021-03-08,4,495,2,501
HARYANA,FATEHABAD,2021-03-09,3,319,2,324
HARYANA,FATEHABAD,2021-03-10,6,394,0,400
HARYANA,GURUGRAM,2021-03-06,81,3173,9,3263
HARYANA,GURUGRAM,2021-03-07,69,2987,28,3084
HARYANA,GURUGRAM,2021-03-08,101,2274,17,2392
HARYANA,GURUGRAM,2021-03-09,100,3168,26,3294
HARYANA,GURUGRAM,2021-03-10,124,3537,15,3676
HARYANA,HISAR,2021-03-06,4,976,0,980
HARYANA,HISAR,2021-03-07,5,703,0,708
HARYANA,HISAR,2021-03-08,3,1199,0,1202
HARYANA,HISAR,2021-03-09,5,1057,0,1062
HARYANA,HISAR,2021-03-10,4,1062,1,1067
HARYANA,JHAJJAR,2021-03-06,2,1197,6,1205
HARYANA,JHAJJAR,2021-03-07,0,443,0,443
HARYANA,JHAJJAR,2021-03-08,1,394,0,395
HARYANA,JHAJJAR,2021-03-09,2,653,2,657
HARYANA,JHAJJAR,2021-03-10,1,457,0,458
HARYANA,JIND,2021-03-06,20,1173,13,1206
HARYANA,JIND,2021-03-07,5,170,0,175
HARYANA,JIND,2021-03-08,5,66,0,71
HARYANA,JIND,2021-03-09,6,229,5,240
HARYANA,JIND,2021-03-10,16,356,3,375
HARYANA,KAITHAL,2021-03-06,16,368,3,387
HARYANA,KAITHAL,2021-03-07,3,331,1,335
HARYANA,KAITHAL,2021-03-08,61,337,0,398
HARYANA,KAITHAL,2021-03-09,3,310,7,320
HARYANA,KAITHAL,2021-03-10,41,406,0,447
HARYANA,KARNAL,2021-03-06,65,928,0,993
HARYANA,KARNAL,2021-03-07,10,105,1,116
HARYANA,KARNAL,2021-03-08,76,597,0,673
HARYANA,KARNAL,2021-03-09,5,806,0,811
HARYANA,KARNAL,2021-03-10,105,641,4,750
HARYANA,KURUKSHETRA,2021-03-06,41,888,0,929
HARYANA,KURUKSHETRA,2021-03-07,47,715,97,859
HARYANA,KURUKSHETRA,2021-03-08,28,1101,3,1132
HARYANA,KURUKSHETRA,2021-03-09,49,1489,12,1550
HARYANA,KURUKSHETRA,2021-03-10,27,917,3,947
HARYANA,MAHENDRAGARH,2021-03-06,1,285,0,286
HARYANA,MAHENDRAGARH,2021-03-07,0,419,0,419
HARYANA,MAHENDRAGARH,2021-03-08,1,45,1,47
HARYANA,MAHENDRAGARH,2021-03-09,0,319,0,319
HARYANA,MAHENDRAGARH,2021-03-10,0,168,0,168
HARYANA,NUH,2021-03-06,0,434,0,434
HARYANA,NUH,2021-03-07,1,24,0,25
HARYANA,NUH,2021-03-08,1,451,0,452
HARYANA,NUH,2021-03-09,3,135,0,138
HARYANA,NUH,2021-03-10,0,176,0,176
HARYANA,PALWAL,2021-03-06,1,238,0,239
HARYANA,PALWAL,2021-03-07,0,27,0,27
HARYANA,PALWAL,2021-03-08,0,44,0,44
HARYANA,PALWAL,2021-03-09,0,86,0,86
HARYANA,PALWAL,2021-03-10,0,48,0,48
HARYANA,PANCHKULA,2021-03-06,74,942,9,1025
HARYANA,PANCHKULA,2021-03-07,37,653,4,694
HARYANA,PANCHKULA,2021-03-08,63,646,5,714
HARYANA,PANCHKULA,2021-03-09,63,847,3,913
HARYANA,PANCHKULA,2021-03-10,87,901,9,997
HARYANA,PANIPAT,2021-03-06,1,821,1,823
HARYANA,PANIPAT,2021-03-07,8,287,0,295
HARYANA,PANIPAT,2021-03-08,6,662,0,668
HARYANA,PANIPAT,2021-03-09,13,1000,0,1013
HARYANA,PANIPAT,2021-03-10,20,1057,0,1077
HARYANA,REWARI,2021-03-06,0,814,0,814
HARYANA,REWARI,2021-03-07,1,921,1,923
HARYANA,REWARI,2021-03-08,3,1213,15,1231
HARYANA,REWARI,2021-03-09,1,837,19,857
HARYANA,REWARI,2021-03-10,0,532,35,567
HARYANA,ROHTAK,2021-03-06,6,521,1,528
HARYANA,ROHTAK,2021-03-07,2,140,0,142
HARYANA,ROHTAK,2021-03-08,4,846,0,850
HARYANA,ROHTAK,2021-03-09,2,617,0,619
HARYANA,ROHTAK,2021-03-10,3,604,0,607
HARYANA,SIRSA,2021-03-06,5,723,7,735
HARYANA,SIRSA,2021-03-07,4,670,39,713
HARYANA,SIRSA,2021-03-08,6,265,0,271
HARYANA,SIRSA,2021-03-09,5,834,11,850
HARYANA,SIRSA,2021-03-10,8,943,68,1019
HARYANA,SONIPAT,2021-03-06,4,942,0,946
HARYANA,SONIPAT,2021-03-07,1,766,0,767
HARYANA,SONIPAT,2021-03-08,4,639,0,643
HARYANA,SONIPAT,2021-03-09,18,1407,0,1425
HARYANA,SONIPAT,2021-03-10,12,1365,0,1377
HARYANA,YAMUNANAGAR,2021-03-06,46,368,1,415
HARYANA,YAMUNANAGAR,2021-03-07,18,643,1,662
HARYANA,YAMUNANAGAR,2021-03-08,12,375,0,387
HARYANA,YAMUNANAGAR,2021-03-09,15,367,3,385
HARYANA,YAMUNANAGAR,2021-03-10,30,121,1,152
HIMACHAL PRADESH,BILASPUR,2021-03-06,4,459,1,464
HIMACHAL PRADESH,BILASPUR,2021-03-07,9,117,0,126
HIMACHAL PRADESH,BILASPUR,2021-03-08,3,381,4,388
HIMACHAL PRADESH,BILASPUR,2021-03-09,5,239,2,246
HIMACHAL PRADESH,BILASPUR,2021-03-10,2,177,1,180
HIMACHAL PRADESH,CHAMBA,2021-03-06,1,200,0,201
HIMACHAL PRADESH,CHAMBA,2021-03-07,0,309,5,314
HIMACHAL PRADESH,CHAMBA,2021-03-08,0,307,2,309
HIMACHAL PRADESH,CHAMBA,2021-03-09,1,349,0,350
HIMACHAL PRADESH,CHAMBA,2021-03-10,1,566,8,575
HIMACHAL PRADESH,HAMIRPUR,2021-03-06,8,554,1,563
HIMACHAL PRADESH,HAMIRPUR,2021-03-07,1,233,4,238
HIMACHAL PRADESH,HAMIRPUR,2021-03-08,0,551,1,552
HIMACHAL PRADESH,HAMIRPUR,2021-03-09,12,322,3,337
HIMACHAL PRADESH,HAMIRPUR,2021-03-10,4,315,0,319
HIMACHAL PRADESH,KANGRA,2021-03-06,6,589,0,595
HIMACHAL PRADESH,KANGRA,2021-03-07,5,286,0,291
HIMACHAL PRADESH,KANGRA,2021-03-08,17,1082,5,1104
HIMACHAL PRADESH,KANGRA,2021-03-09,14,533,3,550
HIMACHAL PRADESH,KANGRA,2021-03-10,18,1126,0,1144
HIMACHAL PRADESH,KINNAUR,2021-03-06,0,10,0,10
HIMACHAL PRADESH,KINNAUR,2021-03-08,0,13,0,13
HIMACHAL PRADESH,KINNAUR,2021-03-09,0,8,0,8
HIMACHAL PRADESH,KINNAUR,2021-03-10,0,64,0,64
HIMACHAL PRADESH,KULLU,2021-03-06,1,92,1,94
HIMACHAL PRADESH,KULLU,2021-03-07,1,99,2,102
HIMACHAL PRADESH,KULLU,2021-03-08,4,103,1,108
HIMACHAL PRADESH,KULLU,2021-03-09,2,134,14,150
HIMACHAL PRADESH,KULLU,2021-03-10,2,113,8,123
HIMACHAL PRADESH,LAHUL AND SPITI,2021-03-06,0,2,0,2
HIMACHAL PRADESH,LAHUL AND SPITI,2021-03-07,0,1,0,1
HIMACHAL PRADESH,LAHUL AND SPITI,2021-03-08,0,6,0,6
HIMACHAL PRADESH,LAHUL AND SPITI,2021-03-09,0,6,0,6
HIMACHAL PRADESH,LAHUL AND SPITI,2021-03-10,0,3,0,3
HIMACHAL PRADESH,MANDI,2021-03-06,1,202,12,215
HIMACHAL PRADESH,MANDI,2021-03-07,2,51,3,56
HIMACHAL PRADESH,MANDI,2021-03-08,5,355,2,362
HIMACHAL PRADESH,MANDI,2021-03-09,4,317,11,332
HIMACHAL PRADESH,MANDI,2021-03-10,3,233,20,256
HIMACHAL PRADESH,SHIMLA,2021-03-06,5,558,4,567
HIMACHAL PRADESH,SHIMLA,2021-03-07,4,158,5,167
HIMACHAL PRADESH,SHIMLA,2021-03-08,8,439,13,460
HIMACHAL PRADESH,SHIMLA,2021-03-09,14,430,6,450
HIMACHAL PRADESH,SHIMLA,2021-03-10,6,374,5,385
HIMACHAL PRADESH,SIRMAUR,2021-03-06,1,328,0,329
HIMACHAL PRADESH,SIRMAUR,2021-03-07,22,191,1,214
HIMACHAL PRADESH,SIRMAUR,2021-03-08,3,209,2,214
HIMACHAL PRADESH,SIRMAUR,2021-03-09,44,423,1,468
HIMACHAL PRADESH,SIRMAUR,2021-03-10,1,295,0,296
HIMACHAL PRADESH,SOLAN,2021-03-06,10,545,1,556
HIMACHAL PRADESH,SOLAN,2021-03-07,11,328,0,339
HIMACHAL PRADESH,SOLAN,2021-03-08,17,467,0,484
HIMACHAL PRADESH,SOLAN,2021-03-09,8,774,2,784
HIMACHAL PRADESH,SOLAN,2021-03-10,19,510,2,531
HIMACHAL PRADESH,UNA,2021-03-06,4,532,1,537
HIMACHAL PRADESH,UNA,2021-03-07,7,207,0,214
HIMACHAL PRADESH,UNA,2021-03-08,13,377,0,390
HIMACHAL PRADESH,UNA,2021-03-09,11,121,0,132
HIMACHAL PRADESH,UNA,2021-03-10,24,322,0,346
INDIA,INDIA,2021-03-06,2,7,0,9
INDIA,INDIA,2021-03-07,5,5,0,10
INDIA,INDIA,2021-03-08,3,3,0,6
INDIA,INDIA,2021-03-09,4,3,0,7
INDIA,INDIA,2021-03-10,3,4,0,7
JAMMU AND KASHMIR,ANANTNAG,2021-03-06,2,369,0,371
JAMMU AND KASHMIR,ANANTNAG,2021-03-07,3,130,0,133
JAMMU AND KASHMIR,ANANTNAG,2021-03-08,7,237,1,245
JAMMU AND KASHMIR,ANANTNAG,2021-03-09,7,356,0,363
JAMMU AND KASHMIR,ANANTNAG,2021-03-10,7,298,0,305
JAMMU AND KASHMIR,BANDIPORA,2021-03-06,0,130,2,132
JAMMU AND KASHMIR,BANDIPORA,2021-03-07,1,18,0,19
JAMMU AND KASHMIR,BANDIPORA,2021-03-08,0,94,1,95
JAMMU AND KASHMIR,BANDIPORA,2021-03-09,1,123,0,124
JAMMU AND KASHMIR,BANDIPORA,2021-03-10,3,182,0,185
JAMMU AND KASHMIR,BARAMULLA,2021-03-06,2,334,0,336
JAMMU AND KASHMIR,BARAMULLA,2021-03-07,3,180,0,183
JAMMU AND KASHMIR,BARAMULLA,2021-03-08,3,272,0,275
JAMMU AND KASHMIR,BARAMULLA,2021-03-09,6,448,0,454
JAMMU AND KASHMIR,BARAMULLA,2021-03-10,4,318,0,322
JAMMU AND KASHMIR,BUDGAM,2021-03-06,6,1025,0,1031
JAMMU AND KASHMIR,BUDGAM,2021-03-07,1,478,0,479
JAMMU AND KASHMIR,BUDGAM,2021-03-08,11,1130,0,1141
JAMMU AND KASHMIR,BUDGAM,2021-03-09,7,1408,0,1415
JAMMU AND KASHMIR,BUDGAM,2021-03-10,2,783,0,785
JAMMU AND KASHMIR,DODA,2021-03-06,2,19,0,21
JAMMU AND KASHMIR,DODA,2021-03-07,2,6,0,8
JAMMU AND KASHMIR,DODA,2021-03-08,3,18,0,21
JAMMU AND KASHMIR,DODA,2021-03-09,0,8,0,8
JAMMU AND KASHMIR,DODA,2021-03-10,0,41,0,41
JAMMU AND KASHMIR,GANDERBAL,2021-03-06,0,69,0,69
JAMMU AND KASHMIR,GANDERBAL,2021-03-07,0,53,0,53
JAMMU AND KASHMIR,GANDERBAL,2021-03-08,3,88,0,91
JAMMU AND KASHMIR,GANDERBAL,2021-03-09,2,130,0,132
JAMMU AND KASHMIR,GANDERBAL,2021-03-10,1,155,0,156
JAMMU AND KASHMIR,JAMMU,2021-03-06,22,575,0,597
JAMMU AND KASHMIR,JAMMU,2021-03-07,5,451,0,456
JAMMU AND KASHMIR,JAMMU,2021-03-08,12,790,2,804
JAMMU AND KASHMIR,JAMMU,2021-03-09,10,722,0,732
JAMMU AND KASHMIR,JAMMU,2021-03-10,8,792,1,801
JAMMU AND KASHMIR,KATHUA,2021-03-06,2,112,0,114
JAMMU AND KASHMIR,KATHUA,2021-03-07,0,14,0,14
JAMMU AND KASHMIR,KATHUA,2021-03-08,2,118,0,120
JAMMU AND KASHMIR,KATHUA,2021-03-09,2,285,0,287
JAMMU AND KASHMIR,KATHUA,2021-03-10,2,352,1,355
JAMMU AND KASHMIR,KISHTWAR,2021-03-06,0,73,0,73
JAMMU AND KASHMIR,KISHTWAR,2021-03-07,0,24,0,24
JAMMU AND KASHMIR,KISHTWAR,2021-03-08,0,21,0,21
JAMMU AND KASHMIR,KISHTWAR,2021-03-09,0,46,0,46
JAMMU AND KASHMIR,KISHTWAR,2021-03-10,0,73,0,73
JAMMU AND KASHMIR,KULGAM,2021-03-06,0,99,0,99
JAMMU AND KASHMIR,KULGAM,2021-03-07,0,28,0,28
JAMMU AND KASHMIR,KULGAM,2021-03-08,2,83,0,85
JAMMU AND KASHMIR,KULGAM,2021-03-09,1,127,1,129
JAMMU AND KASHMIR,KULGAM,2021-03-10,0,235,0,235
JAMMU AND KASHMIR,KUPWARA,2021-03-06,0,94,0,94
JAMMU AND KASHMIR,KUPWARA,2021-03-07,1,112,0,113
JAMMU AND KASHMIR,KUPWARA,2021-03-08,1,117,0,118
JAMMU AND KASHMIR,KUPWARA,2021-03-09,1,141,0,142
JAMMU AND KASHMIR,KUPWARA,2021-03-10,1,165,0,166
JAMMU AND KASHMIR,POONCH,2021-03-06,1,390,0,391
JAMMU AND KASHMIR,POONCH,2021-03-07,1,245,0,246
JAMMU AND KASHMIR,POONCH,2021-03-08,1,392,0,393
JAMMU AND KASHMIR,POONCH,2021-03-09,1,194,0,195
JAMMU AND KASHMIR,POONCH,2021-03-10,0,234,0,234
JAMMU AND KASHMIR,PULWAMA,2021-03-06,0,512,0,512
JAMMU AND KASHMIR,PULWAMA,2021-03-07,0,149,0,149
JAMMU AND KASHMIR,PULWAMA,2021-03-08,12,645,5,662
JAMMU AND KASHMIR,PULWAMA,2021-03-09,5,814,0,819
JAMMU AND KASHMIR,PULWAMA,2021-03-10,8,539,1,548
JAMMU AND KASHMIR,RAJOURI,2021-03-06,1,91,0,92
JAMMU AND KASHMIR,RAJOURI,2021-03-07,0,13,0,13
JAMMU AND KASHMIR,RAJOURI,2021-03-08,0,77,0,77
JAMMU AND KASHMIR,RAJOURI,2021-03-09,1,152,0,153
JAMMU AND KASHMIR,RAJOURI,2021-03-10,0,159,0,159
JAMMU AND KASHMIR,RAMBAN,2021-03-06,6,280,0,286
JAMMU AND KASHMIR,RAMBAN,2021-03-07,2,112,0,114
JAMMU AND KASHMIR,RAMBAN,2021-03-08,0,195,1,196
JAMMU AND KASHMIR,RAMBAN,2021-03-09,0,139,0,139
JAMMU AND KASHMIR,RAMBAN,2021-03-10,0,155,0,155
JAMMU AND KASHMIR,REASI,2021-03-06,0,88,0,88
JAMMU AND KASHMIR,REASI,2021-03-07,0,5,0,5
JAMMU AND KASHMIR,REASI,2021-03-08,0,95,0,95
JAMMU AND KASHMIR,REASI,2021-03-09,0,81,0,81
JAMMU AND KASHMIR,REASI,2021-03-10,0,86,0,86
JAMMU AND KASHMIR,SAMBA,2021-03-06,0,135,0,135
JAMMU AND KASHMIR,SAMBA,2021-03-07,0,107,0,107
JAMMU AND KASHMIR,SAMBA,2021-03-08,0,118,0,118
JAMMU AND KASHMIR,SAMBA,2021-03-09,1,196,0,197
JAMMU AND KASHMIR,SAMBA,2021-03-10,0,136,0,136
JAMMU AND KASHMIR,SHOPIAN,2021-03-06,0,42,0,42
JAMMU AND KASHMIR,SHOPIAN,2021-03-07,0,6,0,6
JAMMU AND KASHMIR,SHOPIAN,2021-03-08,0,65,0,65
JAMMU AND KASHMIR,SHOPIAN,2021-03-09,6,85,1,92
JAMMU AND KASHMIR,SHOPIAN,2021-03-10,1,74,0,75
JAMMU AND KASHMIR,SRINAGAR,2021-03-06,30,4317,2,4349
JAMMU AND KASHMIR,SRINAGAR,2021-03-07,10,1869,0,1879
JAMMU AND KASHMIR,SRINAGAR,2021-03-08,38,3930,5,3973
JAMMU AND KASHMIR,SRINAGAR,2021-03-09,41,3771,1,3813
JAMMU AND KASHMIR,SRINAGAR,2021-03-10,37,3861,6,3904
JAMMU AND KASHMIR,UDHAMPUR,2021-03-06,17,698,0,715
JAMMU AND KASHMIR,UDHAMPUR,2021-03-07,0,144,0,144
JAMMU AND KASHMIR,UDHAMPUR,2021-03-08,4,724,1,729
JAMMU AND KASHMIR,UDHAMPUR,2021-03-09,2,538,0,540
JAMMU AND KASHMIR,UDHAMPUR,2021-03-10,1,411,0,412
JHARKHAND,BOKARO,2021-03-06,5,1005,6,1016
JHARKHAND,BOKARO,2021-03-07,0,852,0,852
JHARKHAND,BOKARO,2021-03-08,1,1158,2,1161
JHARKHAND,BOKARO,2021-03-09,4,1486,2,1492
JHARKHAND,BOKARO,2021-03-10,4,1177,2,1183
JHARKHAND,CHATRA,2021-03-06,0,316,48,364
JHARKHAND,CHATRA,2021-03-07,0,543,5,548
JHARKHAND,CHATRA,2021-03-08,0,330,0,330
JHARKHAND,CHATRA,2021-03-09,0,261,1,262
JHARKHAND,CHATRA,2021-03-10,1,585,0,586
JHARKHAND,DEOGHAR,2021-03-06,1,982,2,985
JHARKHAND,DEOGHAR,2021-03-07,2,530,0,532
JHARKHAND,DEOGHAR,2021-03-08,1,486,1,488
JHARKHAND,DEOGHAR,2021-03-09,1,421,0,422
JHARKHAND,DEOGHAR,2021-03-10,2,845,2,849
JHARKHAND,DHANBAD,2021-03-06,0,181,0,181
JHARKHAND,DHANBAD,2021-03-07,0,97,0,97
JHARKHAND,DHANBAD,2021-03-08,0,194,1,195
JHARKHAND,DHANBAD,2021-03-09,7,172,0,179
JHARKHAND,DHANBAD,2021-03-10,3,273,0,276
JHARKHAND,DUMKA,2021-03-06,1,232,7,240
JHARKHAND,DUMKA,2021-03-07,0,293,4,297
JHARKHAND,DUMKA,2021-03-08,0,1026,5,1031
JHARKHAND,DUMKA,2021-03-09,2,455,3,460
JHARKHAND,DUMKA,2021-03-10,0,281,0,281
JHARKHAND,EAST SINGHBUM,2021-03-06,12,1788,1,1801
JHARKHAND,EAST SINGHBUM,2021-03-07,1,503,0,504
JHARKHAND,EAST SINGHBUM,2021-03-08,23,2433,1,2457
JHARKHAND,EAST SINGHBUM,2021-03-09,21,1963,1,1985
JHARKHAND,EAST SINGHBUM,2021-03-10,17,1920,1,1938
JHARKHAND,GARHWA,2021-03-06,0,827,0,827
JHARKHAND,GARHWA,2021-03-07,0,592,0,592
JHARKHAND,GARHWA,2021-03-08,0,283,0,283
JHARKHAND,GARHWA,2021-03-09,0,584,0,584
JHARKHAND,GARHWA,2021-03-10,0,332,0,332
JHARKHAND,GIRIDIH,2021-03-06,0,1276,0,1276
JHARKHAND,GIRIDIH,2021-03-07,0,152,0,152
JHARKHAND,GIRIDIH,2021-03-08,0,1251,0,1251
JHARKHAND,GIRIDIH,2021-03-09,1,940,0,941
JHARKHAND,GIRIDIH,2021-03-10,1,997,0,998
JHARKHAND,GODDA,2021-03-06,2,133,0,135
JHARKHAND,GODDA,2021-03-07,0,278,1,279
JHARKHAND,GODDA,2021-03-08,0,45,0,45
JHARKHAND,GODDA,2021-03-09,1,333,0,334
JHARKHAND,GODDA,2021-03-10,1,139,0,140
JHARKHAND,GUMLA,2021-03-06,2,476,0,478
JHARKHAND,GUMLA,2021-03-07,1,148,0,149
JHARKHAND,GUMLA,2021-03-08,1,156,0,157
JHARKHAND,GUMLA,2021-03-09,0,265,0,265
JHARKHAND,GUMLA,2021-03-10,2,744,0,746
JHARKHAND,HAZARIBAGH,2021-03-06,2,266,0,268
JHARKHAND,HAZARIBAGH,2021-03-07,0,520,0,520
JHARKHAND,HAZARIBAGH,2021-03-08,0,540,0,540
JHARKHAND,HAZARIBAGH,2021-03-09,2,467,0,469
JHARKHAND,HAZARIBAGH,2021-03-10,1,747,0,748
JHARKHAND,JAMTARA,2021-03-06,2,464,0,466
JHARKHAND,JAMTARA,2021-03-07,0,130,0,130
JHARKHAND,JAMTARA,2021-03-08,2,192,0,194
JHARKHAND,JAMTARA,2021-03-09,0,185,0,185
JHARKHAND,JAMTARA,2021-03-10,1,291,0,292
JHARKHAND,KHUNTI,2021-03-06,0,20,0,20
JHARKHAND,KHUNTI,2021-03-07,0,1,0,1
JHARKHAND,KHUNTI,2021-03-08,0,20,0,20
JHARKHAND,KHUNTI,2021-03-09,0,392,2,394
JHARKHAND,KHUNTI,2021-03-10,0,40,0,40
JHARKHAND,KODERMA,2021-03-06,2,420,2,424
JHARKHAND,KODERMA,2021-03-07,0,189,1,190
JHARKHAND,KODERMA,2021-03-08,1,705,5,711
JHARKHAND,KODERMA,2021-03-09,0,461,0,461
JHARKHAND,KODERMA,2021-03-10,7,253,1,261
JHARKHAND,LATEHAR,2021-03-06,1,787,0,788
JHARKHAND,LATEHAR,2021-03-07,0,4,0,4
JHARKHAND,LATEHAR,2021-03-08,0,371,0,371
JHARKHAND,LATEHAR,2021-03-09,0,566,4,570
JHARKHAND,LATEHAR,2021-03-10,0,317,5,322
JHARKHAND,LOHARDAGA,2021-03-06,1,205,0,206
JHARKHAND,LOHARDAGA,2021-03-07,0,99,0,99
JHARKHAND,LOHARDAGA,2021-03-08,1,54,0,55
JHARKHAND,LOHARDAGA,2021-03-09,0,57,0,57
JHARKHAND,LOHARDAGA,2021-03-10,0,375,0,375
JHARKHAND,PAKUR,2021-03-06,0,1084,0,1084
JHARKHAND,PAKUR,2021-03-07,0,263,0,263
JHARKHAND,PAKUR,2021-03-08,0,212,0,212
JHARKHAND,PAKUR,2021-03-09,0,145,0,145
JHARKHAND,PAKUR,2021-03-10,0,83,0,83
JHARKHAND,PALAMU,2021-03-06,0,434,0,434
JHARKHAND,PALAMU,2021-03-07,0,188,0,188
JHARKHAND,PALAMU,2021-03-08,0,636,2,638
JHARKHAND,PALAMU,2021-03-09,0,300,0,300
JHARKHAND,PALAMU,2021-03-10,0,842,0,842
JHARKHAND,RAMGARH,2021-03-06,3,176,0,179
JHARKHAND,RAMGARH,2021-03-07,2,26,0,28
JHARKHAND,RAMGARH,2021-03-08,0,71,0,71
JHARKHAND,RAMGARH,2021-03-09,0,200,0,200
JHARKHAND,RAMGARH,2021-03-10,1,301,0,302
JHARKHAND,RANCHI,2021-03-06,88,1287,3,1378
JHARKHAND,RANCHI,2021-03-07,54,598,0,652
JHARKHAND,RANCHI,2021-03-08,41,1118,3,1162
JHARKHAND,RANCHI,2021-03-09,67,914,3,984
JHARKHAND,RANCHI,2021-03-10,67,898,2,967
JHARKHAND,SAHEBGANJ,2021-03-06,0,89,0,89
JHARKHAND,SAHEBGANJ,2021-03-07,0,7,0,7
JHARKHAND,SAHEBGANJ,2021-03-08,0,143,0,143
JHARKHAND,SAHEBGANJ,2021-03-09,0,173,0,173
JHARKHAND,SAHEBGANJ,2021-03-10,0,89,0,89
JHARKHAND,SARAIKELA KHARSAWAN,2021-03-06,0,42,0,42
JHARKHAND,SARAIKELA KHARSAWAN,2021-03-07,0,56,0,56
JHARKHAND,SARAIKELA KHARSAWAN,2021-03-08,0,217,0,217
JHARKHAND,SARAIKELA KHARSAWAN,2021-03-09,0,132,0,132
JHARKHAND,SARAIKELA KHARSAWAN,2021-03-10,1,150,0,151
JHARKHAND,SIMDEGA,2021-03-06,1,883,0,884
JHARKHAND,SIMDEGA,2021-03-07,1,171,0,172
JHARKHAND,SIMDEGA,2021-03-08,0,408,0,408
JHARKHAND,SIMDEGA,2021-03-09,0,316,0,316
JHARKHAND,SIMDEGA,2021-03-10,3,796,1,800
JHARKHAND,WEST SINGHBHUM,2021-03-06,2,651,0,653
JHARKHAND,WEST SINGHBHUM,2021-03-07,0,914,0,914
JHARKHAND,WEST SINGHBHUM,2021-03-08,0,1038,0,1038
JHARKHAND,WEST SINGHBHUM,2021-03-09,1,1031,1,1033
JHARKHAND,WEST SINGHBHUM,2021-03-10,0,425,0,425
KARNATAKA,BAGALKOTE,2021-03-06,0,916,1,917
KARNATAKA,BAGALKOTE,2021-03-07,0,1362,4,1366
KARNATAKA,BAGALKOTE,2021-03-08,3,1020,1,1024
KARNATAKA,BAGALKOTE,2021-03-09,1,1157,1,1159
KARNATAKA,BAGALKOTE,2021-03-10,8,1287,1,1296
KARNATAKA,BALLARI,2021-03-06,2,2313,18,2333
KARNATAKA,BALLARI,2021-03-07,4,1360,9,1373
KARNATAKA,BALLARI,2021-03-08,27,1143,9,1179
KARNATAKA,BALLARI,2021-03-09,10,1988,15,2013
KARNATAKA,BALLARI,2021-03-10,21,1362,10,1393
KARNATAKA,BELAGAVI,2021-03-06,18,1573,1,1592
KARNATAKA,BELAGAVI,2021-03-07,2,182,2,186
KARNATAKA,BELAGAVI,2021-03-08,16,1486,0,1502
KARNATAKA,BELAGAVI,2021-03-09,10,1622,4,1636
KARNATAKA,BELAGAVI,2021-03-10,14,1406,0,1420
KARNATAKA,BENGALURU RURAL,2021-03-06,9,945,0,954
KARNATAKA,BENGALURU RURAL,2021-03-07,3,378,2,383
KARNATAKA,BENGALURU RURAL,2021-03-08,7,776,2,785
KARNATAKA,BENGALURU RURAL,2021-03-09,10,874,5,889
KARNATAKA,BENGALURU RURAL,2021-03-10,26,699,1,726
KARNATAKA,BENGALURU URBAN,2021-03-06,418,37383,274,38075
KARNATAKA,BENGALURU URBAN,2021-03-07,304,26442,98,26844
KARNATAKA,BENGALURU URBAN,2021-03-08,372,37046,89,37507
KARNATAKA,BENGALURU URBAN,2021-03-09,519,35142,96,35757
KARNATAKA,BENGALURU URBAN,2021-03-10,514,37048,293,37855
KARNATAKA,BIDAR,2021-03-06,29,470,0,499
KARNATAKA,BIDAR,2021-03-07,16,1062,0,1078
KARNATAKA,BIDAR,2021-03-08,7,133,0,140
KARNATAKA,BIDAR,2021-03-09,22,1078,0,1100
KARNATAKA,BIDAR,2021-03-10,20,612,0,632
KARNATAKA,CHAMARAJANAGARA,2021-03-06,2,589,2,593
KARNATAKA,CHAMARAJANAGARA,2021-03-07,1,622,1,624
KARNATAKA,CHAMARAJANAGARA,2021-03-08,3,240,0,243
KARNATAKA,CHAMARAJANAGARA,2021-03-09,0,581,0,581
KARNATAKA,CHAMARAJANAGARA,2021-03-10,3,490,0,493
KARNATAKA,CHIKKABALLAPURA,2021-03-06,3,1434,2,1439
KARNATAKA,CHIKKABALLAPURA,2021-03-07,9,1308,2,1319
KARNATAKA,CHIKKABALLAPURA,2021-03-08,6,688,1,695
KARNATAKA,CHIKKABALLAPURA,2021-03-09,6,977,0,983
KARNATAKA,CHIKKABALLAPURA,2021-03-10,5,1583,1,1589
KARNATAKA,CHIKKAMAGALURU,2021-03-06,4,862,3,869
KARNATAKA,CHIKKAMAGALURU,2021-03-07,2,666,0,668
KARNATAKA,CHIKKAMAGALURU,2021-03-08,1,310,1,312
KARNATAKA,CHIKKAMAGALURU,2021-03-09,2,628,5,635
KARNATAKA,CHIKKAMAGALURU,2021-03-10,2,808,0,810
KARNATAKA,CHITRADURGA,2021-03-06,2,1163,1,1166
KARNATAKA,CHITRADURGA,2021-03-07,6,890,0,896
KARNATAKA,CHITRADURGA,2021-03-08,3,603,1,607
KARNATAKA,CHITRADURGA,2021-03-09,5,584,0,589
KARNATAKA,CHITRADURGA,2021-03-10,8,751,1,760
KARNATAKA,DAKSHINA KANNADA,2021-03-06,23,2567,12,2602
KARNATAKA,DAKSHINA KANNADA,2021-03-07,17,2039,1,2057
KARNATAKA,DAKSHINA KANNADA,2021-03-08,12,2172,2,2186
KARNATAKA,DAKSHINA KANNADA,2021-03-09,32,2290,3,2325
KARNATAKA,DAKSHINA KANNADA,2021-03-10,18,2109,0,2127
KARNATAKA,DAVANGERE,2021-03-06,2,1404,125,1531
KARNATAKA,DAVANGERE,2021-03-07,2,1530,189,1721
KARNATAKA,DAVANGERE,2021-03-08,0,893,79,972
KARNATAKA,DAVANGERE,2021-03-09,4,1953,71,2028
KARNATAKA,DAVANGERE,2021-03-10,6,1285,48,1339
KARNATAKA,DHARWAD,2021-03-06,16,2413,23,2452
KARNATAKA,DHARWAD,2021-03-07,10,1330,6,1346
KARNATAKA,DHARWAD,2021-03-08,7,1227,8,1242
KARNATAKA,DHARWAD,2021-03-09,26,1678,2,1706
KARNATAKA,DHARWAD,2021-03-10,20,2312,24,2356
KARNATAKA,GADAG,2021-03-06,8,1142,67,1217
KARNATAKA,GADAG,2021-03-07,3,906,47,956
KARNATAKA,GADAG,2021-03-08,3,591,37,631
KARNATAKA,GADAG,2021-03-09,1,759,124,884
KARNATAKA,GADAG,2021-03-10,3,933,184,1120
KARNATAKA,HASSAN,2021-03-06,4,1660,16,1680
KARNATAKA,HASSAN,2021-03-07,7,2165,1,2173
KARNATAKA,HASSAN,2021-03-08,8,2220,53,2281
KARNATAKA,HASSAN,2021-03-09,5,2059,41,2105
KARNATAKA,HASSAN,2021-03-10,9,1250,95,1354
KARNATAKA,HAVERI,2021-03-06,1,887,0,888
KARNATAKA,HAVERI,2021-03-07,0,551,1,552
KARNATAKA,HAVERI,2021-03-08,0,1327,0,1327
KARNATAKA,HAVERI,2021-03-09,0,287,0,287
KARNATAKA,HAVERI,2021-03-10,1,754,0,755
KARNATAKA,KALABURAGI,2021-03-06,45,2184,6,2235
KARNATAKA,KALABURAGI,2021-03-07,26,1824,12,1862
KARNATAKA,KALABURAGI,2021-03-08,25,1267,16,1308
KARNATAKA,KALABURAGI,2021-03-09,44,1476,10,1530
KARNATAKA,KALABURAGI,2021-03-10,20,1752,0,1772
KARNATAKA,KODAGU,2021-03-06,5,547,7,559
KARNATAKA,KODAGU,2021-03-07,0,27,0,27
KARNATAKA,KODAGU,2021-03-08,7,472,8,487
KARNATAKA,KODAGU,2021-03-09,0,175,6,181
KARNATAKA,KODAGU,2021-03-10,5,484,4,493
KARNATAKA,KOLAR,2021-03-06,6,1686,2,1694
KARNATAKA,KOLAR,2021-03-07,9,1604,9,1622
KARNATAKA,KOLAR,2021-03-08,1,621,0,622
KARNATAKA,KOLAR,2021-03-09,9,1258,5,1272
KARNATAKA,KOLAR,2021-03-10,8,1487,1,1496
KARNATAKA,KOPPAL,2021-03-06,1,949,4,954
KARNATAKA,KOPPAL,2021-03-07,0,270,0,270
KARNATAKA,KOPPAL,2021-03-08,0,302,1,303
KARNATAKA,KOPPAL,2021-03-09,0,425,2,427
KARNATAKA,KOPPAL,2021-03-10,1,685,4,690
KARNATAKA,MANDYA,2021-03-06,2,1351,4,1357
KARNATAKA,MANDYA,2021-03-07,3,830,3,836
KARNATAKA,MANDYA,2021-03-08,4,1001,5,1010
KARNATAKA,MANDYA,2021-03-09,3,1487,4,1494
KARNATAKA,MANDYA,2021-03-10,5,1578,10,1593
KARNATAKA,MYSURU,2021-03-06,26,1995,4,2025
KARNATAKA,MYSURU,2021-03-07,6,160,0,166
KARNATAKA,MYSURU,2021-03-08,43,2150,2,2195
KARNATAKA,MYSURU,2021-03-09,38,1924,1,1963
KARNATAKA,MYSURU,2021-03-10,51,2822,1,2874
KARNATAKA,RAICHUR,2021-03-06,3,737,5,745
KARNATAKA,RAICHUR,2021-03-07,3,735,75,813
KARNATAKA,RAICHUR,2021-03-08,0,756,51,807
KARNATAKA,RAICHUR,2021-03-09,1,702,37,740
KARNATAKA,RAICHUR,2021-03-10,4,831,15,850
KARNATAKA,RAMANAGARA,2021-03-06,0,517,1,518
KARNATAKA,RAMANAGARA,2021-03-07,0,190,0,190
KARNATAKA,RAMANAGARA,2021-03-08,1,775,0,776
KARNATAKA,RAMANAGARA,2021-03-09,1,456,0,457
KARNATAKA,RAMANAGARA,2021-03-10,1,353,0,354
KARNATAKA,SHIVAMOGGA,2021-03-06,3,1044,29,1076
KARNATAKA,SHIVAMOGGA,2021-03-07,0,185,30,215
KARNATAKA,SHIVAMOGGA,2021-03-08,7,995,1,1003
KARNATAKA,SHIVAMOGGA,2021-03-09,6,893,15,914
KARNATAKA,SHIVAMOGGA,2021-03-10,2,842,9,853
KARNATAKA,TUMAKURU,2021-03-06,26,1496,1,1523
KARNATAKA,TUMAKURU,2021-03-07,14,2097,29,2140
KARNATAKA,TUMAKURU,2021-03-08,15,1543,0,1558
KARNATAKA,TUMAKURU,2021-03-09,39,2566,0,2605
KARNATAKA,TUMAKURU,2021-03-10,39,1920,18,1977
KARNATAKA,UDUPI,2021-03-06,32,1097,0,1129
KARNATAKA,UDUPI,2021-03-07,18,1222,2,1242
KARNATAKA,UDUPI,2021-03-08,11,1009,0,1020
KARNATAKA,UDUPI,2021-03-09,32,977,0,1009
KARNATAKA,UDUPI,2021-03-10,16,1225,3,1244
KARNATAKA,UTTARA KANNADA,2021-03-06,6,1434,105,1545
KARNATAKA,UTTARA KANNADA,2021-03-07,3,1253,282,1538
KARNATAKA,UTTARA KANNADA,2021-03-08,8,1483,26,1517
KARNATAKA,UTTARA KANNADA,2021-03-09,4,1494,119,1617
KARNATAKA,UTTARA KANNADA,2021-03-10,11,1490,75,1576
KARNATAKA,VIJAYAPURA,2021-03-06,6,1085,2,1093
KARNATAKA,VIJAYAPURA,2021-03-07,3,1356,0,1359
KARNATAKA,VIJAYAPURA,2021-03-08,2,783,0,785
KARNATAKA,VIJAYAPURA,2021-03-09,6,708,1,715
KARNATAKA,VIJAYAPURA,2021-03-10,9,579,0,588
KARNATAKA,YADGIR,2021-03-06,1,822,0,823
KARNATAKA,YADGIR,2021-03-07,1,712,0,713
KARNATAKA,YADGIR,2021-03-08,2,487,0,489
KARNATAKA,YADGIR,2021-03-09,0,642,1,643
KARNATAKA,YADGIR,2021-03-10,3,795,0,798
KERALA,ALAPPUZHA,2021-03-06,261,3379,14,3654
KERALA,ALAPPUZHA,2021-03-07,118,1967,2,2087
KERALA,ALAPPUZHA,2021-03-08,107,2107,2,2216
KERALA,ALAPPUZHA,2021-03-09,127,3156,11,3294
KERALA,ALAPPUZHA,2021-03-10,200,3507,30,3737
KERALA,ERNAKULAM,2021-03-06,337,6780,56,7173
KERALA,ERNAKULAM,2021-03-07,193,3847,50,4090
KERALA,ERNAKULAM,2021-03-08,236,6202,29,6467
KERALA,ERNAKULAM,2021-03-09,404,7644,32,8080
KERALA,ERNAKULAM,2021-03-10,212,5730,40,5982
KERALA,IDUKKI,2021-03-06,82,1550,6,1638
KERALA,IDUKKI,2021-03-07,135,885,4,1024
KERALA,IDUKKI,2021-03-08,68,1217,3,1288
KERALA,IDUKKI,2021-03-09,83,1536,6,1625
KERALA,IDUKKI,2021-03-10,100,1388,2,1490
KERALA,KANNUR,2021-03-06,248,4949,18,5215
KERALA,KANNUR,2021-03-07,143,2660,14,2817
KERALA,KANNUR,2021-03-08,121,3055,4,3180
KERALA,KANNUR,2021-03-09,240,3865,8,4113
KERALA,KANNUR,2021-03-10,143,3558,14,3715
KERALA,KASARAGOD,2021-03-06,115,1715,8,1838
KERALA,KASARAGOD,2021-03-07,84,1554,2,1640
KERALA,KASARAGOD,2021-03-08,76,1723,0,1799
KERALA,KASARAGOD,2021-03-09,79,2044,1,2124
KERALA,KASARAGOD,2021-03-10,146,2140,2,2288
KERALA,KOLLAM,2021-03-06,374,5501,9,5884
KERALA,KOLLAM,2021-03-07,158,2454,17,2629
KERALA,KOLLAM,2021-03-08,218,2472,10,2700
KERALA,KOLLAM,2021-03-09,284,4355,24,4663
KERALA,KOLLAM,2021-03-10,205,3618,14,3837
KERALA,KOTTAYAM,2021-03-06,210,3473,20,3703
KERALA,KOTTAYAM,2021-03-07,148,2077,17,2242
KERALA,KOTTAYAM,2021-03-08,130,2349,9,2488
KERALA,KOTTAYAM,2021-03-09,321,3634,30,3985
KERALA,KOTTAYAM,2021-03-10,186,2402,24,2612
KERALA,KOZHIKODE,2021-03-06,460,4698,32,5190
KERALA,KOZHIKODE,2021-03-07,301,4980,26,5307
KERALA,KOZHIKODE,2021-03-08,252,3839,9,4100
KERALA,KOZHIKODE,2021-03-09,395,5063,18,5476
KERALA,KOZHIKODE,2021-03-10,377,6725,57,7159
KERALA,MALAPPURAM,2021-03-06,302,3772,11,4085
KERALA,MALAPPURAM,2021-03-07,110,1887,4,2001
KERALA,MALAPPURAM,2021-03-08,187,4026,3,4216
KERALA,MALAPPURAM,2021-03-09,145,3914,7,4066
KERALA,MALAPPURAM,2021-03-10,281,7399,9,7689
KERALA,PALAKKAD,2021-03-06,139,3493,0,3632
KERALA,PALAKKAD,2021-03-07,70,2059,0,2129
KERALA,PALAKKAD,2021-03-08,68,2592,1,2661
KERALA,PALAKKAD,2021-03-09,93,3065,4,3162
KERALA,PALAKKAD,2021-03-10,68,3597,1,3666
KERALA,PATHANAMTHITTA,2021-03-06,180,2161,4,2345
KERALA,PATHANAMTHITTA,2021-03-07,81,1417,6,1504
KERALA,PATHANAMTHITTA,2021-03-08,129,1686,4,1819
KERALA,PATHANAMTHITTA,2021-03-09,249,3208,17,3474
KERALA,PATHANAMTHITTA,2021-03-10,181,2145,2,2328
KERALA,THIRUVANANTHAPURAM,2021-03-06,289,5426,17,5732
KERALA,THIRUVANANTHAPURAM,2021-03-07,193,3417,23,3633
KERALA,THIRUVANANTHAPURAM,2021-03-08,182,4158,12,4352
KERALA,THIRUVANANTHAPURAM,2021-03-09,211,5042,37,5290
KERALA,THIRUVANANTHAPURAM,2021-03-10,188,3862,17,4067
KERALA,THRISSUR,2021-03-06,259,4376,4,4639
KERALA,THRISSUR,2021-03-07,198,2168,4,2370
KERALA,THRISSUR,2021-03-08,192,3432,2,3626
KERALA,THRISSUR,2021-03-09,344,3905,5,4254
KERALA,THRISSUR,2021-03-10,200,4055,5,4260
KERALA,WAYANAD,2021-03-06,84,884,0,968
KERALA,WAYANAD,2021-03-07,46,430,0,476
KERALA,WAYANAD,2021-03-08,57,1204,0,1261
KERALA,WAYANAD,2021-03-09,86,1241,2,1329
KERALA,WAYANAD,2021-03-10,53,1420,2,1475
LADAKH,KARGIL,2021-03-06,0,50,0,50
LADAKH,KARGIL,2021-03-07,0,25,0,25
LADAKH,KARGIL,2021-03-08,0,105,1,106
LADAKH,KARGIL,2021-03-09,0,99,0,99
LADAKH,KARGIL,2021-03-10,0,67,0,67
LADAKH,LEH LADAKH,2021-03-06,2,266,4,272
LADAKH,LEH LADAKH,2021-03-07,4,121,0,125
LADAKH,LEH LADAKH,2021-03-08,2,210,0,212
LADAKH,LEH LADAKH,2021-03-09,2,142,2,146
LADAKH,LEH LADAKH,2021-03-10,5,158,0,163
LAKSHADWEEP,LAKSHADWEEP DISTRICT,2021-03-06,1,284,0,285
LAKSHADWEEP,LAKSHADWEEP DISTRICT,2021-03-07,24,249,0,273
LAKSHADWEEP,LAKSHADWEEP DISTRICT,2021-03-08,30,268,0,298
LAKSHADWEEP,LAKSHADWEEP DISTRICT,2021-03-09,23,402,0,425
LAKSHADWEEP,LAKSHADWEEP DISTRICT,2021-03-10,21,295,0,316
MADHYA PRADESH,AGAR MALWA,2021-03-06,3,125,0,128
MADHYA PRADESH,AGAR MALWA,2021-03-07,0,54,0,54
MADHYA PRADESH,AGAR MALWA,2021-03-08,1,220,0,221
MADHYA PRADESH,AGAR MALWA,2021-03-09,1,123,0,124
MADHYA PRADESH,AGAR MALWA,2021-03-10,2,76,0,78
MADHYA PRADESH,ALIRAJPUR,2021-03-06,0,222,2,224
MADHYA PRADESH,ALIRAJPUR,2021-03-07,1,35,0,36
MADHYA PRADESH,ALIRAJPUR,2021-03-08,2,125,0,127
MADHYA PRADESH,ALIRAJPUR,2021-03-09,6,82,0,88
MADHYA PRADESH,ALIRAJPUR,2021-03-10,5,123,0,128
MADHYA PRADESH,ANUPPUR,2021-03-06,9,76,0,85
MADHYA PRADESH,ANUPPUR,2021-03-07,1,44,0,45
MADHYA PRADESH,ANUPPUR,2021-03-08,5,123,1,129
MADHYA PRADESH,ANUPPUR,2021-03-09,2,88,7,97
MADHYA PRADESH,ANUPPUR,2021-03-10,1,57,0,58
MADHYA PRADESH,ASHOKNAGAR,2021-03-06,0,62,0,62
MADHYA PRADESH,ASHOKNAGAR,2021-03-07,2,5,0,7
MADHYA PRADESH,ASHOKNAGAR,2021-03-08,0,246,1,247
MADHYA PRADESH,ASHOKNAGAR,2021-03-09,0,100,0,100
MADHYA PRADESH,ASHOKNAGAR,2021-03-10,0,49,0,49
MADHYA PRADESH,BALAGHAT,2021-03-06,2,437,0,439
MADHYA PRADESH,BALAGHAT,2021-03-07,2,44,0,46
MADHYA PRADESH,BALAGHAT,2021-03-08,3,387,0,390
MADHYA PRADESH,BALAGHAT,2021-03-09,2,607,0,609
MADHYA PRADESH,BALAGHAT,2021-03-10,0,89,0,89
MADHYA PRADESH,BARWANI,2021-03-06,7,144,2,153
MADHYA PRADESH,BARWANI,2021-03-07,0,203,0,203
MADHYA PRADESH,BARWANI,2021-03-08,5,312,1,318
MADHYA PRADESH,BARWANI,2021-03-09,6,103,0,109
MADHYA PRADESH,BARWANI,2021-03-10,10,107,0,117
MADHYA PRADESH,BETUL,2021-03-06,15,218,0,233
MADHYA PRADESH,BETUL,2021-03-07,24,170,1,195
MADHYA PRADESH,BETUL,2021-03-08,2,169,0,171
MADHYA PRADESH,BETUL,2021-03-09,31,236,0,267
MADHYA PRADESH,BETUL,2021-03-10,1,167,2,170
MADHYA PRADESH,BHIND,2021-03-06,0,181,0,181
MADHYA PRADESH,BHIND,2021-03-07,1,102,1,104
MADHYA PRADESH,BHIND,2021-03-08,0,335,0,335
MADHYA PRADESH,BHIND,2021-03-09,2,108,0,110
MADHYA PRADESH,BHIND,2021-03-10,2,255,0,257
MADHYA PRADESH,BHOPAL,2021-03-06,114,1187,312,1613
MADHYA PRADESH,BHOPAL,2021-03-07,110,1080,12,1202
MADHYA PRADESH,BHOPAL,2021-03-08,89,1133,11,1233
MADHYA PRADESH,BHOPAL,2021-03-09,156,1489,8,1653
MADHYA PRADESH,BHOPAL,2021-03-10,158,1570,8,1736
MADHYA PRADESH,BURHANPUR,2021-03-06,37,472,1,510
MADHYA PRADESH,BURHANPUR,2021-03-07,7,136,0,143
MADHYA PRADESH,BURHANPUR,2021-03-08,13,440,0,453
MADHYA PRADESH,BURHANPUR,2021-03-09,24,270,0,294
MADHYA PRADESH,BURHANPUR,2021-03-10,17,262,0,279
MADHYA PRADESH,CHHATARPUR,2021-03-06,0,86,0,86
MADHYA PRADESH,CHHATARPUR,2021-03-07,1,139,0,140
MADHYA PRADESH,CHHATARPUR,2021-03-08,0,107,0,107
MADHYA PRADESH,CHHATARPUR,2021-03-09,0,64,0,64
MADHYA PRADESH,CHHATARPUR,2021-03-10,1,224,1,226
MADHYA PRADESH,CHHINDWARA,2021-03-06,38,351,5,394
MADHYA PRADESH,CHHINDWARA,2021-03-07,15,148,1,164
MADHYA PRADESH,CHHINDWARA,2021-03-08,27,311,8,346
MADHYA PRADESH,CHHINDWARA,2021-03-09,49,312,3,364
MADHYA PRADESH,CHHINDWARA,2021-03-10,50,377,3,430
MADHYA PRADESH,DAMOH,2021-03-06,3,332,4,339
MADHYA PRADESH,DAMOH,2021-03-07,2,395,2,399
MADHYA PRADESH,DAMOH,2021-03-08,1,154,0,155
MADHYA PRADESH,DAMOH,2021-03-09,0,61,0,61
MADHYA PRADESH,DAMOH,2021-03-10,0,193,0,193
MADHYA PRADESH,DATIA,2021-03-06,0,194,36,230
MADHYA PRADESH,DATIA,2021-03-07,3,96,0,99
MADHYA PRADESH,DATIA,2021-03-08,1,287,43,331
MADHYA PRADESH,DATIA,2021-03-09,2,187,31,220
MADHYA PRADESH,DATIA,2021-03-10,0,170,19,189
MADHYA PRADESH,DEWAS,2021-03-06,2,245,0,247
MADHYA PRADESH,DEWAS,2021-03-07,1,462,0,463
MADHYA PRADESH,DEWAS,2021-03-08,37,432,0,469
MADHYA PRADESH,DEWAS,2021-03-09,4,556,1,561
MADHYA PRADESH,DEWAS,2021-03-10,11,341,0,352
MADHYA PRADESH,DHAR,2021-03-06,8,85,18,111
MADHYA PRADESH,DHAR,2021-03-07,5,253,0,258
MADHYA PRADESH,DHAR,2021-03-08,8,135,3,146
MADHYA PRADESH,DHAR,2021-03-09,6,214,0,220
MADHYA PRADESH,DHAR,2021-03-10,13,138,0,151
MADHYA PRADESH,DINDORI,2021-03-06,5,618,1,624
MADHYA PRADESH,DINDORI,2021-03-07,0,65,0,65
MADHYA PRADESH,DINDORI,2021-03-08,1,560,0,561
MADHYA PRADESH,DINDORI,2021-03-09,0,79,0,79
MADHYA PRADESH,DINDORI,2021-03-10,0,259,0,259
MADHYA PRADESH,EAST NIMAR,2021-03-06,12,237,6,255
MADHYA PRADESH,EAST NIMAR,2021-03-07,12,205,2,219
MADHYA PRADESH,EAST NIMAR,2021-03-08,9,227,8,244
MADHYA PRADESH,EAST NIMAR,2021-03-09,4,250,0,254
MADHYA PRADESH,EAST NIMAR,2021-03-10,13,228,0,241
MADHYA PRADESH,GUNA,2021-03-06,0,182,0,182
MADHYA PRADESH,GUNA,2021-03-07,3,262,0,265
MADHYA PRADESH,GUNA,2021-03-08,4,202,0,206
MADHYA PRADESH,GUNA,2021-03-09,0,217,0,217
MADHYA PRADESH,GUNA,2021-03-10,4,145,0,149
MADHYA PRADESH,GWALIOR,2021-03-06,14,843,0,857
MADHYA PRADESH,GWALIOR,2021-03-07,15,687,1,703
MADHYA PRADESH,GWALIOR,2021-03-08,14,827,4,845
MADHYA PRADESH,GWALIOR,2021-03-09,15,681,2,698
MADHYA PRADESH,GWALIOR,2021-03-10,17,719,0,736
MADHYA PRADESH,HARDA,2021-03-06,1,172,9,182
MADHYA PRADESH,HARDA,2021-03-07,1,83,0,84
MADHYA PRADESH,HARDA,2021-03-08,1,196,5,202
MADHYA PRADESH,HARDA,2021-03-09,2,117,0,119
MADHYA PRADESH,HARDA,2021-03-10,1,114,0,115
MADHYA PRADESH,HOSHANGABAD,2021-03-06,9,298,0,307
MADHYA PRADESH,HOSHANGABAD,2021-03-07,5,224,0,229
MADHYA PRADESH,HOSHANGABAD,2021-03-08,12,251,1,264
MADHYA PRADESH,HOSHANGABAD,2021-03-09,7,237,0,244
MADHYA PRADESH,HOSHANGABAD,2021-03-10,1,175,0,176
MADHYA PRADESH,INDORE,2021-03-06,367,2305,30,2702
MADHYA PRADESH,INDORE,2021-03-07,321,1573,1,1895
MADHYA PRADESH,INDORE,2021-03-08,483,2400,24,2907
MADHYA PRADESH,INDORE,2021-03-09,398,2409,2,2809
MADHYA PRADESH,INDORE,2021-03-10,422,2247,2,2671
MADHYA PRADESH,JABALPUR,2021-03-06,25,489,1,515
MADHYA PRADESH,JABALPUR,2021-03-07,30,411,0,441
MADHYA PRADESH,JABALPUR,2021-03-08,36,609,0,645
MADHYA PRADESH,JABALPUR,2021-03-09,34,598,1,633
MADHYA PRADESH,JABALPUR,2021-03-10,29,780,7,816
MADHYA PRADESH,JHABUA,2021-03-06,3,302,3,308
MADHYA PRADESH,JHABUA,2021-03-07,3,178,0,181
MADHYA PRADESH,JHABUA,2021-03-08,5,192,0,197
MADHYA PRADESH,JHABUA,2021-03-09,4,277,1,282
MADHYA PRADESH,JHABUA,2021-03-10,6,69,0,75
MADHYA PRADESH,KATNI,2021-03-06,1,241,0,242
MADHYA PRADESH,KATNI,2021-03-07,0,14,0,14
MADHYA PRADESH,KATNI,2021-03-08,0,149,0,149
MADHYA PRADESH,KATNI,2021-03-09,4,299,1,304
MADHYA PRADESH,KATNI,2021-03-10,2,310,2,314
MADHYA PRADESH,KHARGONE,2021-03-06,12,472,9,493
MADHYA PRADESH,KHARGONE,2021-03-07,13,170,0,183
MADHYA PRADESH,KHARGONE,2021-03-08,23,202,1,226
MADHYA PRADESH,KHARGONE,2021-03-09,12,425,1,438
MADHYA PRADESH,KHARGONE,2021-03-10,16,179,0,195
MADHYA PRADESH,MANDLA,2021-03-06,1,183,0,184
MADHYA PRADESH,MANDLA,2021-03-07,0,27,0,27
MADHYA PRADESH,MANDLA,2021-03-08,1,538,2,541
MADHYA PRADESH,MANDLA,2021-03-09,0,483,0,483
MADHYA PRADESH,MANDLA,2021-03-10,3,124,0,127
MADHYA PRADESH,MANDSAUR,2021-03-06,13,108,2,123
MADHYA PRADESH,MANDSAUR,2021-03-07,9,77,1,87
MADHYA PRADESH,MANDSAUR,2021-03-08,13,151,0,164
MADHYA PRADESH,MANDSAUR,2021-03-09,16,153,0,169
MADHYA PRADESH,MANDSAUR,2021-03-10,11,184,2,197
MADHYA PRADESH,MORENA,2021-03-06,0,247,1,248
MADHYA PRADESH,MORENA,2021-03-07,1,372,0,373
MADHYA PRADESH,MORENA,2021-03-08,0,261,0,261
MADHYA PRADESH,MORENA,2021-03-09,4,354,0,358
MADHYA PRADESH,MORENA,2021-03-10,1,229,0,230
MADHYA PRADESH,NARSINGHPUR,2021-03-06,1,268,2,271
MADHYA PRADESH,NARSINGHPUR,2021-03-07,0,80,0,80
MADHYA PRADESH,NARSINGHPUR,2021-03-08,2,184,0,186
MADHYA PRADESH,NARSINGHPUR,2021-03-09,1,406,0,407
MADHYA PRADESH,NARSINGHPUR,2021-03-10,1,175,0,176
MADHYA PRADESH,NEEMUCH,2021-03-06,6,171,0,177
MADHYA PRADESH,NEEMUCH,2021-03-07,2,96,1,99
MADHYA PRADESH,NEEMUCH,2021-03-08,4,140,0,144
MADHYA PRADESH,NEEMUCH,2021-03-09,6,228,2,236
MADHYA PRADESH,NEEMUCH,2021-03-10,6,197,1,204
MADHYA PRADESH,NIWARI,2021-03-06,0,45,0,45
MADHYA PRADESH,NIWARI,2021-03-07,0,33,0,33
MADHYA PRADESH,NIWARI,2021-03-08,0,25,0,25
MADHYA PRADESH,NIWARI,2021-03-09,0,22,0,22
MADHYA PRADESH,NIWARI,2021-03-10,0,26,0,26
MADHYA PRADESH,PANNA,2021-03-06,3,79,0,82
MADHYA PRADESH,PANNA,2021-03-07,2,195,0,197
MADHYA PRADESH,PANNA,2021-03-08,15,59,0,74
MADHYA PRADESH,PANNA,2021-03-09,1,168,1,170
MADHYA PRADESH,PANNA,2021-03-10,3,141,0,144
MADHYA PRADESH,RAISEN,2021-03-06,2,200,0,202
MADHYA PRADESH,RAISEN,2021-03-07,1,99,0,100
MADHYA PRADESH,RAISEN,2021-03-08,0,199,0,199
MADHYA PRADESH,RAISEN,2021-03-09,3,250,0,253
MADHYA PRADESH,RAISEN,2021-03-10,3,87,0,90
MADHYA PRADESH,RAJGARH,2021-03-06,1,167,0,168
MADHYA PRADESH,RAJGARH,2021-03-07,0,118,0,118
MADHYA PRADESH,RAJGARH,2021-03-08,4,130,0,134
MADHYA PRADESH,RAJGARH,2021-03-09,3,105,0,108
MADHYA PRADESH,RAJGARH,2021-03-10,6,175,0,181
MADHYA PRADESH,RATLAM,2021-03-06,9,182,11,202
MADHYA PRADESH,RATLAM,2021-03-07,9,67,0,76
MADHYA PRADESH,RATLAM,2021-03-08,8,106,2,116
MADHYA PRADESH,RATLAM,2021-03-09,24,278,3,305
MADHYA PRADESH,RATLAM,2021-03-10,10,226,3,239
MADHYA PRADESH,REWA,2021-03-06,18,572,1,591
MADHYA PRADESH,REWA,2021-03-07,8,410,1,419
MADHYA PRADESH,REWA,2021-03-08,7,538,1,546
MADHYA PRADESH,REWA,2021-03-09,3,533,4,540
MADHYA PRADESH,REWA,2021-03-10,7,413,0,420
MADHYA PRADESH,SAGAR,2021-03-06,10,487,0,497
MADHYA PRADESH,SAGAR,2021-03-07,10,720,0,730
MADHYA PRADESH,SAGAR,2021-03-08,9,257,0,266
MADHYA PRADESH,SAGAR,2021-03-09,7,724,1,732
MADHYA PRADESH,SAGAR,2021-03-10,10,513,1,524
MADHYA PRADESH,SATNA,2021-03-06,6,275,0,281
MADHYA PRADESH,SATNA,2021-03-07,2,83,0,85
MADHYA PRADESH,SATNA,2021-03-08,5,117,0,122
MADHYA PRADESH,SATNA,2021-03-09,1,513,7,521
MADHYA PRADESH,SATNA,2021-03-10,4,315,1,320
MADHYA PRADESH,SEHORE,2021-03-06,0,246,0,246
MADHYA PRADESH,SEHORE,2021-03-07,4,207,0,211
MADHYA PRADESH,SEHORE,2021-03-08,0,400,6,406
MADHYA PRADESH,SEHORE,2021-03-09,7,217,0,224
MADHYA PRADESH,SEHORE,2021-03-10,3,180,0,183
MADHYA PRADESH,SEONI,2021-03-06,10,245,4,259
MADHYA PRADESH,SEONI,2021-03-07,1,152,1,154
MADHYA PRADESH,SEONI,2021-03-08,3,123,0,126
MADHYA PRADESH,SEONI,2021-03-09,4,200,3,207
MADHYA PRADESH,SEONI,2021-03-10,1,203,0,204
MADHYA PRADESH,SHAHDOL,2021-03-06,0,131,4,135
MADHYA PRADESH,SHAHDOL,2021-03-07,1,117,1,119
MADHYA PRADESH,SHAHDOL,2021-03-08,12,60,0,72
MADHYA PRADESH,SHAHDOL,2021-03-09,0,81,5,86
MADHYA PRADESH,SHAHDOL,2021-03-10,0,114,5,119
MADHYA PRADESH,SHAJAPUR,2021-03-06,1,199,0,200
MADHYA PRADESH,SHAJAPUR,2021-03-07,1,55,0,56
MADHYA PRADESH,SHAJAPUR,2021-03-08,4,212,1,217
MADHYA PRADESH,SHAJAPUR,2021-03-09,4,188,0,192
MADHYA PRADESH,SHAJAPUR,2021-03-10,6,274,0,280
MADHYA PRADESH,SHEOPUR,2021-03-06,5,71,1,77
MADHYA PRADESH,SHEOPUR,2021-03-07,3,129,0,132
MADHYA PRADESH,SHEOPUR,2021-03-08,2,156,0,158
MADHYA PRADESH,SHEOPUR,2021-03-09,1,53,0,54
MADHYA PRADESH,SHEOPUR,2021-03-10,7,146,1,154
MADHYA PRADESH,SHIVPURI,2021-03-06,0,192,1,193
MADHYA PRADESH,SHIVPURI,2021-03-07,0,61,0,61
MADHYA PRADESH,SHIVPURI,2021-03-08,0,182,1,183
MADHYA PRADESH,SHIVPURI,2021-03-09,4,146,0,150
MADHYA PRADESH,SHIVPURI,2021-03-10,1,121,2,124
MADHYA PRADESH,SIDHI,2021-03-06,10,268,1,279
MADHYA PRADESH,SIDHI,2021-03-07,4,283,7,294
MADHYA PRADESH,SIDHI,2021-03-08,0,125,0,125
MADHYA PRADESH,SIDHI,2021-03-09,0,8,0,8
MADHYA PRADESH,SIDHI,2021-03-10,9,13,0,22
MADHYA PRADESH,SINGRAULI,2021-03-06,0,90,0,90
MADHYA PRADESH,SINGRAULI,2021-03-07,1,142,0,143
MADHYA PRADESH,SINGRAULI,2021-03-08,3,224,0,227
MADHYA PRADESH,SINGRAULI,2021-03-09,2,150,0,152
MADHYA PRADESH,SINGRAULI,2021-03-10,6,107,0,113
MADHYA PRADESH,TIKAMGARH,2021-03-06,1,204,0,205
MADHYA PRADESH,TIKAMGARH,2021-03-07,1,207,0,208
MADHYA PRADESH,TIKAMGARH,2021-03-08,2,274,0,276
MADHYA PRADESH,TIKAMGARH,2021-03-09,0,147,0,147
MADHYA PRADESH,TIKAMGARH,2021-03-10,1,118,0,119
MADHYA PRADESH,UJJAIN,2021-03-06,14,401,0,415
MADHYA PRADESH,UJJAIN,2021-03-07,25,24,0,49
MADHYA PRADESH,UJJAIN,2021-03-08,24,170,0,194
MADHYA PRADESH,UJJAIN,2021-03-09,16,205,0,221
MADHYA PRADESH,UJJAIN,2021-03-10,24,185,1,210
MADHYA PRADESH,UMARIA,2021-03-06,0,204,19,223
MADHYA PRADESH,UMARIA,2021-03-07,0,186,14,200
MADHYA PRADESH,UMARIA,2021-03-08,0,287,21,308
MADHYA PRADESH,UMARIA,2021-03-09,2,83,18,103
MADHYA PRADESH,UMARIA,2021-03-10,1,114,18,133
MADHYA PRADESH,VIDISHA,2021-03-06,3,129,0,132
MADHYA PRADESH,VIDISHA,2021-03-07,3,89,1,93
MADHYA PRADESH,VIDISHA,2021-03-08,4,109,0,113
MADHYA PRADESH,VIDISHA,2021-03-09,9,242,19,270
MADHYA PRADESH,VIDISHA,2021-03-10,7,133,3,143
MAHARASHTRA,AHMEDNAGAR,2021-03-06,371,1335,2,1708
MAHARASHTRA,AHMEDNAGAR,2021-03-07,322,1616,7,1945
MAHARASHTRA,AHMEDNAGAR,2021-03-08,241,840,1,1082
MAHARASHTRA,AHMEDNAGAR,2021-03-09,331,789,2,1122
MAHARASHTRA,AHMEDNAGAR,2021-03-10,326,1900,3,2229
MAHARASHTRA,AKOLA,2021-03-06,428,1619,9,2056
MAHARASHTRA,AKOLA,2021-03-07,225,900,11,1136
MAHARASHTRA,AKOLA,2021-03-08,338,2407,56,2801
MAHARASHTRA,AKOLA,2021-03-09,357,2268,17,2642
MAHARASHTRA,AKOLA,2021-03-10,429,2751,17,3197
MAHARASHTRA,AMRAVATI,2021-03-06,617,3056,6,3679
MAHARASHTRA,AMRAVATI,2021-03-07,350,3066,5,3421
MAHARASHTRA,AMRAVATI,2021-03-08,474,2695,1,3170
MAHARASHTRA,AMRAVATI,2021-03-09,410,3149,2,3561
MAHARASHTRA,AMRAVATI,2021-03-10,497,2650,3,3150
MAHARASHTRA,AURANGABAD,2021-03-06,559,679,1,1239
MAHARASHTRA,AURANGABAD,2021-03-07,449,901,5,1355
MAHARASHTRA,AURANGABAD,2021-03-08,291,946,8,1245
MAHARASHTRA,AURANGABAD,2021-03-09,650,958,5,1613
MAHARASHTRA,AURANGABAD,2021-03-10,640,1367,6,2013
MAHARASHTRA,BEED,2021-03-06,130,1091,1,1222
MAHARASHTRA,BEED,2021-03-07,91,764,0,855
MAHARASHTRA,BEED,2021-03-08,97,690,3,790
MAHARASHTRA,BEED,2021-03-09,114,945,0,1059
MAHARASHTRA,BEED,2021-03-10,188,1211,0,1399
MAHARASHTRA,BHANDARA,2021-03-06,38,1462,1,1501
MAHARASHTRA,BHANDARA,2021-03-07,49,937,0,986
MAHARASHTRA,BHANDARA,2021-03-08,44,1028,0,1072
MAHARASHTRA,BHANDARA,2021-03-09,36,773,1,810
MAHARASHTRA,BHANDARA,2021-03-10,63,1124,0,1187
MAHARASHTRA,BULDHANA,2021-03-06,199,783,18,1000
MAHARASHTRA,BULDHANA,2021-03-07,162,947,6,1115
MAHARASHTRA,BULDHANA,2021-03-08,192,432,18,642
MAHARASHTRA,BULDHANA,2021-03-09,266,1069,17,1352
MAHARASHTRA,BULDHANA,2021-03-10,322,981,26,1329
MAHARASHTRA,CHANDRAPUR,2021-03-06,81,1281,8,1370
MAHARASHTRA,CHANDRAPUR,2021-03-07,20,374,0,394
MAHARASHTRA,CHANDRAPUR,2021-03-08,102,1255,1,1358
MAHARASHTRA,CHANDRAPUR,2021-03-09,58,1064,2,1124
MAHARASHTRA,CHANDRAPUR,2021-03-10,119,1562,3,1684
MAHARASHTRA,DHULE,2021-03-06,90,117,0,207
MAHARASHTRA,DHULE,2021-03-07,92,55,0,147
MAHARASHTRA,DHULE,2021-03-08,137,151,0,288
MAHARASHTRA,DHULE,2021-03-09,173,219,1,393
MAHARASHTRA,DHULE,2021-03-10,170,355,1,526
MAHARASHTRA,GADCHIROLI,2021-03-06,26,2244,1,2271
MAHARASHTRA,GADCHIROLI,2021-03-07,17,2055,0,2072
MAHARASHTRA,GADCHIROLI,2021-03-08,21,864,3,888
MAHARASHTRA,GADCHIROLI,2021-03-09,39,646,0,685
MAHARASHTRA,GADCHIROLI,2021-03-10,19,1087,0,1106
MAHARASHTRA,GONDIA,2021-03-06,15,710,0,725
MAHARASHTRA,GONDIA,2021-03-07,25,425,0,450
MAHARASHTRA,GONDIA,2021-03-08,12,806,2,820
MAHARASHTRA,GONDIA,2021-03-09,27,1007,0,1034
MAHARASHTRA,GONDIA,2021-03-10,15,1121,2,1138
MAHARASHTRA,HINGOLI,2021-03-06,33,103,0,136
MAHARASHTRA,HINGOLI,2021-03-07,47,186,0,233
MAHARASHTRA,HINGOLI,2021-03-08,35,190,0,225
MAHARASHTRA,HINGOLI,2021-03-09,41,278,0,319
MAHARASHTRA,HINGOLI,2021-03-10,19,87,0,106
MAHARASHTRA,JALGAON,2021-03-06,429,994,0,1423
MAHARASHTRA,JALGAON,2021-03-07,361,1042,0,1403
MAHARASHTRA,JALGAON,2021-03-08,910,2856,5,3771
MAHARASHTRA,JALGAON,2021-03-09,825,3017,0,3842
MAHARASHTRA,JALGAON,2021-03-10,1114,3032,22,4168
MAHARASHTRA,JALNA,2021-03-06,171,555,0,726
MAHARASHTRA,JALNA,2021-03-07,121,444,0,565
MAHARASHTRA,JALNA,2021-03-08,164,585,0,749
MAHARASHTRA,JALNA,2021-03-09,315,777,0,1092
MAHARASHTRA,JALNA,2021-03-10,285,667,0,952
MAHARASHTRA,KOLHAPUR,2021-03-06,23,1189,7,1219
MAHARASHTRA,KOLHAPUR,2021-03-07,29,839,10,878
MAHARASHTRA,KOLHAPUR,2021-03-08,23,579,11,613
MAHARASHTRA,KOLHAPUR,2021-03-09,25,1139,23,1187
MAHARASHTRA,KOLHAPUR,2021-03-10,25,950,13,988
MAHARASHTRA,LATUR,2021-03-06,119,1184,4,1307
MAHARASHTRA,LATUR,2021-03-07,67,963,7,1037
MAHARASHTRA,LATUR,2021-03-08,71,770,5,846
MAHARASHTRA,LATUR,2021-03-09,146,1559,9,1714
MAHARASHTRA,LATUR,2021-03-10,113,1595,11,1719
MAHARASHTRA,MUMBAI,2021-03-06,1240,18174,45,19459
MAHARASHTRA,MUMBAI,2021-03-07,823,13607,54,14484
MAHARASHTRA,MUMBAI,2021-03-08,915,14804,83,15802
MAHARASHTRA,MUMBAI,2021-03-09,1283,14878,22,16183
MAHARASHTRA,MUMBAI,2021-03-10,1340,15737,43,17120
MAHARASHTRA,MUMBAI SUBURBAN,2021-03-06,325,3478,7,3810
MAHARASHTRA,MUMBAI SUBURBAN,2021-03-07,302,3169,17,3488
MAHARASHTRA,MUMBAI SUBURBAN,2021-03-08,296,3564,12,3872
MAHARASHTRA,MUMBAI SUBURBAN,2021-03-09,421,3860,5,4286
MAHARASHTRA,MUMBAI SUBURBAN,2021-03-10,389,2933,6,3328
MAHARASHTRA,NAGPUR,2021-03-06,1614,5271,72,6957
MAHARASHTRA,NAGPUR,2021-03-07,1190,4144,44,5378
MAHARASHTRA,NAGPUR,2021-03-08,1557,6335,45,7937
MAHARASHTRA,NAGPUR,2021-03-09,1881,5852,38,7771
MAHARASHTRA,NAGPUR,2021-03-10,2224,6000,41,8265
MAHARASHTRA,NANDED,2021-03-06,235,1461,38,1734
MAHARASHTRA,NANDED,2021-03-07,104,641,16,761
MAHARASHTRA,NANDED,2021-03-08,193,828,49,1070
MAHARASHTRA,NANDED,2021-03-09,228,1286,17,1531
MAHARASHTRA,NANDED,2021-03-10,217,840,16,1073
MAHARASHTRA,NANDURBAR,2021-03-06,59,756,1,816
MAHARASHTRA,NANDURBAR,2021-03-07,11,176,0,187
MAHARASHTRA,NANDURBAR,2021-03-08,69,861,1,931
MAHARASHTRA,NANDURBAR,2021-03-09,116,1199,0,1315
MAHARASHTRA,NANDURBAR,2021-03-10,103,650,1,754
MAHARASHTRA,NASHIK,2021-03-06,441,1413,12,1866
MAHARASHTRA,NASHIK,2021-03-07,647,1366,15,2028
MAHARASHTRA,NASHIK,2021-03-08,528,1331,10,1869
MAHARASHTRA,NASHIK,2021-03-09,1052,1437,10,2499
MAHARASHTRA,NASHIK,2021-03-10,921,1321,27,2269
MAHARASHTRA,OSMANABAD,2021-03-06,53,450,3,506
MAHARASHTRA,OSMANABAD,2021-03-07,31,455,2,488
MAHARASHTRA,OSMANABAD,2021-03-08,41,448,3,492
MAHARASHTRA,OSMANABAD,2021-03-09,44,238,3,285
MAHARASHTRA,OSMANABAD,2021-03-10,23,346,0,369
MAHARASHTRA,PALGHAR,2021-03-06,71,792,1,864
MAHARASHTRA,PALGHAR,2021-03-07,43,461,0,504
MAHARASHTRA,PALGHAR,2021-03-08,61,852,1,914
MAHARASHTRA,PALGHAR,2021-03-09,75,967,5,1047
MAHARASHTRA,PALGHAR,2021-03-10,141,850,2,993
MAHARASHTRA,PARBHANI,2021-03-06,43,275,0,318
MAHARASHTRA,PARBHANI,2021-03-07,48,2619,0,2667
MAHARASHTRA,PARBHANI,2021-03-08,72,1047,4,1123
MAHARASHTRA,PARBHANI,2021-03-09,106,491,3,600
MAHARASHTRA,PARBHANI,2021-03-10,60,1568,1,1629
MAHARASHTRA,PUNE,2021-03-06,2074,8740,144,10958
MAHARASHTRA,PUNE,2021-03-07,1481,5147,25,6653
MAHARASHTRA,PUNE,2021-03-08,2314,6718,135,9167
MAHARASHTRA,PUNE,2021-03-09,2827,8308,184,11319
MAHARASHTRA,PUNE,2021-03-10,3054,8052,206,11312
MAHARASHTRA,RAIGAD,2021-03-06,166,1344,7,1517
MAHARASHTRA,RAIGAD,2021-03-07,108,1013,1,1122
MAHARASHTRA,RAIGAD,2021-03-08,136,1085,1,1222
MAHARASHTRA,RAIGAD,2021-03-09,215,1430,1,1646
MAHARASHTRA,RAIGAD,2021-03-10,228,1524,4,1756
MAHARASHTRA,RATNAGIRI,2021-03-06,41,263,0,304
MAHARASHTRA,RATNAGIRI,2021-03-07,2,61,0,63
MAHARASHTRA,RATNAGIRI,2021-03-08,4,355,0,359
MAHARASHTRA,RATNAGIRI,2021-03-09,8,227,0,235
MAHARASHTRA,RATNAGIRI,2021-03-10,47,123,0,170
MAHARASHTRA,SANGLI,2021-03-06,42,865,3,910
MAHARASHTRA,SANGLI,2021-03-07,29,816,3,848
MAHARASHTRA,SANGLI,2021-03-08,24,708,3,735
MAHARASHTRA,SANGLI,2021-03-09,44,726,1,771
MAHARASHTRA,SANGLI,2021-03-10,59,742,7,808
MAHARASHTRA,SATARA,2021-03-06,67,830,0,897
MAHARASHTRA,SATARA,2021-03-07,182,450,5,637
MAHARASHTRA,SATARA,2021-03-08,66,1474,4,1544
MAHARASHTRA,SATARA,2021-03-09,197,2097,8,2302
MAHARASHTRA,SATARA,2021-03-10,151,3431,35,3617
MAHARASHTRA,SINDHUDURG,2021-03-06,13,202,0,215
MAHARASHTRA,SINDHUDURG,2021-03-07,1,181,0,182
MAHARASHTRA,SINDHUDURG,2021-03-08,14,278,0,292
MAHARASHTRA,SINDHUDURG,2021-03-09,13,406,0,419
MAHARASHTRA,SINDHUDURG,2021-03-10,15,230,0,245
MAHARASHTRA,SOLAPUR,2021-03-06,125,1872,5,2002
MAHARASHTRA,SOLAPUR,2021-03-07,114,1442,5,1561
MAHARASHTRA,SOLAPUR,2021-03-08,150,1889,14,2053
MAHARASHTRA,SOLAPUR,2021-03-09,166,1526,17,1709
MAHARASHTRA,SOLAPUR,2021-03-10,164,1424,20,1608
MAHARASHTRA,THANE,2021-03-06,1019,7977,43,9039
MAHARASHTRA,THANE,2021-03-07,705,6500,7,7212
MAHARASHTRA,THANE,2021-03-08,823,7433,30,8286
MAHARASHTRA,THANE,2021-03-09,1251,8196,8,9455
MAHARASHTRA,THANE,2021-03-10,1132,8317,18,9467
MAHARASHTRA,WARDHA,2021-03-06,284,1007,0,1291
MAHARASHTRA,WARDHA,2021-03-07,96,389,0,485
MAHARASHTRA,WARDHA,2021-03-08,209,981,5,1195
MAHARASHTRA,WARDHA,2021-03-09,326,1194,7,1527
MAHARASHTRA,WARDHA,2021-03-10,330,1269,7,1606
MAHARASHTRA,WASHIM,2021-03-06,249,1047,18,1314
MAHARASHTRA,WASHIM,2021-03-07,131,1095,20,1246
MAHARASHTRA,WASHIM,2021-03-08,100,848,10,958
MAHARASHTRA,WASHIM,2021-03-09,137,622,4,763
MAHARASHTRA,WASHIM,2021-03-10,130,858,10,998
MAHARASHTRA,YAVATMAL,2021-03-06,408,1885,3,2296
MAHARASHTRA,YAVATMAL,2021-03-07,207,971,1,1179
MAHARASHTRA,YAVATMAL,2021-03-08,339,1641,1,1981
MAHARASHTRA,YAVATMAL,2021-03-09,411,1740,1,2152
MAHARASHTRA,YAVATMAL,2021-03-10,272,1225,1,1498
MANIPUR,BISHNUPUR,2021-03-06,0,72,0,72
MANIPUR,BISHNUPUR,2021-03-07,1,30,0,31
MANIPUR,BISHNUPUR,2021-03-08,1,72,0,73
MANIPUR,BISHNUPUR,2021-03-09,2,113,0,115
MANIPUR,BISHNUPUR,2021-03-10,0,177,0,177
MANIPUR,CHANDEL,2021-03-06,0,27,0,27
MANIPUR,CHANDEL,2021-03-07,0,16,0,16
MANIPUR,CHANDEL,2021-03-08,0,57,0,57
MANIPUR,CHANDEL,2021-03-09,0,16,0,16
MANIPUR,CHANDEL,2021-03-10,0,9,0,9
MANIPUR,CHURACHANDPUR,2021-03-06,1,62,0,63
MANIPUR,CHURACHANDPUR,2021-03-07,0,99,0,99
MANIPUR,CHURACHANDPUR,2021-03-08,2,182,0,184
MANIPUR,CHURACHANDPUR,2021-03-09,0,155,0,155
MANIPUR,CHURACHANDPUR,2021-03-10,1,78,0,79
MANIPUR,IMPHAL EAST,2021-03-06,0,129,0,129
MANIPUR,IMPHAL EAST,2021-03-07,2,109,0,111
MANIPUR,IMPHAL EAST,2021-03-08,2,130,0,132
MANIPUR,IMPHAL EAST,2021-03-09,0,114,0,114
MANIPUR,IMPHAL EAST,2021-03-10,2,139,0,141
MANIPUR,IMPHAL WEST,2021-03-06,1,474,0,475
MANIPUR,IMPHAL WEST,2021-03-07,3,285,0,288
MANIPUR,IMPHAL WEST,2021-03-08,3,482,0,485
MANIPUR,IMPHAL WEST,2021-03-09,1,441,0,442
MANIPUR,IMPHAL WEST,2021-03-10,1,556,0,557
MANIPUR,JIRIBAM,2021-03-06,0,1,0,1
MANIPUR,JIRIBAM,2021-03-07,0,2,0,2
MANIPUR,JIRIBAM,2021-03-08,1,3,0,4
MANIPUR,JIRIBAM,2021-03-09,0,4,0,4
MANIPUR,KAKCHING,2021-03-06,6,85,0,91
MANIPUR,KAKCHING,2021-03-07,0,23,0,23
MANIPUR,KAKCHING,2021-03-08,0,62,0,62
MANIPUR,KAKCHING,2021-03-09,1,59,0,60
MANIPUR,KAKCHING,2021-03-10,1,133,0,134
MANIPUR,KAMJONG,2021-03-08,0,2,0,2
MANIPUR,KAMJONG,2021-03-09,0,24,0,24
MANIPUR,KANGPOKPI,2021-03-06,0,26,0,26
MANIPUR,KANGPOKPI,2021-03-07,0,12,0,12
MANIPUR,KANGPOKPI,2021-03-08,0,19,0,19
MANIPUR,KANGPOKPI,2021-03-09,0,20,0,20
MANIPUR,KANGPOKPI,2021-03-10,0,21,0,21
MANIPUR,NONEY,2021-03-06,1,1,0,2
MANIPUR,NONEY,2021-03-08,0,2,0,2
MANIPUR,NONEY,2021-03-09,0,6,0,6
MANIPUR,NONEY,2021-03-10,0,2,0,2
MANIPUR,PHERZAWL,2021-03-07,0,20,0,20
MANIPUR,PHERZAWL,2021-03-08,0,14,0,14
MANIPUR,PHERZAWL,2021-03-09,0,17,0,17
MANIPUR,SENAPATI,2021-03-06,0,16,0,16
MANIPUR,SENAPATI,2021-03-07,0,11,0,11
MANIPUR,SENAPATI,2021-03-08,1,15,0,16
MANIPUR,SENAPATI,2021-03-09,0,28,0,28
MANIPUR,SENAPATI,2021-03-10,0,17,0,17
MANIPUR,TAMENGLONG,2021-03-06,0,73,0,73
MANIPUR,TAMENGLONG,2021-03-07,0,39,0,39
MANIPUR,TAMENGLONG,2021-03-08,0,36,0,36
MANIPUR,TAMENGLONG,2021-03-09,0,95,0,95
MANIPUR,TAMENGLONG,2021-03-10,1,112,0,113
MANIPUR,TENGNOUPAL,2021-03-06,0,8,0,8
MANIPUR,TENGNOUPAL,2021-03-07,0,19,0,19
MANIPUR,TENGNOUPAL,2021-03-08,0,3,0,3
MANIPUR,TENGNOUPAL,2021-03-09,0,5,0,5
MANIPUR,TENGNOUPAL,2021-03-10,1,4,0,5
MANIPUR,THOUBAL,2021-03-06,2,76,0,78
MANIPUR,THOUBAL,2021-03-07,2,142,0,144
MANIPUR,THOUBAL,2021-03-08,6,140,0,146
MANIPUR,THOUBAL,2021-03-09,0,102,0,102
MANIPUR,THOUBAL,2021-03-10,0,145,0,145
MANIPUR,UKHRUL,2021-03-06,0,46,0,46
MANIPUR,UKHRUL,2021-03-07,0,136,0,136
MANIPUR,UKHRUL,2021-03-08,0,88,0,88
MANIPUR,UKHRUL,2021-03-09,0,129,0,129
MANIPUR,UKHRUL,2021-03-10,0,48,0,48
MEGHALAYA,EAST GARO HILLS,2021-03-06,0,12,0,12
MEGHALAYA,EAST GARO HILLS,2021-03-07,0,2,0,2
MEGHALAYA,EAST GARO HILLS,2021-03-08,0,33,0,33
MEGHALAYA,EAST GARO HILLS,2021-03-09,1,14,0,15
MEGHALAYA,EAST GARO HILLS,2021-03-10,0,24,0,24
MEGHALAYA,EAST JAINTIA HILLS,2021-03-06,0,16,0,16
MEGHALAYA,EAST JAINTIA HILLS,2021-03-07,0,26,0,26
MEGHALAYA,EAST JAINTIA HILLS,2021-03-08,0,95,0,95
MEGHALAYA,EAST JAINTIA HILLS,2021-03-09,0,130,0,130
MEGHALAYA,EAST JAINTIA HILLS,2021-03-10,1,106,0,107
MEGHALAYA,EAST KHASI HILLS,2021-03-06,3,593,0,596
MEGHALAYA,EAST KHASI HILLS,2021-03-07,2,465,0,467
MEGHALAYA,EAST KHASI HILLS,2021-03-08,1,617,1,619
MEGHALAYA,EAST KHASI HILLS,2021-03-09,5,537,1,543
MEGHALAYA,EAST KHASI HILLS,2021-03-10,3,873,0,876
MEGHALAYA,NORTH GARO HILLS,2021-03-06,0,5,0,5
MEGHALAYA,NORTH GARO HILLS,2021-03-07,0,5,0,5
MEGHALAYA,NORTH GARO HILLS,2021-03-08,0,18,0,18
MEGHALAYA,NORTH GARO HILLS,2021-03-09,0,4,0,4
MEGHALAYA,NORTH GARO HILLS,2021-03-10,0,6,0,6
MEGHALAYA,RI BHOI,2021-03-06,1,19,0,20
MEGHALAYA,RI BHOI,2021-03-07,0,28,0,28
MEGHALAYA,RI BHOI,2021-03-08,0,153,0,153
MEGHALAYA,RI BHOI,2021-03-09,0,89,0,89
MEGHALAYA,RI BHOI,2021-03-10,0,69,0,69
MEGHALAYA,SOUTH GARO HILLS,2021-03-06,0,5,0,5
MEGHALAYA,SOUTH GARO HILLS,2021-03-07,0,3,0,3
MEGHALAYA,SOUTH GARO HILLS,2021-03-08,0,5,0,5
MEGHALAYA,SOUTH GARO HILLS,2021-03-09,0,10,0,10
MEGHALAYA,SOUTH GARO HILLS,2021-03-10,0,9,0,9
MEGHALAYA,SOUTH WEST GARO HILLS,2021-03-06,0,9,0,9
MEGHALAYA,SOUTH WEST GARO HILLS,2021-03-07,0,5,0,5
MEGHALAYA,SOUTH WEST GARO HILLS,2021-03-08,0,39,0,39
MEGHALAYA,SOUTH WEST GARO HILLS,2021-03-09,0,32,0,32
MEGHALAYA,SOUTH WEST GARO HILLS,2021-03-10,0,38,0,38
MEGHALAYA,SOUTH WEST KHASI HILLS,2021-03-06,0,13,0,13
MEGHALAYA,SOUTH WEST KHASI HILLS,2021-03-08,0,3,0,3
MEGHALAYA,SOUTH WEST KHASI HILLS,2021-03-09,0,5,0,5
MEGHALAYA,SOUTH WEST KHASI HILLS,2021-03-10,0,11,0,11
MEGHALAYA,WEST GARO HILLS,2021-03-06,0,49,0,49
MEGHALAYA,WEST GARO HILLS,2021-03-08,1,112,0,113
MEGHALAYA,WEST GARO HILLS,2021-03-09,1,45,0,46
MEGHALAYA,WEST GARO HILLS,2021-03-10,0,110,0,110
MEGHALAYA,WEST JAINTIA HILLS,2021-03-06,0,45,1,46
MEGHALAYA,WEST JAINTIA HILLS,2021-03-07,0,27,0,27
MEGHALAYA,WEST JAINTIA HILLS,2021-03-08,0,63,0,63
MEGHALAYA,WEST JAINTIA HILLS,2021-03-09,0,58,1,59
MEGHALAYA,WEST JAINTIA HILLS,2021-03-10,1,70,0,71
MEGHALAYA,WEST KHASI HILLS,2021-03-06,0,35,0,35
MEGHALAYA,WEST KHASI HILLS,2021-03-07,0,8,0,8
MEGHALAYA,WEST KHASI HILLS,2021-03-08,0,41,0,41
MEGHALAYA,WEST KHASI HILLS,2021-03-09,0,48,0,48
MEGHALAYA,WEST KHASI HILLS,2021-03-10,0,39,0,39
MIZORAM,AIZAWL,2021-03-06,0,324,0,324
MIZORAM,AIZAWL,2021-03-07,0,96,0,96
MIZORAM,AIZAWL,2021-03-08,4,387,0,391
MIZORAM,AIZAWL,2021-03-09,1,361,0,362
MIZORAM,AIZAWL,2021-03-10,0,452,0,452
MIZORAM,CHAMPHAI,2021-03-06,0,33,0,33
MIZORAM,CHAMPHAI,2021-03-07,0,1,0,1
MIZORAM,CHAMPHAI,2021-03-08,0,13,0,13
MIZORAM,CHAMPHAI,2021-03-09,0,10,0,10
MIZORAM,CHAMPHAI,2021-03-10,0,3,0,3
MIZORAM,HNAHTHIAL,2021-03-06,0,11,0,11
MIZORAM,HNAHTHIAL,2021-03-08,0,6,0,6
MIZORAM,HNAHTHIAL,2021-03-09,0,1,0,1
MIZORAM,HNAHTHIAL,2021-03-10,0,1,0,1
MIZORAM,KHAWZAWL,2021-03-08,0,5,0,5
MIZORAM,KHAWZAWL,2021-03-10,0,1,0,1
MIZORAM,KOLASIB,2021-03-06,0,65,0,65
MIZORAM,KOLASIB,2021-03-07,0,67,0,67
MIZORAM,KOLASIB,2021-03-08,0,52,0,52
MIZORAM,KOLASIB,2021-03-09,0,30,0,30
MIZORAM,KOLASIB,2021-03-10,0,164,0,164
MIZORAM,LAWNGTLAI,2021-03-06,0,32,0,32
MIZORAM,LAWNGTLAI,2021-03-07,0,4,0,4
MIZORAM,LAWNGTLAI,2021-03-08,0,28,0,28
MIZORAM,LAWNGTLAI,2021-03-09,0,11,0,11
MIZORAM,LAWNGTLAI,2021-03-10,0,4,0,4
MIZORAM,LUNGLEI,2021-03-06,0,11,0,11
MIZORAM,LUNGLEI,2021-03-08,0,62,0,62
MIZORAM,LUNGLEI,2021-03-09,0,12,0,12
MIZORAM,LUNGLEI,2021-03-10,0,10,0,10
MIZORAM,MAMIT,2021-03-06,0,3,0,3
MIZORAM,MAMIT,2021-03-07,0,54,0,54
MIZORAM,MAMIT,2021-03-08,0,18,0,18
MIZORAM,MAMIT,2021-03-09,0,90,0,90
MIZORAM,MAMIT,2021-03-10,0,60,0,60
MIZORAM,SAIHA,2021-03-06,0,12,0,12
MIZORAM,SAIHA,2021-03-07,0,8,0,8
MIZORAM,SAIHA,2021-03-08,0,8,0,8
MIZORAM,SAIHA,2021-03-09,0,3,0,3
MIZORAM,SAIHA,2021-03-10,0,3,0,3
MIZORAM,SAITUAL,2021-03-06,0,15,0,15
MIZORAM,SAITUAL,2021-03-08,0,97,0,97
MIZORAM,SAITUAL,2021-03-09,0,49,0,49
MIZORAM,SAITUAL,2021-03-10,0,80,0,80
MIZORAM,SERCHHIP,2021-03-07,0,1,0,1
MIZORAM,SERCHHIP,2021-03-08,0,35,0,35
MIZORAM,SERCHHIP,2021-03-09,0,13,0,13
MIZORAM,SERCHHIP,2021-03-10,0,5,0,5
NAGALAND,DIMAPUR,2021-03-06,61,141,0,202
NAGALAND,DIMAPUR,2021-03-07,0,43,0,43
NAGALAND,DIMAPUR,2021-03-08,0,176,0,176
NAGALAND,DIMAPUR,2021-03-09,0,131,0,131
NAGALAND,DIMAPUR,2021-03-10,1,107,0,108
NAGALAND,KIPHIRE,2021-03-08,0,29,0,29
NAGALAND,KIPHIRE,2021-03-09,0,1,0,1
NAGALAND,KIPHIRE,2021-03-10,0,3,0,3
NAGALAND,KOHIMA,2021-03-06,29,51,0,80
NAGALAND,KOHIMA,2021-03-07,0,5,0,5
NAGALAND,KOHIMA,2021-03-08,0,100,0,100
NAGALAND,KOHIMA,2021-03-09,1,151,0,152
NAGALAND,KOHIMA,2021-03-10,1,152,0,153
NAGALAND,LONGLENG,2021-03-06,1,1,0,2
NAGALAND,LONGLENG,2021-03-08,0,1,0,1
NAGALAND,LONGLENG,2021-03-10,0,13,0,13
NAGALAND,MOKOKCHUNG,2021-03-06,0,14,0,14
NAGALAND,MOKOKCHUNG,2021-03-07,0,13,0,13
NAGALAND,MOKOKCHUNG,2021-03-08,0,18,0,18
NAGALAND,MOKOKCHUNG,2021-03-09,0,15,0,15
NAGALAND,MOKOKCHUNG,2021-03-10,0,30,0,30
NAGALAND,MON,2021-03-06,0,2,0,2
NAGALAND,MON,2021-03-07,0,1,0,1
NAGALAND,MON,2021-03-08,0,14,0,14
NAGALAND,MON,2021-03-09,0,30,0,30
NAGALAND,MON,2021-03-10,0,6,0,6
NAGALAND,PEREN,2021-03-06,0,3,0,3
NAGALAND,PEREN,2021-03-07,0,1,0,1
NAGALAND,PEREN,2021-03-08,0,1,0,1
NAGALAND,PEREN,2021-03-09,0,3,0,3
NAGALAND,PEREN,2021-03-10,0,17,0,17
NAGALAND,PHEK,2021-03-06,0,1,0,1
NAGALAND,PHEK,2021-03-07,0,1,0,1
NAGALAND,PHEK,2021-03-08,0,4,0,4
NAGALAND,PHEK,2021-03-09,0,6,0,6
NAGALAND,PHEK,2021-03-10,0,2,0,2
NAGALAND,TUENSANG,2021-03-06,0,3,0,3
NAGALAND,TUENSANG,2021-03-07,0,1,0,1
NAGALAND,TUENSANG,2021-03-08,0,2,0,2
NAGALAND,TUENSANG,2021-03-10,0,1,0,1
NAGALAND,WOKHA,2021-03-10,0,2,0,2
NAGALAND,ZUNHEBOTO,2021-03-08,0,4,0,4
NAGALAND,ZUNHEBOTO,2021-03-09,0,3,0,3
ODISHA,ANUGUL,2021-03-06,7,740,0,747
ODISHA,ANUGUL,2021-03-07,6,194,0,200
ODISHA,ANUGUL,2021-03-08,10,600,0,610
ODISHA,ANUGUL,2021-03-09,2,725,0,727
ODISHA,ANUGUL,2021-03-10,3,532,0,535
ODISHA,BALANGIR,2021-03-06,1,856,0,857
ODISHA,BALANGIR,2021-03-07,2,1102,2,1106
ODISHA,BALANGIR,2021-03-08,4,906,0,910
ODISHA,BALANGIR,2021-03-09,2,923,0,925
ODISHA,BALANGIR,2021-03-10,6,1009,4,1019
ODISHA,BALESHWAR,2021-03-06,13,1886,0,1899
ODISHA,BALESHWAR,2021-03-07,1,1510,0,1511
ODISHA,BALESHWAR,2021-03-08,1,1694,0,1695
ODISHA,BALESHWAR,2021-03-09,4,1469,1,1474
ODISHA,BALESHWAR,2021-03-10,7,1424,0,1431
ODISHA,BARGARH,2021-03-06,1,484,0,485
ODISHA,BARGARH,2021-03-07,1,318,1,320
ODISHA,BARGARH,2021-03-08,2,389,0,391
ODISHA,BARGARH,2021-03-09,0,388,0,388
ODISHA,BARGARH,2021-03-10,1,327,0,328
ODISHA,BHADRAK,2021-03-06,0,379,0,379
ODISHA,BHADRAK,2021-03-07,0,416,0,416
ODISHA,BHADRAK,2021-03-08,0,547,0,547
ODISHA,BHADRAK,2021-03-09,0,689,1,690
ODISHA,BHADRAK,2021-03-10,0,520,0,520
ODISHA,BOUDH,2021-03-06,0,102,0,102
ODISHA,BOUDH,2021-03-07,0,138,0,138
ODISHA,BOUDH,2021-03-08,0,53,0,53
ODISHA,BOUDH,2021-03-09,0,137,0,137
ODISHA,BOUDH,2021-03-10,0,239,0,239
ODISHA,CUTTACK,2021-03-06,3,1578,0,1581
ODISHA,CUTTACK,2021-03-07,5,643,0,648
ODISHA,CUTTACK,2021-03-08,11,1856,1,1868
ODISHA,CUTTACK,2021-03-09,9,1602,0,1611
ODISHA,CUTTACK,2021-03-10,4,1594,0,1598
ODISHA,DEOGARH,2021-03-06,2,83,0,85
ODISHA,DEOGARH,2021-03-07,2,229,0,231
ODISHA,DEOGARH,2021-03-08,3,154,0,157
ODISHA,DEOGARH,2021-03-09,4,78,0,82
ODISHA,DEOGARH,2021-03-10,0,181,0,181
ODISHA,DHENKANAL,2021-03-06,0,326,2,328
ODISHA,DHENKANAL,2021-03-07,1,195,0,196
ODISHA,DHENKANAL,2021-03-08,0,719,0,719
ODISHA,DHENKANAL,2021-03-09,0,666,0,666
ODISHA,DHENKANAL,2021-03-10,0,992,1,993
ODISHA,GAJAPATI,2021-03-06,1,288,0,289
ODISHA,GAJAPATI,2021-03-07,1,238,0,239
ODISHA,GAJAPATI,2021-03-08,0,196,0,196
ODISHA,GAJAPATI,2021-03-09,3,326,0,329
ODISHA,GAJAPATI,2021-03-10,7,350,2,359
ODISHA,GANJAM,2021-03-06,0,896,3,899
ODISHA,GANJAM,2021-03-07,2,511,0,513
ODISHA,GANJAM,2021-03-08,1,838,3,842
ODISHA,GANJAM,2021-03-09,2,862,29,893
ODISHA,GANJAM,2021-03-10,1,861,0,862
ODISHA,JAGATSINGHAPUR,2021-03-06,1,633,0,634
ODISHA,JAGATSINGHAPUR,2021-03-07,1,248,2,251
ODISHA,JAGATSINGHAPUR,2021-03-08,0,608,0,608
ODISHA,JAGATSINGHAPUR,2021-03-09,0,634,0,634
ODISHA,JAGATSINGHAPUR,2021-03-10,0,630,0,630
ODISHA,JAJAPUR,2021-03-06,1,379,0,380
ODISHA,JAJAPUR,2021-03-07,0,168,0,168
ODISHA,JAJAPUR,2021-03-08,1,431,0,432
ODISHA,JAJAPUR,2021-03-09,2,430,0,432
ODISHA,JAJAPUR,2021-03-10,2,571,0,573
ODISHA,JHARSUGUDA,2021-03-06,6,377,0,383
ODISHA,JHARSUGUDA,2021-03-07,4,302,0,306
ODISHA,JHARSUGUDA,2021-03-08,1,360,0,361
ODISHA,JHARSUGUDA,2021-03-09,0,249,0,249
ODISHA,JHARSUGUDA,2021-03-10,3,417,2,422
ODISHA,KALAHANDI,2021-03-06,1,113,0,114
ODISHA,KALAHANDI,2021-03-07,0,232,0,232
ODISHA,KALAHANDI,2021-03-08,0,78,0,78
ODISHA,KALAHANDI,2021-03-09,1,259,0,260
ODISHA,KALAHANDI,2021-03-10,2,306,0,308
ODISHA,KANDHAMAL,2021-03-06,0,642,0,642
ODISHA,KANDHAMAL,2021-03-07,0,604,0,604
ODISHA,KANDHAMAL,2021-03-08,0,635,0,635
ODISHA,KANDHAMAL,2021-03-09,0,633,0,633
ODISHA,KANDHAMAL,2021-03-10,0,641,0,641
ODISHA,KENDRAPARA,2021-03-06,0,1283,0,1283
ODISHA,KENDRAPARA,2021-03-07,0,834,0,834
ODISHA,KENDRAPARA,2021-03-08,0,1319,0,1319
ODISHA,KENDRAPARA,2021-03-09,0,1549,3,1552
ODISHA,KENDRAPARA,2021-03-10,0,1124,0,1124
ODISHA,KENDUJHAR,2021-03-06,1,502,0,503
ODISHA,KENDUJHAR,2021-03-07,1,350,0,351
ODISHA,KENDUJHAR,2021-03-08,1,642,0,643
ODISHA,KENDUJHAR,2021-03-09,0,610,0,610
ODISHA,KENDUJHAR,2021-03-10,1,604,0,605
ODISHA,KHORDHA,2021-03-06,21,1629,1,1651
ODISHA,KHORDHA,2021-03-07,6,958,6,970
ODISHA,KHORDHA,2021-03-08,9,1998,0,2007
ODISHA,KHORDHA,2021-03-09,6,1758,1,1765
ODISHA,KHORDHA,2021-03-10,8,2149,1,2158
ODISHA,KORAPUT,2021-03-06,0,1273,0,1273
ODISHA,KORAPUT,2021-03-07,0,1263,0,1263
ODISHA,KORAPUT,2021-03-08,1,1497,0,1498
ODISHA,KORAPUT,2021-03-09,0,1648,0,1648
ODISHA,KORAPUT,2021-03-10,1,1494,0,1495
ODISHA,MALKANGIRI,2021-03-06,0,371,0,371
ODISHA,MALKANGIRI,2021-03-07,1,209,0,210
ODISHA,MALKANGIRI,2021-03-08,0,451,0,451
ODISHA,MALKANGIRI,2021-03-09,0,201,0,201
ODISHA,MALKANGIRI,2021-03-10,0,177,0,177
ODISHA,MAYURBHANJ,2021-03-06,0,1124,0,1124
ODISHA,MAYURBHANJ,2021-03-07,4,1040,0,1044
ODISHA,MAYURBHANJ,2021-03-08,5,1628,5,1638
ODISHA,MAYURBHANJ,2021-03-09,8,1459,0,1467
ODISHA,MAYURBHANJ,2021-03-10,14,1281,0,1295
ODISHA,NABARANGPUR,2021-03-06,2,907,0,909
ODISHA,NABARANGPUR,2021-03-07,0,467,0,467
ODISHA,NABARANGPUR,2021-03-08,0,870,0,870
ODISHA,NABARANGPUR,2021-03-09,0,878,0,878
ODISHA,NABARANGPUR,2021-03-10,0,848,0,848
ODISHA,NAYAGARH,2021-03-06,0,385,0,385
ODISHA,NAYAGARH,2021-03-07,3,249,0,252
ODISHA,NAYAGARH,2021-03-08,0,668,2,670
ODISHA,NAYAGARH,2021-03-09,0,881,1,882
ODISHA,NAYAGARH,2021-03-10,0,943,0,943
ODISHA,NUAPADA,2021-03-06,2,140,0,142
ODISHA,NUAPADA,2021-03-07,0,32,0,32
ODISHA,NUAPADA,2021-03-08,0,455,1,456
ODISHA,NUAPADA,2021-03-09,1,246,15,262
ODISHA,NUAPADA,2021-03-10,0,102,0,102
ODISHA,PURI,2021-03-06,3,748,0,751
ODISHA,PURI,2021-03-07,1,731,0,732
ODISHA,PURI,2021-03-08,1,881,0,882
ODISHA,PURI,2021-03-09,1,764,0,765
ODISHA,PURI,2021-03-10,0,694,1,695
ODISHA,RAYAGADA,2021-03-06,3,568,0,571
ODISHA,RAYAGADA,2021-03-07,2,311,0,313
ODISHA,RAYAGADA,2021-03-08,0,317,0,317
ODISHA,RAYAGADA,2021-03-09,0,982,0,982
ODISHA,RAYAGADA,2021-03-10,2,767,0,769
ODISHA,SAMBALPUR,2021-03-06,8,552,0,560
ODISHA,SAMBALPUR,2021-03-07,6,441,0,447
ODISHA,SAMBALPUR,2021-03-08,8,454,0,462
ODISHA,SAMBALPUR,2021-03-09,4,463,0,467
ODISHA,SAMBALPUR,2021-03-10,6,452,0,458
ODISHA,SONEPUR,2021-03-06,0,151,0,151
ODISHA,SONEPUR,2021-03-07,1,155,0,156
ODISHA,SONEPUR,2021-03-08,0,368,0,368
ODISHA,SONEPUR,2021-03-09,0,323,0,323
ODISHA,SONEPUR,2021-03-10,0,270,0,270
ODISHA,SUNDARGARH,2021-03-06,18,448,0,466
ODISHA,SUNDARGARH,2021-03-07,4,280,0,284
ODISHA,SUNDARGARH,2021-03-08,4,585,0,589
ODISHA,SUNDARGARH,2021-03-09,12,483,0,495
ODISHA,SUNDARGARH,2021-03-10,7,641,0,648
PUDUCHERRY,KARAIKAL,2021-03-06,2,383,0,385
PUDUCHERRY,KARAIKAL,2021-03-07,1,142,0,143
PUDUCHERRY,KARAIKAL,2021-03-08,5,272,0,277
PUDUCHERRY,KARAIKAL,2021-03-09,6,392,0,398
PUDUCHERRY,KARAIKAL,2021-03-10,5,185,0,190
PUDUCHERRY,MAHE,2021-03-06,2,232,0,234
PUDUCHERRY,MAHE,2021-03-07,2,81,1,84
PUDUCHERRY,MAHE,2021-03-08,4,174,0,178
PUDUCHERRY,MAHE,2021-03-09,6,134,0,140
PUDUCHERRY,MAHE,2021-03-10,14,144,0,158
PUDUCHERRY,PONDICHERRY,2021-03-06,21,384,0,405
PUDUCHERRY,PONDICHERRY,2021-03-07,16,145,0,161
PUDUCHERRY,PONDICHERRY,2021-03-08,21,378,2,401
PUDUCHERRY,PONDICHERRY,2021-03-09,20,376,0,396
PUDUCHERRY,PONDICHERRY,2021-03-10,21,276,3,300
PUDUCHERRY,YANAM,2021-03-06,0,99,0,99
PUDUCHERRY,YANAM,2021-03-07,0,9,0,9
PUDUCHERRY,YANAM,2021-03-08,1,117,0,118
PUDUCHERRY,YANAM,2021-03-09,0,168,0,168
PUDUCHERRY,YANAM,2021-03-10,0,96,0,96
PUNJAB,AMRITSAR,2021-03-06,77,1680,6,1763
PUNJAB,AMRITSAR,2021-03-07,150,1689,18,1857
PUNJAB,AMRITSAR,2021-03-08,94,1637,0,1731
PUNJAB,AMRITSAR,2021-03-09,189,1509,2,1700
PUNJAB,AMRITSAR,2021-03-10,210,2763,5,2978
PUNJAB,BARNALA,2021-03-06,2,254,0,256
PUNJAB,BARNALA,2021-03-07,1,295,0,296
PUNJAB,BARNALA,2021-03-08,4,110,2,116
PUNJAB,BARNALA,2021-03-09,2,233,0,235
PUNJAB,BARNALA,2021-03-10,3,177,9,189
PUNJAB,BATHINDA,2021-03-06,30,456,5,491
PUNJAB,BATHINDA,2021-03-07,37,513,22,572
PUNJAB,BATHINDA,2021-03-08,53,1033,8,1094
PUNJAB,BATHINDA,2021-03-09,24,950,21,995
PUNJAB,BATHINDA,2021-03-10,51,674,47,772
PUNJAB,FARIDKOT,2021-03-06,29,584,3,616
PUNJAB,FARIDKOT,2021-03-07,6,462,6,474
PUNJAB,FARIDKOT,2021-03-08,8,196,4,208
PUNJAB,FARIDKOT,2021-03-09,24,1002,4,1030
PUNJAB,FARIDKOT,2021-03-10,26,492,17,535
PUNJAB,FATEHGARH SAHIB,2021-03-06,23,506,3,532
PUNJAB,FATEHGARH SAHIB,2021-03-07,17,102,0,119
PUNJAB,FATEHGARH SAHIB,2021-03-08,15,547,2,564
PUNJAB,FATEHGARH SAHIB,2021-03-09,26,369,0,395
PUNJAB,FATEHGARH SAHIB,2021-03-10,65,470,1,536
PUNJAB,FAZILKA,2021-03-06,6,172,0,178
PUNJAB,FAZILKA,2021-03-07,10,380,10,400
PUNJAB,FAZILKA,2021-03-08,9,953,3,965
PUNJAB,FAZILKA,2021-03-09,7,765,0,772
PUNJAB,FAZILKA,2021-03-10,10,351,6,367
PUNJAB,FIROZEPUR,2021-03-06,19,180,2,201
PUNJAB,FIROZEPUR,2021-03-07,14,466,9,489
PUNJAB,FIROZEPUR,2021-03-08,16,925,18,959
PUNJAB,FIROZEPUR,2021-03-09,1,494,2,497
PUNJAB,FIROZEPUR,2021-03-10,25,392,3,420
PUNJAB,GURDASPUR,2021-03-06,25,497,0,522
PUNJAB,GURDASPUR,2021-03-07,71,225,2,298
PUNJAB,GURDASPUR,2021-03-08,47,1289,2,1338
PUNJAB,GURDASPUR,2021-03-09,45,802,0,847
PUNJAB,GURDASPUR,2021-03-10,78,795,2,875
PUNJAB,HOSHIARPUR,2021-03-06,170,974,3,1147
PUNJAB,HOSHIARPUR,2021-03-07,162,331,5,498
PUNJAB,HOSHIARPUR,2021-03-08,176,750,0,926
PUNJAB,HOSHIARPUR,2021-03-09,209,2140,10,2359
PUNJAB,HOSHIARPUR,2021-03-10,281,489,6,776
PUNJAB,JALANDHAR,2021-03-06,240,2528,16,2784
PUNJAB,JALANDHAR,2021-03-07,199,2514,116,2829
PUNJAB,JALANDHAR,2021-03-08,226,4290,67,4583
PUNJAB,JALANDHAR,2021-03-09,155,2531,45,2731
PUNJAB,JALANDHAR,2021-03-10,287,3047,187,3521
PUNJAB,KAPURTHALA,2021-03-06,92,663,2,757
PUNJAB,KAPURTHALA,2021-03-07,109,1193,7,1309
PUNJAB,KAPURTHALA,2021-03-08,56,910,1,967
PUNJAB,KAPURTHALA,2021-03-09,56,666,1,723
PUNJAB,KAPURTHALA,2021-03-10,47,358,7,412
PUNJAB,LUDHIANA,2021-03-06,103,4031,9,4143
PUNJAB,LUDHIANA,2021-03-07,123,3326,6,3455
PUNJAB,LUDHIANA,2021-03-08,124,3763,15,3902
PUNJAB,LUDHIANA,2021-03-09,181,3570,28,3779
PUNJAB,LUDHIANA,2021-03-10,234,3693,35,3962
PUNJAB,MANSA,2021-03-06,9,578,0,587
PUNJAB,MANSA,2021-03-07,3,499,1,503
PUNJAB,MANSA,2021-03-08,3,255,0,258
PUNJAB,MANSA,2021-03-09,10,970,0,980
PUNJAB,MANSA,2021-03-10,8,581,0,589
PUNJAB,MOGA,2021-03-06,25,269,10,304
PUNJAB,MOGA,2021-03-07,10,310,7,327
PUNJAB,MOGA,2021-03-08,18,381,3,402
PUNJAB,MOGA,2021-03-09,23,307,2,332
PUNJAB,MOGA,2021-03-10,26,411,9,446
PUNJAB,PATHANKOT,2021-03-06,12,1130,7,1149
PUNJAB,PATHANKOT,2021-03-07,8,46,0,54
PUNJAB,PATHANKOT,2021-03-08,6,1133,3,1142
PUNJAB,PATHANKOT,2021-03-09,1,83,0,84
PUNJAB,PATHANKOT,2021-03-10,18,1174,1,1193
PUNJAB,PATIALA,2021-03-06,114,1700,3,1817
PUNJAB,PATIALA,2021-03-07,87,1841,0,1928
PUNJAB,PATIALA,2021-03-08,103,1671,1,1775
PUNJAB,PATIALA,2021-03-09,135,1864,0,1999
PUNJAB,PATIALA,2021-03-10,148,1980,45,2173
PUNJAB,RUPNAGAR,2021-03-06,33,595,37,665
PUNJAB,RUPNAGAR,2021-03-07,27,1678,5,1710
PUNJAB,RUPNAGAR,2021-03-08,21,740,2,763
PUNJAB,RUPNAGAR,2021-03-09,53,848,0,901
PUNJAB,RUPNAGAR,2021-03-10,70,666,0,736
PUNJAB,S.A.S NAGAR,2021-03-06,133,1117,4,1254
PUNJAB,S.A.S NAGAR,2021-03-07,116,1168,1,1285
PUNJAB,S.A.S NAGAR,2021-03-08,153,1347,2,1502
PUNJAB,S.A.S NAGAR,2021-03-09,126,1276,5,1407
PUNJAB,S.A.S NAGAR,2021-03-10,197,1612,12,1821
PUNJAB,SANGRUR,2021-03-06,31,1812,3,1846
PUNJAB,SANGRUR,2021-03-07,10,1385,1,1396
PUNJAB,SANGRUR,2021-03-08,9,1260,1,1270
PUNJAB,SANGRUR,2021-03-09,13,1336,2,1351
PUNJAB,SANGRUR,2021-03-10,10,1707,8,1725
PUNJAB,SHAHID BHAGAT SINGH NAGAR,2021-03-06,211,1246,1,1458
PUNJAB,SHAHID BHAGAT SINGH NAGAR,2021-03-07,134,1102,0,1236
PUNJAB,SHAHID BHAGAT SINGH NAGAR,2021-03-08,117,726,0,843
PUNJAB,SHAHID BHAGAT SINGH NAGAR,2021-03-09,223,1231,0,1454
PUNJAB,SHAHID BHAGAT SINGH NAGAR,2021-03-10,151,1287,1,1439
PUNJAB,SRI MUKTSAR SAHIB,2021-03-06,7,78,3,88
PUNJAB,SRI MUKTSAR SAHIB,2021-03-07,7,627,8,642
PUNJAB,SRI MUKTSAR SAHIB,2021-03-08,6,83,0,89
PUNJAB,SRI MUKTSAR SAHIB,2021-03-09,2,405,0,407
PUNJAB,SRI MUKTSAR SAHIB,2021-03-10,9,556,6,571
PUNJAB,TARN TARAN,2021-03-06,14,605,0,619
PUNJAB,TARN TARAN,2021-03-07,5,376,2,383
PUNJAB,TARN TARAN,2021-03-08,16,749,0,765
PUNJAB,TARN TARAN,2021-03-09,34,864,2,900
PUNJAB,TARN TARAN,2021-03-10,28,104,0,132
RAJASTHAN,AJMER,2021-03-06,0,37,716,753
RAJASTHAN,AJMER,2021-03-07,0,38,394,432
RAJASTHAN,AJMER,2021-03-08,2,44,643,689
RAJASTHAN,AJMER,2021-03-09,0,55,903,958
RAJASTHAN,AJMER,2021-03-10,4,54,683,741
RAJASTHAN,ALWAR,2021-03-06,3,2424,106,2533
RAJASTHAN,ALWAR,2021-03-07,5,1901,48,1954
RAJASTHAN,ALWAR,2021-03-08,19,782,54,855
RAJASTHAN,ALWAR,2021-03-09,21,1020,128,1169
RAJASTHAN,ALWAR,2021-03-10,59,1084,32,1175
RAJASTHAN,BANSWARA,2021-03-06,8,102,1,111
RAJASTHAN,BANSWARA,2021-03-07,0,51,0,51
RAJASTHAN,BANSWARA,2021-03-08,0,84,0,84
RAJASTHAN,BANSWARA,2021-03-09,23,88,1,112
RAJASTHAN,BANSWARA,2021-03-10,12,78,0,90
RAJASTHAN,BARAN,2021-03-06,1,145,0,146
RAJASTHAN,BARAN,2021-03-07,1,138,0,139
RAJASTHAN,BARAN,2021-03-08,1,121,1,123
RAJASTHAN,BARAN,2021-03-09,3,119,1,123
RAJASTHAN,BARAN,2021-03-10,2,97,1,100
RAJASTHAN,BARMER,2021-03-06,1,314,0,315
RAJASTHAN,BARMER,2021-03-07,1,155,0,156
RAJASTHAN,BARMER,2021-03-08,0,179,3,182
RAJASTHAN,BARMER,2021-03-09,0,181,1,182
RAJASTHAN,BARMER,2021-03-10,0,199,5,204
RAJASTHAN,BHARATPUR,2021-03-06,2,574,2,578
RAJASTHAN,BHARATPUR,2021-03-07,0,274,3,277
RAJASTHAN,BHARATPUR,2021-03-08,1,252,2,255
RAJASTHAN,BHARATPUR,2021-03-09,0,245,5,250
RAJASTHAN,BHARATPUR,2021-03-10,3,368,5,376
RAJASTHAN,BHILWARA,2021-03-06,7,332,2,341
RAJASTHAN,BHILWARA,2021-03-07,5,211,1,217
RAJASTHAN,BHILWARA,2021-03-08,21,418,3,442
RAJASTHAN,BHILWARA,2021-03-09,18,688,1,707
RAJASTHAN,BHILWARA,2021-03-10,5,226,1,232
RAJASTHAN,BIKANER,2021-03-06,7,1064,1,1072
RAJASTHAN,BIKANER,2021-03-07,0,902,1,903
RAJASTHAN,BIKANER,2021-03-08,4,1104,1,1109
RAJASTHAN,BIKANER,2021-03-09,3,509,0,512
RAJASTHAN,BIKANER,2021-03-10,2,797,3,802
RAJASTHAN,BUNDI,2021-03-06,1,136,0,137
RAJASTHAN,BUNDI,2021-03-07,0,34,1,35
RAJASTHAN,BUNDI,2021-03-08,1,134,2,137
RAJASTHAN,BUNDI,2021-03-09,0,97,0,97
RAJASTHAN,BUNDI,2021-03-10,0,101,0,101
RAJASTHAN,CHITTORGARH,2021-03-06,0,790,2,792
RAJASTHAN,CHITTORGARH,2021-03-07,9,482,6,497
RAJASTHAN,CHITTORGARH,2021-03-08,3,602,1,606
RAJASTHAN,CHITTORGARH,2021-03-09,3,503,8,514
RAJASTHAN,CHITTORGARH,2021-03-10,7,526,2,535
RAJASTHAN,CHURU,2021-03-06,4,233,5,242
RAJASTHAN,CHURU,2021-03-07,2,215,0,217
RAJASTHAN,CHURU,2021-03-08,1,89,5,95
RAJASTHAN,CHURU,2021-03-09,3,325,7,335
RAJASTHAN,CHURU,2021-03-10,1,298,1,300
RAJASTHAN,DAUSA,2021-03-06,0,279,9,288
RAJASTHAN,DAUSA,2021-03-07,0,214,3,217
RAJASTHAN,DAUSA,2021-03-08,0,66,9,75
RAJASTHAN,DAUSA,2021-03-09,1,215,21,237
RAJASTHAN,DAUSA,2021-03-10,0,231,7,238
RAJASTHAN,DHOLPUR,2021-03-06,2,59,0,61
RAJASTHAN,DHOLPUR,2021-03-07,0,7,0,7
RAJASTHAN,DHOLPUR,2021-03-08,10,359,1,370
RAJASTHAN,DHOLPUR,2021-03-09,6,31,0,37
RAJASTHAN,DHOLPUR,2021-03-10,5,286,3,294
RAJASTHAN,DUNGARPUR,2021-03-06,35,221,0,256
RAJASTHAN,DUNGARPUR,2021-03-07,59,451,0,510
RAJASTHAN,DUNGARPUR,2021-03-08,30,120,0,150
RAJASTHAN,DUNGARPUR,2021-03-09,15,316,0,331
RAJASTHAN,DUNGARPUR,2021-03-10,18,280,0,298
RAJASTHAN,GANGANAGAR,2021-03-06,113,328,25,466
RAJASTHAN,GANGANAGAR,2021-03-07,15,133,9,157
RAJASTHAN,GANGANAGAR,2021-03-08,126,328,11,465
RAJASTHAN,GANGANAGAR,2021-03-09,139,252,16,407
RAJASTHAN,GANGANAGAR,2021-03-10,21,114,16,151
RAJASTHAN,HANUMANGARH,2021-03-06,3,607,1,611
RAJASTHAN,HANUMANGARH,2021-03-07,5,449,0,454
RAJASTHAN,HANUMANGARH,2021-03-08,2,299,0,301
RAJASTHAN,HANUMANGARH,2021-03-09,5,427,2,434
RAJASTHAN,HANUMANGARH,2021-03-10,0,18,4,22
RAJASTHAN,JAIPUR,2021-03-06,75,1859,342,2276
RAJASTHAN,JAIPUR,2021-03-07,93,1944,278,2315
RAJASTHAN,JAIPUR,2021-03-08,100,2129,406,2635
RAJASTHAN,JAIPUR,2021-03-09,72,3081,313,3466
RAJASTHAN,JAIPUR,2021-03-10,64,3022,380,3466
RAJASTHAN,JAISALMER,2021-03-06,0,180,0,180
RAJASTHAN,JAISALMER,2021-03-07,1,140,0,141
RAJASTHAN,JAISALMER,2021-03-08,0,53,2,55
RAJASTHAN,JAISALMER,2021-03-09,0,170,0,170
RAJASTHAN,JAISALMER,2021-03-10,2,147,0,149
RAJASTHAN,JALORE,2021-03-06,0,358,0,358
RAJASTHAN,JALORE,2021-03-07,0,341,0,341
RAJASTHAN,JALORE,2021-03-08,0,478,0,478
RAJASTHAN,JALORE,2021-03-09,0,426,0,426
RAJASTHAN,JALORE,2021-03-10,0,666,1,667
RAJASTHAN,JHALAWAR,2021-03-06,1,159,0,160
RAJASTHAN,JHALAWAR,2021-03-07,8,118,1,127
RAJASTHAN,JHALAWAR,2021-03-08,0,545,0,545
RAJASTHAN,JHALAWAR,2021-03-09,5,219,1,225
RAJASTHAN,JHALAWAR,2021-03-10,4,45,0,49
RAJASTHAN,JHUNJHUNU,2021-03-06,1,82,0,83
RAJASTHAN,JHUNJHUNU,2021-03-07,0,43,4,47
RAJASTHAN,JHUNJHUNU,2021-03-08,0,58,2,60
RAJASTHAN,JHUNJHUNU,2021-03-09,0,97,4,101
RAJASTHAN,JHUNJHUNU,2021-03-10,0,90,9,99
RAJASTHAN,JODHPUR,2021-03-06,15,587,7,609
RAJASTHAN,JODHPUR,2021-03-07,11,643,1,655
RAJASTHAN,JODHPUR,2021-03-08,11,938,2,951
RAJASTHAN,JODHPUR,2021-03-09,16,836,0,852
RAJASTHAN,JODHPUR,2021-03-10,23,867,12,902
RAJASTHAN,KARAULI,2021-03-06,2,131,5,138
RAJASTHAN,KARAULI,2021-03-07,5,415,6,426
RAJASTHAN,KARAULI,2021-03-08,1,278,3,282
RAJASTHAN,KARAULI,2021-03-09,2,341,7,350
RAJASTHAN,KARAULI,2021-03-10,1,217,2,220
RAJASTHAN,KOTA,2021-03-06,36,1356,5,1397
RAJASTHAN,KOTA,2021-03-07,5,1319,1,1325
RAJASTHAN,KOTA,2021-03-08,40,1112,0,1152
RAJASTHAN,KOTA,2021-03-09,21,801,2,824
RAJASTHAN,KOTA,2021-03-10,32,1417,2,1451
RAJASTHAN,NAGAUR,2021-03-06,0,144,152,296
RAJASTHAN,NAGAUR,2021-03-07,2,57,211,270
RAJASTHAN,NAGAUR,2021-03-08,1,43,108,152
RAJASTHAN,NAGAUR,2021-03-09,1,135,60,196
RAJASTHAN,NAGAUR,2021-03-10,3,229,140,372
RAJASTHAN,PALI,2021-03-06,1,20,0,21
RAJASTHAN,PALI,2021-03-07,0,14,5,19
RAJASTHAN,PALI,2021-03-08,0,23,7,30
RAJASTHAN,PALI,2021-03-09,2,38,2,42
RAJASTHAN,PALI,2021-03-10,1,31,7,39
RAJASTHAN,PRATAPGARH,2021-03-06,6,11,0,17
RAJASTHAN,PRATAPGARH,2021-03-07,1,4,0,5
RAJASTHAN,PRATAPGARH,2021-03-08,5,8,0,13
RAJASTHAN,PRATAPGARH,2021-03-09,0,10,0,10
RAJASTHAN,PRATAPGARH,2021-03-10,3,6,0,9
RAJASTHAN,RAJSAMAND,2021-03-06,10,290,2,302
RAJASTHAN,RAJSAMAND,2021-03-07,6,157,5,168
RAJASTHAN,RAJSAMAND,2021-03-08,6,61,1,68
RAJASTHAN,RAJSAMAND,2021-03-09,0,57,1,58
RAJASTHAN,RAJSAMAND,2021-03-10,16,46,0,62
RAJASTHAN,SAWAI MADHOPUR,2021-03-06,1,59,1,61
RAJASTHAN,SAWAI MADHOPUR,2021-03-07,1,259,8,268
RAJASTHAN,SAWAI MADHOPUR,2021-03-08,1,30,4,35
RAJASTHAN,SAWAI MADHOPUR,2021-03-09,3,210,0,213
RAJASTHAN,SAWAI MADHOPUR,2021-03-10,1,92,3,96
RAJASTHAN,SIKAR,2021-03-06,0,156,3,159
RAJASTHAN,SIKAR,2021-03-07,0,188,7,195
RAJASTHAN,SIKAR,2021-03-08,1,145,12,158
RAJASTHAN,SIKAR,2021-03-09,1,108,3,112
RAJASTHAN,SIKAR,2021-03-10,2,163,8,173
RAJASTHAN,SIROHI,2021-03-06,0,18,0,18
RAJASTHAN,SIROHI,2021-03-07,1,151,0,152
RAJASTHAN,SIROHI,2021-03-08,1,161,0,162
RAJASTHAN,SIROHI,2021-03-09,0,129,0,129
RAJASTHAN,SIROHI,2021-03-10,0,32,0,32
RAJASTHAN,TONK,2021-03-06,0,26,0,26
RAJASTHAN,TONK,2021-03-07,0,19,1,20
RAJASTHAN,TONK,2021-03-08,0,34,13,47
RAJASTHAN,TONK,2021-03-09,1,191,19,211
RAJASTHAN,TONK,2021-03-10,0,184,15,199
RAJASTHAN,UDAIPUR,2021-03-06,53,773,2,828
RAJASTHAN,UDAIPUR,2021-03-07,41,961,2,1004
RAJASTHAN,UDAIPUR,2021-03-08,55,636,0,691
RAJASTHAN,UDAIPUR,2021-03-09,63,968,6,1037
RAJASTHAN,UDAIPUR,2021-03-10,85,1108,2,1195
SIKKIM,EAST DISTRICT,2021-03-06,6,139,0,145
SIKKIM,EAST DISTRICT,2021-03-07,0,4,0,4
SIKKIM,EAST DISTRICT,2021-03-08,2,136,0,138
SIKKIM,EAST DISTRICT,2021-03-09,3,157,2,162
SIKKIM,EAST DISTRICT,2021-03-10,1,97,0,98
SIKKIM,NORTH DISTRICT,2021-03-06,0,2,0,2
SIKKIM,NORTH DISTRICT,2021-03-08,0,2,0,2
SIKKIM,NORTH DISTRICT,2021-03-09,0,2,0,2
SIKKIM,NORTH DISTRICT,2021-03-10,0,2,0,2
SIKKIM,SOUTH DISTRICT,2021-03-06,0,13,0,13
SIKKIM,SOUTH DISTRICT,2021-03-08,0,2,0,2
SIKKIM,SOUTH DISTRICT,2021-03-09,0,32,0,32
SIKKIM,SOUTH DISTRICT,2021-03-10,0,8,0,8
SIKKIM,WEST DISTRICT,2021-03-06,1,7,0,8
SIKKIM,WEST DISTRICT,2021-03-07,0,2,0,2
SIKKIM,WEST DISTRICT,2021-03-08,0,2,0,2
SIKKIM,WEST DISTRICT,2021-03-09,0,5,0,5
SIKKIM,WEST DISTRICT,2021-03-10,0,4,0,4
TAMIL NADU,ARIYALUR,2021-03-06,0,140,0,140
TAMIL NADU,ARIYALUR,2021-03-07,1,626,0,627
TAMIL NADU,ARIYALUR,2021-03-08,1,50,0,51
TAMIL NADU,ARIYALUR,2021-03-09,1,712,1,714
TAMIL NADU,ARIYALUR,2021-03-10,2,530,0,532
TAMIL NADU,CHENGALPATTU,2021-03-06,51,1968,0,2019
TAMIL NADU,CHENGALPATTU,2021-03-07,33,2581,0,2614
TAMIL NADU,CHENGALPATTU,2021-03-08,40,2399,0,2439
TAMIL NADU,CHENGALPATTU,2021-03-09,51,2487,0,2538
TAMIL NADU,CHENGALPATTU,2021-03-10,83,3086,1,3170
TAMIL NADU,CHENNAI,2021-03-06,305,10504,7,10816
TAMIL NADU,CHENNAI,2021-03-07,264,10617,9,10890
TAMIL NADU,CHENNAI,2021-03-08,308,10034,27,10369
TAMIL NADU,CHENNAI,2021-03-09,403,12007,11,12421
TAMIL NADU,CHENNAI,2021-03-10,468,11776,26,12270
TAMIL NADU,COIMBATORE,2021-03-06,57,1727,9,1793
TAMIL NADU,COIMBATORE,2021-03-07,58,1063,0,1121
TAMIL NADU,COIMBATORE,2021-03-08,69,1629,0,1698
TAMIL NADU,COIMBATORE,2021-03-09,83,1908,1,1992
TAMIL NADU,COIMBATORE,2021-03-10,76,2320,1,2397
TAMIL NADU,CUDDALORE,2021-03-06,9,1446,1,1456
TAMIL NADU,CUDDALORE,2021-03-07,5,427,1,433
TAMIL NADU,CUDDALORE,2021-03-08,5,1657,2,1664
TAMIL NADU,CUDDALORE,2021-03-09,18,3869,1,3888
TAMIL NADU,CUDDALORE,2021-03-10,1,3856,0,3857
TAMIL NADU,DHARMAPURI,2021-03-06,4,577,0,581
TAMIL NADU,DHARMAPURI,2021-03-07,3,544,0,547
TAMIL NADU,DHARMAPURI,2021-03-08,0,483,0,483
TAMIL NADU,DHARMAPURI,2021-03-09,0,741,0,741
TAMIL NADU,DHARMAPURI,2021-03-10,5,612,0,617
TAMIL NADU,DINDIGUL,2021-03-06,9,264,0,273
TAMIL NADU,DINDIGUL,2021-03-07,5,102,0,107
TAMIL NADU,DINDIGUL,2021-03-08,8,128,1,137
TAMIL NADU,DINDIGUL,2021-03-09,10,316,3,329
TAMIL NADU,DINDIGUL,2021-03-10,11,1139,0,1150
TAMIL NADU,ERODE,2021-03-06,16,1017,0,1033
TAMIL NADU,ERODE,2021-03-07,13,1401,0,1414
TAMIL NADU,ERODE,2021-03-08,5,681,0,686
TAMIL NADU,ERODE,2021-03-09,14,1186,0,1200
TAMIL NADU,ERODE,2021-03-10,19,1273,0,1292
TAMIL NADU,KALLAKURICHI,2021-03-06,0,539,0,539
TAMIL NADU,KALLAKURICHI,2021-03-07,0,378,0,378
TAMIL NADU,KALLAKURICHI,2021-03-08,0,99,1,100
TAMIL NADU,KALLAKURICHI,2021-03-09,0,440,0,440
TAMIL NADU,KALLAKURICHI,2021-03-10,2,216,0,218
TAMIL NADU,KANCHIPURAM,2021-03-06,12,2341,1,2354
TAMIL NADU,KANCHIPURAM,2021-03-07,6,2456,2,2464
TAMIL NADU,KANCHIPURAM,2021-03-08,37,1932,3,1972
TAMIL NADU,KANCHIPURAM,2021-03-09,33,2494,3,2530
TAMIL NADU,KANCHIPURAM,2021-03-10,26,1737,0,1763
TAMIL NADU,KANNIYAKUMARI,2021-03-06,21,1155,23,1199
TAMIL NADU,KANNIYAKUMARI,2021-03-07,13,1500,7,1520
TAMIL NADU,KANNIYAKUMARI,2021-03-08,7,932,3,942
TAMIL NADU,KANNIYAKUMARI,2021-03-09,10,1963,12,1985
TAMIL NADU,KANNIYAKUMARI,2021-03-10,11,1408,4,1423
TAMIL NADU,KARUR,2021-03-06,2,833,0,835
TAMIL NADU,KARUR,2021-03-07,2,868,0,870
TAMIL NADU,KARUR,2021-03-08,1,676,0,677
TAMIL NADU,KARUR,2021-03-09,3,1142,0,1145
TAMIL NADU,KARUR,2021-03-10,4,753,0,757
TAMIL NADU,KRISHNAGIRI,2021-03-06,3,1072,2,1077
TAMIL NADU,KRISHNAGIRI,2021-03-07,7,698,1,706
TAMIL NADU,KRISHNAGIRI,2021-03-08,4,829,0,833
TAMIL NADU,KRISHNAGIRI,2021-03-09,5,1349,2,1356
TAMIL NADU,KRISHNAGIRI,2021-03-10,1,1249,0,1250
TAMIL NADU,MADURAI,2021-03-06,12,2787,0,2799
TAMIL NADU,MADURAI,2021-03-07,7,2809,2,2818
TAMIL NADU,MADURAI,2021-03-08,2,2158,0,2160
TAMIL NADU,MADURAI,2021-03-09,10,2426,2,2438
TAMIL NADU,MADURAI,2021-03-10,17,2192,1,2210
TAMIL NADU,NAGAPATTINAM,2021-03-06,5,457,0,462
TAMIL NADU,NAGAPATTINAM,2021-03-07,4,376,0,380
TAMIL NADU,NAGAPATTINAM,2021-03-08,10,260,1,271
TAMIL NADU,NAGAPATTINAM,2021-03-09,11,542,4,557
TAMIL NADU,NAGAPATTINAM,2021-03-10,12,534,0,546
TAMIL NADU,NAMAKKAL,2021-03-06,8,975,0,983
TAMIL NADU,NAMAKKAL,2021-03-07,10,356,0,366
TAMIL NADU,NAMAKKAL,2021-03-08,11,839,0,850
TAMIL NADU,NAMAKKAL,2021-03-09,15,1447,0,1462
TAMIL NADU,NAMAKKAL,2021-03-10,15,1095,0,1110
TAMIL NADU,PERAMBALUR,2021-03-06,0,273,0,273
TAMIL NADU,PERAMBALUR,2021-03-07,1,233,0,234
TAMIL NADU,PERAMBALUR,2021-03-08,0,167,0,167
TAMIL NADU,PERAMBALUR,2021-03-09,2,241,0,243
TAMIL NADU,PERAMBALUR,2021-03-10,0,310,0,310
TAMIL NADU,PUDUKKOTTAI,2021-03-06,4,454,0,458
TAMIL NADU,PUDUKKOTTAI,2021-03-07,1,483,0,484
TAMIL NADU,PUDUKKOTTAI,2021-03-08,2,142,0,144
TAMIL NADU,PUDUKKOTTAI,2021-03-09,3,367,0,370
TAMIL NADU,PUDUKKOTTAI,2021-03-10,4,405,0,409
TAMIL NADU,RAMANATHAPURAM,2021-03-06,2,769,0,771
TAMIL NADU,RAMANATHAPURAM,2021-03-07,1,771,0,772
TAMIL NADU,RAMANATHAPURAM,2021-03-08,1,674,0,675
TAMIL NADU,RAMANATHAPURAM,2021-03-09,1,871,0,872
TAMIL NADU,RAMANATHAPURAM,2021-03-10,2,434,0,436
TAMIL NADU,RANIPET,2021-03-06,1,387,0,388
TAMIL NADU,RANIPET,2021-03-07,1,33,0,34
TAMIL NADU,RANIPET,2021-03-08,1,230,0,231
TAMIL NADU,RANIPET,2021-03-09,3,192,0,195
TAMIL NADU,RANIPET,2021-03-10,2,397,0,399
TAMIL NADU,SALEM,2021-03-06,115,557,0,672
TAMIL NADU,SALEM,2021-03-07,8,1375,21,1404
TAMIL NADU,SALEM,2021-03-08,17,6793,17,6827
TAMIL NADU,SALEM,2021-03-09,17,5269,2,5288
TAMIL NADU,SALEM,2021-03-10,15,5787,7,5809
TAMIL NADU,SIVAGANGA,2021-03-06,3,619,0,622
TAMIL NADU,SIVAGANGA,2021-03-07,1,298,1,300
TAMIL NADU,SIVAGANGA,2021-03-08,4,219,0,223
TAMIL NADU,SIVAGANGA,2021-03-09,5,706,1,712
TAMIL NADU,SIVAGANGA,2021-03-10,4,507,0,511
TAMIL NADU,TENKASI,2021-03-06,4,437,2,443
TAMIL NADU,TENKASI,2021-03-07,2,490,0,492
TAMIL NADU,TENKASI,2021-03-08,2,298,6,306
TAMIL NADU,TENKASI,2021-03-09,2,494,22,518
TAMIL NADU,TENKASI,2021-03-10,4,481,4,489
TAMIL NADU,THANJAVUR,2021-03-06,21,359,0,380
TAMIL NADU,THANJAVUR,2021-03-07,17,231,13,261
TAMIL NADU,THANJAVUR,2021-03-08,27,343,21,391
TAMIL NADU,THANJAVUR,2021-03-09,14,2006,24,2044
TAMIL NADU,THANJAVUR,2021-03-10,37,6443,1,6481
TAMIL NADU,THE NILGIRIS,2021-03-06,10,1015,3,1028
TAMIL NADU,THE NILGIRIS,2021-03-07,5,945,34,984
TAMIL NADU,THE NILGIRIS,2021-03-08,6,897,87,990
TAMIL NADU,THE NILGIRIS,2021-03-09,9,1001,1,1011
TAMIL NADU,THE NILGIRIS,2021-03-10,4,1017,0,1021
TAMIL NADU,THENI,2021-03-06,1,396,0,397
TAMIL NADU,THENI,2021-03-07,3,196,1,200
TAMIL NADU,THENI,2021-03-08,7,472,0,479
TAMIL NADU,THENI,2021-03-09,1,603,0,604
TAMIL NADU,THENI,2021-03-10,3,352,0,355
TAMIL NADU,THIRUVALLUR,2021-03-06,34,2332,3,2369
TAMIL NADU,THIRUVALLUR,2021-03-07,21,1606,0,1627
TAMIL NADU,THIRUVALLUR,2021-03-08,30,1685,4,1719
TAMIL NADU,THIRUVALLUR,2021-03-09,59,2061,5,2125
TAMIL NADU,THIRUVALLUR,2021-03-10,68,1284,4,1356
TAMIL NADU,THIRUVARUR,2021-03-06,5,499,0,504
TAMIL NADU,THIRUVARUR,2021-03-07,17,295,2,314
TAMIL NADU,THIRUVARUR,2021-03-08,7,1232,6,1245
TAMIL NADU,THIRUVARUR,2021-03-09,24,1995,8,2027
TAMIL NADU,THIRUVARUR,2021-03-10,6,2406,2,2414
TAMIL NADU,TIRUCHIRAPPALLI,2021-03-06,9,1301,1,1311
TAMIL NADU,TIRUCHIRAPPALLI,2021-03-07,13,1111,0,1124
TAMIL NADU,TIRUCHIRAPPALLI,2021-03-08,18,987,1,1006
TAMIL NADU,TIRUCHIRAPPALLI,2021-03-09,14,1384,0,1398
TAMIL NADU,TIRUCHIRAPPALLI,2021-03-10,16,1369,0,1385
TAMIL NADU,TIRUNELVELI,2021-03-06,10,734,1,745
TAMIL NADU,TIRUNELVELI,2021-03-07,9,336,15,360
TAMIL NADU,TIRUNELVELI,2021-03-08,5,945,2,952
TAMIL NADU,TIRUNELVELI,2021-03-09,3,824,20,847
TAMIL NADU,TIRUNELVELI,2021-03-10,9,872,0,881
TAMIL NADU,TIRUPATHUR,2021-03-06,3,2829,3,2835
TAMIL NADU,TIRUPATHUR,2021-03-07,0,1433,2,1435
TAMIL NADU,TIRUPATHUR,2021-03-08,1,839,2,842
TAMIL NADU,TIRUPATHUR,2021-03-09,3,2154,0,2157
TAMIL NADU,TIRUPATHUR,2021-03-10,6,1295,0,1301
TAMIL NADU,TIRUPPUR,2021-03-06,15,1696,0,1711
TAMIL NADU,TIRUPPUR,2021-03-07,16,1127,0,1143
TAMIL NADU,TIRUPPUR,2021-03-08,19,855,0,874
TAMIL NADU,TIRUPPUR,2021-03-09,30,1496,3,1529
TAMIL NADU,TIRUPPUR,2021-03-10,27,1335,2,1364
TAMIL NADU,TIRUVANNAMALAI,2021-03-06,3,336,0,339
TAMIL NADU,TIRUVANNAMALAI,2021-03-07,1,663,0,664
TAMIL NADU,TIRUVANNAMALAI,2021-03-08,0,525,1,526
TAMIL NADU,TIRUVANNAMALAI,2021-03-09,7,803,0,810
TAMIL NADU,TIRUVANNAMALAI,2021-03-10,5,812,1,818
TAMIL NADU,TUTICORIN,2021-03-06,9,629,2,640
TAMIL NADU,TUTICORIN,2021-03-07,5,546,14,565
TAMIL NADU,TUTICORIN,2021-03-08,3,386,1,390
TAMIL NADU,TUTICORIN,2021-03-09,1,642,25,668
TAMIL NADU,TUTICORIN,2021-03-10,3,576,1,580
TAMIL NADU,VELLORE,2021-03-06,10,837,0,847
TAMIL NADU,VELLORE,2021-03-07,2,895,0,897
TAMIL NADU,VELLORE,2021-03-08,14,1047,0,1061
TAMIL NADU,VELLORE,2021-03-09,16,2118,1,2135
TAMIL NADU,VELLORE,2021-03-10,15,1268,0,1283
TAMIL NADU,VILLUPURAM,2021-03-06,5,803,1,809
TAMIL NADU,VILLUPURAM,2021-03-07,2,573,0,575
TAMIL NADU,VILLUPURAM,2021-03-08,3,594,1,598
TAMIL NADU,VILLUPURAM,2021-03-09,6,680,1,687
TAMIL NADU,VILLUPURAM,2021-03-10,2,781,0,783
TAMIL NADU,VIRUDHUNAGAR,2021-03-06,5,192,0,197
TAMIL NADU,VIRUDHUNAGAR,2021-03-07,3,1186,2,1191
TAMIL NADU,VIRUDHUNAGAR,2021-03-08,5,2138,7,2150
TAMIL NADU,VIRUDHUNAGAR,2021-03-09,5,1940,21,1966
TAMIL NADU,VIRUDHUNAGAR,2021-03-10,4,965,0,969
TELANGANA,ADILABAD,2021-03-06,0,7,0,7
TELANGANA,ADILABAD,2021-03-07,1,1,0,2
TELANGANA,ADILABAD,2021-03-08,0,1140,0,1140
TELANGANA,ADILABAD,2021-03-09,1,669,0,670
TELANGANA,ADILABAD,2021-03-10,2,915,0,917
TELANGANA,BHADRADRI KOTHAGUDEM,2021-03-06,0,1,0,1
TELANGANA,BHADRADRI KOTHAGUDEM,2021-03-07,1,1,0,2
TELANGANA,BHADRADRI KOTHAGUDEM,2021-03-08,0,1141,0,1141
TELANGANA,BHADRADRI KOTHAGUDEM,2021-03-09,0,384,0,384
TELANGANA,BHADRADRI KOTHAGUDEM,2021-03-10,0,389,0,389
TELANGANA,HYDERABAD,2021-03-06,22,377,3,402
TELANGANA,HYDERABAD,2021-03-07,18,235,2,255
TELANGANA,HYDERABAD,2021-03-08,37,16352,12,16401
TELANGANA,HYDERABAD,2021-03-09,25,6887,8,6920
TELANGANA,HYDERABAD,2021-03-10,32,7030,7,7069
TELANGANA,JAGITIAL,2021-03-06,0,5,0,5
TELANGANA,JAGITIAL,2021-03-07,0,2,0,2
TELANGANA,JAGITIAL,2021-03-08,0,1679,0,1679
TELANGANA,JAGITIAL,2021-03-09,0,598,0,598
TELANGANA,JAGITIAL,2021-03-10,0,769,0,769
TELANGANA,JANGOAN,2021-03-08,0,1450,0,1450
TELANGANA,JANGOAN,2021-03-09,0,641,0,641
TELANGANA,JANGOAN,2021-03-10,0,798,0,798
TELANGANA,JAYASHANKAR BHUPALAPALLY,2021-03-08,0,579,0,579
TELANGANA,JAYASHANKAR BHUPALAPALLY,2021-03-09,0,169,0,169
TELANGANA,JAYASHANKAR BHUPALAPALLY,2021-03-10,0,147,0,147
TELANGANA,JOGULAMBA GADWAL,2021-03-08,0,1399,0,1399
TELANGANA,JOGULAMBA GADWAL,2021-03-09,0,432,0,432
TELANGANA,JOGULAMBA GADWAL,2021-03-10,0,424,0,424
TELANGANA,KAMAREDDY,2021-03-06,0,2,0,2
TELANGANA,KAMAREDDY,2021-03-07,0,2,0,2
TELANGANA,KAMAREDDY,2021-03-08,0,1044,0,1044
TELANGANA,KAMAREDDY,2021-03-09,0,461,0,461
TELANGANA,KAMAREDDY,2021-03-10,0,1642,0,1642
TELANGANA,KARIMNAGAR,2021-03-06,0,10,0,10
TELANGANA,KARIMNAGAR,2021-03-07,1,9,0,10
TELANGANA,KARIMNAGAR,2021-03-08,0,3132,0,3132
TELANGANA,KARIMNAGAR,2021-03-09,0,1242,0,1242
TELANGANA,KARIMNAGAR,2021-03-10,1,1148,0,1149
TELANGANA,KHAMMAM,2021-03-06,0,22,0,22
TELANGANA,KHAMMAM,2021-03-07,0,9,0,9
TELANGANA,KHAMMAM,2021-03-08,0,1283,0,1283
TELANGANA,KHAMMAM,2021-03-09,0,648,0,648
TELANGANA,KHAMMAM,2021-03-10,0,886,0,886
TELANGANA,KUMURAM BHEEM ASIFABAD,2021-03-08,0,1056,0,1056
TELANGANA,KUMURAM BHEEM ASIFABAD,2021-03-09,0,218,0,218
TELANGANA,KUMURAM BHEEM ASIFABAD,2021-03-10,0,176,0,176
TELANGANA,MAHABUBABAD,2021-03-08,0,994,0,994
TELANGANA,MAHABUBABAD,2021-03-09,0,454,0,454
TELANGANA,MAHABUBABAD,2021-03-10,0,346,0,346
TELANGANA,MAHABUBNAGAR,2021-03-06,0,2,0,2
TELANGANA,MAHABUBNAGAR,2021-03-07,0,4,0,4
TELANGANA,MAHABUBNAGAR,2021-03-08,0,1419,0,1419
TELANGANA,MAHABUBNAGAR,2021-03-09,0,1483,0,1483
TELANGANA,MAHABUBNAGAR,2021-03-10,0,924,0,924
TELANGANA,MANCHERIAL,2021-03-08,0,2674,0,2674
TELANGANA,MANCHERIAL,2021-03-09,0,721,0,721
TELANGANA,MANCHERIAL,2021-03-10,0,635,0,635
TELANGANA,MEDAK,2021-03-06,0,4,0,4
TELANGANA,MEDAK,2021-03-07,0,7,0,7
TELANGANA,MEDAK,2021-03-08,2,766,0,768
TELANGANA,MEDAK,2021-03-09,1,270,0,271
TELANGANA,MEDAK,2021-03-10,0,227,0,227
TELANGANA,MEDCHAL MALKAJGIRI,2021-03-06,0,19,1,20
TELANGANA,MEDCHAL MALKAJGIRI,2021-03-07,2,8,0,10
TELANGANA,MEDCHAL MALKAJGIRI,2021-03-08,0,4269,1,4270
TELANGANA,MEDCHAL MALKAJGIRI,2021-03-09,2,2255,0,2257
TELANGANA,MEDCHAL MALKAJGIRI,2021-03-10,2,1832,2,1836
TELANGANA,MULUGU,2021-03-08,0,369,0,369
TELANGANA,MULUGU,2021-03-09,0,121,0,121
TELANGANA,MULUGU,2021-03-10,0,42,0,42
TELANGANA,NAGARKURNOOL,2021-03-08,0,3935,0,3935
TELANGANA,NAGARKURNOOL,2021-03-09,0,1669,0,1669
TELANGANA,NAGARKURNOOL,2021-03-10,0,1626,0,1626
TELANGANA,NALGONDA,2021-03-06,0,7,0,7
TELANGANA,NALGONDA,2021-03-07,0,3,0,3
TELANGANA,NALGONDA,2021-03-08,0,2031,0,2031
TELANGANA,NALGONDA,2021-03-09,0,1083,0,1083
TELANGANA,NALGONDA,2021-03-10,0,1043,0,1043
TELANGANA,NARAYANPET,2021-03-08,0,805,0,805
TELANGANA,NARAYANPET,2021-03-09,0,270,0,270
TELANGANA,NARAYANPET,2021-03-10,0,78,0,78
TELANGANA,NIRMAL,2021-03-07,1,1,0,2
TELANGANA,NIRMAL,2021-03-08,0,2781,0,2781
TELANGANA,NIRMAL,2021-03-09,0,362,0,362
TELANGANA,NIRMAL,2021-03-10,0,452,0,452
TELANGANA,NIZAMABAD,2021-03-06,0,26,0,26
TELANGANA,NIZAMABAD,2021-03-07,0,2,0,2
TELANGANA,NIZAMABAD,2021-03-08,0,2420,0,2420
TELANGANA,NIZAMABAD,2021-03-09,0,1261,0,1261
TELANGANA,NIZAMABAD,2021-03-10,0,546,0,546
TELANGANA,PEDDAPALLI,2021-03-06,0,6,0,6
TELANGANA,PEDDAPALLI,2021-03-08,0,2711,0,2711
TELANGANA,PEDDAPALLI,2021-03-09,0,942,0,942
TELANGANA,PEDDAPALLI,2021-03-10,0,900,0,900
TELANGANA,RAJANNA SIRCILLA,2021-03-07,0,3,0,3
TELANGANA,RAJANNA SIRCILLA,2021-03-08,0,885,0,885
TELANGANA,RAJANNA SIRCILLA,2021-03-09,0,286,0,286
TELANGANA,RAJANNA SIRCILLA,2021-03-10,0,156,0,156
TELANGANA,RANGA REDDY,2021-03-06,3,101,2,106
TELANGANA,RANGA REDDY,2021-03-07,5,35,0,40
TELANGANA,RANGA REDDY,2021-03-08,10,5305,1,5316
TELANGANA,RANGA REDDY,2021-03-09,10,2416,3,2429
TELANGANA,RANGA REDDY,2021-03-10,5,2328,3,2336
TELANGANA,SANGAREDDY,2021-03-06,0,35,0,35
TELANGANA,SANGAREDDY,2021-03-07,0,10,0,10
TELANGANA,SANGAREDDY,2021-03-08,1,1763,0,1764
TELANGANA,SANGAREDDY,2021-03-09,0,657,0,657
TELANGANA,SANGAREDDY,2021-03-10,0,589,0,589
TELANGANA,SIDDIPET,2021-03-08,0,3017,0,3017
TELANGANA,SIDDIPET,2021-03-09,0,1173,0,1173
TELANGANA,SIDDIPET,2021-03-10,0,939,0,939
TELANGANA,SURYAPET,2021-03-06,0,5,0,5
TELANGANA,SURYAPET,2021-03-07,0,6,0,6
TELANGANA,SURYAPET,2021-03-08,0,2080,0,2080
TELANGANA,SURYAPET,2021-03-09,0,692,0,692
TELANGANA,SURYAPET,2021-03-10,1,796,0,797
TELANGANA,VIKARABAD,2021-03-06,2,4,0,6
TELANGANA,VIKARABAD,2021-03-08,0,1187,0,1187
TELANGANA,VIKARABAD,2021-03-09,0,712,0,712
TELANGANA,VIKARABAD,2021-03-10,3,499,0,502
TELANGANA,WANAPARTHY,2021-03-08,0,1232,0,1232
TELANGANA,WANAPARTHY,2021-03-09,0,299,0,299
TELANGANA,WANAPARTHY,2021-03-10,0,329,0,329
TELANGANA,WARANGAL RURAL,2021-03-06,0,4,0,4
TELANGANA,WARANGAL RURAL,2021-03-07,1,16,0,17
TELANGANA,WARANGAL RURAL,2021-03-08,2,960,0,962
TELANGANA,WARANGAL RURAL,2021-03-09,1,445,0,446
TELANGANA,WARANGAL RURAL,2021-03-10,1,258,0,259
TELANGANA,WARANGAL URBAN,2021-03-06,0,18,0,18
TELANGANA,WARANGAL URBAN,2021-03-07,0,1,0,1
TELANGANA,WARANGAL URBAN,2021-03-08,1,4027,0,4028
TELANGANA,WARANGAL URBAN,2021-03-09,0,1395,0,1395
TELANGANA,WARANGAL URBAN,2021-03-10,0,1309,0,1309
TELANGANA,YADADRI BHUVANAGIRI,2021-03-06,0,3,0,3
TELANGANA,YADADRI BHUVANAGIRI,2021-03-07,0,1,0,1
TELANGANA,YADADRI BHUVANAGIRI,2021-03-08,0,683,0,683
TELANGANA,YADADRI BHUVANAGIRI,2021-03-09,0,305,0,305
TELANGANA,YADADRI BHUVANAGIRI,2021-03-10,0,241,0,241
TRIPURA,DHALAI,2021-03-06,0,29,0,29
TRIPURA,DHALAI,2021-03-07,0,6,0,6
TRIPURA,DHALAI,2021-03-08,0,18,0,18
TRIPURA,DHALAI,2021-03-09,0,35,0,35
TRIPURA,DHALAI,2021-03-10,0,24,0,24
TRIPURA,GOMATI,2021-03-06,0,39,0,39
TRIPURA,GOMATI,2021-03-07,0,8,0,8
TRIPURA,GOMATI,2021-03-08,0,43,0,43
TRIPURA,GOMATI,2021-03-09,0,49,0,49
TRIPURA,GOMATI,2021-03-10,0,39,0,39
TRIPURA,KHOWAI,2021-03-06,0,30,0,30
TRIPURA,KHOWAI,2021-03-07,0,14,0,14
TRIPURA,KHOWAI,2021-03-08,0,24,0,24
TRIPURA,KHOWAI,2021-03-09,0,10,0,10
TRIPURA,KHOWAI,2021-03-10,0,9,0,9
TRIPURA,NORTH TRIPURA,2021-03-06,0,74,0,74
TRIPURA,NORTH TRIPURA,2021-03-07,0,79,0,79
TRIPURA,NORTH TRIPURA,2021-03-08,0,123,0,123
TRIPURA,NORTH TRIPURA,2021-03-09,0,49,0,49
TRIPURA,NORTH TRIPURA,2021-03-10,0,88,0,88
TRIPURA,SEPAHIJALA,2021-03-06,0,33,0,33
TRIPURA,SEPAHIJALA,2021-03-07,0,7,0,7
TRIPURA,SEPAHIJALA,2021-03-08,0,77,0,77
TRIPURA,SEPAHIJALA,2021-03-09,0,56,0,56
TRIPURA,SEPAHIJALA,2021-03-10,0,95,0,95
TRIPURA,SOUTH TRIPURA,2021-03-06,0,70,0,70
TRIPURA,SOUTH TRIPURA,2021-03-07,0,3,0,3
TRIPURA,SOUTH TRIPURA,2021-03-08,0,59,0,59
TRIPURA,SOUTH TRIPURA,2021-03-09,0,75,0,75
TRIPURA,SOUTH TRIPURA,2021-03-10,0,27,0,27
TRIPURA,UNAKOTI,2021-03-06,0,1,0,1
TRIPURA,UNAKOTI,2021-03-08,0,7,0,7
TRIPURA,UNAKOTI,2021-03-09,0,11,0,11
TRIPURA,UNAKOTI,2021-03-10,0,7,0,7
TRIPURA,WEST TRIPURA,2021-03-06,0,277,0,277
TRIPURA,WEST TRIPURA,2021-03-07,0,52,0,52
TRIPURA,WEST TRIPURA,2021-03-08,2,420,0,422
TRIPURA,WEST TRIPURA,2021-03-09,1,243,0,244
TRIPURA,WEST TRIPURA,2021-03-10,1,205,0,206
UTTAR PRADESH,AGRA,2021-03-06,7,1183,1,1191
UTTAR PRADESH,AGRA,2021-03-07,3,1212,1,1216
UTTAR PRADESH,AGRA,2021-03-08,1,1711,18,1730
UTTAR PRADESH,AGRA,2021-03-09,4,2106,6,2116
UTTAR PRADESH,AGRA,2021-03-10,9,1038,1,1048
UTTAR PRADESH,ALIGARH,2021-03-06,6,2310,3,2319
UTTAR PRADESH,ALIGARH,2021-03-07,2,2162,1,2165
UTTAR PRADESH,ALIGARH,2021-03-08,4,2252,0,2256
UTTAR PRADESH,ALIGARH,2021-03-09,3,2424,9,2436
UTTAR PRADESH,ALIGARH,2021-03-10,3,1530,5,1538
UTTAR PRADESH,AMBEDKAR NAGAR,2021-03-06,0,909,0,909
UTTAR PRADESH,AMBEDKAR NAGAR,2021-03-07,0,817,15,832
UTTAR PRADESH,AMBEDKAR NAGAR,2021-03-08,0,1514,0,1514
UTTAR PRADESH,AMBEDKAR NAGAR,2021-03-09,0,1074,50,1124
UTTAR PRADESH,AMBEDKAR NAGAR,2021-03-10,0,2373,29,2402
UTTAR PRADESH,AMETHI,2021-03-06,5,1131,1,1137
UTTAR PRADESH,AMETHI,2021-03-07,1,278,0,279
UTTAR PRADESH,AMETHI,2021-03-08,0,1600,1,1601
UTTAR PRADESH,AMETHI,2021-03-09,1,350,1,352
UTTAR PRADESH,AMETHI,2021-03-10,0,571,51,622
UTTAR PRADESH,AMROHA,2021-03-06,1,1718,1,1720
UTTAR PRADESH,AMROHA,2021-03-07,3,792,0,795
UTTAR PRADESH,AMROHA,2021-03-08,0,888,0,888
UTTAR PRADESH,AMROHA,2021-03-09,0,373,0,373
UTTAR PRADESH,AMROHA,2021-03-10,0,952,0,952
UTTAR PRADESH,AURAIYA,2021-03-06,0,898,56,954
UTTAR PRADESH,AURAIYA,2021-03-07,0,602,68,670
UTTAR PRADESH,AURAIYA,2021-03-08,0,499,64,563
UTTAR PRADESH,AURAIYA,2021-03-09,0,784,46,830
UTTAR PRADESH,AURAIYA,2021-03-10,0,483,46,529
UTTAR PRADESH,AYODHYA,2021-03-06,1,1263,0,1264
UTTAR PRADESH,AYODHYA,2021-03-07,0,1080,0,1080
UTTAR PRADESH,AYODHYA,2021-03-08,1,1240,0,1241
UTTAR PRADESH,AYODHYA,2021-03-09,1,1390,1,1392
UTTAR PRADESH,AYODHYA,2021-03-10,2,1508,1,1511
UTTAR PRADESH,AZAMGARH,2021-03-06,0,650,1,651
UTTAR PRADESH,AZAMGARH,2021-03-07,0,761,1,762
UTTAR PRADESH,AZAMGARH,2021-03-08,0,427,0,427
UTTAR PRADESH,AZAMGARH,2021-03-09,0,909,1,910
UTTAR PRADESH,AZAMGARH,2021-03-10,2,549,7,558
UTTAR PRADESH,BAGHPAT,2021-03-06,1,1202,34,1237
UTTAR PRADESH,BAGHPAT,2021-03-07,0,1241,3,1244
UTTAR PRADESH,BAGHPAT,2021-03-08,0,1075,15,1090
UTTAR PRADESH,BAGHPAT,2021-03-09,1,379,32,412
UTTAR PRADESH,BAGHPAT,2021-03-10,3,1532,42,1577
UTTAR PRADESH,BAHRAICH,2021-03-06,0,1469,22,1491
UTTAR PRADESH,BAHRAICH,2021-03-07,1,1265,10,1276
UTTAR PRADESH,BAHRAICH,2021-03-08,0,1146,16,1162
UTTAR PRADESH,BAHRAICH,2021-03-09,0,1782,26,1808
UTTAR PRADESH,BAHRAICH,2021-03-10,1,1574,38,1613
UTTAR PRADESH,BALLIA,2021-03-06,1,2034,2,2037
UTTAR PRADESH,BALLIA,2021-03-07,1,656,134,791
UTTAR PRADESH,BALLIA,2021-03-08,3,1627,60,1690
UTTAR PRADESH,BALLIA,2021-03-09,1,1260,1,1262
UTTAR PRADESH,BALLIA,2021-03-10,1,2279,14,2294
UTTAR PRADESH,BALRAMPUR,2021-03-06,3,602,0,605
UTTAR PRADESH,BALRAMPUR,2021-03-07,0,697,0,697
UTTAR PRADESH,BALRAMPUR,2021-03-08,1,628,0,629
UTTAR PRADESH,BALRAMPUR,2021-03-09,0,854,0,854
UTTAR PRADESH,BALRAMPUR,2021-03-10,1,1068,20,1089
UTTAR PRADESH,BANDA,2021-03-06,1,1775,45,1821
UTTAR PRADESH,BANDA,2021-03-07,3,1473,26,1502
UTTAR PRADESH,BANDA,2021-03-08,0,1808,35,1843
UTTAR PRADESH,BANDA,2021-03-09,3,1668,16,1687
UTTAR PRADESH,BANDA,2021-03-10,1,1776,43,1820
UTTAR PRADESH,BARABANKI,2021-03-06,0,1083,31,1114
UTTAR PRADESH,BARABANKI,2021-03-07,0,774,0,774
UTTAR PRADESH,BARABANKI,2021-03-08,1,1492,4,1497
UTTAR PRADESH,BARABANKI,2021-03-09,9,1486,1,1496
UTTAR PRADESH,BARABANKI,2021-03-10,1,1214,0,1215
UTTAR PRADESH,BAREILLY,2021-03-06,8,3057,1,3066
UTTAR PRADESH,BAREILLY,2021-03-07,8,1590,1,1599
UTTAR PRADESH,BAREILLY,2021-03-08,10,1221,1,1232
UTTAR PRADESH,BAREILLY,2021-03-09,6,1643,2,1651
UTTAR PRADESH,BAREILLY,2021-03-10,8,2577,1,2586
UTTAR PRADESH,BASTI,2021-03-06,1,902,83,986
UTTAR PRADESH,BASTI,2021-03-07,54,752,27,833
UTTAR PRADESH,BASTI,2021-03-08,0,614,1,615
UTTAR PRADESH,BASTI,2021-03-09,0,826,138,964
UTTAR PRADESH,BASTI,2021-03-10,0,854,26,880
UTTAR PRADESH,BHADOHI,2021-03-06,0,219,0,219
UTTAR PRADESH,BHADOHI,2021-03-07,0,9,0,9
UTTAR PRADESH,BHADOHI,2021-03-08,0,665,1,666
UTTAR PRADESH,BHADOHI,2021-03-09,0,683,0,683
UTTAR PRADESH,BHADOHI,2021-03-10,0,667,1,668
UTTAR PRADESH,BIJNOR,2021-03-06,0,1462,59,1521
UTTAR PRADESH,BIJNOR,2021-03-07,0,1947,8,1955
UTTAR PRADESH,BIJNOR,2021-03-08,1,1834,1,1836
UTTAR PRADESH,BIJNOR,2021-03-09,2,2076,1,2079
UTTAR PRADESH,BIJNOR,2021-03-10,1,1266,0,1267
UTTAR PRADESH,BUDAUN,2021-03-06,0,493,36,529
UTTAR PRADESH,BUDAUN,2021-03-07,0,531,12,543
UTTAR PRADESH,BUDAUN,2021-03-08,1,420,62,483
UTTAR PRADESH,BUDAUN,2021-03-09,1,500,12,513
UTTAR PRADESH,BUDAUN,2021-03-10,0,426,127,553
UTTAR PRADESH,BULANDSHAHR,2021-03-06,0,2231,72,2303
UTTAR PRADESH,BULANDSHAHR,2021-03-07,0,457,3,460
UTTAR PRADESH,BULANDSHAHR,2021-03-08,0,3074,0,3074
UTTAR PRADESH,BULANDSHAHR,2021-03-09,2,1698,16,1716
UTTAR PRADESH,BULANDSHAHR,2021-03-10,2,1862,0,1864
UTTAR PRADESH,CHANDAULI,2021-03-06,0,874,45,919
UTTAR PRADESH,CHANDAULI,2021-03-07,1,443,15,459
UTTAR PRADESH,CHANDAULI,2021-03-08,1,474,21,496
UTTAR PRADESH,CHANDAULI,2021-03-09,1,681,3,685
UTTAR PRADESH,CHANDAULI,2021-03-10,1,892,2,895
UTTAR PRADESH,CHITRAKOOT,2021-03-06,1,1271,22,1294
UTTAR PRADESH,CHITRAKOOT,2021-03-07,0,942,10,952
UTTAR PRADESH,CHITRAKOOT,2021-03-08,0,1192,15,1207
UTTAR PRADESH,CHITRAKOOT,2021-03-09,0,2022,11,2033
UTTAR PRADESH,CHITRAKOOT,2021-03-10,0,1106,0,1106
UTTAR PRADESH,DEORIA,2021-03-06,2,989,40,1031
UTTAR PRADESH,DEORIA,2021-03-07,1,864,18,883
UTTAR PRADESH,DEORIA,2021-03-08,0,715,44,759
UTTAR PRADESH,DEORIA,2021-03-09,1,259,0,260
UTTAR PRADESH,DEORIA,2021-03-10,1,1577,0,1578
UTTAR PRADESH,ETAH,2021-03-06,0,797,3,800
UTTAR PRADESH,ETAH,2021-03-07,1,541,35,577
UTTAR PRADESH,ETAH,2021-03-08,0,1423,17,1440
UTTAR PRADESH,ETAH,2021-03-09,0,842,0,842
UTTAR PRADESH,ETAH,2021-03-10,0,509,2,511
UTTAR PRADESH,ETAWAH,2021-03-06,1,1228,18,1247
UTTAR PRADESH,ETAWAH,2021-03-07,0,726,21,747
UTTAR PRADESH,ETAWAH,2021-03-08,1,1219,15,1235
UTTAR PRADESH,ETAWAH,2021-03-09,1,1138,15,1154
UTTAR PRADESH,ETAWAH,2021-03-10,1,1051,6,1058
UTTAR PRADESH,FARRUKHABAD,2021-03-06,0,515,22,537
UTTAR PRADESH,FARRUKHABAD,2021-03-07,3,284,45,332
UTTAR PRADESH,FARRUKHABAD,2021-03-08,0,881,25,906
UTTAR PRADESH,FARRUKHABAD,2021-03-09,0,819,25,844
UTTAR PRADESH,FARRUKHABAD,2021-03-10,0,773,21,794
UTTAR PRADESH,FATEHPUR,2021-03-06,0,932,75,1007
UTTAR PRADESH,FATEHPUR,2021-03-07,0,864,61,925
UTTAR PRADESH,FATEHPUR,2021-03-08,3,882,119,1004
UTTAR PRADESH,FATEHPUR,2021-03-09,3,675,54,732
UTTAR PRADESH,FATEHPUR,2021-03-10,2,828,122,952
UTTAR PRADESH,FIROZABAD,2021-03-06,1,1676,0,1677
UTTAR PRADESH,FIROZABAD,2021-03-07,1,390,1,392
UTTAR PRADESH,FIROZABAD,2021-03-08,0,2925,0,2925
UTTAR PRADESH,FIROZABAD,2021-03-09,2,2853,9,2864
UTTAR PRADESH,FIROZABAD,2021-03-10,1,483,5,489
UTTAR PRADESH,GAUTAM BUDDHA NAGAR,2021-03-06,42,2956,51,3049
UTTAR PRADESH,GAUTAM BUDDHA NAGAR,2021-03-07,37,1538,1,1576
UTTAR PRADESH,GAUTAM BUDDHA NAGAR,2021-03-08,35,2640,2,2677
UTTAR PRADESH,GAUTAM BUDDHA NAGAR,2021-03-09,60,2883,7,2950
UTTAR PRADESH,GAUTAM BUDDHA NAGAR,2021-03-10,55,1933,8,1996
UTTAR PRADESH,GHAZIABAD,2021-03-06,18,3472,29,3519
UTTAR PRADESH,GHAZIABAD,2021-03-07,33,1684,119,1836
UTTAR PRADESH,GHAZIABAD,2021-03-08,30,1636,68,1734
UTTAR PRADESH,GHAZIABAD,2021-03-09,32,4577,255,4864
UTTAR PRADESH,GHAZIABAD,2021-03-10,56,4183,193,4432
UTTAR PRADESH,GHAZIPUR,2021-03-06,1,612,0,613
UTTAR PRADESH,GHAZIPUR,2021-03-07,1,432,20,453
UTTAR PRADESH,GHAZIPUR,2021-03-08,1,648,4,653
UTTAR PRADESH,GHAZIPUR,2021-03-09,0,504,5,509
UTTAR PRADESH,GHAZIPUR,2021-03-10,3,932,6,941
UTTAR PRADESH,GONDA,2021-03-06,0,1316,0,1316
UTTAR PRADESH,GONDA,2021-03-07,0,1143,53,1196
UTTAR PRADESH,GONDA,2021-03-08,1,1141,2,1144
UTTAR PRADESH,GONDA,2021-03-09,2,1217,0,1219
UTTAR PRADESH,GONDA,2021-03-10,1,1042,1,1044
UTTAR PRADESH,GORAKHPUR,2021-03-06,3,1912,111,2026
UTTAR PRADESH,GORAKHPUR,2021-03-07,2,1505,28,1535
UTTAR PRADESH,GORAKHPUR,2021-03-08,2,1346,34,1382
UTTAR PRADESH,GORAKHPUR,2021-03-09,2,1213,3,1218
UTTAR PRADESH,GORAKHPUR,2021-03-10,3,2216,20,2239
UTTAR PRADESH,HAMIRPUR,2021-03-06,1,671,25,697
UTTAR PRADESH,HAMIRPUR,2021-03-07,0,799,42,841
UTTAR PRADESH,HAMIRPUR,2021-03-08,1,675,36,712
UTTAR PRADESH,HAMIRPUR,2021-03-09,0,744,0,744
UTTAR PRADESH,HAMIRPUR,2021-03-10,0,529,41,570
UTTAR PRADESH,HAPUR,2021-03-06,0,1639,30,1669
UTTAR PRADESH,HAPUR,2021-03-07,1,931,48,980
UTTAR PRADESH,HAPUR,2021-03-08,4,1178,13,1195
UTTAR PRADESH,HAPUR,2021-03-09,1,1308,61,1370
UTTAR PRADESH,HAPUR,2021-03-10,6,709,108,823
UTTAR PRADESH,HARDOI,2021-03-06,1,1142,52,1195
UTTAR PRADESH,HARDOI,2021-03-07,0,1204,0,1204
UTTAR PRADESH,HARDOI,2021-03-08,0,1385,29,1414
UTTAR PRADESH,HARDOI,2021-03-09,0,1415,4,1419
UTTAR PRADESH,HARDOI,2021-03-10,1,1343,9,1353
UTTAR PRADESH,HATHRAS,2021-03-06,0,1806,0,1806
UTTAR PRADESH,HATHRAS,2021-03-07,0,882,0,882
UTTAR PRADESH,HATHRAS,2021-03-08,0,875,1,876
UTTAR PRADESH,HATHRAS,2021-03-09,0,740,0,740
UTTAR PRADESH,HATHRAS,2021-03-10,0,906,1,907
UTTAR PRADESH,JALAUN,2021-03-06,1,1172,8,1181
UTTAR PRADESH,JALAUN,2021-03-07,0,751,0,751
UTTAR PRADESH,JALAUN,2021-03-08,1,1109,1,1111
UTTAR PRADESH,JALAUN,2021-03-09,0,1280,1,1281
UTTAR PRADESH,JALAUN,2021-03-10,0,1130,1,1131
UTTAR PRADESH,JAUNPUR,2021-03-06,3,1754,4,1761
UTTAR PRADESH,JAUNPUR,2021-03-07,3,564,1,568
UTTAR PRADESH,JAUNPUR,2021-03-08,0,1239,0,1239
UTTAR PRADESH,JAUNPUR,2021-03-09,2,612,0,614
UTTAR PRADESH,JAUNPUR,2021-03-10,0,643,1,644
UTTAR PRADESH,JHANSI,2021-03-06,1,2017,0,2018
UTTAR PRADESH,JHANSI,2021-03-07,2,1535,0,1537
UTTAR PRADESH,JHANSI,2021-03-08,2,1597,3,1602
UTTAR PRADESH,JHANSI,2021-03-09,2,1769,0,1771
UTTAR PRADESH,JHANSI,2021-03-10,0,2261,0,2261
UTTAR PRADESH,KANNAUJ,2021-03-06,1,1410,0,1411
UTTAR PRADESH,KANNAUJ,2021-03-07,0,1235,1,1236
UTTAR PRADESH,KANNAUJ,2021-03-08,0,1479,0,1479
UTTAR PRADESH,KANNAUJ,2021-03-09,1,1659,1,1661
UTTAR PRADESH,KANNAUJ,2021-03-10,1,1530,0,1531
UTTAR PRADESH,KANPUR DEHAT,2021-03-06,0,1211,0,1211
UTTAR PRADESH,KANPUR DEHAT,2021-03-07,54,892,24,970
UTTAR PRADESH,KANPUR DEHAT,2021-03-08,2,781,1,784
UTTAR PRADESH,KANPUR DEHAT,2021-03-09,0,912,0,912
UTTAR PRADESH,KANPUR DEHAT,2021-03-10,0,1790,0,1790
UTTAR PRADESH,KANPUR NAGAR,2021-03-06,6,1963,0,1969
UTTAR PRADESH,KANPUR NAGAR,2021-03-07,9,1626,0,1635
UTTAR PRADESH,KANPUR NAGAR,2021-03-08,7,1806,1,1814
UTTAR PRADESH,KANPUR NAGAR,2021-03-09,4,1951,3,1958
UTTAR PRADESH,KANPUR NAGAR,2021-03-10,8,1677,2,1687
UTTAR PRADESH,KASGANJ,2021-03-06,4,911,24,939
UTTAR PRADESH,KASGANJ,2021-03-07,0,338,47,385
UTTAR PRADESH,KASGANJ,2021-03-08,0,355,0,355
UTTAR PRADESH,KASGANJ,2021-03-09,0,4444,89,4533
UTTAR PRADESH,KASGANJ,2021-03-10,0,16,0,16
UTTAR PRADESH,KAUSHAMBI,2021-03-06,0,1207,0,1207
UTTAR PRADESH,KAUSHAMBI,2021-03-07,0,819,0,819
UTTAR PRADESH,KAUSHAMBI,2021-03-08,0,3457,0,3457
UTTAR PRADESH,KAUSHAMBI,2021-03-09,0,1017,0,1017
UTTAR PRADESH,KAUSHAMBI,2021-03-10,0,937,0,937
UTTAR PRADESH,KHERI,2021-03-06,0,1237,5,1242
UTTAR PRADESH,KHERI,2021-03-07,3,1215,0,1218
UTTAR PRADESH,KHERI,2021-03-08,1,1732,7,1740
UTTAR PRADESH,KHERI,2021-03-09,0,1093,2,1095
UTTAR PRADESH,KHERI,2021-03-10,0,1050,11,1061
UTTAR PRADESH,KUSHI NAGAR,2021-03-06,1,1318,29,1348
UTTAR PRADESH,KUSHI NAGAR,2021-03-07,0,309,1,310
UTTAR PRADESH,KUSHI NAGAR,2021-03-08,2,883,5,890
UTTAR PRADESH,KUSHI NAGAR,2021-03-09,1,722,20,743
UTTAR PRADESH,KUSHI NAGAR,2021-03-10,1,719,8,728
UTTAR PRADESH,LALITPUR,2021-03-06,0,3188,3,3191
UTTAR PRADESH,LALITPUR,2021-03-07,0,1446,0,1446
UTTAR PRADESH,LALITPUR,2021-03-08,0,1317,1,1318
UTTAR PRADESH,LALITPUR,2021-03-09,1,1476,3,1480
UTTAR PRADESH,LALITPUR,2021-03-10,0,1189,5,1194
UTTAR PRADESH,LUCKNOW,2021-03-06,21,5270,18,5309
UTTAR PRADESH,LUCKNOW,2021-03-07,24,4864,6,4894
UTTAR PRADESH,LUCKNOW,2021-03-08,20,4148,22,4190
UTTAR PRADESH,LUCKNOW,2021-03-09,25,5289,17,5331
UTTAR PRADESH,LUCKNOW,2021-03-10,30,5250,99,5379
UTTAR PRADESH,MAHARAJGANJ,2021-03-06,0,899,79,978
UTTAR PRADESH,MAHARAJGANJ,2021-03-07,1,520,9,530
UTTAR PRADESH,MAHARAJGANJ,2021-03-08,0,687,40,727
UTTAR PRADESH,MAHARAJGANJ,2021-03-09,1,865,39,905
UTTAR PRADESH,MAHARAJGANJ,2021-03-10,4,867,145,1016
UTTAR PRADESH,MAHOBA,2021-03-06,0,474,35,509
UTTAR PRADESH,MAHOBA,2021-03-07,0,468,21,489
UTTAR PRADESH,MAHOBA,2021-03-08,0,231,10,241
UTTAR PRADESH,MAHOBA,2021-03-09,0,574,1,575
UTTAR PRADESH,MAHOBA,2021-03-10,0,393,5,398
UTTAR PRADESH,MAINPURI,2021-03-06,0,1442,2,1444
UTTAR PRADESH,MAINPURI,2021-03-07,0,1332,0,1332
UTTAR PRADESH,MAINPURI,2021-03-08,0,1337,27,1364
UTTAR PRADESH,MAINPURI,2021-03-09,4,1601,0,1605
UTTAR PRADESH,MAINPURI,2021-03-10,1,1323,0,1324
UTTAR PRADESH,MATHURA,2021-03-06,0,1438,2,1440
UTTAR PRADESH,MATHURA,2021-03-07,4,833,0,837
UTTAR PRADESH,MATHURA,2021-03-08,5,1375,17,1397
UTTAR PRADESH,MATHURA,2021-03-09,4,1044,5,1053
UTTAR PRADESH,MATHURA,2021-03-10,3,1242,0,1245
UTTAR PRADESH,MAU,2021-03-06,0,887,1,888
UTTAR PRADESH,MAU,2021-03-07,0,972,3,975
UTTAR PRADESH,MAU,2021-03-08,3,666,4,673
UTTAR PRADESH,MAU,2021-03-09,0,845,0,845
UTTAR PRADESH,MAU,2021-03-10,0,919,1,920
UTTAR PRADESH,MEERUT,2021-03-06,4,3326,1,3331
UTTAR PRADESH,MEERUT,2021-03-07,7,2069,2,2078
UTTAR PRADESH,MEERUT,2021-03-08,5,2421,9,2435
UTTAR PRADESH,MEERUT,2021-03-09,13,2567,1,2581
UTTAR PRADESH,MEERUT,2021-03-10,6,2742,7,2755
UTTAR PRADESH,MIRZAPUR,2021-03-06,0,1399,0,1399
UTTAR PRADESH,MIRZAPUR,2021-03-07,1,1268,0,1269
UTTAR PRADESH,MIRZAPUR,2021-03-08,1,1412,0,1413
UTTAR PRADESH,MIRZAPUR,2021-03-09,0,1198,0,1198
UTTAR PRADESH,MIRZAPUR,2021-03-10,0,1746,60,1806
UTTAR PRADESH,MORADABAD,2021-03-06,2,1508,0,1510
UTTAR PRADESH,MORADABAD,2021-03-07,0,1780,0,1780
UTTAR PRADESH,MORADABAD,2021-03-08,1,2099,1,2101
UTTAR PRADESH,MORADABAD,2021-03-09,3,1993,0,1996
UTTAR PRADESH,MORADABAD,2021-03-10,3,1776,1,1780
UTTAR PRADESH,MUZAFFARNAGAR,2021-03-06,4,1817,1,1822
UTTAR PRADESH,MUZAFFARNAGAR,2021-03-07,1,1599,0,1600
UTTAR PRADESH,MUZAFFARNAGAR,2021-03-08,1,1066,0,1067
UTTAR PRADESH,MUZAFFARNAGAR,2021-03-09,11,1878,6,1895
UTTAR PRADESH,MUZAFFARNAGAR,2021-03-10,5,1988,0,1993
UTTAR PRADESH,PILIBHIT,2021-03-06,0,680,1,681
UTTAR PRADESH,PILIBHIT,2021-03-07,0,1294,27,1321
UTTAR PRADESH,PILIBHIT,2021-03-08,0,724,1,725
UTTAR PRADESH,PILIBHIT,2021-03-09,1,1765,6,1772
UTTAR PRADESH,PILIBHIT,2021-03-10,2,875,0,877
UTTAR PRADESH,PRATAPGARH,2021-03-06,2,1239,17,1258
UTTAR PRADESH,PRATAPGARH,2021-03-07,1,3817,7,3825
UTTAR PRADESH,PRATAPGARH,2021-03-08,1,1174,10,1185
UTTAR PRADESH,PRATAPGARH,2021-03-09,3,2132,14,2149
UTTAR PRADESH,PRATAPGARH,2021-03-10,0,1493,31,1524
UTTAR PRADESH,PRAYAGRAJ,2021-03-06,10,3681,5,3696
UTTAR PRADESH,PRAYAGRAJ,2021-03-07,7,2988,2,2997
UTTAR PRADESH,PRAYAGRAJ,2021-03-08,11,3989,0,4000
UTTAR PRADESH,PRAYAGRAJ,2021-03-09,8,2374,1,2383
UTTAR PRADESH,PRAYAGRAJ,2021-03-10,9,7080,0,7089
UTTAR PRADESH,RAE BARELI,2021-03-06,1,1717,1,1719
UTTAR PRADESH,RAE BARELI,2021-03-07,2,1300,1,1303
UTTAR PRADESH,RAE BARELI,2021-03-08,8,2319,7,2334
UTTAR PRADESH,RAE BARELI,2021-03-09,2,1964,27,1993
UTTAR PRADESH,RAE BARELI,2021-03-10,5,1727,7,1739
UTTAR PRADESH,RAMPUR,2021-03-06,0,1297,80,1377
UTTAR PRADESH,RAMPUR,2021-03-07,0,1244,33,1277
UTTAR PRADESH,RAMPUR,2021-03-08,2,1318,10,1330
UTTAR PRADESH,RAMPUR,2021-03-09,3,1353,41,1397
UTTAR PRADESH,RAMPUR,2021-03-10,3,1333,13,1349
UTTAR PRADESH,SAHARANPUR,2021-03-06,2,1606,19,1627
UTTAR PRADESH,SAHARANPUR,2021-03-07,2,818,0,820
UTTAR PRADESH,SAHARANPUR,2021-03-08,0,929,0,929
UTTAR PRADESH,SAHARANPUR,2021-03-09,2,1036,2,1040
UTTAR PRADESH,SAHARANPUR,2021-03-10,3,1268,1,1272
UTTAR PRADESH,SAMBHAL,2021-03-06,1,1156,168,1325
UTTAR PRADESH,SAMBHAL,2021-03-07,0,775,96,871
UTTAR PRADESH,SAMBHAL,2021-03-08,0,1218,30,1248
UTTAR PRADESH,SAMBHAL,2021-03-09,0,1383,24,1407
UTTAR PRADESH,SAMBHAL,2021-03-10,0,1810,106,1916
UTTAR PRADESH,SANT KABEER NAGAR,2021-03-06,2,1418,0,1420
UTTAR PRADESH,SANT KABEER NAGAR,2021-03-07,1,1531,0,1532
UTTAR PRADESH,SANT KABEER NAGAR,2021-03-08,0,780,0,780
UTTAR PRADESH,SANT KABEER NAGAR,2021-03-09,2,1344,1,1347
UTTAR PRADESH,SANT KABEER NAGAR,2021-03-10,0,686,0,686
UTTAR PRADESH,SHAHJAHANPUR,2021-03-06,9,1294,23,1326
UTTAR PRADESH,SHAHJAHANPUR,2021-03-07,3,966,0,969
UTTAR PRADESH,SHAHJAHANPUR,2021-03-08,2,2480,10,2492
UTTAR PRADESH,SHAHJAHANPUR,2021-03-09,5,1191,0,1196
UTTAR PRADESH,SHAHJAHANPUR,2021-03-10,1,1790,32,1823
UTTAR PRADESH,SHAMLI,2021-03-06,2,1646,3,1651
UTTAR PRADESH,SHAMLI,2021-03-07,6,1073,0,1079
UTTAR PRADESH,SHAMLI,2021-03-08,2,1027,0,1029
UTTAR PRADESH,SHAMLI,2021-03-09,1,1064,0,1065
UTTAR PRADESH,SHAMLI,2021-03-10,7,1948,0,1955
UTTAR PRADESH,SHRAVASTI,2021-03-06,0,589,0,589
UTTAR PRADESH,SHRAVASTI,2021-03-07,0,730,0,730
UTTAR PRADESH,SHRAVASTI,2021-03-08,0,550,21,571
UTTAR PRADESH,SHRAVASTI,2021-03-09,0,900,1,901
UTTAR PRADESH,SHRAVASTI,2021-03-10,0,744,0,744
UTTAR PRADESH,SIDDHARTH NAGAR,2021-03-06,0,811,71,882
UTTAR PRADESH,SIDDHARTH NAGAR,2021-03-07,0,693,80,773
UTTAR PRADESH,SIDDHARTH NAGAR,2021-03-08,2,845,1,848
UTTAR PRADESH,SIDDHARTH NAGAR,2021-03-09,0,734,0,734
UTTAR PRADESH,SIDDHARTH NAGAR,2021-03-10,1,860,1,862
UTTAR PRADESH,SITAPUR,2021-03-06,1,1191,10,1202
UTTAR PRADESH,SITAPUR,2021-03-07,0,1017,2,1019
UTTAR PRADESH,SITAPUR,2021-03-08,0,906,3,909
UTTAR PRADESH,SITAPUR,2021-03-09,0,1100,25,1125
UTTAR PRADESH,SITAPUR,2021-03-10,1,1033,2,1036
UTTAR PRADESH,SONBHADRA,2021-03-06,1,1774,96,1871
UTTAR PRADESH,SONBHADRA,2021-03-07,1,1149,0,1150
UTTAR PRADESH,SONBHADRA,2021-03-08,1,818,20,839
UTTAR PRADESH,SONBHADRA,2021-03-09,1,968,31,1000
UTTAR PRADESH,SONBHADRA,2021-03-10,1,1349,40,1390
UTTAR PRADESH,SULTANPUR,2021-03-06,0,1437,7,1444
UTTAR PRADESH,SULTANPUR,2021-03-07,1,848,7,856
UTTAR PRADESH,SULTANPUR,2021-03-08,1,845,2,848
UTTAR PRADESH,SULTANPUR,2021-03-09,0,1354,19,1373
UTTAR PRADESH,SULTANPUR,2021-03-10,0,1336,12,1348
UTTAR PRADESH,UNNAO,2021-03-06,0,1580,2,1582
UTTAR PRADESH,UNNAO,2021-03-07,1,1725,14,1740
UTTAR PRADESH,UNNAO,2021-03-08,0,1727,10,1737
UTTAR PRADESH,UNNAO,2021-03-09,0,1715,6,1721
UTTAR PRADESH,UNNAO,2021-03-10,1,1806,31,1838
UTTAR PRADESH,VARANASI,2021-03-06,8,2627,6,2641
UTTAR PRADESH,VARANASI,2021-03-07,2,2268,0,2270
UTTAR PRADESH,VARANASI,2021-03-08,9,2739,1,2749
UTTAR PRADESH,VARANASI,2021-03-09,7,2410,54,2471
UTTAR PRADESH,VARANASI,2021-03-10,10,2452,2,2464
UTTARAKHAND,ALMORA,2021-03-06,1,66,1,68
UTTARAKHAND,ALMORA,2021-03-07,0,9,0,9
UTTARAKHAND,ALMORA,2021-03-08,1,213,1,215
UTTARAKHAND,ALMORA,2021-03-09,1,232,0,233
UTTARAKHAND,ALMORA,2021-03-10,0,102,0,102
UTTARAKHAND,BAGESHWAR,2021-03-06,1,172,0,173
UTTARAKHAND,BAGESHWAR,2021-03-07,0,32,0,32
UTTARAKHAND,BAGESHWAR,2021-03-08,0,188,0,188
UTTARAKHAND,BAGESHWAR,2021-03-09,0,103,0,103
UTTARAKHAND,BAGESHWAR,2021-03-10,1,373,4,378
UTTARAKHAND,CHAMOLI,2021-03-06,0,47,0,47
UTTARAKHAND,CHAMOLI,2021-03-07,0,146,2,148
UTTARAKHAND,CHAMOLI,2021-03-08,0,24,0,24
UTTARAKHAND,CHAMOLI,2021-03-09,0,179,0,179
UTTARAKHAND,CHAMOLI,2021-03-10,0,80,0,80
UTTARAKHAND,CHAMPAWAT,2021-03-06,0,84,0,84
UTTARAKHAND,CHAMPAWAT,2021-03-07,0,4,0,4
UTTARAKHAND,CHAMPAWAT,2021-03-08,0,5,0,5
UTTARAKHAND,CHAMPAWAT,2021-03-09,1,37,1,39
UTTARAKHAND,CHAMPAWAT,2021-03-10,0,29,0,29
UTTARAKHAND,DEHRADUN,2021-03-06,16,2272,9,2297
UTTARAKHAND,DEHRADUN,2021-03-07,24,1094,2,1120
UTTARAKHAND,DEHRADUN,2021-03-08,15,1688,2,1705
UTTARAKHAND,DEHRADUN,2021-03-09,27,1625,4,1656
UTTARAKHAND,DEHRADUN,2021-03-10,38,1284,0,1322
UTTARAKHAND,HARIDWAR,2021-03-06,19,2564,2,2585
UTTARAKHAND,HARIDWAR,2021-03-07,13,3067,0,3080
UTTARAKHAND,HARIDWAR,2021-03-08,5,2745,0,2750
UTTARAKHAND,HARIDWAR,2021-03-09,9,3558,3,3570
UTTARAKHAND,HARIDWAR,2021-03-10,26,10670,3,10699
UTTARAKHAND,NAINITAL,2021-03-06,21,1282,1,1304
UTTARAKHAND,NAINITAL,2021-03-07,5,501,0,506
UTTARAKHAND,NAINITAL,2021-03-08,26,1504,3,1533
UTTARAKHAND,NAINITAL,2021-03-09,7,768,6,781
UTTARAKHAND,NAINITAL,2021-03-10,15,948,3,966
UTTARAKHAND,PAURI GARHWAL,2021-03-06,2,485,4,491
UTTARAKHAND,PAURI GARHWAL,2021-03-07,3,245,4,252
UTTARAKHAND,PAURI GARHWAL,2021-03-08,2,306,1,309
UTTARAKHAND,PAURI GARHWAL,2021-03-09,1,583,1,585
UTTARAKHAND,PAURI GARHWAL,2021-03-10,2,999,3,1004
UTTARAKHAND,PITHORAGARH,2021-03-06,0,216,0,216
UTTARAKHAND,PITHORAGARH,2021-03-07,0,8,0,8
UTTARAKHAND,PITHORAGARH,2021-03-08,0,235,0,235
UTTARAKHAND,PITHORAGARH,2021-03-09,0,388,0,388
UTTARAKHAND,PITHORAGARH,2021-03-10,0,123,0,123
UTTARAKHAND,RUDRA PRAYAG,2021-03-06,0,79,0,79
UTTARAKHAND,RUDRA PRAYAG,2021-03-07,0,159,2,161
UTTARAKHAND,RUDRA PRAYAG,2021-03-08,0,29,0,29
UTTARAKHAND,RUDRA PRAYAG,2021-03-09,0,34,0,34
UTTARAKHAND,RUDRA PRAYAG,2021-03-10,1,98,1,100
UTTARAKHAND,TEHRI GARHWAL,2021-03-06,2,135,0,137
UTTARAKHAND,TEHRI GARHWAL,2021-03-07,0,260,1,261
UTTARAKHAND,TEHRI GARHWAL,2021-03-08,1,114,0,115
UTTARAKHAND,TEHRI GARHWAL,2021-03-09,0,201,1,202
UTTARAKHAND,TEHRI GARHWAL,2021-03-10,0,228,0,228
UTTARAKHAND,UDAM SINGH NAGAR,2021-03-06,12,1135,2,1149
UTTARAKHAND,UDAM SINGH NAGAR,2021-03-07,2,873,21,896
UTTARAKHAND,UDAM SINGH NAGAR,2021-03-08,8,1729,35,1772
UTTARAKHAND,UDAM SINGH NAGAR,2021-03-09,12,1577,102,1691
UTTARAKHAND,UDAM SINGH NAGAR,2021-03-10,2,1277,111,1390
UTTARAKHAND,UTTAR KASHI,2021-03-06,0,480,0,480
UTTARAKHAND,UTTAR KASHI,2021-03-07,0,403,8,411
UTTARAKHAND,UTTAR KASHI,2021-03-08,1,197,0,198
UTTARAKHAND,UTTAR KASHI,2021-03-09,0,125,0,125
UTTARAKHAND,UTTAR KASHI,2021-03-10,0,193,0,193
WEST BENGAL,24 PARAGANAS NORTH,2021-03-06,33,3109,10,3152
WEST BENGAL,24 PARAGANAS NORTH,2021-03-07,67,2304,23,2394
WEST BENGAL,24 PARAGANAS NORTH,2021-03-08,45,2678,9,2732
WEST BENGAL,24 PARAGANAS NORTH,2021-03-09,89,2849,10,2948
WEST BENGAL,24 PARAGANAS NORTH,2021-03-10,56,2359,14,2429
WEST BENGAL,24 PARAGANAS SOUTH,2021-03-06,7,2362,215,2584
WEST BENGAL,24 PARAGANAS SOUTH,2021-03-07,8,1951,1,1960
WEST BENGAL,24 PARAGANAS SOUTH,2021-03-08,5,2261,2,2268
WEST BENGAL,24 PARAGANAS SOUTH,2021-03-09,15,2003,17,2035
WEST BENGAL,24 PARAGANAS SOUTH,2021-03-10,14,2607,4,2625
WEST BENGAL,ALIPURDUAR,2021-03-06,1,659,20,680
WEST BENGAL,ALIPURDUAR,2021-03-07,0,164,0,164
WEST BENGAL,ALIPURDUAR,2021-03-08,0,106,0,106
WEST BENGAL,ALIPURDUAR,2021-03-09,0,539,0,539
WEST BENGAL,ALIPURDUAR,2021-03-10,0,1449,0,1449
WEST BENGAL,BANKURA,2021-03-06,10,236,0,246
WEST BENGAL,BANKURA,2021-03-07,4,109,0,113
WEST BENGAL,BANKURA,2021-03-08,3,285,0,288
WEST BENGAL,BANKURA,2021-03-09,3,221,1,225
WEST BENGAL,BANKURA,2021-03-10,10,260,0,270
WEST BENGAL,BIRBHUM,2021-03-06,3,589,7,599
WEST BENGAL,BIRBHUM,2021-03-07,5,410,4,419
WEST BENGAL,BIRBHUM,2021-03-08,4,327,2,333
WEST BENGAL,BIRBHUM,2021-03-09,2,557,3,562
WEST BENGAL,BIRBHUM,2021-03-10,1,498,6,505
WEST BENGAL,COOCHBEHAR,2021-03-06,0,988,1,989
WEST BENGAL,COOCHBEHAR,2021-03-07,1,1126,0,1127
WEST BENGAL,COOCHBEHAR,2021-03-08,5,1243,0,1248
WEST BENGAL,COOCHBEHAR,2021-03-09,1,911,0,912
WEST BENGAL,COOCHBEHAR,2021-03-10,1,1104,0,1105
WEST BENGAL,DARJEELING,2021-03-06,0,708,7,715
WEST BENGAL,DARJEELING,2021-03-07,4,295,1,300
WEST BENGAL,DARJEELING,2021-03-08,3,210,0,213
WEST BENGAL,DARJEELING,2021-03-09,2,406,0,408
WEST BENGAL,DARJEELING,2021-03-10,4,719,3,726
WEST BENGAL,DINAJPUR DAKSHIN,2021-03-06,1,457,9,467
WEST BENGAL,DINAJPUR DAKSHIN,2021-03-07,0,411,56,467
WEST BENGAL,DINAJPUR DAKSHIN,2021-03-08,0,353,49,402
WEST BENGAL,DINAJPUR DAKSHIN,2021-03-09,1,464,5,470
WEST BENGAL,DINAJPUR DAKSHIN,2021-03-10,0,389,1,390
WEST BENGAL,DINAJPUR UTTAR,2021-03-06,6,284,0,290
WEST BENGAL,DINAJPUR UTTAR,2021-03-07,3,125,0,128
WEST BENGAL,DINAJPUR UTTAR,2021-03-08,3,276,0,279
WEST BENGAL,DINAJPUR UTTAR,2021-03-09,4,187,0,191
WEST BENGAL,DINAJPUR UTTAR,2021-03-10,4,242,0,246
WEST BENGAL,HOOGHLY,2021-03-06,9,712,11,732
WEST BENGAL,HOOGHLY,2021-03-07,3,495,1,499
WEST BENGAL,HOOGHLY,2021-03-08,11,730,3,744
WEST BENGAL,HOOGHLY,2021-03-09,7,706,3,716
WEST BENGAL,HOOGHLY,2021-03-10,9,700,4,713
WEST BENGAL,HOWRAH,2021-03-06,13,882,42,937
WEST BENGAL,HOWRAH,2021-03-07,19,904,36,959
WEST BENGAL,HOWRAH,2021-03-08,14,798,52,864
WEST BENGAL,HOWRAH,2021-03-09,30,818,26,874
WEST BENGAL,HOWRAH,2021-03-10,20,873,68,961
WEST BENGAL,JALPAIGURI,2021-03-06,1,486,1,488
WEST BENGAL,JALPAIGURI,2021-03-07,4,105,0,109
WEST BENGAL,JALPAIGURI,2021-03-08,1,395,0,396
WEST BENGAL,JALPAIGURI,2021-03-09,1,310,0,311
WEST BENGAL,JALPAIGURI,2021-03-10,1,267,0,268
WEST BENGAL,JHARGRAM,2021-03-06,3,26,0,29
WEST BENGAL,JHARGRAM,2021-03-07,9,9,0,18
WEST BENGAL,JHARGRAM,2021-03-08,1,37,0,38
WEST BENGAL,JHARGRAM,2021-03-09,0,16,0,16
WEST BENGAL,JHARGRAM,2021-03-10,0,29,0,29
WEST BENGAL,KALIMPONG,2021-03-06,0,114,0,114
WEST BENGAL,KALIMPONG,2021-03-07,0,103,0,103
WEST BENGAL,KALIMPONG,2021-03-08,0,196,0,196
WEST BENGAL,KALIMPONG,2021-03-09,1,46,0,47
WEST BENGAL,KALIMPONG,2021-03-10,0,123,0,123
WEST BENGAL,KOLKATA,2021-03-06,93,3159,17,3269
WEST BENGAL,KOLKATA,2021-03-07,91,2767,6,2864
WEST BENGAL,KOLKATA,2021-03-08,96,3096,12,3204
WEST BENGAL,KOLKATA,2021-03-09,153,3759,21,3933
WEST BENGAL,KOLKATA,2021-03-10,116,3377,17,3510
WEST BENGAL,MALDAH,2021-03-06,4,414,2,420
WEST BENGAL,MALDAH,2021-03-07,1,49,0,50
WEST BENGAL,MALDAH,2021-03-08,2,432,2,436
WEST BENGAL,MALDAH,2021-03-09,1,360,1,362
WEST BENGAL,MALDAH,2021-03-10,6,420,1,427
WEST BENGAL,MEDINIPUR EAST,2021-03-06,4,788,1,793
WEST BENGAL,MEDINIPUR EAST,2021-03-07,4,490,0,494
WEST BENGAL,MEDINIPUR EAST,2021-03-08,3,605,1,609
WEST BENGAL,MEDINIPUR EAST,2021-03-09,3,539,0,542
WEST BENGAL,MEDINIPUR EAST,2021-03-10,3,662,0,665
WEST BENGAL,MEDINIPUR WEST,2021-03-06,3,386,3,392
WEST BENGAL,MEDINIPUR WEST,2021-03-07,1,285,13,299
WEST BENGAL,MEDINIPUR WEST,2021-03-08,3,450,9,462
WEST BENGAL,MEDINIPUR WEST,2021-03-09,2,281,0,283
WEST BENGAL,MEDINIPUR WEST,2021-03-10,3,409,9,421
WEST BENGAL,MURSHIDABAD,2021-03-06,0,865,1,866
WEST BENGAL,MURSHIDABAD,2021-03-07,0,434,3,437
WEST BENGAL,MURSHIDABAD,2021-03-08,0,993,2,995
WEST BENGAL,MURSHIDABAD,2021-03-09,4,840,2,846
WEST BENGAL,MURSHIDABAD,2021-03-10,2,829,8,839
WEST BENGAL,NADIA,2021-03-06,2,709,18,729
WEST BENGAL,NADIA,2021-03-07,4,636,7,647
WEST BENGAL,NADIA,2021-03-08,5,546,8,559
WEST BENGAL,NADIA,2021-03-09,1,647,13,661
WEST BENGAL,NADIA,2021-03-10,1,484,7,492
WEST BENGAL,PASCHIM BARDHAMAN,2021-03-06,5,505,2,512
WEST BENGAL,PASCHIM BARDHAMAN,2021-03-07,6,342,1,349
WEST BENGAL,PASCHIM BARDHAMAN,2021-03-08,1,277,2,280
WEST BENGAL,PASCHIM BARDHAMAN,2021-03-09,28,479,1,508
WEST BENGAL,PASCHIM BARDHAMAN,2021-03-10,15,383,3,401
WEST BENGAL,PURBA BARDHAMAN,2021-03-06,2,703,0,705
WEST BENGAL,PURBA BARDHAMAN,2021-03-07,2,493,0,495
WEST BENGAL,PURBA BARDHAMAN,2021-03-08,1,429,0,430
WEST BENGAL,PURBA BARDHAMAN,2021-03-09,1,519,0,520
WEST BENGAL,PURBA BARDHAMAN,2021-03-10,4,709,0,713
WEST BENGAL,PURULIA,2021-03-06,3,550,0,553
WEST BENGAL,PURULIA,2021-03-07,3,12,0,15
WEST BENGAL,PURULIA,2021-03-08,0,154,0,154
WEST BENGAL,PURULIA,2021-03-09,9,353,0,362
WEST BENGAL,PURULIA,2021-03-10,4,493,0,497
ANDAMAN AND NICOBAR ISLANDS,NICOBARS,2021-03-16,1,11,0,12
ANDAMAN AND NICOBAR ISLANDS,NICOBARS,2021-03-17,0,18,0,18
ANDAMAN AND NICOBAR ISLANDS,NICOBARS,2021-03-18,0,6,0,6
ANDAMAN AND NICOBAR ISLANDS,NICOBARS,2021-03-19,0,2,0,2
ANDAMAN AND NICOBAR ISLANDS,NICOBARS,2021-03-20,0,14,0,14
ANDAMAN AND NICOBAR ISLANDS,NORTH AND MIDDLE ANDAMAN,2021-03-16,0,2,0,2
ANDAMAN AND NICOBAR ISLANDS,NORTH AND MIDDLE ANDAMAN,2021-03-17,0,9,0,9
ANDAMAN AND NICOBAR ISLANDS,NORTH AND MIDDLE ANDAMAN,2021-03-18,0,50,0,50
ANDAMAN AND NICOBAR ISLANDS,NORTH AND MIDDLE ANDAMAN,2021-03-19,0,8,0,8
ANDAMAN AND NICOBAR ISLANDS,NORTH AND MIDDLE ANDAMAN,2021-03-20,0,9,0,9
ANDAMAN AND NICOBAR ISLANDS,SOUTH ANDAMANS,2021-03-16,2,410,0,412
ANDAMAN AND NICOBAR ISLANDS,SOUTH ANDAMANS,2021-03-17,0,458,0,458
ANDAMAN AND NICOBAR ISLANDS,SOUTH ANDAMANS,2021-03-18,4,357,1,362
ANDAMAN AND NICOBAR ISLANDS,SOUTH ANDAMANS,2021-03-19,0,269,0,269
ANDAMAN AND NICOBAR ISLANDS,SOUTH ANDAMANS,2021-03-20,0,207,1,208
ANDHRA PRADESH,ANANTAPUR,2021-03-16,17,3520,1,3538
ANDHRA PRADESH,ANANTAPUR,2021-03-17,19,8896,1,8916
ANDHRA PRADESH,ANANTAPUR,2021-03-18,17,6203,1,6221
ANDHRA PRADESH,ANANTAPUR,2021-03-19,27,4208,0,4235
ANDHRA PRADESH,ANANTAPUR,2021-03-20,34,3829,0,3863
ANDHRA PRADESH,CHITTOOR,2021-03-16,48,3757,2,3807
ANDHRA PRADESH,CHITTOOR,2021-03-17,70,19009,0,19079
ANDHRA PRADESH,CHITTOOR,2021-03-18,98,23214,0,23312
ANDHRA PRADESH,CHITTOOR,2021-03-19,85,8837,0,8922
ANDHRA PRADESH,CHITTOOR,2021-03-20,86,4436,0,4522
ANDHRA PRADESH,EAST GODAVARI,2021-03-16,44,3876,0,3920
ANDHRA PRADESH,EAST GODAVARI,2021-03-17,46,6012,0,6058
ANDHRA PRADESH,EAST GODAVARI,2021-03-18,29,7170,0,7199
ANDHRA PRADESH,EAST GODAVARI,2021-03-19,76,8874,0,8950
ANDHRA PRADESH,EAST GODAVARI,2021-03-20,58,3958,0,4016
ANDHRA PRADESH,GUNTUR,2021-03-16,78,2043,0,2121
ANDHRA PRADESH,GUNTUR,2021-03-17,40,4217,0,4257
ANDHRA PRADESH,GUNTUR,2021-03-18,91,5451,0,5542
ANDHRA PRADESH,GUNTUR,2021-03-19,86,3017,1,3104
ANDHRA PRADESH,GUNTUR,2021-03-20,98,2350,0,2448
ANDHRA PRADESH,KRISHNA,2021-03-16,56,7851,0,7907
ANDHRA PRADESH,KRISHNA,2021-03-17,33,13931,0,13964
ANDHRA PRADESH,KRISHNA,2021-03-18,54,4065,0,4119
ANDHRA PRADESH,KRISHNA,2021-03-19,55,3876,0,3931
ANDHRA PRADESH,KRISHNA,2021-03-20,52,4317,0,4369
ANDHRA PRADESH,KURNOOL,2021-03-16,41,3713,1,3755
ANDHRA PRADESH,KURNOOL,2021-03-17,36,6425,0,6461
ANDHRA PRADESH,KURNOOL,2021-03-18,67,6904,0,6971
ANDHRA PRADESH,KURNOOL,2021-03-19,37,4595,0,4632
ANDHRA PRADESH,KURNOOL,2021-03-20,82,5477,1,5560
ANDHRA PRADESH,PRAKASAM,2021-03-16,11,2122,0,2133
ANDHRA PRADESH,PRAKASAM,2021-03-17,10,3515,0,3525
ANDHRA PRADESH,PRAKASAM,2021-03-18,12,5383,0,5395
ANDHRA PRADESH,PRAKASAM,2021-03-19,11,7184,0,7195
ANDHRA PRADESH,PRAKASAM,2021-03-20,15,4446,0,4461
ANDHRA PRADESH,SPSR NELLORE,2021-03-16,6,799,0,805
ANDHRA PRADESH,SPSR NELLORE,2021-03-17,8,3705,0,3713
ANDHRA PRADESH,SPSR NELLORE,2021-03-18,21,5151,0,5172
ANDHRA PRADESH,SPSR NELLORE,2021-03-19,29,2539,0,2568
ANDHRA PRADESH,SPSR NELLORE,2021-03-20,20,3631,0,3651
ANDHRA PRADESH,SRIKAKULAM,2021-03-16,18,3656,0,3674
ANDHRA PRADESH,SRIKAKULAM,2021-03-17,11,9256,0,9267
ANDHRA PRADESH,SRIKAKULAM,2021-03-18,13,6138,0,6151
ANDHRA PRADESH,SRIKAKULAM,2021-03-19,23,5889,1,5913
ANDHRA PRADESH,SRIKAKULAM,2021-03-20,23,3406,0,3429
ANDHRA PRADESH,VISAKHAPATANAM,2021-03-16,55,3341,0,3396
ANDHRA PRADESH,VISAKHAPATANAM,2021-03-17,36,4158,0,4194
ANDHRA PRADESH,VISAKHAPATANAM,2021-03-18,64,6246,2,6312
ANDHRA PRADESH,VISAKHAPATANAM,2021-03-19,85,15826,0,15911
ANDHRA PRADESH,VISAKHAPATANAM,2021-03-20,63,48996,0,49059
ANDHRA PRADESH,VIZIANAGARAM,2021-03-16,8,15546,0,15554
ANDHRA PRADESH,VIZIANAGARAM,2021-03-17,4,22562,0,22566
ANDHRA PRADESH,VIZIANAGARAM,2021-03-18,8,3586,0,3594
ANDHRA PRADESH,VIZIANAGARAM,2021-03-19,12,1348,0,1360
ANDHRA PRADESH,VIZIANAGARAM,2021-03-20,8,2318,0,2326
ANDHRA PRADESH,WEST GODAVARI,2021-03-16,4,736,0,740
ANDHRA PRADESH,WEST GODAVARI,2021-03-17,11,5288,0,5299
ANDHRA PRADESH,WEST GODAVARI,2021-03-18,8,4862,0,4870
ANDHRA PRADESH,WEST GODAVARI,2021-03-19,15,2720,0,2735
ANDHRA PRADESH,WEST GODAVARI,2021-03-20,24,7031,0,7055
ANDHRA PRADESH,Y.S.R.,2021-03-16,19,3670,0,3689
ANDHRA PRADESH,Y.S.R.,2021-03-17,28,5580,0,5608
ANDHRA PRADESH,Y.S.R.,2021-03-18,22,4840,0,4862
ANDHRA PRADESH,Y.S.R.,2021-03-19,13,1588,0,1601
ANDHRA PRADESH,Y.S.R.,2021-03-20,19,7757,0,7776
ARUNACHAL PRADESH,ANJAW,2021-03-16,0,14,0,14
ARUNACHAL PRADESH,ANJAW,2021-03-17,0,3,0,3
ARUNACHAL PRADESH,ANJAW,2021-03-18,0,1,0,1
ARUNACHAL PRADESH,ANJAW,2021-03-19,0,6,0,6
ARUNACHAL PRADESH,ANJAW,2021-03-20,0,7,0,7
ARUNACHAL PRADESH,CHANGLANG,2021-03-16,0,1,0,1
ARUNACHAL PRADESH,CHANGLANG,2021-03-17,0,3,0,3
ARUNACHAL PRADESH,CHANGLANG,2021-03-18,0,2,0,2
ARUNACHAL PRADESH,CHANGLANG,2021-03-19,0,7,0,7
ARUNACHAL PRADESH,CHANGLANG,2021-03-20,0,2,0,2
ARUNACHAL PRADESH,DIBANG VALLEY,2021-03-16,0,2,0,2
ARUNACHAL PRADESH,DIBANG VALLEY,2021-03-17,0,2,0,2
ARUNACHAL PRADESH,DIBANG VALLEY,2021-03-18,0,1,0,1
ARUNACHAL PRADESH,DIBANG VALLEY,2021-03-20,0,2,0,2
ARUNACHAL PRADESH,EAST KAMENG,2021-03-16,0,1,0,1
ARUNACHAL PRADESH,EAST KAMENG,2021-03-17,0,3,0,3
ARUNACHAL PRADESH,EAST KAMENG,2021-03-20,0,2,0,2
ARUNACHAL PRADESH,EAST SIANG,2021-03-16,0,28,0,28
ARUNACHAL PRADESH,EAST SIANG,2021-03-17,0,26,0,26
ARUNACHAL PRADESH,EAST SIANG,2021-03-18,0,12,0,12
ARUNACHAL PRADESH,EAST SIANG,2021-03-19,0,13,0,13
ARUNACHAL PRADESH,EAST SIANG,2021-03-20,0,6,0,6
ARUNACHAL PRADESH,KAMLE,2021-03-18,0,1,0,1
ARUNACHAL PRADESH,KRA  DAADI,2021-03-16,0,1,0,1
ARUNACHAL PRADESH,KRA  DAADI,2021-03-17,0,1,0,1
ARUNACHAL PRADESH,KURUNG KUMEY,2021-03-17,0,1,0,1
ARUNACHAL PRADESH,LEPARADA,2021-03-16,0,1,0,1
ARUNACHAL PRADESH,LEPARADA,2021-03-18,0,2,0,2
ARUNACHAL PRADESH,LOHIT,2021-03-16,0,4,0,4
ARUNACHAL PRADESH,LOHIT,2021-03-17,0,1,0,1
ARUNACHAL PRADESH,LOHIT,2021-03-20,0,1,0,1
ARUNACHAL PRADESH,LONGDING,2021-03-17,0,2,0,2
ARUNACHAL PRADESH,LOWER DIBANG VALLEY,2021-03-17,0,1,0,1
ARUNACHAL PRADESH,LOWER SIANG,2021-03-16,0,4,0,4
ARUNACHAL PRADESH,LOWER SIANG,2021-03-17,0,5,0,5
ARUNACHAL PRADESH,LOWER SIANG,2021-03-18,0,7,0,7
ARUNACHAL PRADESH,LOWER SIANG,2021-03-19,0,9,0,9
ARUNACHAL PRADESH,LOWER SIANG,2021-03-20,0,5,0,5
ARUNACHAL PRADESH,LOWER SUBANSIRI,2021-03-16,0,3,0,3
ARUNACHAL PRADESH,LOWER SUBANSIRI,2021-03-17,0,2,0,2
ARUNACHAL PRADESH,LOWER SUBANSIRI,2021-03-18,0,1,0,1
ARUNACHAL PRADESH,LOWER SUBANSIRI,2021-03-19,0,21,0,21
ARUNACHAL PRADESH,LOWER SUBANSIRI,2021-03-20,0,2,0,2
ARUNACHAL PRADESH,NAMSAI,2021-03-16,0,2,0,2
ARUNACHAL PRADESH,NAMSAI,2021-03-17,0,2,0,2
ARUNACHAL PRADESH,NAMSAI,2021-03-18,0,1,0,1
ARUNACHAL PRADESH,NAMSAI,2021-03-19,1,1,0,2
ARUNACHAL PRADESH,PAKKE KESSANG,2021-03-17,0,2,0,2
ARUNACHAL PRADESH,PAKKE KESSANG,2021-03-19,0,2,0,2
ARUNACHAL PRADESH,PAKKE KESSANG,2021-03-20,0,1,0,1
ARUNACHAL PRADESH,PAPUM PARE,2021-03-16,0,28,0,28
ARUNACHAL PRADESH,PAPUM PARE,2021-03-17,0,19,0,19
ARUNACHAL PRADESH,PAPUM PARE,2021-03-18,0,38,0,38
ARUNACHAL PRADESH,PAPUM PARE,2021-03-19,0,33,0,33
ARUNACHAL PRADESH,PAPUM PARE,2021-03-20,0,8,0,8
ARUNACHAL PRADESH,SHI YOMI,2021-03-16,0,2,0,2
ARUNACHAL PRADESH,SHI YOMI,2021-03-17,0,1,0,1
ARUNACHAL PRADESH,SHI YOMI,2021-03-18,0,1,0,1
ARUNACHAL PRADESH,SHI YOMI,2021-03-20,0,1,0,1
ARUNACHAL PRADESH,SIANG,2021-03-16,0,2,0,2
ARUNACHAL PRADESH,SIANG,2021-03-20,0,2,0,2
ARUNACHAL PRADESH,TAWANG,2021-03-16,0,2,0,2
ARUNACHAL PRADESH,TAWANG,2021-03-17,0,3,0,3
ARUNACHAL PRADESH,TAWANG,2021-03-19,0,1,0,1
ARUNACHAL PRADESH,TAWANG,2021-03-20,0,2,0,2
ARUNACHAL PRADESH,UPPER SUBANSIRI,2021-03-18,0,2,0,2
ARUNACHAL PRADESH,WEST KAMENG,2021-03-16,0,2,0,2
ARUNACHAL PRADESH,WEST KAMENG,2021-03-17,0,129,0,129
ARUNACHAL PRADESH,WEST KAMENG,2021-03-18,0,227,0,227
ARUNACHAL PRADESH,WEST KAMENG,2021-03-19,0,67,0,67
ARUNACHAL PRADESH,WEST KAMENG,2021-03-20,0,132,0,132
ARUNACHAL PRADESH,WEST SIANG,2021-03-17,0,1,0,1
ARUNACHAL PRADESH,WEST SIANG,2021-03-18,0,7,0,7
ARUNACHAL PRADESH,WEST SIANG,2021-03-20,0,1,0,1
ASSAM,BAKSA,2021-03-16,0,77,0,77
ASSAM,BAKSA,2021-03-17,0,68,0,68
ASSAM,BAKSA,2021-03-18,0,80,0,80
ASSAM,BAKSA,2021-03-19,0,75,0,75
ASSAM,BAKSA,2021-03-20,0,42,0,42
ASSAM,BARPETA,2021-03-16,0,157,0,157
ASSAM,BARPETA,2021-03-17,0,109,0,109
ASSAM,BARPETA,2021-03-18,0,145,0,145
ASSAM,BARPETA,2021-03-19,0,108,0,108
ASSAM,BARPETA,2021-03-20,0,111,0,111
ASSAM,BISWANATH,2021-03-16,0,46,0,46
ASSAM,BISWANATH,2021-03-17,0,21,0,21
ASSAM,BISWANATH,2021-03-18,0,18,0,18
ASSAM,BISWANATH,2021-03-19,0,9,0,9
ASSAM,BISWANATH,2021-03-20,0,36,0,36
ASSAM,BONGAIGAON,2021-03-16,1,170,0,171
ASSAM,BONGAIGAON,2021-03-17,1,122,0,123
ASSAM,BONGAIGAON,2021-03-18,0,180,0,180
ASSAM,BONGAIGAON,2021-03-19,0,160,0,160
ASSAM,BONGAIGAON,2021-03-20,0,84,0,84
ASSAM,CACHAR,2021-03-16,6,9300,15,9321
ASSAM,CACHAR,2021-03-17,0,278,61,339
ASSAM,CACHAR,2021-03-18,0,5205,32,5237
ASSAM,CACHAR,2021-03-19,3,5352,40,5395
ASSAM,CACHAR,2021-03-20,0,153,5,158
ASSAM,CHARAIDEO,2021-03-16,0,9,0,9
ASSAM,CHARAIDEO,2021-03-17,0,35,0,35
ASSAM,CHARAIDEO,2021-03-18,0,70,0,70
ASSAM,CHARAIDEO,2021-03-19,1,18,0,19
ASSAM,CHARAIDEO,2021-03-20,3,64,0,67
ASSAM,CHIRANG,2021-03-16,0,36,0,36
ASSAM,CHIRANG,2021-03-17,0,61,0,61
ASSAM,CHIRANG,2021-03-18,0,110,0,110
ASSAM,CHIRANG,2021-03-19,1,80,0,81
ASSAM,CHIRANG,2021-03-20,0,33,0,33
ASSAM,DARRANG,2021-03-16,0,393,0,393
ASSAM,DARRANG,2021-03-17,0,402,0,402
ASSAM,DARRANG,2021-03-18,1,400,0,401
ASSAM,DARRANG,2021-03-19,0,408,0,408
ASSAM,DARRANG,2021-03-20,0,355,0,355
ASSAM,DHEMAJI,2021-03-16,0,56,0,56
ASSAM,DHEMAJI,2021-03-17,0,19,0,19
ASSAM,DHEMAJI,2021-03-18,0,18,0,18
ASSAM,DHEMAJI,2021-03-19,0,28,0,28
ASSAM,DHEMAJI,2021-03-20,0,16,0,16
ASSAM,DHUBRI,2021-03-16,0,194,0,194
ASSAM,DHUBRI,2021-03-17,1,221,0,222
ASSAM,DHUBRI,2021-03-18,0,155,0,155
ASSAM,DHUBRI,2021-03-19,0,196,0,196
ASSAM,DHUBRI,2021-03-20,0,227,0,227
ASSAM,DIBRUGARH,2021-03-16,1,202,0,203
ASSAM,DIBRUGARH,2021-03-17,5,182,0,187
ASSAM,DIBRUGARH,2021-03-18,1,210,1,212
ASSAM,DIBRUGARH,2021-03-19,5,266,0,271
ASSAM,DIBRUGARH,2021-03-20,9,318,0,327
ASSAM,DIMA HASAO,2021-03-16,0,17,0,17
ASSAM,DIMA HASAO,2021-03-17,0,17,0,17
ASSAM,DIMA HASAO,2021-03-18,0,14,0,14
ASSAM,DIMA HASAO,2021-03-19,0,9,0,9
ASSAM,DIMA HASAO,2021-03-20,0,23,0,23
ASSAM,GOALPARA,2021-03-16,0,275,0,275
ASSAM,GOALPARA,2021-03-17,0,281,0,281
ASSAM,GOALPARA,2021-03-18,0,194,0,194
ASSAM,GOALPARA,2021-03-19,0,294,0,294
ASSAM,GOALPARA,2021-03-20,0,217,0,217
ASSAM,GOLAGHAT,2021-03-16,0,103,0,103
ASSAM,GOLAGHAT,2021-03-17,1,149,0,150
ASSAM,GOLAGHAT,2021-03-18,0,89,0,89
ASSAM,GOLAGHAT,2021-03-19,0,128,0,128
ASSAM,GOLAGHAT,2021-03-20,1,49,1,51
ASSAM,HAILAKANDI,2021-03-16,0,330,1,331
ASSAM,HAILAKANDI,2021-03-17,0,441,51,492
ASSAM,HAILAKANDI,2021-03-18,0,315,0,315
ASSAM,HAILAKANDI,2021-03-19,0,280,0,280
ASSAM,HAILAKANDI,2021-03-20,1,314,0,315
ASSAM,HOJAI,2021-03-16,0,136,0,136
ASSAM,HOJAI,2021-03-17,0,156,0,156
ASSAM,HOJAI,2021-03-18,0,108,0,108
ASSAM,HOJAI,2021-03-19,2,65,0,67
ASSAM,HOJAI,2021-03-20,0,82,0,82
ASSAM,JORHAT,2021-03-16,3,302,0,305
ASSAM,JORHAT,2021-03-17,8,259,0,267
ASSAM,JORHAT,2021-03-18,10,270,0,280
ASSAM,JORHAT,2021-03-19,4,278,0,282
ASSAM,JORHAT,2021-03-20,8,257,0,265
ASSAM,KAMRUP,2021-03-16,0,622,0,622
ASSAM,KAMRUP,2021-03-17,1,542,2,545
ASSAM,KAMRUP,2021-03-18,1,457,0,458
ASSAM,KAMRUP,2021-03-19,1,565,0,566
ASSAM,KAMRUP,2021-03-20,4,490,0,494
ASSAM,KAMRUP METRO,2021-03-16,11,1510,1,1522
ASSAM,KAMRUP METRO,2021-03-17,9,1145,2,1156
ASSAM,KAMRUP METRO,2021-03-18,19,1318,0,1337
ASSAM,KAMRUP METRO,2021-03-19,8,1793,1,1802
ASSAM,KAMRUP METRO,2021-03-20,5,1410,0,1415
ASSAM,KARBI ANGLONG,2021-03-16,0,11,0,11
ASSAM,KARBI ANGLONG,2021-03-17,0,37,0,37
ASSAM,KARBI ANGLONG,2021-03-18,0,13,0,13
ASSAM,KARBI ANGLONG,2021-03-19,0,15,0,15
ASSAM,KARBI ANGLONG,2021-03-20,0,19,0,19
ASSAM,KARIMGANJ,2021-03-16,2,269,1,272
ASSAM,KARIMGANJ,2021-03-17,0,195,0,195
ASSAM,KARIMGANJ,2021-03-18,0,194,187,381
ASSAM,KARIMGANJ,2021-03-19,0,231,0,231
ASSAM,KARIMGANJ,2021-03-20,0,131,0,131
ASSAM,KOKRAJHAR,2021-03-16,0,17,0,17
ASSAM,KOKRAJHAR,2021-03-17,0,30,0,30
ASSAM,KOKRAJHAR,2021-03-18,0,16,0,16
ASSAM,KOKRAJHAR,2021-03-19,0,22,0,22
ASSAM,KOKRAJHAR,2021-03-20,0,23,0,23
ASSAM,LAKHIMPUR,2021-03-16,0,235,0,235
ASSAM,LAKHIMPUR,2021-03-17,0,223,0,223
ASSAM,LAKHIMPUR,2021-03-18,0,197,0,197
ASSAM,LAKHIMPUR,2021-03-19,0,175,0,175
ASSAM,LAKHIMPUR,2021-03-20,0,158,0,158
ASSAM,MAJULI,2021-03-16,0,10,0,10
ASSAM,MAJULI,2021-03-17,0,8,1,9
ASSAM,MAJULI,2021-03-18,0,3,0,3
ASSAM,MAJULI,2021-03-19,0,3,0,3
ASSAM,MARIGAON,2021-03-16,0,126,0,126
ASSAM,MARIGAON,2021-03-17,0,90,0,90
ASSAM,MARIGAON,2021-03-18,0,104,0,104
ASSAM,MARIGAON,2021-03-19,0,104,0,104
ASSAM,MARIGAON,2021-03-20,0,65,0,65
ASSAM,NAGAON,2021-03-16,2,199,0,201
ASSAM,NAGAON,2021-03-17,0,212,0,212
ASSAM,NAGAON,2021-03-18,3,210,0,213
ASSAM,NAGAON,2021-03-19,0,169,0,169
ASSAM,NAGAON,2021-03-20,1,707,0,708
ASSAM,NALBARI,2021-03-16,0,39,0,39
ASSAM,NALBARI,2021-03-17,0,37,0,37
ASSAM,NALBARI,2021-03-18,0,79,0,79
ASSAM,NALBARI,2021-03-19,0,54,0,54
ASSAM,NALBARI,2021-03-20,1,97,0,98
ASSAM,SIVASAGAR,2021-03-16,0,52,0,52
ASSAM,SIVASAGAR,2021-03-17,0,186,0,186
ASSAM,SIVASAGAR,2021-03-18,1,111,0,112
ASSAM,SIVASAGAR,2021-03-19,0,124,0,124
ASSAM,SIVASAGAR,2021-03-20,0,95,0,95
ASSAM,SONITPUR,2021-03-16,1,161,0,162
ASSAM,SONITPUR,2021-03-17,1,116,0,117
ASSAM,SONITPUR,2021-03-18,0,137,0,137
ASSAM,SONITPUR,2021-03-19,1,75,0,76
ASSAM,SONITPUR,2021-03-20,0,63,0,63
ASSAM,SOUTH SALMARA MANCACHAR,2021-03-16,0,23,0,23
ASSAM,SOUTH SALMARA MANCACHAR,2021-03-17,0,12,0,12
ASSAM,SOUTH SALMARA MANCACHAR,2021-03-18,0,16,0,16
ASSAM,SOUTH SALMARA MANCACHAR,2021-03-19,0,8,0,8
ASSAM,SOUTH SALMARA MANCACHAR,2021-03-20,0,11,0,11
ASSAM,TINSUKIA,2021-03-16,1,110,0,111
ASSAM,TINSUKIA,2021-03-17,1,162,0,163
ASSAM,TINSUKIA,2021-03-18,1,359,1,361
ASSAM,TINSUKIA,2021-03-19,0,203,2,205
ASSAM,TINSUKIA,2021-03-20,2,370,5,377
ASSAM,UDALGURI,2021-03-16,0,3,0,3
ASSAM,UDALGURI,2021-03-17,0,6,0,6
ASSAM,UDALGURI,2021-03-18,0,9,0,9
ASSAM,UDALGURI,2021-03-19,0,8,0,8
ASSAM,UDALGURI,2021-03-20,1,5,0,6
ASSAM,WEST KARBI ANGLONG,2021-03-16,0,2,0,2
ASSAM,WEST KARBI ANGLONG,2021-03-17,0,1,0,1
ASSAM,WEST KARBI ANGLONG,2021-03-18,0,1,0,1
ASSAM,WEST KARBI ANGLONG,2021-03-19,0,9,0,9
ASSAM,WEST KARBI ANGLONG,2021-03-20,0,2,0,2
BIHAR,ARARIA,2021-03-16,0,778,0,778
BIHAR,ARARIA,2021-03-17,1,565,0,566
BIHAR,ARARIA,2021-03-18,4,793,0,797
BIHAR,ARARIA,2021-03-19,0,857,0,857
BIHAR,ARARIA,2021-03-20,6,691,0,697
BIHAR,ARWAL,2021-03-16,0,486,9,495
BIHAR,ARWAL,2021-03-17,1,600,0,601
BIHAR,ARWAL,2021-03-18,0,344,1,345
BIHAR,ARWAL,2021-03-19,0,528,0,528
BIHAR,ARWAL,2021-03-20,0,355,4,359
BIHAR,AURANGABAD,2021-03-16,2,953,0,955
BIHAR,AURANGABAD,2021-03-17,2,1242,0,1244
BIHAR,AURANGABAD,2021-03-18,1,774,4,779
BIHAR,AURANGABAD,2021-03-19,1,429,0,430
BIHAR,AURANGABAD,2021-03-20,3,404,0,407
BIHAR,BANKA,2021-03-16,0,1150,0,1150
BIHAR,BANKA,2021-03-17,0,1614,0,1614
BIHAR,BANKA,2021-03-18,1,1267,0,1268
BIHAR,BANKA,2021-03-19,0,393,0,393
BIHAR,BANKA,2021-03-20,0,650,0,650
BIHAR,BEGUSARAI,2021-03-16,2,1100,0,1102
BIHAR,BEGUSARAI,2021-03-17,2,1593,1,1596
BIHAR,BEGUSARAI,2021-03-18,5,1436,0,1441
BIHAR,BEGUSARAI,2021-03-19,5,1935,0,1940
BIHAR,BEGUSARAI,2021-03-20,1,833,0,834
BIHAR,BHAGALPUR,2021-03-16,17,509,101,627
BIHAR,BHAGALPUR,2021-03-17,17,1742,24,1783
BIHAR,BHAGALPUR,2021-03-18,8,1412,14,1434
BIHAR,BHAGALPUR,2021-03-19,4,1294,57,1355
BIHAR,BHAGALPUR,2021-03-20,15,570,37,622
BIHAR,BHOJPUR,2021-03-16,3,1596,0,1599
BIHAR,BHOJPUR,2021-03-17,3,1885,28,1916
BIHAR,BHOJPUR,2021-03-18,3,2538,462,3003
BIHAR,BHOJPUR,2021-03-19,2,1934,230,2166
BIHAR,BHOJPUR,2021-03-20,0,2263,20,2283
BIHAR,BUXAR,2021-03-16,1,540,2,543
BIHAR,BUXAR,2021-03-17,2,478,5,485
BIHAR,BUXAR,2021-03-18,1,860,5,866
BIHAR,BUXAR,2021-03-19,0,660,0,660
BIHAR,BUXAR,2021-03-20,2,985,53,1040
BIHAR,DARBHANGA,2021-03-16,3,616,0,619
BIHAR,DARBHANGA,2021-03-17,2,1060,0,1062
BIHAR,DARBHANGA,2021-03-18,7,656,9,672
BIHAR,DARBHANGA,2021-03-19,3,700,1,704
BIHAR,DARBHANGA,2021-03-20,4,979,3,986
BIHAR,GAYA,2021-03-16,3,3833,12,3848
BIHAR,GAYA,2021-03-17,6,2958,6,2970
BIHAR,GAYA,2021-03-18,5,2280,14,2299
BIHAR,GAYA,2021-03-19,6,2624,3,2633
BIHAR,GAYA,2021-03-20,14,5862,53,5929
BIHAR,GOPALGANJ,2021-03-16,0,951,5,956
BIHAR,GOPALGANJ,2021-03-17,2,2980,8,2990
BIHAR,GOPALGANJ,2021-03-18,3,2895,14,2912
BIHAR,GOPALGANJ,2021-03-19,1,2040,5,2046
BIHAR,GOPALGANJ,2021-03-20,1,1703,5,1709
BIHAR,JAMUI,2021-03-16,1,393,0,394
BIHAR,JAMUI,2021-03-17,0,1302,0,1302
BIHAR,JAMUI,2021-03-18,2,1008,0,1010
BIHAR,JAMUI,2021-03-19,0,1038,0,1038
BIHAR,JAMUI,2021-03-20,1,1091,0,1092
BIHAR,JEHANABAD,2021-03-16,0,763,0,763
BIHAR,JEHANABAD,2021-03-17,0,264,0,264
BIHAR,JEHANABAD,2021-03-18,1,881,0,882
BIHAR,JEHANABAD,2021-03-19,0,433,5,438
BIHAR,JEHANABAD,2021-03-20,1,740,18,759
BIHAR,KAIMUR (BHABUA),2021-03-16,1,640,0,641
BIHAR,KAIMUR (BHABUA),2021-03-17,0,392,0,392
BIHAR,KAIMUR (BHABUA),2021-03-18,1,1577,0,1578
BIHAR,KAIMUR (BHABUA),2021-03-19,4,355,0,359
BIHAR,KAIMUR (BHABUA),2021-03-20,0,1229,0,1229
BIHAR,KATIHAR,2021-03-16,2,1400,1,1403
BIHAR,KATIHAR,2021-03-17,5,1729,0,1734
BIHAR,KATIHAR,2021-03-18,4,3637,0,3641
BIHAR,KATIHAR,2021-03-19,0,1438,0,1438
BIHAR,KATIHAR,2021-03-20,0,876,1,877
BIHAR,KHAGARIA,2021-03-16,0,577,0,577
BIHAR,KHAGARIA,2021-03-17,0,651,0,651
BIHAR,KHAGARIA,2021-03-18,2,295,0,297
BIHAR,KHAGARIA,2021-03-19,1,327,1,329
BIHAR,KHAGARIA,2021-03-20,0,744,1,745
BIHAR,KISHANGANJ,2021-03-16,0,213,0,213
BIHAR,KISHANGANJ,2021-03-17,5,461,0,466
BIHAR,KISHANGANJ,2021-03-18,3,527,0,530
BIHAR,KISHANGANJ,2021-03-19,0,803,1,804
BIHAR,KISHANGANJ,2021-03-20,3,410,0,413
BIHAR,LAKHISARAI,2021-03-16,0,224,0,224
BIHAR,LAKHISARAI,2021-03-17,0,327,0,327
BIHAR,LAKHISARAI,2021-03-18,0,165,0,165
BIHAR,LAKHISARAI,2021-03-19,0,216,0,216
BIHAR,LAKHISARAI,2021-03-20,1,521,0,522
BIHAR,MADHEPURA,2021-03-16,0,1513,0,1513
BIHAR,MADHEPURA,2021-03-17,3,1642,0,1645
BIHAR,MADHEPURA,2021-03-18,2,1170,0,1172
BIHAR,MADHEPURA,2021-03-19,1,1889,0,1890
BIHAR,MADHEPURA,2021-03-20,1,1139,0,1140
BIHAR,MADHUBANI,2021-03-16,0,1296,4,1300
BIHAR,MADHUBANI,2021-03-17,2,695,7,704
BIHAR,MADHUBANI,2021-03-18,5,1290,6,1301
BIHAR,MADHUBANI,2021-03-19,2,852,3,857
BIHAR,MADHUBANI,2021-03-20,1,1896,9,1906
BIHAR,MUNGER,2021-03-16,2,734,13,749
BIHAR,MUNGER,2021-03-17,4,1008,4,1016
BIHAR,MUNGER,2021-03-18,1,1050,5,1056
BIHAR,MUNGER,2021-03-19,8,1020,1,1029
BIHAR,MUNGER,2021-03-20,3,1282,32,1317
BIHAR,MUZAFFARPUR,2021-03-16,2,1159,0,1161
BIHAR,MUZAFFARPUR,2021-03-17,1,620,0,621
BIHAR,MUZAFFARPUR,2021-03-18,0,1236,0,1236
BIHAR,MUZAFFARPUR,2021-03-19,3,686,0,689
BIHAR,MUZAFFARPUR,2021-03-20,3,1819,0,1822
BIHAR,NALANDA,2021-03-16,1,1335,8,1344
BIHAR,NALANDA,2021-03-17,3,1818,46,1867
BIHAR,NALANDA,2021-03-18,2,2113,6,2121
BIHAR,NALANDA,2021-03-19,2,3431,0,3433
BIHAR,NALANDA,2021-03-20,4,2229,0,2233
BIHAR,NAWADA,2021-03-16,0,478,0,478
BIHAR,NAWADA,2021-03-17,2,1268,3,1273
BIHAR,NAWADA,2021-03-18,2,1096,0,1098
BIHAR,NAWADA,2021-03-19,7,939,2,948
BIHAR,NAWADA,2021-03-20,5,1810,0,1815
BIHAR,PASHCHIM CHAMPARAN,2021-03-16,3,665,23,691
BIHAR,PASHCHIM CHAMPARAN,2021-03-17,2,490,0,492
BIHAR,PASHCHIM CHAMPARAN,2021-03-18,2,666,0,668
BIHAR,PASHCHIM CHAMPARAN,2021-03-19,0,1290,0,1290
BIHAR,PASHCHIM CHAMPARAN,2021-03-20,0,1395,0,1395
BIHAR,PATNA,2021-03-16,21,2600,1,2622
BIHAR,PATNA,2021-03-17,48,2660,1,2709
BIHAR,PATNA,2021-03-18,43,3571,4,3618
BIHAR,PATNA,2021-03-19,51,3096,8,3155
BIHAR,PATNA,2021-03-20,53,3397,5,3455
BIHAR,PURBI CHAMPARAN,2021-03-16,0,1664,0,1664
BIHAR,PURBI CHAMPARAN,2021-03-17,3,1697,0,1700
BIHAR,PURBI CHAMPARAN,2021-03-18,4,2284,3,2291
BIHAR,PURBI CHAMPARAN,2021-03-19,4,2108,0,2112
BIHAR,PURBI CHAMPARAN,2021-03-20,0,2271,3,2274
BIHAR,PURNIA,2021-03-16,5,690,35,730
BIHAR,PURNIA,2021-03-17,1,677,0,678
BIHAR,PURNIA,2021-03-18,2,777,25,804
BIHAR,PURNIA,2021-03-19,5,905,47,957
BIHAR,PURNIA,2021-03-20,1,872,0,873
BIHAR,ROHTAS,2021-03-16,2,1787,0,1789
BIHAR,ROHTAS,2021-03-17,3,1625,0,1628
BIHAR,ROHTAS,2021-03-18,4,1075,0,1079
BIHAR,ROHTAS,2021-03-19,5,864,0,869
BIHAR,ROHTAS,2021-03-20,6,3012,0,3018
BIHAR,SAHARSA,2021-03-16,0,653,0,653
BIHAR,SAHARSA,2021-03-17,0,625,0,625
BIHAR,SAHARSA,2021-03-18,6,840,0,846
BIHAR,SAHARSA,2021-03-19,3,1322,0,1325
BIHAR,SAHARSA,2021-03-20,0,596,0,596
BIHAR,SAMASTIPUR,2021-03-16,1,1107,14,1122
BIHAR,SAMASTIPUR,2021-03-17,2,1539,9,1550
BIHAR,SAMASTIPUR,2021-03-18,3,1772,12,1787
BIHAR,SAMASTIPUR,2021-03-19,3,1846,40,1889
BIHAR,SAMASTIPUR,2021-03-20,5,1764,47,1816
BIHAR,SARAN,2021-03-16,0,1158,0,1158
BIHAR,SARAN,2021-03-17,1,1123,0,1124
BIHAR,SARAN,2021-03-18,1,1316,0,1317
BIHAR,SARAN,2021-03-19,0,1450,1,1451
BIHAR,SARAN,2021-03-20,1,1081,1,1083
BIHAR,SHEIKHPURA,2021-03-16,0,229,4,233
BIHAR,SHEIKHPURA,2021-03-17,2,570,52,624
BIHAR,SHEIKHPURA,2021-03-18,0,286,6,292
BIHAR,SHEIKHPURA,2021-03-19,1,690,7,698
BIHAR,SHEIKHPURA,2021-03-20,0,533,46,579
BIHAR,SHEOHAR,2021-03-16,0,47,0,47
BIHAR,SHEOHAR,2021-03-17,0,647,0,647
BIHAR,SHEOHAR,2021-03-18,1,290,0,291
BIHAR,SHEOHAR,2021-03-19,8,904,0,912
BIHAR,SHEOHAR,2021-03-20,1,536,0,537
BIHAR,SITAMARHI,2021-03-16,0,861,29,890
BIHAR,SITAMARHI,2021-03-17,3,801,0,804
BIHAR,SITAMARHI,2021-03-18,0,1416,1,1417
BIHAR,SITAMARHI,2021-03-19,2,852,1,855
BIHAR,SITAMARHI,2021-03-20,1,1586,4,1591
BIHAR,SIWAN,2021-03-16,5,2964,2,2971
BIHAR,SIWAN,2021-03-17,9,1793,0,1802
BIHAR,SIWAN,2021-03-18,7,2081,2,2090
BIHAR,SIWAN,2021-03-19,3,1607,3,1613
BIHAR,SIWAN,2021-03-20,4,2491,0,2495
BIHAR,SUPAUL,2021-03-16,0,876,7,883
BIHAR,SUPAUL,2021-03-17,0,1019,3,1022
BIHAR,SUPAUL,2021-03-18,1,1293,1,1295
BIHAR,SUPAUL,2021-03-19,0,1324,1,1325
BIHAR,SUPAUL,2021-03-20,2,1328,72,1402
BIHAR,VAISHALI,2021-03-16,3,1644,65,1712
BIHAR,VAISHALI,2021-03-17,2,3383,899,4284
BIHAR,VAISHALI,2021-03-18,2,3376,80,3458
BIHAR,VAISHALI,2021-03-19,2,2091,14,2107
BIHAR,VAISHALI,2021-03-20,1,2000,0,2001
CHANDIGARH,CHANDIGARH,2021-03-16,190,2005,25,2220
CHANDIGARH,CHANDIGARH,2021-03-17,227,1762,9,1998
CHANDIGARH,CHANDIGARH,2021-03-18,242,1386,26,1654
CHANDIGARH,CHANDIGARH,2021-03-19,252,1534,20,1806
CHANDIGARH,CHANDIGARH,2021-03-20,297,1890,44,2231
CHHATTISGARH,BALOD,2021-03-16,6,802,0,808
CHHATTISGARH,BALOD,2021-03-17,10,952,0,962
CHHATTISGARH,BALOD,2021-03-18,9,1226,0,1235
CHHATTISGARH,BALOD,2021-03-19,9,1699,1,1709
CHHATTISGARH,BALOD,2021-03-20,14,1255,2,1271
CHHATTISGARH,BALODA BAZAR,2021-03-16,11,653,2,666
CHHATTISGARH,BALODA BAZAR,2021-03-17,17,444,2,463
CHHATTISGARH,BALODA BAZAR,2021-03-18,13,659,5,677
CHHATTISGARH,BALODA BAZAR,2021-03-19,19,455,1,475
CHHATTISGARH,BALODA BAZAR,2021-03-20,20,643,1,664
CHHATTISGARH,BALRAMPUR,2021-03-16,8,801,4,813
CHHATTISGARH,BALRAMPUR,2021-03-17,6,496,0,502
CHHATTISGARH,BALRAMPUR,2021-03-18,14,631,5,650
CHHATTISGARH,BALRAMPUR,2021-03-19,4,664,7,675
CHHATTISGARH,BALRAMPUR,2021-03-20,2,312,0,314
CHHATTISGARH,BASTAR,2021-03-16,5,1780,0,1785
CHHATTISGARH,BASTAR,2021-03-17,9,1940,1,1950
CHHATTISGARH,BASTAR,2021-03-18,9,1700,0,1709
CHHATTISGARH,BASTAR,2021-03-19,9,1696,0,1705
CHHATTISGARH,BASTAR,2021-03-20,15,1679,0,1694
CHHATTISGARH,BEMETARA,2021-03-16,8,401,0,409
CHHATTISGARH,BEMETARA,2021-03-17,21,292,1,314
CHHATTISGARH,BEMETARA,2021-03-18,19,1029,0,1048
CHHATTISGARH,BEMETARA,2021-03-19,25,1032,0,1057
CHHATTISGARH,BEMETARA,2021-03-20,31,250,0,281
CHHATTISGARH,BIJAPUR,2021-03-16,0,352,0,352
CHHATTISGARH,BIJAPUR,2021-03-17,0,148,0,148
CHHATTISGARH,BIJAPUR,2021-03-18,0,659,0,659
CHHATTISGARH,BIJAPUR,2021-03-19,2,313,0,315
CHHATTISGARH,BIJAPUR,2021-03-20,0,359,2,361
CHHATTISGARH,BILASPUR,2021-03-16,64,2533,18,2615
CHHATTISGARH,BILASPUR,2021-03-17,59,2340,3,2402
CHHATTISGARH,BILASPUR,2021-03-18,81,2268,11,2360
CHHATTISGARH,BILASPUR,2021-03-19,49,2171,42,2262
CHHATTISGARH,BILASPUR,2021-03-20,51,2641,5,2697
CHHATTISGARH,DANTEWADA,2021-03-16,1,269,0,270
CHHATTISGARH,DANTEWADA,2021-03-17,2,442,0,444
CHHATTISGARH,DANTEWADA,2021-03-18,2,389,0,391
CHHATTISGARH,DANTEWADA,2021-03-19,0,230,0,230
CHHATTISGARH,DANTEWADA,2021-03-20,4,227,0,231
CHHATTISGARH,DHAMTARI,2021-03-16,28,879,6,913
CHHATTISGARH,DHAMTARI,2021-03-17,18,893,4,915
CHHATTISGARH,DHAMTARI,2021-03-18,36,959,17,1012
CHHATTISGARH,DHAMTARI,2021-03-19,29,1271,21,1321
CHHATTISGARH,DHAMTARI,2021-03-20,18,862,41,921
CHHATTISGARH,DURG,2021-03-16,228,1146,1,1375
CHHATTISGARH,DURG,2021-03-17,233,1410,7,1650
CHHATTISGARH,DURG,2021-03-18,306,1289,0,1595
CHHATTISGARH,DURG,2021-03-19,331,1286,4,1621
CHHATTISGARH,DURG,2021-03-20,454,1497,1,1952
CHHATTISGARH,GARIYABAND,2021-03-16,7,240,5,252
CHHATTISGARH,GARIYABAND,2021-03-17,10,318,7,335
CHHATTISGARH,GARIYABAND,2021-03-18,1,382,3,386
CHHATTISGARH,GARIYABAND,2021-03-19,6,326,4,336
CHHATTISGARH,GARIYABAND,2021-03-20,4,506,5,515
CHHATTISGARH,GAURELLA PENDRA MARWAHI,2021-03-16,1,782,0,783
CHHATTISGARH,GAURELLA PENDRA MARWAHI,2021-03-17,0,735,0,735
CHHATTISGARH,GAURELLA PENDRA MARWAHI,2021-03-18,0,431,5,436
CHHATTISGARH,GAURELLA PENDRA MARWAHI,2021-03-19,15,465,3,483
CHHATTISGARH,GAURELLA PENDRA MARWAHI,2021-03-20,8,916,1,925
CHHATTISGARH,JANJGIR CHAMPA,2021-03-16,12,2794,2,2808
CHHATTISGARH,JANJGIR CHAMPA,2021-03-17,22,2880,1,2903
CHHATTISGARH,JANJGIR CHAMPA,2021-03-18,9,3109,5,3123
CHHATTISGARH,JANJGIR CHAMPA,2021-03-19,2,2194,3,2199
CHHATTISGARH,JANJGIR CHAMPA,2021-03-20,6,1843,0,1849
CHHATTISGARH,JASHPUR,2021-03-16,8,495,103,606
CHHATTISGARH,JASHPUR,2021-03-17,25,571,1,597
CHHATTISGARH,JASHPUR,2021-03-18,14,398,0,412
CHHATTISGARH,JASHPUR,2021-03-19,36,461,2,499
CHHATTISGARH,JASHPUR,2021-03-20,24,468,1,493
CHHATTISGARH,KABIRDHAM,2021-03-16,2,138,0,140
CHHATTISGARH,KABIRDHAM,2021-03-17,6,122,0,128
CHHATTISGARH,KABIRDHAM,2021-03-18,7,1406,0,1413
CHHATTISGARH,KABIRDHAM,2021-03-19,5,457,0,462
CHHATTISGARH,KABIRDHAM,2021-03-20,6,911,0,917
CHHATTISGARH,KANKER,2021-03-16,7,1685,0,1692
CHHATTISGARH,KANKER,2021-03-17,8,2106,0,2114
CHHATTISGARH,KANKER,2021-03-18,3,1462,0,1465
CHHATTISGARH,KANKER,2021-03-19,12,1622,0,1634
CHHATTISGARH,KANKER,2021-03-20,13,1625,0,1638
CHHATTISGARH,KONDAGAON,2021-03-16,0,266,0,266
CHHATTISGARH,KONDAGAON,2021-03-17,2,698,0,700
CHHATTISGARH,KONDAGAON,2021-03-18,5,903,2,910
CHHATTISGARH,KONDAGAON,2021-03-19,3,920,0,923
CHHATTISGARH,KONDAGAON,2021-03-20,2,912,0,914
CHHATTISGARH,KORBA,2021-03-16,9,930,1,940
CHHATTISGARH,KORBA,2021-03-17,4,732,0,736
CHHATTISGARH,KORBA,2021-03-18,17,1663,0,1680
CHHATTISGARH,KORBA,2021-03-19,32,2169,1,2202
CHHATTISGARH,KORBA,2021-03-20,17,1666,0,1683
CHHATTISGARH,KOREA,2021-03-16,17,555,1,573
CHHATTISGARH,KOREA,2021-03-17,25,520,1,546
CHHATTISGARH,KOREA,2021-03-18,37,655,2,694
CHHATTISGARH,KOREA,2021-03-19,16,486,0,502
CHHATTISGARH,KOREA,2021-03-20,24,646,6,676
CHHATTISGARH,MAHASAMUND,2021-03-16,17,1098,8,1123
CHHATTISGARH,MAHASAMUND,2021-03-17,21,917,4,942
CHHATTISGARH,MAHASAMUND,2021-03-18,23,1071,1,1095
CHHATTISGARH,MAHASAMUND,2021-03-19,28,1280,3,1311
CHHATTISGARH,MAHASAMUND,2021-03-20,17,935,6,958
CHHATTISGARH,MUNGELI,2021-03-16,12,472,0,484
CHHATTISGARH,MUNGELI,2021-03-17,2,417,23,442
CHHATTISGARH,MUNGELI,2021-03-18,9,479,0,488
CHHATTISGARH,MUNGELI,2021-03-19,10,434,0,444
CHHATTISGARH,MUNGELI,2021-03-20,13,600,1,614
CHHATTISGARH,NARAYANPUR,2021-03-16,3,133,0,136
CHHATTISGARH,NARAYANPUR,2021-03-17,0,222,0,222
CHHATTISGARH,NARAYANPUR,2021-03-18,1,119,0,120
CHHATTISGARH,NARAYANPUR,2021-03-19,2,23,0,25
CHHATTISGARH,NARAYANPUR,2021-03-20,1,125,0,126
CHHATTISGARH,RAIGARH,2021-03-16,25,2062,9,2096
CHHATTISGARH,RAIGARH,2021-03-17,20,1412,17,1449
CHHATTISGARH,RAIGARH,2021-03-18,11,1519,6,1536
CHHATTISGARH,RAIGARH,2021-03-19,18,1453,4,1475
CHHATTISGARH,RAIGARH,2021-03-20,21,1264,11,1296
CHHATTISGARH,RAIPUR,2021-03-16,363,2334,28,2725
CHHATTISGARH,RAIPUR,2021-03-17,379,2245,25,2649
CHHATTISGARH,RAIPUR,2021-03-18,416,2809,42,3267
CHHATTISGARH,RAIPUR,2021-03-19,491,2544,34,3069
CHHATTISGARH,RAIPUR,2021-03-20,389,2286,51,2726
CHHATTISGARH,RAJNANDGAON,2021-03-16,27,570,68,665
CHHATTISGARH,RAJNANDGAON,2021-03-17,46,708,13,767
CHHATTISGARH,RAJNANDGAON,2021-03-18,64,1521,36,1621
CHHATTISGARH,RAJNANDGAON,2021-03-19,47,1501,31,1579
CHHATTISGARH,RAJNANDGAON,2021-03-20,70,1566,25,1661
CHHATTISGARH,SUKMA,2021-03-16,0,514,0,514
CHHATTISGARH,SUKMA,2021-03-17,0,341,0,341
CHHATTISGARH,SUKMA,2021-03-18,0,64,0,64
CHHATTISGARH,SUKMA,2021-03-19,0,594,0,594
CHHATTISGARH,SUKMA,2021-03-20,0,145,0,145
CHHATTISGARH,SURAJPUR,2021-03-16,9,1022,1,1032
CHHATTISGARH,SURAJPUR,2021-03-17,10,1185,1,1196
CHHATTISGARH,SURAJPUR,2021-03-18,30,814,0,844
CHHATTISGARH,SURAJPUR,2021-03-19,14,899,0,913
CHHATTISGARH,SURAJPUR,2021-03-20,17,725,0,742
CHHATTISGARH,SURGUJA,2021-03-16,43,1044,1,1088
CHHATTISGARH,SURGUJA,2021-03-17,36,939,2,977
CHHATTISGARH,SURGUJA,2021-03-18,61,1157,16,1234
CHHATTISGARH,SURGUJA,2021-03-19,55,947,22,1024
CHHATTISGARH,SURGUJA,2021-03-20,53,1351,4,1408
DADRA AND NAGAR HAVELI,DADRA AND NAGAR HAVELI,2021-03-16,1,310,0,311
DADRA AND NAGAR HAVELI,DADRA AND NAGAR HAVELI,2021-03-17,4,238,0,242
DADRA AND NAGAR HAVELI,DADRA AND NAGAR HAVELI,2021-03-18,6,267,0,273
DADRA AND NAGAR HAVELI,DADRA AND NAGAR HAVELI,2021-03-19,6,226,0,232
DADRA AND NAGAR HAVELI,DADRA AND NAGAR HAVELI,2021-03-20,7,251,0,258
DAMAN AND DIU,DAMAN,2021-03-16,4,173,0,177
DAMAN AND DIU,DAMAN,2021-03-17,5,171,0,176
DAMAN AND DIU,DAMAN,2021-03-18,1,42,0,43
DAMAN AND DIU,DAMAN,2021-03-19,7,152,1,160
DAMAN AND DIU,DAMAN,2021-03-20,2,178,0,180
DAMAN AND DIU,DIU,2021-03-16,0,21,0,21
DAMAN AND DIU,DIU,2021-03-17,0,26,0,26
DAMAN AND DIU,DIU,2021-03-18,1,28,0,29
DAMAN AND DIU,DIU,2021-03-19,0,27,0,27
DAMAN AND DIU,DIU,2021-03-20,0,23,0,23
DELHI,CENTRAL,2021-03-16,20,6786,6,6812
DELHI,CENTRAL,2021-03-17,21,6865,11,6897
DELHI,CENTRAL,2021-03-18,37,5869,9,5915
DELHI,CENTRAL,2021-03-19,35,6543,30,6608
DELHI,CENTRAL,2021-03-20,37,6183,10,6230
DELHI,EAST,2021-03-16,58,5605,1,5664
DELHI,EAST,2021-03-17,40,4314,12,4366
DELHI,EAST,2021-03-18,46,5284,35,5365
DELHI,EAST,2021-03-19,70,4461,17,4548
DELHI,EAST,2021-03-20,105,5904,6,6015
DELHI,NEW DELHI,2021-03-16,75,5969,14,6058
DELHI,NEW DELHI,2021-03-17,75,5764,12,5851
DELHI,NEW DELHI,2021-03-18,111,6215,9,6335
DELHI,NEW DELHI,2021-03-19,121,6569,26,6716
DELHI,NEW DELHI,2021-03-20,95,7073,4,7172
DELHI,NORTH,2021-03-16,20,8015,8,8043
DELHI,NORTH,2021-03-17,39,8840,12,8891
DELHI,NORTH,2021-03-18,45,7680,6,7731
DELHI,NORTH,2021-03-19,73,7956,7,8036
DELHI,NORTH,2021-03-20,53,7798,6,7857
DELHI,NORTH EAST,2021-03-16,5,5211,17,5233
DELHI,NORTH EAST,2021-03-17,14,4932,2,4948
DELHI,NORTH EAST,2021-03-18,16,4356,2,4374
DELHI,NORTH EAST,2021-03-19,9,3295,0,3304
DELHI,NORTH EAST,2021-03-20,20,6124,3,6147
DELHI,NORTH WEST,2021-03-16,91,9669,20,9780
DELHI,NORTH WEST,2021-03-17,90,9573,13,9676
DELHI,NORTH WEST,2021-03-18,93,7235,16,7344
DELHI,NORTH WEST,2021-03-19,148,9977,12,10137
DELHI,NORTH WEST,2021-03-20,101,9228,6,9335
DELHI,SHAHDARA,2021-03-16,15,7405,11,7431
DELHI,SHAHDARA,2021-03-17,23,7645,3,7671
DELHI,SHAHDARA,2021-03-18,26,7522,4,7552
DELHI,SHAHDARA,2021-03-19,45,7220,38,7303
DELHI,SHAHDARA,2021-03-20,24,5760,6,5790
DELHI,SOUTH,2021-03-16,91,8895,7,8993
DELHI,SOUTH,2021-03-17,122,8215,16,8353
DELHI,SOUTH,2021-03-18,141,8745,56,8942
DELHI,SOUTH,2021-03-19,140,5466,76,5682
DELHI,SOUTH,2021-03-20,189,8788,25,9002
DELHI,SOUTH EAST,2021-03-16,37,6212,31,6280
DELHI,SOUTH EAST,2021-03-17,37,6266,186,6489
DELHI,SOUTH EAST,2021-03-18,52,5993,119,6164
DELHI,SOUTH EAST,2021-03-19,30,6256,8,6294
DELHI,SOUTH EAST,2021-03-20,37,3976,9,4022
DELHI,SOUTH WEST,2021-03-16,54,6520,7,6581
DELHI,SOUTH WEST,2021-03-17,71,7367,4,7442
DELHI,SOUTH WEST,2021-03-18,72,7807,2,7881
DELHI,SOUTH WEST,2021-03-19,76,7649,0,7725
DELHI,SOUTH WEST,2021-03-20,101,9064,3,9168
DELHI,WEST,2021-03-16,103,9824,13,9940
DELHI,WEST,2021-03-17,132,9519,8,9659
DELHI,WEST,2021-03-18,122,9602,2,9726
DELHI,WEST,2021-03-19,157,9358,3,9518
DELHI,WEST,2021-03-20,121,8844,1,8966
GOA,NORTH GOA,2021-03-16,54,858,0,912
GOA,NORTH GOA,2021-03-17,42,759,0,801
GOA,NORTH GOA,2021-03-18,39,906,0,945
GOA,NORTH GOA,2021-03-19,75,757,0,832
GOA,NORTH GOA,2021-03-20,66,861,3,930
GOA,SOUTH GOA,2021-03-16,46,873,0,919
GOA,SOUTH GOA,2021-03-17,66,697,0,763
GOA,SOUTH GOA,2021-03-18,49,883,0,932
GOA,SOUTH GOA,2021-03-19,75,883,1,959
GOA,SOUTH GOA,2021-03-20,81,728,1,810
GUJARAT,AHMADABAD,2021-03-16,315,4016,58,4389
GUJARAT,AHMADABAD,2021-03-17,356,4070,106,4532
GUJARAT,AHMADABAD,2021-03-18,325,4015,50,4390
GUJARAT,AHMADABAD,2021-03-19,430,3971,57,4458
GUJARAT,AHMADABAD,2021-03-20,415,3213,7,3635
GUJARAT,AMRELI,2021-03-16,5,857,0,862
GUJARAT,AMRELI,2021-03-17,16,1079,0,1095
GUJARAT,AMRELI,2021-03-18,7,1145,0,1152
GUJARAT,AMRELI,2021-03-19,9,1213,0,1222
GUJARAT,AMRELI,2021-03-20,11,1043,0,1054
GUJARAT,ANAND,2021-03-16,55,2184,1,2240
GUJARAT,ANAND,2021-03-17,87,4430,18,4535
GUJARAT,ANAND,2021-03-18,36,2741,6,2783
GUJARAT,ANAND,2021-03-19,80,3180,28,3288
GUJARAT,ANAND,2021-03-20,46,2398,1,2445
GUJARAT,ARVALLI,2021-03-16,5,415,0,420
GUJARAT,ARVALLI,2021-03-17,9,399,9,417
GUJARAT,ARVALLI,2021-03-18,9,218,0,227
GUJARAT,ARVALLI,2021-03-19,6,529,28,563
GUJARAT,ARVALLI,2021-03-20,7,331,30,368
GUJARAT,BANAS KANTHA,2021-03-16,3,325,0,328
GUJARAT,BANAS KANTHA,2021-03-17,9,298,0,307
GUJARAT,BANAS KANTHA,2021-03-18,12,297,0,309
GUJARAT,BANAS KANTHA,2021-03-19,10,462,0,472
GUJARAT,BANAS KANTHA,2021-03-20,6,405,0,411
GUJARAT,BHARUCH,2021-03-16,70,299,0,369
GUJARAT,BHARUCH,2021-03-17,36,259,27,322
GUJARAT,BHARUCH,2021-03-18,29,520,20,569
GUJARAT,BHARUCH,2021-03-19,33,380,3,416
GUJARAT,BHARUCH,2021-03-20,46,379,24,449
GUJARAT,BHAVNAGAR,2021-03-16,18,711,0,729
GUJARAT,BHAVNAGAR,2021-03-17,31,980,0,1011
GUJARAT,BHAVNAGAR,2021-03-18,52,1081,0,1133
GUJARAT,BHAVNAGAR,2021-03-19,71,1138,1,1210
GUJARAT,BHAVNAGAR,2021-03-20,53,770,3,826
GUJARAT,BOTAD,2021-03-16,1,255,0,256
GUJARAT,BOTAD,2021-03-17,0,154,0,154
GUJARAT,BOTAD,2021-03-18,1,203,0,204
GUJARAT,BOTAD,2021-03-19,0,126,0,126
GUJARAT,BOTAD,2021-03-20,1,136,0,137
GUJARAT,CHHOTAUDEPUR,2021-03-16,3,191,1,195
GUJARAT,CHHOTAUDEPUR,2021-03-17,4,207,0,211
GUJARAT,CHHOTAUDEPUR,2021-03-18,6,186,0,192
GUJARAT,CHHOTAUDEPUR,2021-03-19,6,287,6,299
GUJARAT,CHHOTAUDEPUR,2021-03-20,8,302,1,311
GUJARAT,DANG,2021-03-16,0,83,0,83
GUJARAT,DANG,2021-03-17,3,59,0,62
GUJARAT,DANG,2021-03-18,1,62,0,63
GUJARAT,DANG,2021-03-19,2,136,0,138
GUJARAT,DANG,2021-03-20,0,98,0,98
GUJARAT,DEVBHUMI DWARKA,2021-03-16,9,214,0,223
GUJARAT,DEVBHUMI DWARKA,2021-03-17,2,147,1,150
GUJARAT,DEVBHUMI DWARKA,2021-03-18,3,148,1,152
GUJARAT,DEVBHUMI DWARKA,2021-03-19,8,145,0,153
GUJARAT,DEVBHUMI DWARKA,2021-03-20,7,111,5,123
GUJARAT,DOHAD,2021-03-16,18,395,2,415
GUJARAT,DOHAD,2021-03-17,13,553,0,566
GUJARAT,DOHAD,2021-03-18,16,415,0,431
GUJARAT,DOHAD,2021-03-19,16,409,2,427
GUJARAT,DOHAD,2021-03-20,51,325,1,377
GUJARAT,GANDHINAGAR,2021-03-16,30,898,3,931
GUJARAT,GANDHINAGAR,2021-03-17,40,651,2,693
GUJARAT,GANDHINAGAR,2021-03-18,37,940,0,977
GUJARAT,GANDHINAGAR,2021-03-19,52,852,4,908
GUJARAT,GANDHINAGAR,2021-03-20,57,798,0,855
GUJARAT,GIR SOMNATH,2021-03-16,1,200,0,201
GUJARAT,GIR SOMNATH,2021-03-17,10,226,0,236
GUJARAT,GIR SOMNATH,2021-03-18,6,124,0,130
GUJARAT,GIR SOMNATH,2021-03-19,7,90,0,97
GUJARAT,GIR SOMNATH,2021-03-20,15,241,0,256
GUJARAT,JAMNAGAR,2021-03-16,34,1160,4,1198
GUJARAT,JAMNAGAR,2021-03-17,37,1002,6,1045
GUJARAT,JAMNAGAR,2021-03-18,40,914,4,958
GUJARAT,JAMNAGAR,2021-03-19,30,727,4,761
GUJARAT,JAMNAGAR,2021-03-20,35,635,20,690
GUJARAT,JUNAGADH,2021-03-16,8,573,0,581
GUJARAT,JUNAGADH,2021-03-17,16,755,0,771
GUJARAT,JUNAGADH,2021-03-18,11,734,0,745
GUJARAT,JUNAGADH,2021-03-19,25,1017,0,1042
GUJARAT,JUNAGADH,2021-03-20,9,887,0,896
GUJARAT,KACHCHH,2021-03-16,33,661,46,740
GUJARAT,KACHCHH,2021-03-17,23,688,6,717
GUJARAT,KACHCHH,2021-03-18,41,641,8,690
GUJARAT,KACHCHH,2021-03-19,34,700,4,738
GUJARAT,KACHCHH,2021-03-20,41,581,2,624
GUJARAT,KHEDA,2021-03-16,15,1017,6,1038
GUJARAT,KHEDA,2021-03-17,19,1192,51,1262
GUJARAT,KHEDA,2021-03-18,20,917,16,953
GUJARAT,KHEDA,2021-03-19,19,1055,13,1087
GUJARAT,KHEDA,2021-03-20,16,881,47,944
GUJARAT,MAHESANA,2021-03-16,14,288,0,302
GUJARAT,MAHESANA,2021-03-17,22,245,0,267
GUJARAT,MAHESANA,2021-03-18,13,270,2,285
GUJARAT,MAHESANA,2021-03-19,24,231,3,258
GUJARAT,MAHESANA,2021-03-20,31,374,0,405
GUJARAT,MAHISAGAR,2021-03-16,19,652,21,692
GUJARAT,MAHISAGAR,2021-03-17,24,573,0,597
GUJARAT,MAHISAGAR,2021-03-18,22,542,0,564
GUJARAT,MAHISAGAR,2021-03-19,13,623,0,636
GUJARAT,MAHISAGAR,2021-03-20,14,503,0,517
GUJARAT,MORBI,2021-03-16,13,356,0,369
GUJARAT,MORBI,2021-03-17,7,442,0,449
GUJARAT,MORBI,2021-03-18,9,368,1,378
GUJARAT,MORBI,2021-03-19,8,411,4,423
GUJARAT,MORBI,2021-03-20,19,365,0,384
GUJARAT,NARMADA,2021-03-16,17,43,0,60
GUJARAT,NARMADA,2021-03-17,19,39,1,59
GUJARAT,NARMADA,2021-03-18,15,81,0,96
GUJARAT,NARMADA,2021-03-19,14,69,0,83
GUJARAT,NARMADA,2021-03-20,26,51,14,91
GUJARAT,NAVSARI,2021-03-16,4,321,1,326
GUJARAT,NAVSARI,2021-03-17,4,365,0,369
GUJARAT,NAVSARI,2021-03-18,6,353,4,363
GUJARAT,NAVSARI,2021-03-19,7,414,1,422
GUJARAT,NAVSARI,2021-03-20,12,299,0,311
GUJARAT,PANCH MAHALS,2021-03-16,45,483,1,529
GUJARAT,PANCH MAHALS,2021-03-17,65,383,0,448
GUJARAT,PANCH MAHALS,2021-03-18,26,393,1,420
GUJARAT,PANCH MAHALS,2021-03-19,38,390,3,431
GUJARAT,PANCH MAHALS,2021-03-20,22,313,2,337
GUJARAT,PATAN,2021-03-16,3,214,0,217
GUJARAT,PATAN,2021-03-17,4,227,0,231
GUJARAT,PATAN,2021-03-18,8,587,0,595
GUJARAT,PATAN,2021-03-19,14,713,0,727
GUJARAT,PATAN,2021-03-20,12,441,0,453
GUJARAT,PORBANDAR,2021-03-16,1,221,1,223
GUJARAT,PORBANDAR,2021-03-17,1,266,1,268
GUJARAT,PORBANDAR,2021-03-18,4,215,0,219
GUJARAT,PORBANDAR,2021-03-19,5,262,0,267
GUJARAT,PORBANDAR,2021-03-20,3,223,0,226
GUJARAT,RAJKOT,2021-03-16,90,1855,1,1946
GUJARAT,RAJKOT,2021-03-17,104,1895,6,2005
GUJARAT,RAJKOT,2021-03-18,139,1887,3,2029
GUJARAT,RAJKOT,2021-03-19,86,1568,1,1655
GUJARAT,RAJKOT,2021-03-20,146,1456,0,1602
GUJARAT,SABAR KANTHA,2021-03-16,14,277,9,300
GUJARAT,SABAR KANTHA,2021-03-17,22,228,7,257
GUJARAT,SABAR KANTHA,2021-03-18,12,144,6,162
GUJARAT,SABAR KANTHA,2021-03-19,23,262,6,291
GUJARAT,SABAR KANTHA,2021-03-20,15,256,34,305
GUJARAT,SURAT,2021-03-16,262,1732,57,2051
GUJARAT,SURAT,2021-03-17,259,1610,42,1911
GUJARAT,SURAT,2021-03-18,333,1709,48,2090
GUJARAT,SURAT,2021-03-19,310,1677,1,1988
GUJARAT,SURAT,2021-03-20,380,1854,31,2265
GUJARAT,SURENDRANAGAR,2021-03-16,4,507,0,511
GUJARAT,SURENDRANAGAR,2021-03-17,11,483,1,495
GUJARAT,SURENDRANAGAR,2021-03-18,4,499,1,504
GUJARAT,SURENDRANAGAR,2021-03-19,15,514,0,529
GUJARAT,SURENDRANAGAR,2021-03-20,16,256,0,272
GUJARAT,TAPI,2021-03-16,7,379,0,386
GUJARAT,TAPI,2021-03-17,14,192,1,207
GUJARAT,TAPI,2021-03-18,29,242,0,271
GUJARAT,TAPI,2021-03-19,34,236,0,270
GUJARAT,TAPI,2021-03-20,42,252,29,323
GUJARAT,VADODARA,2021-03-16,182,1658,124,1964
GUJARAT,VADODARA,2021-03-17,205,1286,74,1565
GUJARAT,VADODARA,2021-03-18,233,1512,73,1818
GUJARAT,VADODARA,2021-03-19,202,1839,104,2145
GUJARAT,VADODARA,2021-03-20,182,1249,96,1527
GUJARAT,VALSAD,2021-03-16,15,487,1,503
GUJARAT,VALSAD,2021-03-17,11,583,0,594
GUJARAT,VALSAD,2021-03-18,18,493,1,512
GUJARAT,VALSAD,2021-03-19,18,444,0,462
GUJARAT,VALSAD,2021-03-20,12,464,0,476
HARYANA,AMBALA,2021-03-16,86,727,64,877
HARYANA,AMBALA,2021-03-17,109,756,41,906
HARYANA,AMBALA,2021-03-18,136,1050,39,1225
HARYANA,AMBALA,2021-03-19,145,1115,31,1291
HARYANA,AMBALA,2021-03-20,172,1380,133,1685
HARYANA,BHIWANI,2021-03-16,2,124,1,127
HARYANA,BHIWANI,2021-03-17,2,936,0,938
HARYANA,BHIWANI,2021-03-18,0,738,1,739
HARYANA,BHIWANI,2021-03-19,3,439,1,443
HARYANA,BHIWANI,2021-03-20,2,234,0,236
HARYANA,CHARKI DADRI,2021-03-16,4,327,0,331
HARYANA,CHARKI DADRI,2021-03-17,0,118,0,118
HARYANA,CHARKI DADRI,2021-03-18,1,320,0,321
HARYANA,CHARKI DADRI,2021-03-19,0,100,0,100
HARYANA,CHARKI DADRI,2021-03-20,2,260,1,263
HARYANA,FARIDABAD,2021-03-16,40,868,4,912
HARYANA,FARIDABAD,2021-03-17,66,919,12,997
HARYANA,FARIDABAD,2021-03-18,43,954,12,1009
HARYANA,FARIDABAD,2021-03-19,59,972,3,1034
HARYANA,FARIDABAD,2021-03-20,56,970,1,1027
HARYANA,FATEHABAD,2021-03-16,1,256,1,258
HARYANA,FATEHABAD,2021-03-17,16,94,0,110
HARYANA,FATEHABAD,2021-03-18,13,443,0,456
HARYANA,FATEHABAD,2021-03-19,17,127,0,144
HARYANA,FATEHABAD,2021-03-20,16,333,0,349
HARYANA,GURUGRAM,2021-03-16,125,3445,9,3579
HARYANA,GURUGRAM,2021-03-17,141,3631,10,3782
HARYANA,GURUGRAM,2021-03-18,219,3960,31,4210
HARYANA,GURUGRAM,2021-03-19,185,4347,16,4548
HARYANA,GURUGRAM,2021-03-20,216,4329,14,4559
HARYANA,HISAR,2021-03-16,9,616,0,625
HARYANA,HISAR,2021-03-17,7,968,0,975
HARYANA,HISAR,2021-03-18,21,1006,0,1027
HARYANA,HISAR,2021-03-19,15,1169,0,1184
HARYANA,HISAR,2021-03-20,16,799,0,815
HARYANA,JHAJJAR,2021-03-16,1,626,0,627
HARYANA,JHAJJAR,2021-03-17,9,725,0,734
HARYANA,JHAJJAR,2021-03-18,1,638,0,639
HARYANA,JHAJJAR,2021-03-19,3,607,0,610
HARYANA,JHAJJAR,2021-03-20,6,806,0,812
HARYANA,JIND,2021-03-16,7,240,2,249
HARYANA,JIND,2021-03-17,27,535,12,574
HARYANA,JIND,2021-03-18,26,400,1,427
HARYANA,JIND,2021-03-19,29,344,17,390
HARYANA,JIND,2021-03-20,24,288,1,313
HARYANA,KAITHAL,2021-03-16,11,212,7,230
HARYANA,KAITHAL,2021-03-17,25,205,6,236
HARYANA,KAITHAL,2021-03-18,23,381,6,410
HARYANA,KAITHAL,2021-03-19,13,280,2,295
HARYANA,KAITHAL,2021-03-20,36,297,1,334
HARYANA,KARNAL,2021-03-16,151,627,6,784
HARYANA,KARNAL,2021-03-17,34,1003,0,1037
HARYANA,KARNAL,2021-03-18,207,978,1,1186
HARYANA,KARNAL,2021-03-19,136,863,0,999
HARYANA,KARNAL,2021-03-20,138,280,1,419
HARYANA,KURUKSHETRA,2021-03-16,81,686,3,770
HARYANA,KURUKSHETRA,2021-03-17,95,1302,3,1400
HARYANA,KURUKSHETRA,2021-03-18,66,1290,1,1357
HARYANA,KURUKSHETRA,2021-03-19,111,967,7,1085
HARYANA,KURUKSHETRA,2021-03-20,99,400,6,505
HARYANA,MAHENDRAGARH,2021-03-16,2,258,0,260
HARYANA,MAHENDRAGARH,2021-03-17,0,301,0,301
HARYANA,MAHENDRAGARH,2021-03-18,1,650,0,651
HARYANA,MAHENDRAGARH,2021-03-19,0,507,0,507
HARYANA,MAHENDRAGARH,2021-03-20,2,467,1,470
HARYANA,NUH,2021-03-16,3,90,0,93
HARYANA,NUH,2021-03-17,0,241,0,241
HARYANA,NUH,2021-03-18,0,13,1,14
HARYANA,NUH,2021-03-19,2,200,0,202
HARYANA,NUH,2021-03-20,0,234,0,234
HARYANA,PALWAL,2021-03-16,2,64,0,66
HARYANA,PALWAL,2021-03-17,1,166,0,167
HARYANA,PALWAL,2021-03-18,0,55,3,58
HARYANA,PALWAL,2021-03-19,2,126,1,129
HARYANA,PALWAL,2021-03-20,1,155,0,156
HARYANA,PANCHKULA,2021-03-16,144,732,49,925
HARYANA,PANCHKULA,2021-03-17,110,994,17,1121
HARYANA,PANCHKULA,2021-03-18,164,756,43,963
HARYANA,PANCHKULA,2021-03-19,175,812,39,1026
HARYANA,PANCHKULA,2021-03-20,139,789,22,950
HARYANA,PANIPAT,2021-03-16,14,940,2,956
HARYANA,PANIPAT,2021-03-17,31,875,0,906
HARYANA,PANIPAT,2021-03-18,27,949,0,976
HARYANA,PANIPAT,2021-03-19,31,472,1,504
HARYANA,PANIPAT,2021-03-20,47,821,1,869
HARYANA,REWARI,2021-03-16,2,396,3,401
HARYANA,REWARI,2021-03-17,4,704,0,708
HARYANA,REWARI,2021-03-18,4,518,1,523
HARYANA,REWARI,2021-03-19,4,601,1,606
HARYANA,REWARI,2021-03-20,6,758,1,765
HARYANA,ROHTAK,2021-03-16,7,393,0,400
HARYANA,ROHTAK,2021-03-17,4,272,1,277
HARYANA,ROHTAK,2021-03-18,11,847,0,858
HARYANA,ROHTAK,2021-03-19,4,612,0,616
HARYANA,ROHTAK,2021-03-20,28,348,0,376
HARYANA,SIRSA,2021-03-16,21,469,4,494
HARYANA,SIRSA,2021-03-17,8,575,4,587
HARYANA,SIRSA,2021-03-18,20,1158,9,1187
HARYANA,SIRSA,2021-03-19,4,887,33,924
HARYANA,SIRSA,2021-03-20,27,864,34,925
HARYANA,SONIPAT,2021-03-16,19,1207,1,1227
HARYANA,SONIPAT,2021-03-17,15,1131,0,1146
HARYANA,SONIPAT,2021-03-18,28,1142,0,1170
HARYANA,SONIPAT,2021-03-19,39,1095,0,1134
HARYANA,SONIPAT,2021-03-20,31,1283,1,1315
HARYANA,YAMUNANAGAR,2021-03-16,28,356,5,389
HARYANA,YAMUNANAGAR,2021-03-17,107,848,5,960
HARYANA,YAMUNANAGAR,2021-03-18,30,488,2,520
HARYANA,YAMUNANAGAR,2021-03-19,86,375,1,462
HARYANA,YAMUNANAGAR,2021-03-20,40,467,1,508
HIMACHAL PRADESH,BILASPUR,2021-03-16,13,1283,0,1296
HIMACHAL PRADESH,BILASPUR,2021-03-17,5,453,1,459
HIMACHAL PRADESH,BILASPUR,2021-03-18,20,388,1,409
HIMACHAL PRADESH,BILASPUR,2021-03-19,10,201,0,211
HIMACHAL PRADESH,BILASPUR,2021-03-20,22,313,0,335
HIMACHAL PRADESH,CHAMBA,2021-03-16,3,343,1,347
HIMACHAL PRADESH,CHAMBA,2021-03-17,0,461,3,464
HIMACHAL PRADESH,CHAMBA,2021-03-18,0,665,19,684
HIMACHAL PRADESH,CHAMBA,2021-03-19,1,737,7,745
HIMACHAL PRADESH,CHAMBA,2021-03-20,0,243,0,243
HIMACHAL PRADESH,HAMIRPUR,2021-03-16,14,969,0,983
HIMACHAL PRADESH,HAMIRPUR,2021-03-17,9,1892,6,1907
HIMACHAL PRADESH,HAMIRPUR,2021-03-18,18,1413,0,1431
HIMACHAL PRADESH,HAMIRPUR,2021-03-19,8,485,1,494
HIMACHAL PRADESH,HAMIRPUR,2021-03-20,14,464,3,481
HIMACHAL PRADESH,KANGRA,2021-03-16,17,554,3,574
HIMACHAL PRADESH,KANGRA,2021-03-17,28,1071,4,1103
HIMACHAL PRADESH,KANGRA,2021-03-18,20,503,2,525
HIMACHAL PRADESH,KANGRA,2021-03-19,37,1200,9,1246
HIMACHAL PRADESH,KANGRA,2021-03-20,43,929,1,973
HIMACHAL PRADESH,KINNAUR,2021-03-16,0,80,0,80
HIMACHAL PRADESH,KINNAUR,2021-03-17,3,105,2,110
HIMACHAL PRADESH,KINNAUR,2021-03-18,0,43,0,43
HIMACHAL PRADESH,KINNAUR,2021-03-19,0,67,1,68
HIMACHAL PRADESH,KINNAUR,2021-03-20,0,44,0,44
HIMACHAL PRADESH,KULLU,2021-03-16,0,77,2,79
HIMACHAL PRADESH,KULLU,2021-03-17,2,116,10,128
HIMACHAL PRADESH,KULLU,2021-03-18,1,110,0,111
HIMACHAL PRADESH,KULLU,2021-03-19,2,225,7,234
HIMACHAL PRADESH,KULLU,2021-03-20,4,205,0,209
HIMACHAL PRADESH,LAHUL AND SPITI,2021-03-16,0,2,0,2
HIMACHAL PRADESH,LAHUL AND SPITI,2021-03-17,0,1,0,1
HIMACHAL PRADESH,LAHUL AND SPITI,2021-03-18,0,1,0,1
HIMACHAL PRADESH,LAHUL AND SPITI,2021-03-19,0,1,0,1
HIMACHAL PRADESH,LAHUL AND SPITI,2021-03-20,0,2,0,2
HIMACHAL PRADESH,MANDI,2021-03-16,7,356,10,373
HIMACHAL PRADESH,MANDI,2021-03-17,6,305,10,321
HIMACHAL PRADESH,MANDI,2021-03-18,13,333,4,350
HIMACHAL PRADESH,MANDI,2021-03-19,9,301,9,319
HIMACHAL PRADESH,MANDI,2021-03-20,14,282,3,299
HIMACHAL PRADESH,SHIMLA,2021-03-16,12,552,12,576
HIMACHAL PRADESH,SHIMLA,2021-03-17,14,420,145,579
HIMACHAL PRADESH,SHIMLA,2021-03-18,10,539,33,582
HIMACHAL PRADESH,SHIMLA,2021-03-19,16,530,12,558
HIMACHAL PRADESH,SHIMLA,2021-03-20,14,735,20,769
HIMACHAL PRADESH,SIRMAUR,2021-03-16,11,495,5,511
HIMACHAL PRADESH,SIRMAUR,2021-03-17,7,392,0,399
HIMACHAL PRADESH,SIRMAUR,2021-03-18,5,210,0,215
HIMACHAL PRADESH,SIRMAUR,2021-03-19,8,287,2,297
HIMACHAL PRADESH,SIRMAUR,2021-03-20,10,387,1,398
HIMACHAL PRADESH,SOLAN,2021-03-16,25,601,13,639
HIMACHAL PRADESH,SOLAN,2021-03-17,15,749,2,766
HIMACHAL PRADESH,SOLAN,2021-03-18,25,687,6,718
HIMACHAL PRADESH,SOLAN,2021-03-19,25,643,1,669
HIMACHAL PRADESH,SOLAN,2021-03-20,27,685,5,717
HIMACHAL PRADESH,UNA,2021-03-16,48,326,7,381
HIMACHAL PRADESH,UNA,2021-03-17,40,500,4,544
HIMACHAL PRADESH,UNA,2021-03-18,56,1075,2,1133
HIMACHAL PRADESH,UNA,2021-03-19,63,797,0,860
HIMACHAL PRADESH,UNA,2021-03-20,37,565,0,602
INDIA,INDIA,2021-03-16,13,3,0,16
INDIA,INDIA,2021-03-17,12,2,0,14
INDIA,INDIA,2021-03-18,9,4,0,13
INDIA,INDIA,2021-03-19,9,1,0,10
INDIA,INDIA,2021-03-20,25,3,0,28
JAMMU AND KASHMIR,ANANTNAG,2021-03-16,10,356,3,369
JAMMU AND KASHMIR,ANANTNAG,2021-03-17,5,428,0,433
JAMMU AND KASHMIR,ANANTNAG,2021-03-18,3,262,1,266
JAMMU AND KASHMIR,ANANTNAG,2021-03-19,8,203,0,211
JAMMU AND KASHMIR,ANANTNAG,2021-03-20,3,357,0,360
JAMMU AND KASHMIR,BANDIPORA,2021-03-16,2,208,3,213
JAMMU AND KASHMIR,BANDIPORA,2021-03-17,1,263,4,268
JAMMU AND KASHMIR,BANDIPORA,2021-03-18,0,236,5,241
JAMMU AND KASHMIR,BANDIPORA,2021-03-19,0,13,0,13
JAMMU AND KASHMIR,BANDIPORA,2021-03-20,2,155,6,163
JAMMU AND KASHMIR,BARAMULLA,2021-03-16,4,410,0,414
JAMMU AND KASHMIR,BARAMULLA,2021-03-17,9,430,0,439
JAMMU AND KASHMIR,BARAMULLA,2021-03-18,12,416,0,428
JAMMU AND KASHMIR,BARAMULLA,2021-03-19,0,199,0,199
JAMMU AND KASHMIR,BARAMULLA,2021-03-20,8,363,0,371
JAMMU AND KASHMIR,BUDGAM,2021-03-16,3,836,0,839
JAMMU AND KASHMIR,BUDGAM,2021-03-17,2,803,0,805
JAMMU AND KASHMIR,BUDGAM,2021-03-18,7,826,0,833
JAMMU AND KASHMIR,BUDGAM,2021-03-19,7,463,0,470
JAMMU AND KASHMIR,BUDGAM,2021-03-20,7,853,0,860
JAMMU AND KASHMIR,DODA,2021-03-16,0,29,0,29
JAMMU AND KASHMIR,DODA,2021-03-17,3,30,0,33
JAMMU AND KASHMIR,DODA,2021-03-18,0,14,0,14
JAMMU AND KASHMIR,DODA,2021-03-19,0,7,0,7
JAMMU AND KASHMIR,DODA,2021-03-20,0,43,0,43
JAMMU AND KASHMIR,GANDERBAL,2021-03-16,0,166,0,166
JAMMU AND KASHMIR,GANDERBAL,2021-03-17,1,166,0,167
JAMMU AND KASHMIR,GANDERBAL,2021-03-18,1,155,0,156
JAMMU AND KASHMIR,GANDERBAL,2021-03-19,4,80,0,84
JAMMU AND KASHMIR,GANDERBAL,2021-03-20,1,110,0,111
JAMMU AND KASHMIR,JAMMU,2021-03-16,30,909,0,939
JAMMU AND KASHMIR,JAMMU,2021-03-17,23,845,2,870
JAMMU AND KASHMIR,JAMMU,2021-03-18,21,1182,2,1205
JAMMU AND KASHMIR,JAMMU,2021-03-19,9,731,2,742
JAMMU AND KASHMIR,JAMMU,2021-03-20,21,491,1,513
JAMMU AND KASHMIR,KATHUA,2021-03-16,1,218,0,219
JAMMU AND KASHMIR,KATHUA,2021-03-17,1,256,0,257
JAMMU AND KASHMIR,KATHUA,2021-03-18,2,121,0,123
JAMMU AND KASHMIR,KATHUA,2021-03-19,0,77,0,77
JAMMU AND KASHMIR,KATHUA,2021-03-20,0,72,0,72
JAMMU AND KASHMIR,KISHTWAR,2021-03-16,0,53,0,53
JAMMU AND KASHMIR,KISHTWAR,2021-03-17,1,18,0,19
JAMMU AND KASHMIR,KISHTWAR,2021-03-18,1,127,1,129
JAMMU AND KASHMIR,KISHTWAR,2021-03-19,0,21,0,21
JAMMU AND KASHMIR,KISHTWAR,2021-03-20,0,74,0,74
JAMMU AND KASHMIR,KULGAM,2021-03-16,2,421,0,423
JAMMU AND KASHMIR,KULGAM,2021-03-17,1,136,0,137
JAMMU AND KASHMIR,KULGAM,2021-03-18,0,169,0,169
JAMMU AND KASHMIR,KULGAM,2021-03-19,0,19,0,19
JAMMU AND KASHMIR,KULGAM,2021-03-20,1,226,0,227
JAMMU AND KASHMIR,KUPWARA,2021-03-16,3,235,0,238
JAMMU AND KASHMIR,KUPWARA,2021-03-17,0,73,0,73
JAMMU AND KASHMIR,KUPWARA,2021-03-18,2,106,0,108
JAMMU AND KASHMIR,KUPWARA,2021-03-19,0,55,0,55
JAMMU AND KASHMIR,KUPWARA,2021-03-20,2,108,2,112
JAMMU AND KASHMIR,POONCH,2021-03-16,0,140,0,140
JAMMU AND KASHMIR,POONCH,2021-03-17,2,274,0,276
JAMMU AND KASHMIR,POONCH,2021-03-18,1,272,1,274
JAMMU AND KASHMIR,POONCH,2021-03-19,2,168,0,170
JAMMU AND KASHMIR,POONCH,2021-03-20,1,195,0,196
JAMMU AND KASHMIR,PULWAMA,2021-03-16,10,600,4,614
JAMMU AND KASHMIR,PULWAMA,2021-03-17,14,483,1,498
JAMMU AND KASHMIR,PULWAMA,2021-03-18,10,708,1,719
JAMMU AND KASHMIR,PULWAMA,2021-03-19,8,491,0,499
JAMMU AND KASHMIR,PULWAMA,2021-03-20,4,730,1,735
JAMMU AND KASHMIR,RAJOURI,2021-03-16,0,71,0,71
JAMMU AND KASHMIR,RAJOURI,2021-03-17,1,185,0,186
JAMMU AND KASHMIR,RAJOURI,2021-03-18,0,142,0,142
JAMMU AND KASHMIR,RAJOURI,2021-03-19,0,146,0,146
JAMMU AND KASHMIR,RAJOURI,2021-03-20,0,137,0,137
JAMMU AND KASHMIR,RAMBAN,2021-03-16,1,246,0,247
JAMMU AND KASHMIR,RAMBAN,2021-03-17,2,377,0,379
JAMMU AND KASHMIR,RAMBAN,2021-03-18,0,199,0,199
JAMMU AND KASHMIR,RAMBAN,2021-03-19,1,50,0,51
JAMMU AND KASHMIR,RAMBAN,2021-03-20,1,169,0,170
JAMMU AND KASHMIR,REASI,2021-03-16,3,77,0,80
JAMMU AND KASHMIR,REASI,2021-03-17,2,99,0,101
JAMMU AND KASHMIR,REASI,2021-03-18,1,37,0,38
JAMMU AND KASHMIR,REASI,2021-03-19,1,81,0,82
JAMMU AND KASHMIR,REASI,2021-03-20,2,38,0,40
JAMMU AND KASHMIR,SAMBA,2021-03-16,0,197,0,197
JAMMU AND KASHMIR,SAMBA,2021-03-17,0,104,0,104
JAMMU AND KASHMIR,SAMBA,2021-03-18,0,137,0,137
JAMMU AND KASHMIR,SAMBA,2021-03-19,0,87,0,87
JAMMU AND KASHMIR,SAMBA,2021-03-20,1,33,0,34
JAMMU AND KASHMIR,SHOPIAN,2021-03-16,1,131,0,132
JAMMU AND KASHMIR,SHOPIAN,2021-03-17,5,129,0,134
JAMMU AND KASHMIR,SHOPIAN,2021-03-18,1,109,0,110
JAMMU AND KASHMIR,SHOPIAN,2021-03-19,1,265,0,266
JAMMU AND KASHMIR,SHOPIAN,2021-03-20,1,287,0,288
JAMMU AND KASHMIR,SRINAGAR,2021-03-16,57,3682,7,3746
JAMMU AND KASHMIR,SRINAGAR,2021-03-17,48,3922,2,3972
JAMMU AND KASHMIR,SRINAGAR,2021-03-18,64,3868,0,3932
JAMMU AND KASHMIR,SRINAGAR,2021-03-19,54,3670,1,3725
JAMMU AND KASHMIR,SRINAGAR,2021-03-20,73,4177,9,4259
JAMMU AND KASHMIR,UDHAMPUR,2021-03-16,7,830,0,837
JAMMU AND KASHMIR,UDHAMPUR,2021-03-17,4,600,0,604
JAMMU AND KASHMIR,UDHAMPUR,2021-03-18,0,656,0,656
JAMMU AND KASHMIR,UDHAMPUR,2021-03-19,1,730,1,732
JAMMU AND KASHMIR,UDHAMPUR,2021-03-20,0,486,0,486
JHARKHAND,BOKARO,2021-03-16,2,754,3,759
JHARKHAND,BOKARO,2021-03-17,8,535,0,543
JHARKHAND,BOKARO,2021-03-18,8,1291,11,1310
JHARKHAND,BOKARO,2021-03-19,4,1290,22,1316
JHARKHAND,BOKARO,2021-03-20,11,1703,45,1759
JHARKHAND,CHATRA,2021-03-16,1,95,0,96
JHARKHAND,CHATRA,2021-03-17,0,65,0,65
JHARKHAND,CHATRA,2021-03-18,0,141,0,141
JHARKHAND,CHATRA,2021-03-19,1,528,0,529
JHARKHAND,CHATRA,2021-03-20,0,113,0,113
JHARKHAND,DEOGHAR,2021-03-16,0,465,1,466
JHARKHAND,DEOGHAR,2021-03-17,0,852,2,854
JHARKHAND,DEOGHAR,2021-03-18,0,815,0,815
JHARKHAND,DEOGHAR,2021-03-19,1,844,1,846
JHARKHAND,DEOGHAR,2021-03-20,5,218,0,223
JHARKHAND,DHANBAD,2021-03-16,6,314,0,320
JHARKHAND,DHANBAD,2021-03-17,2,485,0,487
JHARKHAND,DHANBAD,2021-03-18,6,339,0,345
JHARKHAND,DHANBAD,2021-03-19,5,369,0,374
JHARKHAND,DHANBAD,2021-03-20,5,362,1,368
JHARKHAND,DUMKA,2021-03-16,2,605,8,615
JHARKHAND,DUMKA,2021-03-17,0,285,1,286
JHARKHAND,DUMKA,2021-03-18,1,449,5,455
JHARKHAND,DUMKA,2021-03-19,3,629,4,636
JHARKHAND,DUMKA,2021-03-20,2,345,6,353
JHARKHAND,EAST SINGHBUM,2021-03-16,17,1829,0,1846
JHARKHAND,EAST SINGHBUM,2021-03-17,15,1539,3,1557
JHARKHAND,EAST SINGHBUM,2021-03-18,21,2286,2,2309
JHARKHAND,EAST SINGHBUM,2021-03-19,29,2400,2,2431
JHARKHAND,EAST SINGHBUM,2021-03-20,43,1595,0,1638
JHARKHAND,GARHWA,2021-03-16,1,134,1,136
JHARKHAND,GARHWA,2021-03-17,1,205,2,208
JHARKHAND,GARHWA,2021-03-18,0,414,0,414
JHARKHAND,GARHWA,2021-03-19,0,511,0,511
JHARKHAND,GARHWA,2021-03-20,0,799,0,799
JHARKHAND,GIRIDIH,2021-03-16,2,936,0,938
JHARKHAND,GIRIDIH,2021-03-17,1,879,0,880
JHARKHAND,GIRIDIH,2021-03-18,2,565,0,567
JHARKHAND,GIRIDIH,2021-03-19,0,1040,0,1040
JHARKHAND,GIRIDIH,2021-03-20,2,1062,0,1064
JHARKHAND,GODDA,2021-03-16,0,81,0,81
JHARKHAND,GODDA,2021-03-17,0,101,0,101
JHARKHAND,GODDA,2021-03-18,0,117,0,117
JHARKHAND,GODDA,2021-03-19,5,148,0,153
JHARKHAND,GODDA,2021-03-20,0,65,0,65
JHARKHAND,GUMLA,2021-03-16,0,652,0,652
JHARKHAND,GUMLA,2021-03-17,1,711,0,712
JHARKHAND,GUMLA,2021-03-18,6,268,0,274
JHARKHAND,GUMLA,2021-03-19,1,315,1,317
JHARKHAND,GUMLA,2021-03-20,3,375,0,378
JHARKHAND,HAZARIBAGH,2021-03-16,1,372,0,373
JHARKHAND,HAZARIBAGH,2021-03-17,1,401,0,402
JHARKHAND,HAZARIBAGH,2021-03-18,2,170,0,172
JHARKHAND,HAZARIBAGH,2021-03-19,3,105,0,108
JHARKHAND,HAZARIBAGH,2021-03-20,2,267,0,269
JHARKHAND,JAMTARA,2021-03-16,0,311,0,311
JHARKHAND,JAMTARA,2021-03-17,0,219,0,219
JHARKHAND,JAMTARA,2021-03-18,0,440,0,440
JHARKHAND,JAMTARA,2021-03-19,1,415,0,416
JHARKHAND,JAMTARA,2021-03-20,0,222,0,222
JHARKHAND,KHUNTI,2021-03-16,0,283,0,283
JHARKHAND,KHUNTI,2021-03-17,0,54,0,54
JHARKHAND,KHUNTI,2021-03-18,0,205,0,205
JHARKHAND,KHUNTI,2021-03-19,2,329,0,331
JHARKHAND,KHUNTI,2021-03-20,0,93,4,97
JHARKHAND,KODERMA,2021-03-16,0,317,0,317
JHARKHAND,KODERMA,2021-03-17,0,570,0,570
JHARKHAND,KODERMA,2021-03-18,3,393,1,397
JHARKHAND,KODERMA,2021-03-19,5,348,1,354
JHARKHAND,KODERMA,2021-03-20,2,288,0,290
JHARKHAND,LATEHAR,2021-03-16,0,615,0,615
JHARKHAND,LATEHAR,2021-03-17,0,525,0,525
JHARKHAND,LATEHAR,2021-03-18,0,627,0,627
JHARKHAND,LATEHAR,2021-03-19,0,397,0,397
JHARKHAND,LATEHAR,2021-03-20,0,698,0,698
JHARKHAND,LOHARDAGA,2021-03-16,0,361,0,361
JHARKHAND,LOHARDAGA,2021-03-17,0,250,1,251
JHARKHAND,LOHARDAGA,2021-03-18,1,42,0,43
JHARKHAND,LOHARDAGA,2021-03-19,0,90,0,90
JHARKHAND,LOHARDAGA,2021-03-20,1,71,0,72
JHARKHAND,PAKUR,2021-03-16,0,149,0,149
JHARKHAND,PAKUR,2021-03-17,2,245,0,247
JHARKHAND,PAKUR,2021-03-18,3,430,0,433
JHARKHAND,PAKUR,2021-03-19,1,1099,0,1100
JHARKHAND,PAKUR,2021-03-20,2,93,0,95
JHARKHAND,PALAMU,2021-03-16,1,950,0,951
JHARKHAND,PALAMU,2021-03-17,0,1078,0,1078
JHARKHAND,PALAMU,2021-03-18,0,731,1,732
JHARKHAND,PALAMU,2021-03-19,0,810,0,810
JHARKHAND,PALAMU,2021-03-20,0,438,0,438
JHARKHAND,RAMGARH,2021-03-16,0,250,0,250
JHARKHAND,RAMGARH,2021-03-17,2,82,0,84
JHARKHAND,RAMGARH,2021-03-18,2,57,0,59
JHARKHAND,RAMGARH,2021-03-19,2,496,0,498
JHARKHAND,RAMGARH,2021-03-20,1,136,1,138
JHARKHAND,RANCHI,2021-03-16,101,1092,1,1194
JHARKHAND,RANCHI,2021-03-17,129,906,0,1035
JHARKHAND,RANCHI,2021-03-18,112,1425,2,1539
JHARKHAND,RANCHI,2021-03-19,107,849,0,956
JHARKHAND,RANCHI,2021-03-20,175,990,1,1166
JHARKHAND,SAHEBGANJ,2021-03-16,2,253,0,255
JHARKHAND,SAHEBGANJ,2021-03-17,2,147,0,149
JHARKHAND,SAHEBGANJ,2021-03-18,2,178,0,180
JHARKHAND,SAHEBGANJ,2021-03-19,3,156,0,159
JHARKHAND,SAHEBGANJ,2021-03-20,1,230,0,231
JHARKHAND,SARAIKELA KHARSAWAN,2021-03-16,0,167,0,167
JHARKHAND,SARAIKELA KHARSAWAN,2021-03-17,0,522,0,522
JHARKHAND,SARAIKELA KHARSAWAN,2021-03-18,1,383,0,384
JHARKHAND,SARAIKELA KHARSAWAN,2021-03-19,3,276,0,279
JHARKHAND,SARAIKELA KHARSAWAN,2021-03-20,0,150,0,150
JHARKHAND,SIMDEGA,2021-03-16,0,981,0,981
JHARKHAND,SIMDEGA,2021-03-17,0,1416,1,1417
JHARKHAND,SIMDEGA,2021-03-18,2,641,0,643
JHARKHAND,SIMDEGA,2021-03-19,2,464,0,466
JHARKHAND,SIMDEGA,2021-03-20,0,635,0,635
JHARKHAND,WEST SINGHBHUM,2021-03-16,0,134,0,134
JHARKHAND,WEST SINGHBHUM,2021-03-17,9,273,0,282
JHARKHAND,WEST SINGHBHUM,2021-03-18,8,441,0,449
JHARKHAND,WEST SINGHBHUM,2021-03-19,14,259,0,273
JHARKHAND,WEST SINGHBHUM,2021-03-20,4,437,0,441
KARNATAKA,BAGALKOTE,2021-03-16,1,1287,2,1290
KARNATAKA,BAGALKOTE,2021-03-17,1,1015,2,1018
KARNATAKA,BAGALKOTE,2021-03-18,5,1328,6,1339
KARNATAKA,BAGALKOTE,2021-03-19,12,1354,0,1366
KARNATAKA,BAGALKOTE,2021-03-20,0,2011,0,2011
KARNATAKA,BALLARI,2021-03-16,4,2909,9,2922
KARNATAKA,BALLARI,2021-03-17,8,2738,18,2764
KARNATAKA,BALLARI,2021-03-18,15,2829,9,2853
KARNATAKA,BALLARI,2021-03-19,28,2754,25,2807
KARNATAKA,BALLARI,2021-03-20,11,3022,39,3072
KARNATAKA,BELAGAVI,2021-03-16,27,1727,4,1758
KARNATAKA,BELAGAVI,2021-03-17,52,1853,0,1905
KARNATAKA,BELAGAVI,2021-03-18,12,2087,3,2102
KARNATAKA,BELAGAVI,2021-03-19,22,2525,4,2551
KARNATAKA,BELAGAVI,2021-03-20,24,2519,11,2554
KARNATAKA,BENGALURU RURAL,2021-03-16,29,3572,1,3602
KARNATAKA,BENGALURU RURAL,2021-03-17,30,4051,1,4082
KARNATAKA,BENGALURU RURAL,2021-03-18,39,4215,3,4257
KARNATAKA,BENGALURU RURAL,2021-03-19,33,1180,0,1213
KARNATAKA,BENGALURU RURAL,2021-03-20,50,1643,3,1696
KARNATAKA,BENGALURU URBAN,2021-03-16,862,39986,336,41184
KARNATAKA,BENGALURU URBAN,2021-03-17,1051,42999,97,44147
KARNATAKA,BENGALURU URBAN,2021-03-18,1027,39875,180,41082
KARNATAKA,BENGALURU URBAN,2021-03-19,1264,44208,91,45563
KARNATAKA,BENGALURU URBAN,2021-03-20,1154,45209,131,46494
KARNATAKA,BIDAR,2021-03-16,61,823,0,884
KARNATAKA,BIDAR,2021-03-17,59,859,0,918
KARNATAKA,BIDAR,2021-03-18,48,1257,0,1305
KARNATAKA,BIDAR,2021-03-19,57,1771,1,1829
KARNATAKA,BIDAR,2021-03-20,81,2125,0,2206
KARNATAKA,CHAMARAJANAGARA,2021-03-16,4,808,4,816
KARNATAKA,CHAMARAJANAGARA,2021-03-17,5,773,3,781
KARNATAKA,CHAMARAJANAGARA,2021-03-18,9,773,3,785
KARNATAKA,CHAMARAJANAGARA,2021-03-19,3,684,5,692
KARNATAKA,CHAMARAJANAGARA,2021-03-20,4,956,5,965
KARNATAKA,CHIKKABALLAPURA,2021-03-16,13,1480,2,1495
KARNATAKA,CHIKKABALLAPURA,2021-03-17,8,2141,1,2150
KARNATAKA,CHIKKABALLAPURA,2021-03-18,11,1929,2,1942
KARNATAKA,CHIKKABALLAPURA,2021-03-19,12,1820,1,1833
KARNATAKA,CHIKKABALLAPURA,2021-03-20,10,1832,8,1850
KARNATAKA,CHIKKAMAGALURU,2021-03-16,11,694,0,705
KARNATAKA,CHIKKAMAGALURU,2021-03-17,16,627,1,644
KARNATAKA,CHIKKAMAGALURU,2021-03-18,8,512,1,521
KARNATAKA,CHIKKAMAGALURU,2021-03-19,5,823,0,828
KARNATAKA,CHIKKAMAGALURU,2021-03-20,7,790,0,797
KARNATAKA,CHITRADURGA,2021-03-16,5,818,1,824
KARNATAKA,CHITRADURGA,2021-03-17,3,894,1,898
KARNATAKA,CHITRADURGA,2021-03-18,14,1204,5,1223
KARNATAKA,CHITRADURGA,2021-03-19,6,910,0,916
KARNATAKA,CHITRADURGA,2021-03-20,3,510,1,514
KARNATAKA,DAKSHINA KANNADA,2021-03-16,71,1767,0,1838
KARNATAKA,DAKSHINA KANNADA,2021-03-17,61,2291,2,2354
KARNATAKA,DAKSHINA KANNADA,2021-03-18,40,2415,0,2455
KARNATAKA,DAKSHINA KANNADA,2021-03-19,54,2177,4,2235
KARNATAKA,DAKSHINA KANNADA,2021-03-20,71,2018,1,2090
KARNATAKA,DAVANGERE,2021-03-16,6,2121,117,2244
KARNATAKA,DAVANGERE,2021-03-17,23,1766,73,1862
KARNATAKA,DAVANGERE,2021-03-18,3,1872,54,1929
KARNATAKA,DAVANGERE,2021-03-19,5,1655,0,1660
KARNATAKA,DAVANGERE,2021-03-20,10,1949,10,1969
KARNATAKA,DHARWAD,2021-03-16,18,2487,49,2554
KARNATAKA,DHARWAD,2021-03-17,20,2949,80,3049
KARNATAKA,DHARWAD,2021-03-18,32,2256,15,2303
KARNATAKA,DHARWAD,2021-03-19,22,2012,7,2041
KARNATAKA,DHARWAD,2021-03-20,28,2412,6,2446
KARNATAKA,GADAG,2021-03-16,2,682,49,733
KARNATAKA,GADAG,2021-03-17,0,833,76,909
KARNATAKA,GADAG,2021-03-18,4,782,32,818
KARNATAKA,GADAG,2021-03-19,11,1719,1,1731
KARNATAKA,GADAG,2021-03-20,5,693,116,814
KARNATAKA,HASSAN,2021-03-16,22,1356,10,1388
KARNATAKA,HASSAN,2021-03-17,36,1191,62,1289
KARNATAKA,HASSAN,2021-03-18,37,1563,33,1633
KARNATAKA,HASSAN,2021-03-19,35,2407,24,2466
KARNATAKA,HASSAN,2021-03-20,43,3309,11,3363
KARNATAKA,HAVERI,2021-03-16,0,428,2,430
KARNATAKA,HAVERI,2021-03-17,1,692,0,693
KARNATAKA,HAVERI,2021-03-18,1,758,0,759
KARNATAKA,HAVERI,2021-03-19,2,975,0,977
KARNATAKA,HAVERI,2021-03-20,3,847,0,850
KARNATAKA,KALABURAGI,2021-03-16,86,2078,1,2165
KARNATAKA,KALABURAGI,2021-03-17,75,1893,1,1969
KARNATAKA,KALABURAGI,2021-03-18,71,1960,3,2034
KARNATAKA,KALABURAGI,2021-03-19,66,2453,3,2522
KARNATAKA,KALABURAGI,2021-03-20,88,2748,21,2857
KARNATAKA,KODAGU,2021-03-16,7,671,46,724
KARNATAKA,KODAGU,2021-03-17,3,793,36,832
KARNATAKA,KODAGU,2021-03-18,3,726,43,772
KARNATAKA,KODAGU,2021-03-19,7,968,12,987
KARNATAKA,KODAGU,2021-03-20,32,1402,98,1532
KARNATAKA,KOLAR,2021-03-16,24,1581,3,1608
KARNATAKA,KOLAR,2021-03-17,13,1624,3,1640
KARNATAKA,KOLAR,2021-03-18,15,1997,4,2016
KARNATAKA,KOLAR,2021-03-19,20,661,0,681
KARNATAKA,KOLAR,2021-03-20,13,2413,3,2429
KARNATAKA,KOPPAL,2021-03-16,1,844,2,847
KARNATAKA,KOPPAL,2021-03-17,1,727,3,731
KARNATAKA,KOPPAL,2021-03-18,0,698,3,701
KARNATAKA,KOPPAL,2021-03-19,5,514,1,520
KARNATAKA,KOPPAL,2021-03-20,0,970,6,976
KARNATAKA,MANDYA,2021-03-16,18,1759,12,1789
KARNATAKA,MANDYA,2021-03-17,21,1189,12,1222
KARNATAKA,MANDYA,2021-03-18,15,2207,15,2237
KARNATAKA,MANDYA,2021-03-19,26,2336,9,2371
KARNATAKA,MANDYA,2021-03-20,20,2100,13,2133
KARNATAKA,MYSURU,2021-03-16,56,3922,53,4031
KARNATAKA,MYSURU,2021-03-17,57,4501,31,4589
KARNATAKA,MYSURU,2021-03-18,54,5136,10,5200
KARNATAKA,MYSURU,2021-03-19,82,4212,4,4298
KARNATAKA,MYSURU,2021-03-20,88,4741,22,4851
KARNATAKA,RAICHUR,2021-03-16,5,503,4,512
KARNATAKA,RAICHUR,2021-03-17,7,734,0,741
KARNATAKA,RAICHUR,2021-03-18,7,911,3,921
KARNATAKA,RAICHUR,2021-03-19,6,979,5,990
KARNATAKA,RAICHUR,2021-03-20,10,887,3,900
KARNATAKA,RAMANAGARA,2021-03-16,2,954,2,958
KARNATAKA,RAMANAGARA,2021-03-17,1,743,1,745
KARNATAKA,RAMANAGARA,2021-03-18,7,323,3,333
KARNATAKA,RAMANAGARA,2021-03-19,3,748,0,751
KARNATAKA,RAMANAGARA,2021-03-20,5,525,1,531
KARNATAKA,SHIVAMOGGA,2021-03-16,6,1055,2,1063
KARNATAKA,SHIVAMOGGA,2021-03-17,13,1217,0,1230
KARNATAKA,SHIVAMOGGA,2021-03-18,12,1333,22,1367
KARNATAKA,SHIVAMOGGA,2021-03-19,14,1404,2,1420
KARNATAKA,SHIVAMOGGA,2021-03-20,9,933,3,945
KARNATAKA,TUMAKURU,2021-03-16,18,1733,16,1767
KARNATAKA,TUMAKURU,2021-03-17,55,2598,6,2659
KARNATAKA,TUMAKURU,2021-03-18,56,1942,5,2003
KARNATAKA,TUMAKURU,2021-03-19,51,1784,49,1884
KARNATAKA,TUMAKURU,2021-03-20,49,3481,3,3533
KARNATAKA,UDUPI,2021-03-16,40,1179,0,1219
KARNATAKA,UDUPI,2021-03-17,41,1313,0,1354
KARNATAKA,UDUPI,2021-03-18,18,1176,1,1195
KARNATAKA,UDUPI,2021-03-19,68,1886,1,1955
KARNATAKA,UDUPI,2021-03-20,173,1796,2,1971
KARNATAKA,UTTARA KANNADA,2021-03-16,6,1840,178,2024
KARNATAKA,UTTARA KANNADA,2021-03-17,7,1388,144,1539
KARNATAKA,UTTARA KANNADA,2021-03-18,5,1237,116,1358
KARNATAKA,UTTARA KANNADA,2021-03-19,5,1255,85,1345
KARNATAKA,UTTARA KANNADA,2021-03-20,13,1327,236,1576
KARNATAKA,VIJAYAPURA,2021-03-16,20,2236,0,2256
KARNATAKA,VIJAYAPURA,2021-03-17,51,3710,2,3763
KARNATAKA,VIJAYAPURA,2021-03-18,36,3258,3,3297
KARNATAKA,VIJAYAPURA,2021-03-19,30,2506,0,2536
KARNATAKA,VIJAYAPURA,2021-03-20,25,2822,0,2847
KARNATAKA,YADGIR,2021-03-16,7,1109,0,1116
KARNATAKA,YADGIR,2021-03-17,5,1029,1,1035
KARNATAKA,YADGIR,2021-03-18,12,1197,0,1209
KARNATAKA,YADGIR,2021-03-19,3,1169,0,1172
KARNATAKA,YADGIR,2021-03-20,6,1125,1,1132
KERALA,ALAPPUZHA,2021-03-16,597,7576,44,8217
KERALA,ALAPPUZHA,2021-03-17,407,7703,38,8148
KERALA,ALAPPUZHA,2021-03-18,388,9007,32,9427
KERALA,ALAPPUZHA,2021-03-19,624,10903,114,11641
KERALA,ALAPPUZHA,2021-03-20,313,10094,89,10496
KERALA,ERNAKULAM,2021-03-16,1365,13501,60,14926
KERALA,ERNAKULAM,2021-03-17,745,16231,75,17051
KERALA,ERNAKULAM,2021-03-18,745,17877,63,18685
KERALA,ERNAKULAM,2021-03-19,1682,22520,151,24353
KERALA,ERNAKULAM,2021-03-20,843,20189,287,21319
KERALA,IDUKKI,2021-03-16,454,4032,23,4509
KERALA,IDUKKI,2021-03-17,160,3066,8,3234
KERALA,IDUKKI,2021-03-18,190,3556,28,3774
KERALA,IDUKKI,2021-03-19,370,4310,43,4723
KERALA,IDUKKI,2021-03-20,129,3738,33,3900
KERALA,KANNUR,2021-03-16,631,8158,23,8812
KERALA,KANNUR,2021-03-17,574,9051,38,9663
KERALA,KANNUR,2021-03-18,519,9326,42,9887
KERALA,KANNUR,2021-03-19,628,13163,85,13876
KERALA,KANNUR,2021-03-20,294,10244,49,10587
KERALA,KASARAGOD,2021-03-16,263,3563,27,3853
KERALA,KASARAGOD,2021-03-17,316,4062,34,4412
KERALA,KASARAGOD,2021-03-18,251,3909,10,4170
KERALA,KASARAGOD,2021-03-19,209,6572,54,6835
KERALA,KASARAGOD,2021-03-20,147,5896,54,6097
KERALA,KOLLAM,2021-03-16,877,9819,83,10779
KERALA,KOLLAM,2021-03-17,685,8790,84,9559
KERALA,KOLLAM,2021-03-18,753,10435,92,11280
KERALA,KOLLAM,2021-03-19,999,11423,295,12717
KERALA,KOLLAM,2021-03-20,628,12273,157,13058
KERALA,KOTTAYAM,2021-03-16,981,7926,46,8953
KERALA,KOTTAYAM,2021-03-17,578,6908,55,7541
KERALA,KOTTAYAM,2021-03-18,559,8225,57,8841
KERALA,KOTTAYAM,2021-03-19,1033,10597,90,11720
KERALA,KOTTAYAM,2021-03-20,473,9916,100,10489
KERALA,KOZHIKODE,2021-03-16,1218,10524,94,11836
KERALA,KOZHIKODE,2021-03-17,917,11773,100,12790
KERALA,KOZHIKODE,2021-03-18,830,13055,78,13963
KERALA,KOZHIKODE,2021-03-19,1203,18626,277,20106
KERALA,KOZHIKODE,2021-03-20,554,16907,254,17715
KERALA,MALAPPURAM,2021-03-16,561,9047,21,9629
KERALA,MALAPPURAM,2021-03-17,608,10392,39,11039
KERALA,MALAPPURAM,2021-03-18,1633,11582,18,13233
KERALA,MALAPPURAM,2021-03-19,1653,16483,62,18198
KERALA,MALAPPURAM,2021-03-20,1606,22404,214,24224
KERALA,PALAKKAD,2021-03-16,441,6979,9,7429
KERALA,PALAKKAD,2021-03-17,205,7399,10,7614
KERALA,PALAKKAD,2021-03-18,297,6920,8,7225
KERALA,PALAKKAD,2021-03-19,443,11167,58,11668
KERALA,PALAKKAD,2021-03-20,248,10977,77,11302
KERALA,PATHANAMTHITTA,2021-03-16,672,6770,14,7456
KERALA,PATHANAMTHITTA,2021-03-17,394,8024,8,8426
KERALA,PATHANAMTHITTA,2021-03-18,597,8906,13,9516
KERALA,PATHANAMTHITTA,2021-03-19,908,8581,21,9510
KERALA,PATHANAMTHITTA,2021-03-20,425,10422,90,10937
KERALA,THIRUVANANTHAPURAM,2021-03-16,782,11348,42,12172
KERALA,THIRUVANANTHAPURAM,2021-03-17,732,14693,76,15501
KERALA,THIRUVANANTHAPURAM,2021-03-18,594,15979,72,16645
KERALA,THIRUVANANTHAPURAM,2021-03-19,744,22188,172,23104
KERALA,THIRUVANANTHAPURAM,2021-03-20,382,20637,119,21138
KERALA,THRISSUR,2021-03-16,763,11125,8,11896
KERALA,THRISSUR,2021-03-17,532,15499,12,16043
KERALA,THRISSUR,2021-03-18,539,12744,10,13293
KERALA,THRISSUR,2021-03-19,962,23798,23,24783
KERALA,THRISSUR,2021-03-20,393,23103,58,23554
KERALA,WAYANAD,2021-03-16,329,2381,15,2725
KERALA,WAYANAD,2021-03-17,146,2533,8,2687
KERALA,WAYANAD,2021-03-18,162,2602,23,2787
KERALA,WAYANAD,2021-03-19,454,4740,37,5231
KERALA,WAYANAD,2021-03-20,129,5530,66,5725
LADAKH,KARGIL,2021-03-16,0,170,1,171
LADAKH,KARGIL,2021-03-17,1,131,0,132
LADAKH,KARGIL,2021-03-18,0,72,0,72
LADAKH,KARGIL,2021-03-19,0,217,3,220
LADAKH,KARGIL,2021-03-20,0,71,0,71
LADAKH,LEH LADAKH,2021-03-16,9,217,0,226
LADAKH,LEH LADAKH,2021-03-17,4,353,1,358
LADAKH,LEH LADAKH,2021-03-18,8,371,1,380
LADAKH,LEH LADAKH,2021-03-19,7,254,4,265
LADAKH,LEH LADAKH,2021-03-20,28,534,2,564
LAKSHADWEEP,LAKSHADWEEP DISTRICT,2021-03-16,6,434,0,440
LAKSHADWEEP,LAKSHADWEEP DISTRICT,2021-03-17,7,235,0,242
LAKSHADWEEP,LAKSHADWEEP DISTRICT,2021-03-18,27,203,0,230
LAKSHADWEEP,LAKSHADWEEP DISTRICT,2021-03-19,9,327,0,336
LAKSHADWEEP,LAKSHADWEEP DISTRICT,2021-03-20,2,274,0,276
MADHYA PRADESH,AGAR MALWA,2021-03-16,4,184,0,188
MADHYA PRADESH,AGAR MALWA,2021-03-17,2,43,0,45
MADHYA PRADESH,AGAR MALWA,2021-03-18,1,203,0,204
MADHYA PRADESH,AGAR MALWA,2021-03-19,2,123,0,125
MADHYA PRADESH,AGAR MALWA,2021-03-20,0,25,0,25
MADHYA PRADESH,ALIRAJPUR,2021-03-16,2,160,0,162
MADHYA PRADESH,ALIRAJPUR,2021-03-17,6,144,0,150
MADHYA PRADESH,ALIRAJPUR,2021-03-18,3,137,0,140
MADHYA PRADESH,ALIRAJPUR,2021-03-19,6,187,0,193
MADHYA PRADESH,ALIRAJPUR,2021-03-20,7,320,0,327
MADHYA PRADESH,ANUPPUR,2021-03-16,4,71,0,75
MADHYA PRADESH,ANUPPUR,2021-03-17,2,103,0,105
MADHYA PRADESH,ANUPPUR,2021-03-18,5,76,0,81
MADHYA PRADESH,ANUPPUR,2021-03-19,2,107,0,109
MADHYA PRADESH,ANUPPUR,2021-03-20,1,122,0,123
MADHYA PRADESH,ASHOKNAGAR,2021-03-16,0,187,0,187
MADHYA PRADESH,ASHOKNAGAR,2021-03-17,5,87,0,92
MADHYA PRADESH,ASHOKNAGAR,2021-03-18,2,245,0,247
MADHYA PRADESH,ASHOKNAGAR,2021-03-19,3,149,0,152
MADHYA PRADESH,ASHOKNAGAR,2021-03-20,1,191,0,192
MADHYA PRADESH,BALAGHAT,2021-03-16,6,317,1,324
MADHYA PRADESH,BALAGHAT,2021-03-17,3,348,0,351
MADHYA PRADESH,BALAGHAT,2021-03-18,4,634,0,638
MADHYA PRADESH,BALAGHAT,2021-03-19,6,363,1,370
MADHYA PRADESH,BALAGHAT,2021-03-20,11,85,0,96
MADHYA PRADESH,BARWANI,2021-03-16,20,277,19,316
MADHYA PRADESH,BARWANI,2021-03-17,8,62,0,70
MADHYA PRADESH,BARWANI,2021-03-18,27,60,4,91
MADHYA PRADESH,BARWANI,2021-03-19,14,202,0,216
MADHYA PRADESH,BARWANI,2021-03-20,16,223,0,239
MADHYA PRADESH,BETUL,2021-03-16,8,125,1,134
MADHYA PRADESH,BETUL,2021-03-17,55,258,2,315
MADHYA PRADESH,BETUL,2021-03-18,16,49,0,65
MADHYA PRADESH,BETUL,2021-03-19,57,255,2,314
MADHYA PRADESH,BETUL,2021-03-20,70,159,2,231
MADHYA PRADESH,BHIND,2021-03-16,4,177,0,181
MADHYA PRADESH,BHIND,2021-03-17,0,260,0,260
MADHYA PRADESH,BHIND,2021-03-18,1,220,0,221
MADHYA PRADESH,BHIND,2021-03-19,1,214,0,215
MADHYA PRADESH,BHIND,2021-03-20,1,73,0,74
MADHYA PRADESH,BHOPAL,2021-03-16,285,1630,35,1950
MADHYA PRADESH,BHOPAL,2021-03-17,352,1981,52,2385
MADHYA PRADESH,BHOPAL,2021-03-18,472,1889,87,2448
MADHYA PRADESH,BHOPAL,2021-03-19,487,1913,130,2530
MADHYA PRADESH,BHOPAL,2021-03-20,582,1568,157,2307
MADHYA PRADESH,BURHANPUR,2021-03-16,11,317,0,328
MADHYA PRADESH,BURHANPUR,2021-03-17,22,225,0,247
MADHYA PRADESH,BURHANPUR,2021-03-18,15,434,2,451
MADHYA PRADESH,BURHANPUR,2021-03-19,21,620,7,648
MADHYA PRADESH,BURHANPUR,2021-03-20,24,304,22,350
MADHYA PRADESH,CHHATARPUR,2021-03-16,0,82,0,82
MADHYA PRADESH,CHHATARPUR,2021-03-17,1,150,0,151
MADHYA PRADESH,CHHATARPUR,2021-03-18,3,123,0,126
MADHYA PRADESH,CHHATARPUR,2021-03-19,5,124,0,129
MADHYA PRADESH,CHHATARPUR,2021-03-20,3,133,0,136
MADHYA PRADESH,CHHINDWARA,2021-03-16,94,334,51,479
MADHYA PRADESH,CHHINDWARA,2021-03-17,52,288,10,350
MADHYA PRADESH,CHHINDWARA,2021-03-18,58,292,24,374
MADHYA PRADESH,CHHINDWARA,2021-03-19,26,430,40,496
MADHYA PRADESH,CHHINDWARA,2021-03-20,53,572,50,675
MADHYA PRADESH,DAMOH,2021-03-16,8,115,0,123
MADHYA PRADESH,DAMOH,2021-03-17,13,208,0,221
MADHYA PRADESH,DAMOH,2021-03-18,9,132,0,141
MADHYA PRADESH,DAMOH,2021-03-19,10,108,0,118
MADHYA PRADESH,DAMOH,2021-03-20,17,158,0,175
MADHYA PRADESH,DATIA,2021-03-16,2,157,15,174
MADHYA PRADESH,DATIA,2021-03-17,6,131,15,152
MADHYA PRADESH,DATIA,2021-03-18,5,141,7,153
MADHYA PRADESH,DATIA,2021-03-19,9,228,16,253
MADHYA PRADESH,DATIA,2021-03-20,7,248,8,263
MADHYA PRADESH,DEWAS,2021-03-16,10,504,0,514
MADHYA PRADESH,DEWAS,2021-03-17,29,395,0,424
MADHYA PRADESH,DEWAS,2021-03-18,26,511,0,537
MADHYA PRADESH,DEWAS,2021-03-19,50,500,0,550
MADHYA PRADESH,DEWAS,2021-03-20,76,373,0,449
MADHYA PRADESH,DHAR,2021-03-16,28,215,5,248
MADHYA PRADESH,DHAR,2021-03-17,16,258,0,274
MADHYA PRADESH,DHAR,2021-03-18,18,102,10,130
MADHYA PRADESH,DHAR,2021-03-19,12,130,0,142
MADHYA PRADESH,DHAR,2021-03-20,21,74,1,96
MADHYA PRADESH,DINDORI,2021-03-16,0,33,0,33
MADHYA PRADESH,DINDORI,2021-03-17,0,100,0,100
MADHYA PRADESH,DINDORI,2021-03-18,0,228,0,228
MADHYA PRADESH,DINDORI,2021-03-19,1,275,0,276
MADHYA PRADESH,DINDORI,2021-03-20,4,336,0,340
MADHYA PRADESH,EAST NIMAR,2021-03-16,28,268,0,296
MADHYA PRADESH,EAST NIMAR,2021-03-17,34,343,4,381
MADHYA PRADESH,EAST NIMAR,2021-03-18,32,476,5,513
MADHYA PRADESH,EAST NIMAR,2021-03-19,33,244,1,278
MADHYA PRADESH,EAST NIMAR,2021-03-20,7,480,5,492
MADHYA PRADESH,GUNA,2021-03-16,7,113,0,120
MADHYA PRADESH,GUNA,2021-03-17,9,127,0,136
MADHYA PRADESH,GUNA,2021-03-18,8,270,0,278
MADHYA PRADESH,GUNA,2021-03-19,9,292,0,301
MADHYA PRADESH,GUNA,2021-03-20,2,165,0,167
MADHYA PRADESH,GWALIOR,2021-03-16,25,1023,2,1050
MADHYA PRADESH,GWALIOR,2021-03-17,20,1216,0,1236
MADHYA PRADESH,GWALIOR,2021-03-18,37,1035,3,1075
MADHYA PRADESH,GWALIOR,2021-03-19,48,1240,1,1289
MADHYA PRADESH,GWALIOR,2021-03-20,46,933,1,980
MADHYA PRADESH,HARDA,2021-03-16,3,147,2,152
MADHYA PRADESH,HARDA,2021-03-17,2,152,0,154
MADHYA PRADESH,HARDA,2021-03-18,2,235,3,240
MADHYA PRADESH,HARDA,2021-03-19,3,162,0,165
MADHYA PRADESH,HARDA,2021-03-20,7,328,0,335
MADHYA PRADESH,HOSHANGABAD,2021-03-16,9,99,2,110
MADHYA PRADESH,HOSHANGABAD,2021-03-17,4,225,1,230
MADHYA PRADESH,HOSHANGABAD,2021-03-18,21,241,0,262
MADHYA PRADESH,HOSHANGABAD,2021-03-19,26,212,0,238
MADHYA PRADESH,HOSHANGABAD,2021-03-20,9,227,0,236
MADHYA PRADESH,INDORE,2021-03-16,929,2173,51,3153
MADHYA PRADESH,INDORE,2021-03-17,931,2139,1,3071
MADHYA PRADESH,INDORE,2021-03-18,1403,2772,17,4192
MADHYA PRADESH,INDORE,2021-03-19,1172,3815,20,5007
MADHYA PRADESH,INDORE,2021-03-20,913,2544,1,3458
MADHYA PRADESH,JABALPUR,2021-03-16,90,434,2,526
MADHYA PRADESH,JABALPUR,2021-03-17,92,540,10,642
MADHYA PRADESH,JABALPUR,2021-03-18,121,620,0,741
MADHYA PRADESH,JABALPUR,2021-03-19,91,527,1,619
MADHYA PRADESH,JABALPUR,2021-03-20,114,829,1,944
MADHYA PRADESH,JHABUA,2021-03-16,22,208,4,234
MADHYA PRADESH,JHABUA,2021-03-17,6,76,0,82
MADHYA PRADESH,JHABUA,2021-03-18,18,165,0,183
MADHYA PRADESH,JHABUA,2021-03-19,9,160,0,169
MADHYA PRADESH,JHABUA,2021-03-20,9,154,1,164
MADHYA PRADESH,KATNI,2021-03-16,10,210,4,224
MADHYA PRADESH,KATNI,2021-03-17,3,200,1,204
MADHYA PRADESH,KATNI,2021-03-18,3,561,0,564
MADHYA PRADESH,KATNI,2021-03-19,5,279,0,284
MADHYA PRADESH,KATNI,2021-03-20,6,112,1,119
MADHYA PRADESH,KHARGONE,2021-03-16,33,284,6,323
MADHYA PRADESH,KHARGONE,2021-03-17,34,94,0,128
MADHYA PRADESH,KHARGONE,2021-03-18,51,299,2,352
MADHYA PRADESH,KHARGONE,2021-03-19,17,297,0,314
MADHYA PRADESH,KHARGONE,2021-03-20,24,345,0,369
MADHYA PRADESH,MANDLA,2021-03-16,1,468,0,469
MADHYA PRADESH,MANDLA,2021-03-17,0,459,2,461
MADHYA PRADESH,MANDLA,2021-03-18,4,357,0,361
MADHYA PRADESH,MANDLA,2021-03-19,2,441,1,444
MADHYA PRADESH,MANDLA,2021-03-20,3,78,0,81
MADHYA PRADESH,MANDSAUR,2021-03-16,17,365,9,391
MADHYA PRADESH,MANDSAUR,2021-03-17,44,366,8,418
MADHYA PRADESH,MANDSAUR,2021-03-18,26,302,1,329
MADHYA PRADESH,MANDSAUR,2021-03-19,28,303,6,337
MADHYA PRADESH,MANDSAUR,2021-03-20,30,456,10,496
MADHYA PRADESH,MORENA,2021-03-16,3,221,0,224
MADHYA PRADESH,MORENA,2021-03-17,3,233,0,236
MADHYA PRADESH,MORENA,2021-03-18,2,354,0,356
MADHYA PRADESH,MORENA,2021-03-19,3,326,0,329
MADHYA PRADESH,MORENA,2021-03-20,3,246,0,249
MADHYA PRADESH,NARSINGHPUR,2021-03-16,2,421,6,429
MADHYA PRADESH,NARSINGHPUR,2021-03-17,3,209,0,212
MADHYA PRADESH,NARSINGHPUR,2021-03-18,1,342,0,343
MADHYA PRADESH,NARSINGHPUR,2021-03-19,9,506,0,515
MADHYA PRADESH,NARSINGHPUR,2021-03-20,4,635,0,639
MADHYA PRADESH,NEEMUCH,2021-03-16,3,359,1,363
MADHYA PRADESH,NEEMUCH,2021-03-17,9,273,0,282
MADHYA PRADESH,NEEMUCH,2021-03-18,22,302,4,328
MADHYA PRADESH,NEEMUCH,2021-03-19,13,682,2,697
MADHYA PRADESH,NEEMUCH,2021-03-20,7,582,0,589
MADHYA PRADESH,NIWARI,2021-03-16,0,16,0,16
MADHYA PRADESH,NIWARI,2021-03-17,0,43,0,43
MADHYA PRADESH,NIWARI,2021-03-18,0,16,0,16
MADHYA PRADESH,NIWARI,2021-03-19,0,79,0,79
MADHYA PRADESH,NIWARI,2021-03-20,3,57,0,60
MADHYA PRADESH,PANNA,2021-03-16,6,364,1,371
MADHYA PRADESH,PANNA,2021-03-17,1,152,0,153
MADHYA PRADESH,PANNA,2021-03-18,3,292,17,312
MADHYA PRADESH,PANNA,2021-03-19,2,198,1,201
MADHYA PRADESH,PANNA,2021-03-20,15,310,8,333
MADHYA PRADESH,RAISEN,2021-03-16,6,246,0,252
MADHYA PRADESH,RAISEN,2021-03-17,19,165,0,184
MADHYA PRADESH,RAISEN,2021-03-18,11,293,0,304
MADHYA PRADESH,RAISEN,2021-03-19,14,119,0,133
MADHYA PRADESH,RAISEN,2021-03-20,18,91,0,109
MADHYA PRADESH,RAJGARH,2021-03-16,4,94,0,98
MADHYA PRADESH,RAJGARH,2021-03-17,16,132,0,148
MADHYA PRADESH,RAJGARH,2021-03-18,9,238,0,247
MADHYA PRADESH,RAJGARH,2021-03-19,9,208,0,217
MADHYA PRADESH,RAJGARH,2021-03-20,21,198,0,219
MADHYA PRADESH,RATLAM,2021-03-16,27,360,10,397
MADHYA PRADESH,RATLAM,2021-03-17,29,284,1,314
MADHYA PRADESH,RATLAM,2021-03-18,48,394,2,444
MADHYA PRADESH,RATLAM,2021-03-19,48,963,13,1024
MADHYA PRADESH,RATLAM,2021-03-20,47,673,11,731
MADHYA PRADESH,REWA,2021-03-16,8,549,4,561
MADHYA PRADESH,REWA,2021-03-17,6,469,4,479
MADHYA PRADESH,REWA,2021-03-18,13,567,1,581
MADHYA PRADESH,REWA,2021-03-19,11,528,1,540
MADHYA PRADESH,REWA,2021-03-20,10,332,1,343
MADHYA PRADESH,SAGAR,2021-03-16,15,684,5,704
MADHYA PRADESH,SAGAR,2021-03-17,24,470,1,495
MADHYA PRADESH,SAGAR,2021-03-18,34,669,0,703
MADHYA PRADESH,SAGAR,2021-03-19,31,490,2,523
MADHYA PRADESH,SAGAR,2021-03-20,40,546,2,588
MADHYA PRADESH,SATNA,2021-03-16,5,341,1,347
MADHYA PRADESH,SATNA,2021-03-17,3,141,0,144
MADHYA PRADESH,SATNA,2021-03-18,11,149,0,160
MADHYA PRADESH,SATNA,2021-03-19,5,303,6,314
MADHYA PRADESH,SATNA,2021-03-20,13,287,0,300
MADHYA PRADESH,SEHORE,2021-03-16,7,320,0,327
MADHYA PRADESH,SEHORE,2021-03-17,4,169,0,173
MADHYA PRADESH,SEHORE,2021-03-18,4,283,1,288
MADHYA PRADESH,SEHORE,2021-03-19,9,259,0,268
MADHYA PRADESH,SEHORE,2021-03-20,18,198,1,217
MADHYA PRADESH,SEONI,2021-03-16,7,240,0,247
MADHYA PRADESH,SEONI,2021-03-17,4,170,55,229
MADHYA PRADESH,SEONI,2021-03-18,12,213,32,257
MADHYA PRADESH,SEONI,2021-03-19,7,204,27,238
MADHYA PRADESH,SEONI,2021-03-20,7,185,2,194
MADHYA PRADESH,SHAHDOL,2021-03-16,0,126,41,167
MADHYA PRADESH,SHAHDOL,2021-03-17,1,208,12,221
MADHYA PRADESH,SHAHDOL,2021-03-18,1,117,75,193
MADHYA PRADESH,SHAHDOL,2021-03-19,4,29,2,35
MADHYA PRADESH,SHAHDOL,2021-03-20,2,26,1,29
MADHYA PRADESH,SHAJAPUR,2021-03-16,8,147,0,155
MADHYA PRADESH,SHAJAPUR,2021-03-17,12,151,1,164
MADHYA PRADESH,SHAJAPUR,2021-03-18,9,166,0,175
MADHYA PRADESH,SHAJAPUR,2021-03-19,7,148,0,155
MADHYA PRADESH,SHAJAPUR,2021-03-20,14,438,0,452
MADHYA PRADESH,SHEOPUR,2021-03-16,5,66,1,72
MADHYA PRADESH,SHEOPUR,2021-03-17,6,121,1,128
MADHYA PRADESH,SHEOPUR,2021-03-18,3,219,0,222
MADHYA PRADESH,SHEOPUR,2021-03-19,5,30,0,35
MADHYA PRADESH,SHEOPUR,2021-03-20,3,38,0,41
MADHYA PRADESH,SHIVPURI,2021-03-16,2,221,1,224
MADHYA PRADESH,SHIVPURI,2021-03-17,9,242,6,257
MADHYA PRADESH,SHIVPURI,2021-03-18,6,247,0,253
MADHYA PRADESH,SHIVPURI,2021-03-19,9,193,0,202
MADHYA PRADESH,SHIVPURI,2021-03-20,4,271,7,282
MADHYA PRADESH,SIDHI,2021-03-16,16,177,0,193
MADHYA PRADESH,SIDHI,2021-03-17,6,229,3,238
MADHYA PRADESH,SIDHI,2021-03-18,5,217,2,224
MADHYA PRADESH,SIDHI,2021-03-19,4,61,0,65
MADHYA PRADESH,SIDHI,2021-03-20,1,238,0,239
MADHYA PRADESH,SINGRAULI,2021-03-16,5,17,0,22
MADHYA PRADESH,SINGRAULI,2021-03-17,3,124,0,127
MADHYA PRADESH,SINGRAULI,2021-03-18,2,198,0,200
MADHYA PRADESH,SINGRAULI,2021-03-19,4,272,0,276
MADHYA PRADESH,SINGRAULI,2021-03-20,0,86,0,86
MADHYA PRADESH,TIKAMGARH,2021-03-16,1,131,0,132
MADHYA PRADESH,TIKAMGARH,2021-03-17,5,207,4,216
MADHYA PRADESH,TIKAMGARH,2021-03-18,4,109,0,113
MADHYA PRADESH,TIKAMGARH,2021-03-19,3,267,3,273
MADHYA PRADESH,TIKAMGARH,2021-03-20,0,136,0,136
MADHYA PRADESH,UJJAIN,2021-03-16,73,678,2,753
MADHYA PRADESH,UJJAIN,2021-03-17,22,636,1,659
MADHYA PRADESH,UJJAIN,2021-03-18,50,461,0,511
MADHYA PRADESH,UJJAIN,2021-03-19,59,377,0,436
MADHYA PRADESH,UJJAIN,2021-03-20,30,450,4,484
MADHYA PRADESH,UMARIA,2021-03-16,2,150,0,152
MADHYA PRADESH,UMARIA,2021-03-17,1,32,0,33
MADHYA PRADESH,UMARIA,2021-03-18,3,24,0,27
MADHYA PRADESH,UMARIA,2021-03-19,5,27,0,32
MADHYA PRADESH,UMARIA,2021-03-20,3,35,0,38
MADHYA PRADESH,VIDISHA,2021-03-16,5,89,0,94
MADHYA PRADESH,VIDISHA,2021-03-17,10,93,0,103
MADHYA PRADESH,VIDISHA,2021-03-18,15,93,0,108
MADHYA PRADESH,VIDISHA,2021-03-19,15,89,1,105
MADHYA PRADESH,VIDISHA,2021-03-20,25,191,1,217
MAHARASHTRA,AHMEDNAGAR,2021-03-16,644,1843,36,2523
MAHARASHTRA,AHMEDNAGAR,2021-03-17,435,835,35,1305
MAHARASHTRA,AHMEDNAGAR,2021-03-18,686,1302,67,2055
MAHARASHTRA,AHMEDNAGAR,2021-03-19,659,1910,56,2625
MAHARASHTRA,AHMEDNAGAR,2021-03-20,856,1439,42,2337
MAHARASHTRA,AKOLA,2021-03-16,474,1906,3,2383
MAHARASHTRA,AKOLA,2021-03-17,861,1469,3,2333
MAHARASHTRA,AKOLA,2021-03-18,667,1078,1,1746
MAHARASHTRA,AKOLA,2021-03-19,744,1682,5,2431
MAHARASHTRA,AKOLA,2021-03-20,634,1830,4,2468
MAHARASHTRA,AMRAVATI,2021-03-16,490,2606,2,3098
MAHARASHTRA,AMRAVATI,2021-03-17,386,1943,5,2334
MAHARASHTRA,AMRAVATI,2021-03-18,473,1849,2,2324
MAHARASHTRA,AMRAVATI,2021-03-19,437,2443,1,2881
MAHARASHTRA,AMRAVATI,2021-03-20,328,2558,3,2889
MAHARASHTRA,AURANGABAD,2021-03-16,1165,2237,5,3407
MAHARASHTRA,AURANGABAD,2021-03-17,1718,2013,4,3735
MAHARASHTRA,AURANGABAD,2021-03-18,1949,2460,11,4420
MAHARASHTRA,AURANGABAD,2021-03-19,1581,2251,13,3845
MAHARASHTRA,AURANGABAD,2021-03-20,1791,3299,17,5107
MAHARASHTRA,BEED,2021-03-16,273,2087,3,2363
MAHARASHTRA,BEED,2021-03-17,249,1652,1,1902
MAHARASHTRA,BEED,2021-03-18,305,1605,1,1911
MAHARASHTRA,BEED,2021-03-19,279,1516,4,1799
MAHARASHTRA,BEED,2021-03-20,343,1363,1,1707
MAHARASHTRA,BHANDARA,2021-03-16,149,1229,2,1380
MAHARASHTRA,BHANDARA,2021-03-17,102,1318,0,1420
MAHARASHTRA,BHANDARA,2021-03-18,109,1324,1,1434
MAHARASHTRA,BHANDARA,2021-03-19,134,1640,4,1778
MAHARASHTRA,BHANDARA,2021-03-20,123,1137,1,1261
MAHARASHTRA,BULDHANA,2021-03-16,542,1076,16,1634
MAHARASHTRA,BULDHANA,2021-03-17,405,841,19,1265
MAHARASHTRA,BULDHANA,2021-03-18,429,1203,24,1656
MAHARASHTRA,BULDHANA,2021-03-19,494,1085,16,1595
MAHARASHTRA,BULDHANA,2021-03-20,580,1141,30,1751
MAHARASHTRA,CHANDRAPUR,2021-03-16,173,1808,13,1994
MAHARASHTRA,CHANDRAPUR,2021-03-17,142,2323,21,2486
MAHARASHTRA,CHANDRAPUR,2021-03-18,132,2372,11,2515
MAHARASHTRA,CHANDRAPUR,2021-03-19,182,2702,76,2960
MAHARASHTRA,CHANDRAPUR,2021-03-20,214,2381,3,2598
MAHARASHTRA,DHULE,2021-03-16,341,977,1,1319
MAHARASHTRA,DHULE,2021-03-17,332,559,2,893
MAHARASHTRA,DHULE,2021-03-18,335,704,1,1040
MAHARASHTRA,DHULE,2021-03-19,428,738,26,1192
MAHARASHTRA,DHULE,2021-03-20,385,835,6,1226
MAHARASHTRA,GADCHIROLI,2021-03-16,44,1180,1,1225
MAHARASHTRA,GADCHIROLI,2021-03-17,43,880,1,924
MAHARASHTRA,GADCHIROLI,2021-03-18,31,1168,4,1203
MAHARASHTRA,GADCHIROLI,2021-03-19,81,1312,1,1394
MAHARASHTRA,GADCHIROLI,2021-03-20,27,1208,0,1235
MAHARASHTRA,GONDIA,2021-03-16,39,2889,4,2932
MAHARASHTRA,GONDIA,2021-03-17,51,1872,4,1927
MAHARASHTRA,GONDIA,2021-03-18,47,1386,1,1434
MAHARASHTRA,GONDIA,2021-03-19,54,1718,2,1774
MAHARASHTRA,GONDIA,2021-03-20,92,2453,2,2547
MAHARASHTRA,HINGOLI,2021-03-16,78,417,0,495
MAHARASHTRA,HINGOLI,2021-03-17,89,323,1,413
MAHARASHTRA,HINGOLI,2021-03-18,28,124,0,152
MAHARASHTRA,HINGOLI,2021-03-19,114,450,1,565
MAHARASHTRA,HINGOLI,2021-03-20,126,431,0,557
MAHARASHTRA,JALGAON,2021-03-16,991,1883,15,2889
MAHARASHTRA,JALGAON,2021-03-17,657,1688,15,2360
MAHARASHTRA,JALGAON,2021-03-18,991,2424,3,3418
MAHARASHTRA,JALGAON,2021-03-19,971,3655,3,4629
MAHARASHTRA,JALGAON,2021-03-20,1535,3951,17,5503
MAHARASHTRA,JALNA,2021-03-16,190,739,0,929
MAHARASHTRA,JALNA,2021-03-17,316,940,0,1256
MAHARASHTRA,JALNA,2021-03-18,701,663,0,1364
MAHARASHTRA,JALNA,2021-03-19,589,595,0,1184
MAHARASHTRA,JALNA,2021-03-20,527,571,0,1098
MAHARASHTRA,KOLHAPUR,2021-03-16,54,880,46,980
MAHARASHTRA,KOLHAPUR,2021-03-17,67,1227,21,1315
MAHARASHTRA,KOLHAPUR,2021-03-18,61,1380,41,1482
MAHARASHTRA,KOLHAPUR,2021-03-19,90,1214,39,1343
MAHARASHTRA,KOLHAPUR,2021-03-20,75,1388,37,1500
MAHARASHTRA,LATUR,2021-03-16,233,2033,7,2273
MAHARASHTRA,LATUR,2021-03-17,294,1823,1,2118
MAHARASHTRA,LATUR,2021-03-18,233,2306,2,2541
MAHARASHTRA,LATUR,2021-03-19,334,2342,10,2686
MAHARASHTRA,LATUR,2021-03-20,343,1986,10,2339
MAHARASHTRA,MUMBAI,2021-03-16,1923,15106,35,17064
MAHARASHTRA,MUMBAI,2021-03-17,2397,16820,17,19234
MAHARASHTRA,MUMBAI,2021-03-18,2484,17473,49,20006
MAHARASHTRA,MUMBAI,2021-03-19,2407,18058,37,20502
MAHARASHTRA,MUMBAI,2021-03-20,3105,16649,54,19808
MAHARASHTRA,MUMBAI SUBURBAN,2021-03-16,646,3728,10,4384
MAHARASHTRA,MUMBAI SUBURBAN,2021-03-17,701,3472,8,4181
MAHARASHTRA,MUMBAI SUBURBAN,2021-03-18,725,3819,3,4547
MAHARASHTRA,MUMBAI SUBURBAN,2021-03-19,709,3189,6,3904
MAHARASHTRA,MUMBAI SUBURBAN,2021-03-20,818,3610,5,4433
MAHARASHTRA,NAGPUR,2021-03-16,3652,7809,86,11547
MAHARASHTRA,NAGPUR,2021-03-17,3854,7642,160,11656
MAHARASHTRA,NAGPUR,2021-03-18,3640,7771,100,11511
MAHARASHTRA,NAGPUR,2021-03-19,3812,7162,94,11068
MAHARASHTRA,NAGPUR,2021-03-20,3796,7851,142,11789
MAHARASHTRA,NANDED,2021-03-16,678,1780,31,2489
MAHARASHTRA,NANDED,2021-03-17,703,1678,15,2396
MAHARASHTRA,NANDED,2021-03-18,781,3450,33,4264
MAHARASHTRA,NANDED,2021-03-19,1076,3010,221,4307
MAHARASHTRA,NANDED,2021-03-20,1183,3492,155,4830
MAHARASHTRA,NANDURBAR,2021-03-16,401,1969,0,2370
MAHARASHTRA,NANDURBAR,2021-03-17,385,1856,0,2241
MAHARASHTRA,NANDURBAR,2021-03-18,452,1815,0,2267
MAHARASHTRA,NANDURBAR,2021-03-19,499,2182,0,2681
MAHARASHTRA,NANDURBAR,2021-03-20,333,1578,0,1911
MAHARASHTRA,NASHIK,2021-03-16,2202,2589,127,4918
MAHARASHTRA,NASHIK,2021-03-17,2540,4161,44,6745
MAHARASHTRA,NASHIK,2021-03-18,1569,3482,110,5161
MAHARASHTRA,NASHIK,2021-03-19,2007,3666,113,5786
MAHARASHTRA,NASHIK,2021-03-20,2789,4368,116,7273
MAHARASHTRA,OSMANABAD,2021-03-16,108,374,5,487
MAHARASHTRA,OSMANABAD,2021-03-17,102,573,0,675
MAHARASHTRA,OSMANABAD,2021-03-18,88,319,1,408
MAHARASHTRA,OSMANABAD,2021-03-19,120,267,5,392
MAHARASHTRA,OSMANABAD,2021-03-20,106,236,1,343
MAHARASHTRA,PALGHAR,2021-03-16,138,824,3,965
MAHARASHTRA,PALGHAR,2021-03-17,198,1215,12,1425
MAHARASHTRA,PALGHAR,2021-03-18,224,1175,5,1404
MAHARASHTRA,PALGHAR,2021-03-19,228,959,1,1188
MAHARASHTRA,PALGHAR,2021-03-20,231,911,4,1146
MAHARASHTRA,PARBHANI,2021-03-16,197,1084,3,1284
MAHARASHTRA,PARBHANI,2021-03-17,184,1336,2,1522
MAHARASHTRA,PARBHANI,2021-03-18,209,1768,4,1981
MAHARASHTRA,PARBHANI,2021-03-19,293,1350,1,1644
MAHARASHTRA,PARBHANI,2021-03-20,268,1406,7,1681
MAHARASHTRA,PUNE,2021-03-16,5274,9799,727,15800
MAHARASHTRA,PUNE,2021-03-17,5162,9206,481,14849
MAHARASHTRA,PUNE,2021-03-18,5542,9721,402,15665
MAHARASHTRA,PUNE,2021-03-19,5778,10456,666,16900
MAHARASHTRA,PUNE,2021-03-20,6087,11090,625,17802
MAHARASHTRA,RAIGAD,2021-03-16,410,1883,1,2294
MAHARASHTRA,RAIGAD,2021-03-17,336,1527,3,1866
MAHARASHTRA,RAIGAD,2021-03-18,420,1604,1,2025
MAHARASHTRA,RAIGAD,2021-03-19,479,1830,12,2321
MAHARASHTRA,RAIGAD,2021-03-20,465,1540,1,2006
MAHARASHTRA,RATNAGIRI,2021-03-16,11,422,1,434
MAHARASHTRA,RATNAGIRI,2021-03-17,1,638,1,640
MAHARASHTRA,RATNAGIRI,2021-03-18,38,337,0,375
MAHARASHTRA,RATNAGIRI,2021-03-19,25,220,3,248
MAHARASHTRA,RATNAGIRI,2021-03-20,24,158,0,182
MAHARASHTRA,SANGLI,2021-03-16,120,781,23,924
MAHARASHTRA,SANGLI,2021-03-17,86,1588,12,1686
MAHARASHTRA,SANGLI,2021-03-18,85,1030,5,1120
MAHARASHTRA,SANGLI,2021-03-19,193,1422,86,1701
MAHARASHTRA,SANGLI,2021-03-20,145,1221,27,1393
MAHARASHTRA,SATARA,2021-03-16,303,1589,45,1937
MAHARASHTRA,SATARA,2021-03-17,304,1681,62,2047
MAHARASHTRA,SATARA,2021-03-18,127,1968,33,2128
MAHARASHTRA,SATARA,2021-03-19,228,2514,16,2758
MAHARASHTRA,SATARA,2021-03-20,326,2154,47,2527
MAHARASHTRA,SINDHUDURG,2021-03-16,20,195,0,215
MAHARASHTRA,SINDHUDURG,2021-03-17,22,275,0,297
MAHARASHTRA,SINDHUDURG,2021-03-18,22,405,1,428
MAHARASHTRA,SINDHUDURG,2021-03-19,18,225,0,243
MAHARASHTRA,SINDHUDURG,2021-03-20,16,241,0,257
MAHARASHTRA,SOLAPUR,2021-03-16,315,1903,112,2330
MAHARASHTRA,SOLAPUR,2021-03-17,334,1558,63,1955
MAHARASHTRA,SOLAPUR,2021-03-18,329,1716,33,2078
MAHARASHTRA,SOLAPUR,2021-03-19,385,1340,97,1822
MAHARASHTRA,SOLAPUR,2021-03-20,390,2191,55,2636
MAHARASHTRA,THANE,2021-03-16,2145,8380,34,10559
MAHARASHTRA,THANE,2021-03-17,1988,8857,19,10864
MAHARASHTRA,THANE,2021-03-18,2310,9009,37,11356
MAHARASHTRA,THANE,2021-03-19,2267,9942,28,12237
MAHARASHTRA,THANE,2021-03-20,2810,9821,35,12666
MAHARASHTRA,WARDHA,2021-03-16,368,1938,10,2316
MAHARASHTRA,WARDHA,2021-03-17,387,2239,8,2634
MAHARASHTRA,WARDHA,2021-03-18,388,2191,4,2583
MAHARASHTRA,WARDHA,2021-03-19,370,2348,1,2719
MAHARASHTRA,WARDHA,2021-03-20,364,2231,3,2598
MAHARASHTRA,WASHIM,2021-03-16,284,1429,7,1720
MAHARASHTRA,WASHIM,2021-03-17,232,1768,7,2007
MAHARASHTRA,WASHIM,2021-03-18,216,1832,10,2058
MAHARASHTRA,WASHIM,2021-03-19,266,1417,11,1694
MAHARASHTRA,WASHIM,2021-03-20,299,1460,22,1781
MAHARASHTRA,YAVATMAL,2021-03-16,372,1585,3,1960
MAHARASHTRA,YAVATMAL,2021-03-17,471,1857,3,2331
MAHARASHTRA,YAVATMAL,2021-03-18,451,2401,0,2852
MAHARASHTRA,YAVATMAL,2021-03-19,466,2283,4,2753
MAHARASHTRA,YAVATMAL,2021-03-20,385,1771,1,2157
MANIPUR,BISHNUPUR,2021-03-16,0,89,0,89
MANIPUR,BISHNUPUR,2021-03-17,0,94,0,94
MANIPUR,BISHNUPUR,2021-03-18,0,134,0,134
MANIPUR,BISHNUPUR,2021-03-19,1,102,0,103
MANIPUR,BISHNUPUR,2021-03-20,0,56,0,56
MANIPUR,CHANDEL,2021-03-16,0,14,0,14
MANIPUR,CHANDEL,2021-03-17,0,15,0,15
MANIPUR,CHANDEL,2021-03-18,0,5,0,5
MANIPUR,CHANDEL,2021-03-19,0,13,0,13
MANIPUR,CHANDEL,2021-03-20,0,15,0,15
MANIPUR,CHURACHANDPUR,2021-03-16,1,89,0,90
MANIPUR,CHURACHANDPUR,2021-03-17,0,72,0,72
MANIPUR,CHURACHANDPUR,2021-03-18,0,46,0,46
MANIPUR,CHURACHANDPUR,2021-03-19,1,77,0,78
MANIPUR,CHURACHANDPUR,2021-03-20,0,55,0,55
MANIPUR,IMPHAL EAST,2021-03-16,0,167,0,167
MANIPUR,IMPHAL EAST,2021-03-17,1,114,0,115
MANIPUR,IMPHAL EAST,2021-03-18,2,88,0,90
MANIPUR,IMPHAL EAST,2021-03-19,1,138,0,139
MANIPUR,IMPHAL EAST,2021-03-20,2,136,0,138
MANIPUR,IMPHAL WEST,2021-03-16,2,529,0,531
MANIPUR,IMPHAL WEST,2021-03-17,0,393,0,393
MANIPUR,IMPHAL WEST,2021-03-18,2,407,0,409
MANIPUR,IMPHAL WEST,2021-03-19,2,357,0,359
MANIPUR,IMPHAL WEST,2021-03-20,1,403,0,404
MANIPUR,JIRIBAM,2021-03-16,0,6,0,6
MANIPUR,JIRIBAM,2021-03-17,0,1,0,1
MANIPUR,JIRIBAM,2021-03-19,0,2,0,2
MANIPUR,JIRIBAM,2021-03-20,0,1,0,1
MANIPUR,KAKCHING,2021-03-16,4,73,0,77
MANIPUR,KAKCHING,2021-03-17,0,72,0,72
MANIPUR,KAKCHING,2021-03-18,0,25,0,25
MANIPUR,KAKCHING,2021-03-19,0,24,0,24
MANIPUR,KAKCHING,2021-03-20,0,19,0,19
MANIPUR,KAMJONG,2021-03-17,0,2,0,2
MANIPUR,KAMJONG,2021-03-19,0,1,0,1
MANIPUR,KAMJONG,2021-03-20,0,52,0,52
MANIPUR,KANGPOKPI,2021-03-16,0,15,0,15
MANIPUR,KANGPOKPI,2021-03-17,0,15,0,15
MANIPUR,KANGPOKPI,2021-03-18,0,11,0,11
MANIPUR,KANGPOKPI,2021-03-19,0,13,0,13
MANIPUR,KANGPOKPI,2021-03-20,0,16,0,16
MANIPUR,NONEY,2021-03-16,0,1,0,1
MANIPUR,NONEY,2021-03-19,0,4,0,4
MANIPUR,NONEY,2021-03-20,0,1,0,1
MANIPUR,SENAPATI,2021-03-16,0,9,0,9
MANIPUR,SENAPATI,2021-03-17,0,12,0,12
MANIPUR,SENAPATI,2021-03-18,1,15,0,16
MANIPUR,SENAPATI,2021-03-19,0,17,0,17
MANIPUR,SENAPATI,2021-03-20,0,23,0,23
MANIPUR,TAMENGLONG,2021-03-16,0,91,0,91
MANIPUR,TAMENGLONG,2021-03-17,0,62,0,62
MANIPUR,TAMENGLONG,2021-03-18,0,10,0,10
MANIPUR,TAMENGLONG,2021-03-19,13,31,0,44
MANIPUR,TAMENGLONG,2021-03-20,0,29,0,29
MANIPUR,TENGNOUPAL,2021-03-17,0,9,0,9
MANIPUR,TENGNOUPAL,2021-03-18,0,3,0,3
MANIPUR,TENGNOUPAL,2021-03-19,0,59,0,59
MANIPUR,TENGNOUPAL,2021-03-20,0,25,0,25
MANIPUR,THOUBAL,2021-03-16,0,72,0,72
MANIPUR,THOUBAL,2021-03-17,0,50,0,50
MANIPUR,THOUBAL,2021-03-18,0,28,0,28
MANIPUR,THOUBAL,2021-03-19,0,66,0,66
MANIPUR,THOUBAL,2021-03-20,0,44,0,44
MANIPUR,UKHRUL,2021-03-16,0,59,0,59
MANIPUR,UKHRUL,2021-03-17,0,87,0,87
MANIPUR,UKHRUL,2021-03-18,0,64,0,64
MANIPUR,UKHRUL,2021-03-19,1,36,0,37
MANIPUR,UKHRUL,2021-03-20,0,21,0,21
MEGHALAYA,EAST GARO HILLS,2021-03-16,0,21,0,21
MEGHALAYA,EAST GARO HILLS,2021-03-17,0,23,0,23
MEGHALAYA,EAST GARO HILLS,2021-03-18,0,16,0,16
MEGHALAYA,EAST GARO HILLS,2021-03-19,0,35,0,35
MEGHALAYA,EAST GARO HILLS,2021-03-20,0,14,0,14
MEGHALAYA,EAST JAINTIA HILLS,2021-03-16,0,142,0,142
MEGHALAYA,EAST JAINTIA HILLS,2021-03-17,0,33,0,33
MEGHALAYA,EAST JAINTIA HILLS,2021-03-18,0,72,0,72
MEGHALAYA,EAST JAINTIA HILLS,2021-03-19,0,59,0,59
MEGHALAYA,EAST JAINTIA HILLS,2021-03-20,0,191,0,191
MEGHALAYA,EAST KHASI HILLS,2021-03-16,3,543,0,546
MEGHALAYA,EAST KHASI HILLS,2021-03-17,3,777,1,781
MEGHALAYA,EAST KHASI HILLS,2021-03-18,2,725,3,730
MEGHALAYA,EAST KHASI HILLS,2021-03-19,2,800,0,802
MEGHALAYA,EAST KHASI HILLS,2021-03-20,5,329,1,335
MEGHALAYA,NORTH GARO HILLS,2021-03-16,0,5,0,5
MEGHALAYA,NORTH GARO HILLS,2021-03-17,0,3,0,3
MEGHALAYA,NORTH GARO HILLS,2021-03-18,0,19,0,19
MEGHALAYA,NORTH GARO HILLS,2021-03-19,0,7,0,7
MEGHALAYA,NORTH GARO HILLS,2021-03-20,0,2,0,2
MEGHALAYA,RI BHOI,2021-03-16,1,190,0,191
MEGHALAYA,RI BHOI,2021-03-17,0,82,0,82
MEGHALAYA,RI BHOI,2021-03-18,4,89,0,93
MEGHALAYA,RI BHOI,2021-03-19,1,104,0,105
MEGHALAYA,RI BHOI,2021-03-20,0,38,0,38
MEGHALAYA,SOUTH GARO HILLS,2021-03-16,0,8,0,8
MEGHALAYA,SOUTH GARO HILLS,2021-03-17,0,2,0,2
MEGHALAYA,SOUTH GARO HILLS,2021-03-18,0,12,0,12
MEGHALAYA,SOUTH GARO HILLS,2021-03-19,0,3,0,3
MEGHALAYA,SOUTH GARO HILLS,2021-03-20,0,1,0,1
MEGHALAYA,SOUTH WEST GARO HILLS,2021-03-16,0,23,0,23
MEGHALAYA,SOUTH WEST GARO HILLS,2021-03-17,0,16,0,16
MEGHALAYA,SOUTH WEST GARO HILLS,2021-03-18,0,35,0,35
MEGHALAYA,SOUTH WEST GARO HILLS,2021-03-19,0,18,0,18
MEGHALAYA,SOUTH WEST GARO HILLS,2021-03-20,0,1,0,1
MEGHALAYA,SOUTH WEST KHASI HILLS,2021-03-16,0,6,0,6
MEGHALAYA,SOUTH WEST KHASI HILLS,2021-03-17,0,2,0,2
MEGHALAYA,SOUTH WEST KHASI HILLS,2021-03-18,0,1,0,1
MEGHALAYA,SOUTH WEST KHASI HILLS,2021-03-19,0,11,0,11
MEGHALAYA,SOUTH WEST KHASI HILLS,2021-03-20,0,3,0,3
MEGHALAYA,WEST GARO HILLS,2021-03-16,0,108,0,108
MEGHALAYA,WEST GARO HILLS,2021-03-17,0,51,0,51
MEGHALAYA,WEST GARO HILLS,2021-03-18,0,158,0,158
MEGHALAYA,WEST GARO HILLS,2021-03-19,0,47,0,47
MEGHALAYA,WEST GARO HILLS,2021-03-20,0,18,0,18
MEGHALAYA,WEST JAINTIA HILLS,2021-03-16,0,52,0,52
MEGHALAYA,WEST JAINTIA HILLS,2021-03-17,0,42,0,42
MEGHALAYA,WEST JAINTIA HILLS,2021-03-18,0,42,0,42
MEGHALAYA,WEST JAINTIA HILLS,2021-03-19,0,45,0,45
MEGHALAYA,WEST JAINTIA HILLS,2021-03-20,0,49,0,49
MEGHALAYA,WEST KHASI HILLS,2021-03-16,0,33,0,33
MEGHALAYA,WEST KHASI HILLS,2021-03-17,0,19,0,19
MEGHALAYA,WEST KHASI HILLS,2021-03-18,0,25,0,25
MEGHALAYA,WEST KHASI HILLS,2021-03-19,0,30,0,30
MEGHALAYA,WEST KHASI HILLS,2021-03-20,0,27,0,27
MIZORAM,AIZAWL,2021-03-16,2,314,0,316
MIZORAM,AIZAWL,2021-03-17,3,368,0,371
MIZORAM,AIZAWL,2021-03-18,2,506,0,508
MIZORAM,AIZAWL,2021-03-19,0,322,0,322
MIZORAM,AIZAWL,2021-03-20,0,319,0,319
MIZORAM,CHAMPHAI,2021-03-16,0,11,0,11
MIZORAM,CHAMPHAI,2021-03-18,0,11,0,11
MIZORAM,CHAMPHAI,2021-03-19,0,1,0,1
MIZORAM,CHAMPHAI,2021-03-20,0,6,0,6
MIZORAM,HNAHTHIAL,2021-03-16,0,1,0,1
MIZORAM,HNAHTHIAL,2021-03-18,0,3,0,3
MIZORAM,HNAHTHIAL,2021-03-20,0,6,0,6
MIZORAM,KHAWZAWL,2021-03-17,0,2,0,2
MIZORAM,KHAWZAWL,2021-03-19,0,1,0,1
MIZORAM,KOLASIB,2021-03-16,0,11,0,11
MIZORAM,KOLASIB,2021-03-17,0,90,0,90
MIZORAM,KOLASIB,2021-03-18,0,29,0,29
MIZORAM,KOLASIB,2021-03-19,0,132,0,132
MIZORAM,KOLASIB,2021-03-20,0,69,1,70
MIZORAM,LAWNGTLAI,2021-03-16,0,1,0,1
MIZORAM,LAWNGTLAI,2021-03-17,0,4,0,4
MIZORAM,LAWNGTLAI,2021-03-18,0,2,0,2
MIZORAM,LAWNGTLAI,2021-03-19,0,1,0,1
MIZORAM,LUNGLEI,2021-03-16,0,16,0,16
MIZORAM,LUNGLEI,2021-03-17,0,42,0,42
MIZORAM,LUNGLEI,2021-03-18,0,7,0,7
MIZORAM,LUNGLEI,2021-03-19,0,8,0,8
MIZORAM,LUNGLEI,2021-03-20,0,3,0,3
MIZORAM,MAMIT,2021-03-16,0,19,0,19
MIZORAM,MAMIT,2021-03-17,0,81,0,81
MIZORAM,MAMIT,2021-03-18,0,57,0,57
MIZORAM,MAMIT,2021-03-19,0,13,0,13
MIZORAM,MAMIT,2021-03-20,1,73,0,74
MIZORAM,SAIHA,2021-03-16,1,6,0,7
MIZORAM,SAIHA,2021-03-18,0,2,0,2
MIZORAM,SAIHA,2021-03-19,1,13,0,14
MIZORAM,SAITUAL,2021-03-16,0,87,0,87
MIZORAM,SERCHHIP,2021-03-16,0,9,0,9
MIZORAM,SERCHHIP,2021-03-17,0,3,0,3
MIZORAM,SERCHHIP,2021-03-18,7,8,0,15
MIZORAM,SERCHHIP,2021-03-19,0,2,0,2
NAGALAND,DIMAPUR,2021-03-16,1,113,0,114
NAGALAND,DIMAPUR,2021-03-17,2,79,0,81
NAGALAND,DIMAPUR,2021-03-18,0,59,0,59
NAGALAND,DIMAPUR,2021-03-19,1,91,0,92
NAGALAND,DIMAPUR,2021-03-20,0,70,0,70
NAGALAND,KIPHIRE,2021-03-16,0,15,0,15
NAGALAND,KIPHIRE,2021-03-17,0,5,0,5
NAGALAND,KIPHIRE,2021-03-20,0,1,0,1
NAGALAND,KOHIMA,2021-03-16,27,154,0,181
NAGALAND,KOHIMA,2021-03-17,5,97,0,102
NAGALAND,KOHIMA,2021-03-18,23,114,0,137
NAGALAND,KOHIMA,2021-03-19,1,52,0,53
NAGALAND,KOHIMA,2021-03-20,0,12,0,12
NAGALAND,LONGLENG,2021-03-16,0,1,0,1
NAGALAND,LONGLENG,2021-03-18,0,1,0,1
NAGALAND,LONGLENG,2021-03-19,0,2,0,2
NAGALAND,LONGLENG,2021-03-20,0,1,0,1
NAGALAND,MOKOKCHUNG,2021-03-16,0,17,0,17
NAGALAND,MOKOKCHUNG,2021-03-17,0,8,0,8
NAGALAND,MOKOKCHUNG,2021-03-18,0,4,0,4
NAGALAND,MOKOKCHUNG,2021-03-19,0,9,0,9
NAGALAND,MOKOKCHUNG,2021-03-20,0,12,0,12
NAGALAND,MON,2021-03-16,0,1,0,1
NAGALAND,MON,2021-03-17,0,3,0,3
NAGALAND,MON,2021-03-18,0,1,0,1
NAGALAND,MON,2021-03-19,0,3,0,3
NAGALAND,MON,2021-03-20,0,1,0,1
NAGALAND,PEREN,2021-03-16,0,2,0,2
NAGALAND,PEREN,2021-03-17,0,1,0,1
NAGALAND,PEREN,2021-03-18,0,1,0,1
NAGALAND,PEREN,2021-03-20,0,3,0,3
NAGALAND,PHEK,2021-03-16,0,28,0,28
NAGALAND,PHEK,2021-03-17,0,11,0,11
NAGALAND,PHEK,2021-03-18,0,10,0,10
NAGALAND,PHEK,2021-03-19,0,1,0,1
NAGALAND,PHEK,2021-03-20,0,2,0,2
NAGALAND,TUENSANG,2021-03-20,1,0,0,1
NAGALAND,WOKHA,2021-03-16,0,3,0,3
NAGALAND,WOKHA,2021-03-17,0,2,0,2
NAGALAND,WOKHA,2021-03-18,0,4,0,4
NAGALAND,WOKHA,2021-03-19,0,1,0,1
NAGALAND,ZUNHEBOTO,2021-03-17,0,1,0,1
NAGALAND,ZUNHEBOTO,2021-03-20,0,2,0,2
ODISHA,ANUGUL,2021-03-16,3,584,0,587
ODISHA,ANUGUL,2021-03-17,7,537,0,544
ODISHA,ANUGUL,2021-03-18,5,726,1,732
ODISHA,ANUGUL,2021-03-19,2,674,0,676
ODISHA,ANUGUL,2021-03-20,4,697,1,702
ODISHA,BALANGIR,2021-03-16,2,836,0,838
ODISHA,BALANGIR,2021-03-17,2,827,5,834
ODISHA,BALANGIR,2021-03-18,2,677,4,683
ODISHA,BALANGIR,2021-03-19,16,687,0,703
ODISHA,BALANGIR,2021-03-20,9,705,1,715
ODISHA,BALESHWAR,2021-03-16,7,2044,1,2052
ODISHA,BALESHWAR,2021-03-17,8,1634,0,1642
ODISHA,BALESHWAR,2021-03-18,9,1701,0,1710
ODISHA,BALESHWAR,2021-03-19,5,1396,1,1402
ODISHA,BALESHWAR,2021-03-20,12,1666,1,1679
ODISHA,BARGARH,2021-03-16,11,361,0,372
ODISHA,BARGARH,2021-03-17,4,434,0,438
ODISHA,BARGARH,2021-03-18,5,390,0,395
ODISHA,BARGARH,2021-03-19,6,369,0,375
ODISHA,BARGARH,2021-03-20,3,356,0,359
ODISHA,BHADRAK,2021-03-16,0,520,0,520
ODISHA,BHADRAK,2021-03-17,2,641,0,643
ODISHA,BHADRAK,2021-03-18,0,661,0,661
ODISHA,BHADRAK,2021-03-19,3,664,0,667
ODISHA,BHADRAK,2021-03-20,7,635,0,642
ODISHA,BOUDH,2021-03-16,0,349,0,349
ODISHA,BOUDH,2021-03-17,0,166,0,166
ODISHA,BOUDH,2021-03-18,0,384,0,384
ODISHA,BOUDH,2021-03-19,0,539,0,539
ODISHA,BOUDH,2021-03-20,0,126,0,126
ODISHA,CUTTACK,2021-03-16,15,1333,0,1348
ODISHA,CUTTACK,2021-03-17,37,1436,1,1474
ODISHA,CUTTACK,2021-03-18,6,1746,0,1752
ODISHA,CUTTACK,2021-03-19,38,2642,0,2680
ODISHA,CUTTACK,2021-03-20,15,2022,2,2039
ODISHA,DEOGARH,2021-03-16,0,347,0,347
ODISHA,DEOGARH,2021-03-17,1,379,0,380
ODISHA,DEOGARH,2021-03-18,2,396,0,398
ODISHA,DEOGARH,2021-03-19,0,173,0,173
ODISHA,DEOGARH,2021-03-20,0,225,0,225
ODISHA,DHENKANAL,2021-03-16,0,612,0,612
ODISHA,DHENKANAL,2021-03-17,0,376,0,376
ODISHA,DHENKANAL,2021-03-18,0,324,0,324
ODISHA,DHENKANAL,2021-03-19,1,436,0,437
ODISHA,DHENKANAL,2021-03-20,1,287,0,288
ODISHA,GAJAPATI,2021-03-16,0,222,0,222
ODISHA,GAJAPATI,2021-03-17,0,307,0,307
ODISHA,GAJAPATI,2021-03-18,0,399,0,399
ODISHA,GAJAPATI,2021-03-19,0,227,0,227
ODISHA,GAJAPATI,2021-03-20,1,571,2,574
ODISHA,GANJAM,2021-03-16,1,1146,68,1215
ODISHA,GANJAM,2021-03-17,5,1034,0,1039
ODISHA,GANJAM,2021-03-18,3,900,0,903
ODISHA,GANJAM,2021-03-19,13,1554,74,1641
ODISHA,GANJAM,2021-03-20,3,1048,51,1102
ODISHA,JAGATSINGHAPUR,2021-03-16,1,543,0,544
ODISHA,JAGATSINGHAPUR,2021-03-17,4,374,0,378
ODISHA,JAGATSINGHAPUR,2021-03-18,0,390,1,391
ODISHA,JAGATSINGHAPUR,2021-03-19,4,601,0,605
ODISHA,JAGATSINGHAPUR,2021-03-20,10,882,0,892
ODISHA,JAJAPUR,2021-03-16,0,979,0,979
ODISHA,JAJAPUR,2021-03-17,1,819,0,820
ODISHA,JAJAPUR,2021-03-18,1,806,0,807
ODISHA,JAJAPUR,2021-03-19,2,439,0,441
ODISHA,JAJAPUR,2021-03-20,0,380,0,380
ODISHA,JHARSUGUDA,2021-03-16,0,459,0,459
ODISHA,JHARSUGUDA,2021-03-17,2,552,0,554
ODISHA,JHARSUGUDA,2021-03-18,1,687,0,688
ODISHA,JHARSUGUDA,2021-03-19,3,552,0,555
ODISHA,JHARSUGUDA,2021-03-20,2,768,0,770
ODISHA,KALAHANDI,2021-03-16,0,142,0,142
ODISHA,KALAHANDI,2021-03-17,3,191,0,194
ODISHA,KALAHANDI,2021-03-18,2,160,0,162
ODISHA,KALAHANDI,2021-03-19,1,273,0,274
ODISHA,KALAHANDI,2021-03-20,0,37,0,37
ODISHA,KANDHAMAL,2021-03-16,0,642,0,642
ODISHA,KANDHAMAL,2021-03-17,0,740,0,740
ODISHA,KANDHAMAL,2021-03-18,0,845,2,847
ODISHA,KANDHAMAL,2021-03-19,1,862,0,863
ODISHA,KANDHAMAL,2021-03-20,0,587,1,588
ODISHA,KENDRAPARA,2021-03-16,3,1636,0,1639
ODISHA,KENDRAPARA,2021-03-17,0,1137,0,1137
ODISHA,KENDRAPARA,2021-03-18,1,1225,5,1231
ODISHA,KENDRAPARA,2021-03-19,1,1257,2,1260
ODISHA,KENDRAPARA,2021-03-20,2,1251,2,1255
ODISHA,KENDUJHAR,2021-03-16,0,786,0,786
ODISHA,KENDUJHAR,2021-03-17,1,934,0,935
ODISHA,KENDUJHAR,2021-03-18,1,869,0,870
ODISHA,KENDUJHAR,2021-03-19,0,1014,0,1014
ODISHA,KENDUJHAR,2021-03-20,1,626,0,627
ODISHA,KHORDHA,2021-03-16,11,1959,1,1971
ODISHA,KHORDHA,2021-03-17,14,1552,2,1568
ODISHA,KHORDHA,2021-03-18,19,1635,8,1662
ODISHA,KHORDHA,2021-03-19,16,1635,0,1651
ODISHA,KHORDHA,2021-03-20,29,1888,1,1918
ODISHA,KORAPUT,2021-03-16,1,1496,0,1497
ODISHA,KORAPUT,2021-03-17,0,1269,0,1269
ODISHA,KORAPUT,2021-03-18,1,1408,0,1409
ODISHA,KORAPUT,2021-03-19,3,1411,1,1415
ODISHA,KORAPUT,2021-03-20,1,1086,0,1087
ODISHA,MALKANGIRI,2021-03-16,1,230,0,231
ODISHA,MALKANGIRI,2021-03-17,0,180,0,180
ODISHA,MALKANGIRI,2021-03-18,0,241,1,242
ODISHA,MALKANGIRI,2021-03-19,0,166,0,166
ODISHA,MALKANGIRI,2021-03-20,0,292,0,292
ODISHA,MAYURBHANJ,2021-03-16,11,1684,1,1696
ODISHA,MAYURBHANJ,2021-03-17,3,1700,0,1703
ODISHA,MAYURBHANJ,2021-03-18,9,1505,0,1514
ODISHA,MAYURBHANJ,2021-03-19,15,1510,0,1525
ODISHA,MAYURBHANJ,2021-03-20,8,1370,0,1378
ODISHA,NABARANGPUR,2021-03-16,1,689,0,690
ODISHA,NABARANGPUR,2021-03-17,0,650,0,650
ODISHA,NABARANGPUR,2021-03-18,0,1006,0,1006
ODISHA,NABARANGPUR,2021-03-19,3,953,0,956
ODISHA,NABARANGPUR,2021-03-20,2,644,0,646
ODISHA,NAYAGARH,2021-03-16,1,523,0,524
ODISHA,NAYAGARH,2021-03-17,0,824,2,826
ODISHA,NAYAGARH,2021-03-18,0,986,1,987
ODISHA,NAYAGARH,2021-03-19,2,592,1,595
ODISHA,NAYAGARH,2021-03-20,0,572,1,573
ODISHA,NUAPADA,2021-03-16,2,106,0,108
ODISHA,NUAPADA,2021-03-17,4,98,0,102
ODISHA,NUAPADA,2021-03-18,8,212,0,220
ODISHA,NUAPADA,2021-03-19,3,367,0,370
ODISHA,NUAPADA,2021-03-20,3,455,0,458
ODISHA,PURI,2021-03-16,3,760,0,763
ODISHA,PURI,2021-03-17,1,538,0,539
ODISHA,PURI,2021-03-18,5,559,1,565
ODISHA,PURI,2021-03-19,3,593,0,596
ODISHA,PURI,2021-03-20,3,635,1,639
ODISHA,RAYAGADA,2021-03-16,2,483,0,485
ODISHA,RAYAGADA,2021-03-17,2,434,0,436
ODISHA,RAYAGADA,2021-03-18,5,222,0,227
ODISHA,RAYAGADA,2021-03-19,3,358,0,361
ODISHA,RAYAGADA,2021-03-20,2,452,0,454
ODISHA,SAMBALPUR,2021-03-16,2,213,0,215
ODISHA,SAMBALPUR,2021-03-17,2,422,0,424
ODISHA,SAMBALPUR,2021-03-18,3,408,0,411
ODISHA,SAMBALPUR,2021-03-19,10,638,1,649
ODISHA,SAMBALPUR,2021-03-20,5,519,0,524
ODISHA,SONEPUR,2021-03-16,0,554,0,554
ODISHA,SONEPUR,2021-03-17,0,410,0,410
ODISHA,SONEPUR,2021-03-18,0,546,0,546
ODISHA,SONEPUR,2021-03-19,2,646,0,648
ODISHA,SONEPUR,2021-03-20,0,66,0,66
ODISHA,SUNDARGARH,2021-03-16,8,541,4,553
ODISHA,SUNDARGARH,2021-03-17,7,558,9,574
ODISHA,SUNDARGARH,2021-03-18,13,490,3,506
ODISHA,SUNDARGARH,2021-03-19,14,562,0,576
ODISHA,SUNDARGARH,2021-03-20,12,374,0,386
PUDUCHERRY,KARAIKAL,2021-03-16,5,286,0,291
PUDUCHERRY,KARAIKAL,2021-03-17,13,228,0,241
PUDUCHERRY,KARAIKAL,2021-03-18,14,216,0,230
PUDUCHERRY,KARAIKAL,2021-03-19,19,243,0,262
PUDUCHERRY,KARAIKAL,2021-03-20,16,220,0,236
PUDUCHERRY,MAHE,2021-03-16,3,77,0,80
PUDUCHERRY,MAHE,2021-03-17,5,105,0,110
PUDUCHERRY,MAHE,2021-03-18,8,87,0,95
PUDUCHERRY,MAHE,2021-03-19,3,87,1,91
PUDUCHERRY,MAHE,2021-03-20,4,84,0,88
PUDUCHERRY,PONDICHERRY,2021-03-16,26,403,1,430
PUDUCHERRY,PONDICHERRY,2021-03-17,50,357,6,413
PUDUCHERRY,PONDICHERRY,2021-03-18,42,375,17,434
PUDUCHERRY,PONDICHERRY,2021-03-19,56,432,1,489
PUDUCHERRY,PONDICHERRY,2021-03-20,37,395,6,438
PUDUCHERRY,YANAM,2021-03-16,1,0,0,1
PUDUCHERRY,YANAM,2021-03-17,0,1,0,1
PUDUCHERRY,YANAM,2021-03-18,0,57,0,57
PUDUCHERRY,YANAM,2021-03-19,0,108,0,108
PUDUCHERRY,YANAM,2021-03-20,1,66,0,67
PUNJAB,AMRITSAR,2021-03-16,215,1536,18,1769
PUNJAB,AMRITSAR,2021-03-17,279,1683,28,1990
PUNJAB,AMRITSAR,2021-03-18,318,2212,13,2543
PUNJAB,AMRITSAR,2021-03-19,210,2301,14,2525
PUNJAB,AMRITSAR,2021-03-20,239,1674,2,1915
PUNJAB,BARNALA,2021-03-16,5,149,3,157
PUNJAB,BARNALA,2021-03-17,11,227,1,239
PUNJAB,BARNALA,2021-03-18,12,55,1,68
PUNJAB,BARNALA,2021-03-19,4,179,1,184
PUNJAB,BARNALA,2021-03-20,22,141,9,172
PUNJAB,BATHINDA,2021-03-16,30,992,12,1034
PUNJAB,BATHINDA,2021-03-17,82,698,32,812
PUNJAB,BATHINDA,2021-03-18,58,533,1,592
PUNJAB,BATHINDA,2021-03-19,42,1019,8,1069
PUNJAB,BATHINDA,2021-03-20,110,697,31,838
PUNJAB,FARIDKOT,2021-03-16,6,329,6,341
PUNJAB,FARIDKOT,2021-03-17,15,494,5,514
PUNJAB,FARIDKOT,2021-03-18,40,104,0,144
PUNJAB,FARIDKOT,2021-03-19,13,202,1,216
PUNJAB,FARIDKOT,2021-03-20,46,492,27,565
PUNJAB,FATEHGARH SAHIB,2021-03-16,10,79,1,90
PUNJAB,FATEHGARH SAHIB,2021-03-17,105,902,4,1011
PUNJAB,FATEHGARH SAHIB,2021-03-18,35,474,3,512
PUNJAB,FATEHGARH SAHIB,2021-03-19,45,453,0,498
PUNJAB,FATEHGARH SAHIB,2021-03-20,81,693,2,776
PUNJAB,FAZILKA,2021-03-16,16,159,2,177
PUNJAB,FAZILKA,2021-03-17,7,847,28,882
PUNJAB,FAZILKA,2021-03-18,36,354,0,390
PUNJAB,FAZILKA,2021-03-19,19,706,5,730
PUNJAB,FAZILKA,2021-03-20,22,697,25,744
PUNJAB,FIROZEPUR,2021-03-16,12,73,3,88
PUNJAB,FIROZEPUR,2021-03-17,9,302,20,331
PUNJAB,FIROZEPUR,2021-03-18,29,769,2,800
PUNJAB,FIROZEPUR,2021-03-19,6,637,1,644
PUNJAB,FIROZEPUR,2021-03-20,49,565,3,617
PUNJAB,GURDASPUR,2021-03-16,38,508,3,549
PUNJAB,GURDASPUR,2021-03-17,136,405,0,541
PUNJAB,GURDASPUR,2021-03-18,133,370,0,503
PUNJAB,GURDASPUR,2021-03-19,52,633,6,691
PUNJAB,GURDASPUR,2021-03-20,52,446,0,498
PUNJAB,HOSHIARPUR,2021-03-16,249,2495,36,2780
PUNJAB,HOSHIARPUR,2021-03-17,254,2402,16,2672
PUNJAB,HOSHIARPUR,2021-03-18,307,2806,27,3140
PUNJAB,HOSHIARPUR,2021-03-19,302,2230,32,2564
PUNJAB,HOSHIARPUR,2021-03-20,360,2766,24,3150
PUNJAB,JALANDHAR,2021-03-16,280,2904,23,3207
PUNJAB,JALANDHAR,2021-03-17,365,3287,206,3858
PUNJAB,JALANDHAR,2021-03-18,425,3096,10,3531
PUNJAB,JALANDHAR,2021-03-19,328,2786,17,3131
PUNJAB,JALANDHAR,2021-03-20,498,3377,164,4039
PUNJAB,KAPURTHALA,2021-03-16,69,430,2,501
PUNJAB,KAPURTHALA,2021-03-17,137,1055,3,1195
PUNJAB,KAPURTHALA,2021-03-18,137,1034,5,1176
PUNJAB,KAPURTHALA,2021-03-19,161,1019,1,1181
PUNJAB,KAPURTHALA,2021-03-20,143,1019,0,1162
PUNJAB,LUDHIANA,2021-03-16,283,2526,9,2818
PUNJAB,LUDHIANA,2021-03-17,257,3762,30,4049
PUNJAB,LUDHIANA,2021-03-18,285,4182,38,4505
PUNJAB,LUDHIANA,2021-03-19,258,4202,7,4467
PUNJAB,LUDHIANA,2021-03-20,428,2979,7,3414
PUNJAB,MANSA,2021-03-16,4,788,0,792
PUNJAB,MANSA,2021-03-17,23,660,0,683
PUNJAB,MANSA,2021-03-18,12,654,0,666
PUNJAB,MANSA,2021-03-19,26,717,0,743
PUNJAB,MANSA,2021-03-20,12,739,0,751
PUNJAB,MOGA,2021-03-16,16,461,7,484
PUNJAB,MOGA,2021-03-17,27,431,6,464
PUNJAB,MOGA,2021-03-18,43,531,1,575
PUNJAB,MOGA,2021-03-19,8,225,1,234
PUNJAB,MOGA,2021-03-20,59,720,12,791
PUNJAB,PATHANKOT,2021-03-16,29,105,0,134
PUNJAB,PATHANKOT,2021-03-17,25,355,1,381
PUNJAB,PATHANKOT,2021-03-18,18,117,0,135
PUNJAB,PATHANKOT,2021-03-19,28,171,3,202
PUNJAB,PATHANKOT,2021-03-20,20,838,1,859
PUNJAB,PATIALA,2021-03-16,256,2029,2,2287
PUNJAB,PATIALA,2021-03-17,199,2386,1,2586
PUNJAB,PATIALA,2021-03-18,214,2637,5,2856
PUNJAB,PATIALA,2021-03-19,254,2409,4,2667
PUNJAB,PATIALA,2021-03-20,341,3062,6,3409
PUNJAB,RUPNAGAR,2021-03-16,114,786,12,912
PUNJAB,RUPNAGAR,2021-03-17,24,191,1,216
PUNJAB,RUPNAGAR,2021-03-18,141,1336,2,1479
PUNJAB,RUPNAGAR,2021-03-19,117,1009,2,1128
PUNJAB,RUPNAGAR,2021-03-20,38,710,2,750
PUNJAB,S.A.S NAGAR,2021-03-16,280,1321,36,1637
PUNJAB,S.A.S NAGAR,2021-03-17,271,1393,28,1692
PUNJAB,S.A.S NAGAR,2021-03-18,337,1435,56,1828
PUNJAB,S.A.S NAGAR,2021-03-19,338,1428,37,1803
PUNJAB,S.A.S NAGAR,2021-03-20,404,1510,14,1928
PUNJAB,SANGRUR,2021-03-16,36,1326,0,1362
PUNJAB,SANGRUR,2021-03-17,36,1674,2,1712
PUNJAB,SANGRUR,2021-03-18,13,1559,1,1573
PUNJAB,SANGRUR,2021-03-19,49,1448,2,1499
PUNJAB,SANGRUR,2021-03-20,55,1402,1,1458
PUNJAB,SHAHID BHAGAT SINGH NAGAR,2021-03-16,41,1383,1,1425
PUNJAB,SHAHID BHAGAT SINGH NAGAR,2021-03-17,148,1189,2,1339
PUNJAB,SHAHID BHAGAT SINGH NAGAR,2021-03-18,210,1268,2,1480
PUNJAB,SHAHID BHAGAT SINGH NAGAR,2021-03-19,73,1433,0,1506
PUNJAB,SHAHID BHAGAT SINGH NAGAR,2021-03-20,142,1644,1,1787
PUNJAB,SRI MUKTSAR SAHIB,2021-03-16,6,281,1,288
PUNJAB,SRI MUKTSAR SAHIB,2021-03-17,26,366,5,397
PUNJAB,SRI MUKTSAR SAHIB,2021-03-18,25,176,0,201
PUNJAB,SRI MUKTSAR SAHIB,2021-03-19,11,499,0,510
PUNJAB,SRI MUKTSAR SAHIB,2021-03-20,52,771,11,834
PUNJAB,TARN TARAN,2021-03-16,39,1132,1,1172
PUNJAB,TARN TARAN,2021-03-17,13,222,0,235
PUNJAB,TARN TARAN,2021-03-18,44,637,5,686
PUNJAB,TARN TARAN,2021-03-19,27,313,0,340
PUNJAB,TARN TARAN,2021-03-20,94,806,3,903
RAJASTHAN,AJMER,2021-03-16,3,35,570,608
RAJASTHAN,AJMER,2021-03-17,5,57,630,692
RAJASTHAN,AJMER,2021-03-18,6,30,741,777
RAJASTHAN,AJMER,2021-03-19,5,51,831,887
RAJASTHAN,AJMER,2021-03-20,3,48,776,827
RAJASTHAN,ALWAR,2021-03-16,2,801,203,1006
RAJASTHAN,ALWAR,2021-03-17,6,1303,49,1358
RAJASTHAN,ALWAR,2021-03-18,21,964,57,1042
RAJASTHAN,ALWAR,2021-03-19,9,881,4,894
RAJASTHAN,ALWAR,2021-03-20,10,1482,110,1602
RAJASTHAN,BANSWARA,2021-03-16,1,72,0,73
RAJASTHAN,BANSWARA,2021-03-17,1,66,0,67
RAJASTHAN,BANSWARA,2021-03-18,1,57,2,60
RAJASTHAN,BANSWARA,2021-03-19,3,12,1,16
RAJASTHAN,BANSWARA,2021-03-20,1,25,0,26
RAJASTHAN,BARAN,2021-03-16,3,71,0,74
RAJASTHAN,BARAN,2021-03-17,11,129,1,141
RAJASTHAN,BARAN,2021-03-18,1,78,0,79
RAJASTHAN,BARAN,2021-03-19,1,125,0,126
RAJASTHAN,BARAN,2021-03-20,7,167,0,174
RAJASTHAN,BARMER,2021-03-16,0,25,0,25
RAJASTHAN,BARMER,2021-03-17,1,95,0,96
RAJASTHAN,BARMER,2021-03-18,1,156,1,158
RAJASTHAN,BARMER,2021-03-19,0,123,1,124
RAJASTHAN,BARMER,2021-03-20,0,75,0,75
RAJASTHAN,BHARATPUR,2021-03-16,11,143,1,155
RAJASTHAN,BHARATPUR,2021-03-17,1,348,2,351
RAJASTHAN,BHARATPUR,2021-03-18,1,22,7,30
RAJASTHAN,BHARATPUR,2021-03-19,2,921,2,925
RAJASTHAN,BHARATPUR,2021-03-20,1,549,2,552
RAJASTHAN,BHILWARA,2021-03-16,21,599,5,625
RAJASTHAN,BHILWARA,2021-03-17,15,479,2,496
RAJASTHAN,BHILWARA,2021-03-18,25,548,7,580
RAJASTHAN,BHILWARA,2021-03-19,19,344,6,369
RAJASTHAN,BHILWARA,2021-03-20,42,406,7,455
RAJASTHAN,BIKANER,2021-03-16,2,630,1,633
RAJASTHAN,BIKANER,2021-03-17,18,669,1,688
RAJASTHAN,BIKANER,2021-03-18,1,708,2,711
RAJASTHAN,BIKANER,2021-03-19,0,579,3,582
RAJASTHAN,BIKANER,2021-03-20,2,551,4,557
RAJASTHAN,BUNDI,2021-03-16,0,198,1,199
RAJASTHAN,BUNDI,2021-03-17,0,120,0,120
RAJASTHAN,BUNDI,2021-03-18,0,106,1,107
RAJASTHAN,BUNDI,2021-03-19,0,82,0,82
RAJASTHAN,BUNDI,2021-03-20,0,160,0,160
RAJASTHAN,CHITTORGARH,2021-03-16,11,290,4,305
RAJASTHAN,CHITTORGARH,2021-03-17,4,347,3,354
RAJASTHAN,CHITTORGARH,2021-03-18,0,272,0,272
RAJASTHAN,CHITTORGARH,2021-03-19,19,583,3,605
RAJASTHAN,CHITTORGARH,2021-03-20,3,365,7,375
RAJASTHAN,CHURU,2021-03-16,0,365,3,368
RAJASTHAN,CHURU,2021-03-17,0,340,4,344
RAJASTHAN,CHURU,2021-03-18,1,217,8,226
RAJASTHAN,CHURU,2021-03-19,1,242,1,244
RAJASTHAN,CHURU,2021-03-20,0,280,3,283
RAJASTHAN,DAUSA,2021-03-16,1,206,11,218
RAJASTHAN,DAUSA,2021-03-17,2,263,9,274
RAJASTHAN,DAUSA,2021-03-18,4,205,7,216
RAJASTHAN,DAUSA,2021-03-19,2,502,4,508
RAJASTHAN,DAUSA,2021-03-20,0,566,14,580
RAJASTHAN,DHOLPUR,2021-03-16,1,64,1,66
RAJASTHAN,DHOLPUR,2021-03-17,4,54,0,58
RAJASTHAN,DHOLPUR,2021-03-18,16,216,1,233
RAJASTHAN,DHOLPUR,2021-03-19,5,97,0,102
RAJASTHAN,DHOLPUR,2021-03-20,5,65,0,70
RAJASTHAN,DUNGARPUR,2021-03-16,14,523,0,537
RAJASTHAN,DUNGARPUR,2021-03-17,32,161,0,193
RAJASTHAN,DUNGARPUR,2021-03-18,18,225,0,243
RAJASTHAN,DUNGARPUR,2021-03-19,35,223,0,258
RAJASTHAN,DUNGARPUR,2021-03-20,36,279,0,315
RAJASTHAN,GANGANAGAR,2021-03-16,96,236,3,335
RAJASTHAN,GANGANAGAR,2021-03-17,58,373,1,432
RAJASTHAN,GANGANAGAR,2021-03-18,116,206,18,340
RAJASTHAN,GANGANAGAR,2021-03-19,43,163,2,208
RAJASTHAN,GANGANAGAR,2021-03-20,57,156,3,216
RAJASTHAN,HANUMANGARH,2021-03-16,2,43,1,46
RAJASTHAN,HANUMANGARH,2021-03-17,2,441,0,443
RAJASTHAN,HANUMANGARH,2021-03-18,2,512,0,514
RAJASTHAN,HANUMANGARH,2021-03-19,0,39,0,39
RAJASTHAN,HANUMANGARH,2021-03-20,6,497,2,505
RAJASTHAN,JAIPUR,2021-03-16,111,2229,512,2852
RAJASTHAN,JAIPUR,2021-03-17,88,2771,402,3261
RAJASTHAN,JAIPUR,2021-03-18,84,3030,356,3470
RAJASTHAN,JAIPUR,2021-03-19,109,3473,338,3920
RAJASTHAN,JAIPUR,2021-03-20,107,2758,354,3219
RAJASTHAN,JAISALMER,2021-03-16,1,152,0,153
RAJASTHAN,JAISALMER,2021-03-17,0,104,0,104
RAJASTHAN,JAISALMER,2021-03-18,1,71,1,73
RAJASTHAN,JAISALMER,2021-03-19,0,7,0,7
RAJASTHAN,JAISALMER,2021-03-20,1,246,1,248
RAJASTHAN,JALORE,2021-03-16,0,147,1,148
RAJASTHAN,JALORE,2021-03-17,5,325,1,331
RAJASTHAN,JALORE,2021-03-18,2,390,0,392
RAJASTHAN,JALORE,2021-03-19,1,233,0,234
RAJASTHAN,JALORE,2021-03-20,3,418,1,422
RAJASTHAN,JHALAWAR,2021-03-16,11,471,4,486
RAJASTHAN,JHALAWAR,2021-03-17,13,206,2,221
RAJASTHAN,JHALAWAR,2021-03-18,5,489,3,497
RAJASTHAN,JHALAWAR,2021-03-19,1,106,0,107
RAJASTHAN,JHALAWAR,2021-03-20,0,309,0,309
RAJASTHAN,JHUNJHUNU,2021-03-16,1,76,5,82
RAJASTHAN,JHUNJHUNU,2021-03-17,4,111,3,118
RAJASTHAN,JHUNJHUNU,2021-03-18,2,103,7,112
RAJASTHAN,JHUNJHUNU,2021-03-19,2,84,1,87
RAJASTHAN,JHUNJHUNU,2021-03-20,0,56,6,62
RAJASTHAN,JODHPUR,2021-03-16,18,1164,4,1186
RAJASTHAN,JODHPUR,2021-03-17,22,833,9,864
RAJASTHAN,JODHPUR,2021-03-18,32,987,3,1022
RAJASTHAN,JODHPUR,2021-03-19,18,700,3,721
RAJASTHAN,JODHPUR,2021-03-20,32,777,7,816
RAJASTHAN,KARAULI,2021-03-16,4,93,6,103
RAJASTHAN,KARAULI,2021-03-17,5,391,4,400
RAJASTHAN,KARAULI,2021-03-18,3,251,6,260
RAJASTHAN,KARAULI,2021-03-19,1,132,4,137
RAJASTHAN,KARAULI,2021-03-20,0,164,3,167
RAJASTHAN,KOTA,2021-03-16,74,1088,2,1164
RAJASTHAN,KOTA,2021-03-17,85,1502,4,1591
RAJASTHAN,KOTA,2021-03-18,14,1206,7,1227
RAJASTHAN,KOTA,2021-03-19,73,1275,7,1355
RAJASTHAN,KOTA,2021-03-20,55,1457,11,1523
RAJASTHAN,NAGAUR,2021-03-16,0,173,46,219
RAJASTHAN,NAGAUR,2021-03-17,3,204,106,313
RAJASTHAN,NAGAUR,2021-03-18,3,33,150,186
RAJASTHAN,NAGAUR,2021-03-19,1,50,205,256
RAJASTHAN,NAGAUR,2021-03-20,3,54,128,185
RAJASTHAN,PALI,2021-03-16,1,17,2,20
RAJASTHAN,PALI,2021-03-17,3,19,5,27
RAJASTHAN,PALI,2021-03-18,1,27,9,37
RAJASTHAN,PALI,2021-03-19,2,14,7,23
RAJASTHAN,PALI,2021-03-20,1,26,13,40
RAJASTHAN,PRATAPGARH,2021-03-16,1,6,0,7
RAJASTHAN,PRATAPGARH,2021-03-17,5,5,0,10
RAJASTHAN,PRATAPGARH,2021-03-18,6,11,0,17
RAJASTHAN,PRATAPGARH,2021-03-19,7,11,0,18
RAJASTHAN,PRATAPGARH,2021-03-20,0,6,0,6
RAJASTHAN,RAJSAMAND,2021-03-16,19,89,0,108
RAJASTHAN,RAJSAMAND,2021-03-17,1,134,1,136
RAJASTHAN,RAJSAMAND,2021-03-18,14,62,2,78
RAJASTHAN,RAJSAMAND,2021-03-19,19,74,0,93
RAJASTHAN,RAJSAMAND,2021-03-20,12,187,3,202
RAJASTHAN,SAWAI MADHOPUR,2021-03-16,0,106,3,109
RAJASTHAN,SAWAI MADHOPUR,2021-03-17,0,151,4,155
RAJASTHAN,SAWAI MADHOPUR,2021-03-18,2,73,4,79
RAJASTHAN,SAWAI MADHOPUR,2021-03-19,0,83,4,87
RAJASTHAN,SAWAI MADHOPUR,2021-03-20,0,123,5,128
RAJASTHAN,SIKAR,2021-03-16,1,345,4,350
RAJASTHAN,SIKAR,2021-03-17,3,401,5,409
RAJASTHAN,SIKAR,2021-03-18,2,430,6,438
RAJASTHAN,SIKAR,2021-03-19,0,371,4,375
RAJASTHAN,SIKAR,2021-03-20,1,244,3,248
RAJASTHAN,SIROHI,2021-03-16,4,360,0,364
RAJASTHAN,SIROHI,2021-03-17,2,499,0,501
RAJASTHAN,SIROHI,2021-03-18,2,49,0,51
RAJASTHAN,SIROHI,2021-03-19,0,435,0,435
RAJASTHAN,SIROHI,2021-03-20,3,196,0,199
RAJASTHAN,TONK,2021-03-16,1,315,17,333
RAJASTHAN,TONK,2021-03-17,1,223,12,236
RAJASTHAN,TONK,2021-03-18,2,230,3,235
RAJASTHAN,TONK,2021-03-19,0,114,2,116
RAJASTHAN,TONK,2021-03-20,1,158,1,160
RAJASTHAN,UDAIPUR,2021-03-16,151,842,1,994
RAJASTHAN,UDAIPUR,2021-03-17,162,927,0,1089
RAJASTHAN,UDAIPUR,2021-03-18,162,888,2,1052
RAJASTHAN,UDAIPUR,2021-03-19,204,992,3,1199
RAJASTHAN,UDAIPUR,2021-03-20,216,1044,0,1260
SIKKIM,EAST DISTRICT,2021-03-16,5,179,0,184
SIKKIM,EAST DISTRICT,2021-03-17,2,129,0,131
SIKKIM,EAST DISTRICT,2021-03-18,0,102,0,102
SIKKIM,EAST DISTRICT,2021-03-19,1,102,0,103
SIKKIM,EAST DISTRICT,2021-03-20,2,137,0,139
SIKKIM,NORTH DISTRICT,2021-03-16,0,4,0,4
SIKKIM,NORTH DISTRICT,2021-03-17,0,6,0,6
SIKKIM,NORTH DISTRICT,2021-03-18,0,2,0,2
SIKKIM,NORTH DISTRICT,2021-03-19,0,5,0,5
SIKKIM,NORTH DISTRICT,2021-03-20,0,1,0,1
SIKKIM,SOUTH DISTRICT,2021-03-16,2,25,0,27
SIKKIM,SOUTH DISTRICT,2021-03-17,0,7,0,7
SIKKIM,SOUTH DISTRICT,2021-03-18,0,5,0,5
SIKKIM,SOUTH DISTRICT,2021-03-19,0,11,0,11
SIKKIM,SOUTH DISTRICT,2021-03-20,0,23,0,23
SIKKIM,WEST DISTRICT,2021-03-16,0,9,0,9
SIKKIM,WEST DISTRICT,2021-03-17,0,2,0,2
SIKKIM,WEST DISTRICT,2021-03-18,0,8,0,8
SIKKIM,WEST DISTRICT,2021-03-19,0,8,0,8
SIKKIM,WEST DISTRICT,2021-03-20,0,4,0,4
TAMIL NADU,ARIYALUR,2021-03-16,5,737,0,742
TAMIL NADU,ARIYALUR,2021-03-17,3,804,0,807
TAMIL NADU,ARIYALUR,2021-03-18,2,673,0,675
TAMIL NADU,ARIYALUR,2021-03-19,7,568,0,575
TAMIL NADU,ARIYALUR,2021-03-20,0,103,0,103
TAMIL NADU,CHENGALPATTU,2021-03-16,122,3374,2,3498
TAMIL NADU,CHENGALPATTU,2021-03-17,121,4007,0,4128
TAMIL NADU,CHENGALPATTU,2021-03-18,134,4329,3,4466
TAMIL NADU,CHENGALPATTU,2021-03-19,156,4027,0,4183
TAMIL NADU,CHENGALPATTU,2021-03-20,162,4601,0,4763
TAMIL NADU,CHENNAI,2021-03-16,682,12650,23,13355
TAMIL NADU,CHENNAI,2021-03-17,651,12921,83,13655
TAMIL NADU,CHENNAI,2021-03-18,617,11114,63,11794
TAMIL NADU,CHENNAI,2021-03-19,679,14143,37,14859
TAMIL NADU,CHENNAI,2021-03-20,694,10890,146,11730
TAMIL NADU,COIMBATORE,2021-03-16,126,3009,0,3135
TAMIL NADU,COIMBATORE,2021-03-17,101,2756,0,2857
TAMIL NADU,COIMBATORE,2021-03-18,134,2803,3,2940
TAMIL NADU,COIMBATORE,2021-03-19,139,3006,0,3145
TAMIL NADU,COIMBATORE,2021-03-20,150,2967,3,3120
TAMIL NADU,CUDDALORE,2021-03-16,16,2606,0,2622
TAMIL NADU,CUDDALORE,2021-03-17,18,2434,2,2454
TAMIL NADU,CUDDALORE,2021-03-18,11,2173,3,2187
TAMIL NADU,CUDDALORE,2021-03-19,15,1888,0,1903
TAMIL NADU,CUDDALORE,2021-03-20,16,1570,2,1588
TAMIL NADU,DHARMAPURI,2021-03-16,5,651,0,656
TAMIL NADU,DHARMAPURI,2021-03-17,6,739,0,745
TAMIL NADU,DHARMAPURI,2021-03-18,9,675,0,684
TAMIL NADU,DHARMAPURI,2021-03-19,7,618,0,625
TAMIL NADU,DHARMAPURI,2021-03-20,20,805,0,825
TAMIL NADU,DINDIGUL,2021-03-16,10,1408,1,1419
TAMIL NADU,DINDIGUL,2021-03-17,10,1679,1,1690
TAMIL NADU,DINDIGUL,2021-03-18,21,1071,0,1092
TAMIL NADU,DINDIGUL,2021-03-19,21,1528,3,1552
TAMIL NADU,DINDIGUL,2021-03-20,46,1347,0,1393
TAMIL NADU,ERODE,2021-03-16,19,1866,0,1885
TAMIL NADU,ERODE,2021-03-17,18,1682,0,1700
TAMIL NADU,ERODE,2021-03-18,17,2044,1,2062
TAMIL NADU,ERODE,2021-03-19,16,2025,0,2041
TAMIL NADU,ERODE,2021-03-20,25,2138,0,2163
TAMIL NADU,KALLAKURICHI,2021-03-16,2,599,3,604
TAMIL NADU,KALLAKURICHI,2021-03-17,4,424,0,428
TAMIL NADU,KALLAKURICHI,2021-03-18,1,478,0,479
TAMIL NADU,KALLAKURICHI,2021-03-19,0,441,0,441
TAMIL NADU,KALLAKURICHI,2021-03-20,0,689,3,692
TAMIL NADU,KANCHIPURAM,2021-03-16,35,1305,5,1345
TAMIL NADU,KANCHIPURAM,2021-03-17,36,2299,4,2339
TAMIL NADU,KANCHIPURAM,2021-03-18,54,2248,3,2305
TAMIL NADU,KANCHIPURAM,2021-03-19,52,2352,1,2405
TAMIL NADU,KANCHIPURAM,2021-03-20,44,1684,4,1732
TAMIL NADU,KANNIYAKUMARI,2021-03-16,21,1376,7,1404
TAMIL NADU,KANNIYAKUMARI,2021-03-17,15,1577,2,1594
TAMIL NADU,KANNIYAKUMARI,2021-03-18,9,1397,3,1409
TAMIL NADU,KANNIYAKUMARI,2021-03-19,25,1439,5,1469
TAMIL NADU,KANNIYAKUMARI,2021-03-20,13,874,1,888
TAMIL NADU,KARUR,2021-03-16,4,1037,0,1041
TAMIL NADU,KARUR,2021-03-17,11,824,0,835
TAMIL NADU,KARUR,2021-03-18,10,1106,0,1116
TAMIL NADU,KARUR,2021-03-19,8,915,1,924
TAMIL NADU,KARUR,2021-03-20,11,1014,0,1025
TAMIL NADU,KRISHNAGIRI,2021-03-16,7,656,6,669
TAMIL NADU,KRISHNAGIRI,2021-03-17,12,585,1,598
TAMIL NADU,KRISHNAGIRI,2021-03-18,12,963,3,978
TAMIL NADU,KRISHNAGIRI,2021-03-19,20,709,1,730
TAMIL NADU,KRISHNAGIRI,2021-03-20,23,927,1,951
TAMIL NADU,MADURAI,2021-03-16,28,3019,1,3048
TAMIL NADU,MADURAI,2021-03-17,33,2723,0,2756
TAMIL NADU,MADURAI,2021-03-18,20,1949,0,1969
TAMIL NADU,MADURAI,2021-03-19,11,3103,0,3114
TAMIL NADU,MADURAI,2021-03-20,36,2800,2,2838
TAMIL NADU,NAGAPATTINAM,2021-03-16,16,750,0,766
TAMIL NADU,NAGAPATTINAM,2021-03-17,18,532,0,550
TAMIL NADU,NAGAPATTINAM,2021-03-18,27,713,0,740
TAMIL NADU,NAGAPATTINAM,2021-03-19,26,686,0,712
TAMIL NADU,NAGAPATTINAM,2021-03-20,30,795,0,825
TAMIL NADU,NAMAKKAL,2021-03-16,9,1498,2,1509
TAMIL NADU,NAMAKKAL,2021-03-17,15,1666,1,1682
TAMIL NADU,NAMAKKAL,2021-03-18,9,1307,0,1316
TAMIL NADU,NAMAKKAL,2021-03-19,25,1105,0,1130
TAMIL NADU,NAMAKKAL,2021-03-20,11,1241,0,1252
TAMIL NADU,PERAMBALUR,2021-03-16,0,539,0,539
TAMIL NADU,PERAMBALUR,2021-03-17,0,535,0,535
TAMIL NADU,PERAMBALUR,2021-03-18,1,480,0,481
TAMIL NADU,PERAMBALUR,2021-03-19,0,640,0,640
TAMIL NADU,PERAMBALUR,2021-03-20,2,504,0,506
TAMIL NADU,PUDUKKOTTAI,2021-03-16,11,648,0,659
TAMIL NADU,PUDUKKOTTAI,2021-03-17,6,1073,0,1079
TAMIL NADU,PUDUKKOTTAI,2021-03-18,9,1249,0,1258
TAMIL NADU,PUDUKKOTTAI,2021-03-19,4,957,0,961
TAMIL NADU,PUDUKKOTTAI,2021-03-20,7,1167,0,1174
TAMIL NADU,RAMANATHAPURAM,2021-03-16,2,1474,0,1476
TAMIL NADU,RAMANATHAPURAM,2021-03-17,3,906,0,909
TAMIL NADU,RAMANATHAPURAM,2021-03-18,1,791,0,792
TAMIL NADU,RAMANATHAPURAM,2021-03-19,1,921,0,922
TAMIL NADU,RAMANATHAPURAM,2021-03-20,3,801,0,804
TAMIL NADU,RANIPET,2021-03-16,2,113,0,115
TAMIL NADU,RANIPET,2021-03-17,3,130,0,133
TAMIL NADU,RANIPET,2021-03-18,10,228,3,241
TAMIL NADU,RANIPET,2021-03-19,8,374,0,382
TAMIL NADU,RANIPET,2021-03-20,12,492,0,504
TAMIL NADU,SALEM,2021-03-16,26,1074,0,1100
TAMIL NADU,SALEM,2021-03-17,28,1409,0,1437
TAMIL NADU,SALEM,2021-03-18,36,1098,4,1138
TAMIL NADU,SALEM,2021-03-19,30,1083,8,1121
TAMIL NADU,SALEM,2021-03-20,34,1551,1,1586
TAMIL NADU,SIVAGANGA,2021-03-16,8,682,0,690
TAMIL NADU,SIVAGANGA,2021-03-17,2,563,1,566
TAMIL NADU,SIVAGANGA,2021-03-18,11,494,1,506
TAMIL NADU,SIVAGANGA,2021-03-19,15,738,0,753
TAMIL NADU,SIVAGANGA,2021-03-20,19,746,0,765
TAMIL NADU,TENKASI,2021-03-16,2,473,0,475
TAMIL NADU,TENKASI,2021-03-17,5,414,1,420
TAMIL NADU,TENKASI,2021-03-18,8,395,1,404
TAMIL NADU,TENKASI,2021-03-19,3,451,1,455
TAMIL NADU,TENKASI,2021-03-20,22,417,0,439
TAMIL NADU,THANJAVUR,2021-03-16,42,9674,0,9716
TAMIL NADU,THANJAVUR,2021-03-17,48,9255,1,9304
TAMIL NADU,THANJAVUR,2021-03-18,66,7054,3,7123
TAMIL NADU,THANJAVUR,2021-03-19,80,8250,3,8333
TAMIL NADU,THANJAVUR,2021-03-20,82,9261,3,9346
TAMIL NADU,THE NILGIRIS,2021-03-16,17,705,3,725
TAMIL NADU,THE NILGIRIS,2021-03-17,15,689,0,704
TAMIL NADU,THE NILGIRIS,2021-03-18,13,1099,6,1118
TAMIL NADU,THE NILGIRIS,2021-03-19,11,1119,2,1132
TAMIL NADU,THE NILGIRIS,2021-03-20,32,1039,8,1079
TAMIL NADU,THENI,2021-03-16,2,482,0,484
TAMIL NADU,THENI,2021-03-17,5,123,0,128
TAMIL NADU,THENI,2021-03-18,0,357,0,357
TAMIL NADU,THENI,2021-03-19,4,352,0,356
TAMIL NADU,THENI,2021-03-20,9,588,0,597
TAMIL NADU,THIRUVALLUR,2021-03-16,79,1835,2,1916
TAMIL NADU,THIRUVALLUR,2021-03-17,109,2403,15,2527
TAMIL NADU,THIRUVALLUR,2021-03-18,97,2348,6,2451
TAMIL NADU,THIRUVALLUR,2021-03-19,66,2429,3,2498
TAMIL NADU,THIRUVALLUR,2021-03-20,104,2367,5,2476
TAMIL NADU,THIRUVARUR,2021-03-16,12,1321,0,1333
TAMIL NADU,THIRUVARUR,2021-03-17,22,1429,0,1451
TAMIL NADU,THIRUVARUR,2021-03-18,24,1698,0,1722
TAMIL NADU,THIRUVARUR,2021-03-19,27,1631,0,1658
TAMIL NADU,THIRUVARUR,2021-03-20,32,1063,0,1095
TAMIL NADU,TIRUCHIRAPPALLI,2021-03-16,20,1729,4,1753
TAMIL NADU,TIRUCHIRAPPALLI,2021-03-17,18,1779,0,1797
TAMIL NADU,TIRUCHIRAPPALLI,2021-03-18,37,2200,3,2240
TAMIL NADU,TIRUCHIRAPPALLI,2021-03-19,20,2344,0,2364
TAMIL NADU,TIRUCHIRAPPALLI,2021-03-20,29,2353,3,2385
TAMIL NADU,TIRUNELVELI,2021-03-16,15,858,4,877
TAMIL NADU,TIRUNELVELI,2021-03-17,6,890,0,896
TAMIL NADU,TIRUNELVELI,2021-03-18,13,825,1,839
TAMIL NADU,TIRUNELVELI,2021-03-19,20,916,0,936
TAMIL NADU,TIRUNELVELI,2021-03-20,24,669,2,695
TAMIL NADU,TIRUPATHUR,2021-03-16,8,3046,1,3055
TAMIL NADU,TIRUPATHUR,2021-03-17,4,3344,1,3349
TAMIL NADU,TIRUPATHUR,2021-03-18,6,3739,1,3746
TAMIL NADU,TIRUPATHUR,2021-03-19,14,3035,2,3051
TAMIL NADU,TIRUPATHUR,2021-03-20,13,2704,2,2719
TAMIL NADU,TIRUPPUR,2021-03-16,38,1478,0,1516
TAMIL NADU,TIRUPPUR,2021-03-17,31,1269,0,1300
TAMIL NADU,TIRUPPUR,2021-03-18,35,1698,1,1734
TAMIL NADU,TIRUPPUR,2021-03-19,38,1638,5,1681
TAMIL NADU,TIRUPPUR,2021-03-20,58,2227,2,2287
TAMIL NADU,TIRUVANNAMALAI,2021-03-16,8,1282,4,1294
TAMIL NADU,TIRUVANNAMALAI,2021-03-17,4,1073,1,1078
TAMIL NADU,TIRUVANNAMALAI,2021-03-18,14,1089,1,1104
TAMIL NADU,TIRUVANNAMALAI,2021-03-19,9,801,0,810
TAMIL NADU,TIRUVANNAMALAI,2021-03-20,8,744,1,753
TAMIL NADU,TUTICORIN,2021-03-16,10,625,3,638
TAMIL NADU,TUTICORIN,2021-03-17,9,693,0,702
TAMIL NADU,TUTICORIN,2021-03-18,4,662,5,671
TAMIL NADU,TUTICORIN,2021-03-19,10,679,1,690
TAMIL NADU,TUTICORIN,2021-03-20,8,645,0,653
TAMIL NADU,VELLORE,2021-03-16,15,1138,7,1160
TAMIL NADU,VELLORE,2021-03-17,21,1110,3,1134
TAMIL NADU,VELLORE,2021-03-18,21,1276,5,1302
TAMIL NADU,VELLORE,2021-03-19,21,1749,0,1770
TAMIL NADU,VELLORE,2021-03-20,28,1428,6,1462
TAMIL NADU,VILLUPURAM,2021-03-16,6,770,0,776
TAMIL NADU,VILLUPURAM,2021-03-17,5,644,0,649
TAMIL NADU,VILLUPURAM,2021-03-18,8,797,1,806
TAMIL NADU,VILLUPURAM,2021-03-19,5,807,0,812
TAMIL NADU,VILLUPURAM,2021-03-20,12,920,1,933
TAMIL NADU,VIRUDHUNAGAR,2021-03-16,4,755,1,760
TAMIL NADU,VIRUDHUNAGAR,2021-03-17,10,957,2,969
TAMIL NADU,VIRUDHUNAGAR,2021-03-18,10,1227,2,1239
TAMIL NADU,VIRUDHUNAGAR,2021-03-19,6,932,0,938
TAMIL NADU,VIRUDHUNAGAR,2021-03-20,12,1034,0,1046
TELANGANA,ADILABAD,2021-03-16,2,1288,0,1290
TELANGANA,ADILABAD,2021-03-17,0,884,0,884
TELANGANA,ADILABAD,2021-03-18,0,1132,0,1132
TELANGANA,ADILABAD,2021-03-19,0,6,0,6
TELANGANA,ADILABAD,2021-03-20,2,1778,0,1780
TELANGANA,BHADRADRI KOTHAGUDEM,2021-03-16,0,618,0,618
TELANGANA,BHADRADRI KOTHAGUDEM,2021-03-17,0,593,1,594
TELANGANA,BHADRADRI KOTHAGUDEM,2021-03-18,0,572,0,572
TELANGANA,BHADRADRI KOTHAGUDEM,2021-03-19,0,6,0,6
TELANGANA,BHADRADRI KOTHAGUDEM,2021-03-20,0,619,0,619
TELANGANA,HYDERABAD,2021-03-16,41,7657,1,7699
TELANGANA,HYDERABAD,2021-03-17,37,8302,5,8344
TELANGANA,HYDERABAD,2021-03-18,52,9335,6,9393
TELANGANA,HYDERABAD,2021-03-19,72,513,4,589
TELANGANA,HYDERABAD,2021-03-20,53,8280,7,8340
TELANGANA,JAGITIAL,2021-03-16,0,1089,0,1089
TELANGANA,JAGITIAL,2021-03-17,0,1376,0,1376
TELANGANA,JAGITIAL,2021-03-18,0,1332,0,1332
TELANGANA,JAGITIAL,2021-03-20,1,1518,0,1519
TELANGANA,JANGOAN,2021-03-16,0,869,0,869
TELANGANA,JANGOAN,2021-03-17,0,767,0,767
TELANGANA,JANGOAN,2021-03-18,0,785,0,785
TELANGANA,JANGOAN,2021-03-19,0,1,0,1
TELANGANA,JANGOAN,2021-03-20,0,767,0,767
TELANGANA,JAYASHANKAR BHUPALAPALLY,2021-03-16,0,380,0,380
TELANGANA,JAYASHANKAR BHUPALAPALLY,2021-03-17,0,432,0,432
TELANGANA,JAYASHANKAR BHUPALAPALLY,2021-03-18,0,420,0,420
TELANGANA,JAYASHANKAR BHUPALAPALLY,2021-03-20,0,398,0,398
TELANGANA,JOGULAMBA GADWAL,2021-03-16,0,740,0,740
TELANGANA,JOGULAMBA GADWAL,2021-03-17,0,928,0,928
TELANGANA,JOGULAMBA GADWAL,2021-03-18,0,737,0,737
TELANGANA,JOGULAMBA GADWAL,2021-03-19,1,0,0,1
TELANGANA,JOGULAMBA GADWAL,2021-03-20,0,748,0,748
TELANGANA,KAMAREDDY,2021-03-16,0,709,0,709
TELANGANA,KAMAREDDY,2021-03-17,0,935,0,935
TELANGANA,KAMAREDDY,2021-03-18,0,1807,0,1807
TELANGANA,KAMAREDDY,2021-03-20,1,1621,0,1622
TELANGANA,KARIMNAGAR,2021-03-16,1,2402,0,2403
TELANGANA,KARIMNAGAR,2021-03-17,0,1826,0,1826
TELANGANA,KARIMNAGAR,2021-03-18,1,2112,0,2113
TELANGANA,KARIMNAGAR,2021-03-19,0,11,0,11
TELANGANA,KARIMNAGAR,2021-03-20,0,1895,0,1895
TELANGANA,KHAMMAM,2021-03-16,0,1417,0,1417
TELANGANA,KHAMMAM,2021-03-17,1,1391,0,1392
TELANGANA,KHAMMAM,2021-03-18,2,1553,0,1555
TELANGANA,KHAMMAM,2021-03-19,1,9,0,10
TELANGANA,KHAMMAM,2021-03-20,0,2173,0,2173
TELANGANA,KUMURAM BHEEM ASIFABAD,2021-03-16,0,464,0,464
TELANGANA,KUMURAM BHEEM ASIFABAD,2021-03-17,0,726,0,726
TELANGANA,KUMURAM BHEEM ASIFABAD,2021-03-18,0,608,0,608
TELANGANA,KUMURAM BHEEM ASIFABAD,2021-03-19,0,1,0,1
TELANGANA,KUMURAM BHEEM ASIFABAD,2021-03-20,0,662,0,662
TELANGANA,MAHABUBABAD,2021-03-16,0,300,0,300
TELANGANA,MAHABUBABAD,2021-03-17,0,268,0,268
TELANGANA,MAHABUBABAD,2021-03-18,0,291,0,291
TELANGANA,MAHABUBABAD,2021-03-19,1,0,0,1
TELANGANA,MAHABUBABAD,2021-03-20,0,483,0,483
TELANGANA,MAHABUBNAGAR,2021-03-16,1,2389,0,2390
TELANGANA,MAHABUBNAGAR,2021-03-17,0,2845,0,2845
TELANGANA,MAHABUBNAGAR,2021-03-18,1,3544,0,3545
TELANGANA,MAHABUBNAGAR,2021-03-19,0,34,0,34
TELANGANA,MAHABUBNAGAR,2021-03-20,0,2894,0,2894
TELANGANA,MANCHERIAL,2021-03-16,0,1708,0,1708
TELANGANA,MANCHERIAL,2021-03-17,0,1563,0,1563
TELANGANA,MANCHERIAL,2021-03-18,0,1348,0,1348
TELANGANA,MANCHERIAL,2021-03-19,0,14,0,14
TELANGANA,MANCHERIAL,2021-03-20,0,1608,0,1608
TELANGANA,MEDAK,2021-03-16,0,638,0,638
TELANGANA,MEDAK,2021-03-17,0,601,2,603
TELANGANA,MEDAK,2021-03-18,0,796,0,796
TELANGANA,MEDAK,2021-03-19,0,14,0,14
TELANGANA,MEDAK,2021-03-20,1,911,0,912
TELANGANA,MEDCHAL MALKAJGIRI,2021-03-16,1,2658,5,2664
TELANGANA,MEDCHAL MALKAJGIRI,2021-03-17,1,3110,1,3112
TELANGANA,MEDCHAL MALKAJGIRI,2021-03-18,3,3383,1,3387
TELANGANA,MEDCHAL MALKAJGIRI,2021-03-19,1,44,1,46
TELANGANA,MEDCHAL MALKAJGIRI,2021-03-20,2,2614,0,2616
TELANGANA,MULUGU,2021-03-16,0,314,0,314
TELANGANA,MULUGU,2021-03-17,0,353,0,353
TELANGANA,MULUGU,2021-03-18,0,400,0,400
TELANGANA,MULUGU,2021-03-19,0,1,0,1
TELANGANA,MULUGU,2021-03-20,0,675,0,675
TELANGANA,NAGARKURNOOL,2021-03-16,0,1715,0,1715
TELANGANA,NAGARKURNOOL,2021-03-17,0,1747,0,1747
TELANGANA,NAGARKURNOOL,2021-03-18,0,1666,0,1666
TELANGANA,NAGARKURNOOL,2021-03-19,0,1,0,1
TELANGANA,NAGARKURNOOL,2021-03-20,0,1826,0,1826
TELANGANA,NALGONDA,2021-03-16,0,3095,0,3095
TELANGANA,NALGONDA,2021-03-17,0,2639,0,2639
TELANGANA,NALGONDA,2021-03-18,0,2502,0,2502
TELANGANA,NALGONDA,2021-03-19,0,17,0,17
TELANGANA,NALGONDA,2021-03-20,1,2350,0,2351
TELANGANA,NARAYANPET,2021-03-16,0,338,0,338
TELANGANA,NARAYANPET,2021-03-17,0,566,0,566
TELANGANA,NARAYANPET,2021-03-18,0,238,0,238
TELANGANA,NARAYANPET,2021-03-20,0,482,0,482
TELANGANA,NIRMAL,2021-03-16,1,612,0,613
TELANGANA,NIRMAL,2021-03-17,0,825,0,825
TELANGANA,NIRMAL,2021-03-18,0,683,0,683
TELANGANA,NIRMAL,2021-03-19,0,2,0,2
TELANGANA,NIRMAL,2021-03-20,0,1196,0,1196
TELANGANA,NIZAMABAD,2021-03-16,1,2423,0,2424
TELANGANA,NIZAMABAD,2021-03-17,1,1737,0,1738
TELANGANA,NIZAMABAD,2021-03-18,0,2010,0,2010
TELANGANA,NIZAMABAD,2021-03-19,1,26,0,27
TELANGANA,NIZAMABAD,2021-03-20,2,2028,0,2030
TELANGANA,PEDDAPALLI,2021-03-16,0,1547,0,1547
TELANGANA,PEDDAPALLI,2021-03-17,0,1550,0,1550
TELANGANA,PEDDAPALLI,2021-03-18,0,1973,0,1973
TELANGANA,PEDDAPALLI,2021-03-20,0,2217,0,2217
TELANGANA,RAJANNA SIRCILLA,2021-03-16,0,547,0,547
TELANGANA,RAJANNA SIRCILLA,2021-03-17,0,656,0,656
TELANGANA,RAJANNA SIRCILLA,2021-03-18,0,423,0,423
TELANGANA,RAJANNA SIRCILLA,2021-03-19,0,22,0,22
TELANGANA,RAJANNA SIRCILLA,2021-03-20,0,644,0,644
TELANGANA,RANGA REDDY,2021-03-16,8,2542,0,2550
TELANGANA,RANGA REDDY,2021-03-17,9,3156,1,3166
TELANGANA,RANGA REDDY,2021-03-18,6,3224,0,3230
TELANGANA,RANGA REDDY,2021-03-19,16,50,1,67
TELANGANA,RANGA REDDY,2021-03-20,18,4320,1,4339
TELANGANA,SANGAREDDY,2021-03-16,0,962,0,962
TELANGANA,SANGAREDDY,2021-03-17,0,872,0,872
TELANGANA,SANGAREDDY,2021-03-18,2,881,0,883
TELANGANA,SANGAREDDY,2021-03-19,2,65,0,67
TELANGANA,SANGAREDDY,2021-03-20,7,1099,0,1106
TELANGANA,SIDDIPET,2021-03-16,0,1805,0,1805
TELANGANA,SIDDIPET,2021-03-17,0,1646,0,1646
TELANGANA,SIDDIPET,2021-03-18,0,1423,0,1423
TELANGANA,SIDDIPET,2021-03-19,0,5,0,5
TELANGANA,SIDDIPET,2021-03-20,0,1656,0,1656
TELANGANA,SURYAPET,2021-03-16,0,928,0,928
TELANGANA,SURYAPET,2021-03-17,0,1009,0,1009
TELANGANA,SURYAPET,2021-03-18,0,1140,0,1140
TELANGANA,SURYAPET,2021-03-19,0,43,0,43
TELANGANA,SURYAPET,2021-03-20,2,1321,0,1323
TELANGANA,VIKARABAD,2021-03-16,0,1006,0,1006
TELANGANA,VIKARABAD,2021-03-17,1,963,0,964
TELANGANA,VIKARABAD,2021-03-18,0,657,0,657
TELANGANA,VIKARABAD,2021-03-19,0,50,0,50
TELANGANA,VIKARABAD,2021-03-20,6,831,0,837
TELANGANA,WANAPARTHY,2021-03-16,0,571,0,571
TELANGANA,WANAPARTHY,2021-03-17,0,534,0,534
TELANGANA,WANAPARTHY,2021-03-18,0,456,0,456
TELANGANA,WANAPARTHY,2021-03-20,0,475,0,475
TELANGANA,WARANGAL RURAL,2021-03-16,2,1123,0,1125
TELANGANA,WARANGAL RURAL,2021-03-17,1,1082,0,1083
TELANGANA,WARANGAL RURAL,2021-03-18,1,1037,0,1038
TELANGANA,WARANGAL RURAL,2021-03-19,0,2,0,2
TELANGANA,WARANGAL RURAL,2021-03-20,3,971,0,974
TELANGANA,WARANGAL URBAN,2021-03-16,0,2963,0,2963
TELANGANA,WARANGAL URBAN,2021-03-17,0,2544,0,2544
TELANGANA,WARANGAL URBAN,2021-03-18,0,2236,0,2236
TELANGANA,WARANGAL URBAN,2021-03-19,0,140,0,140
TELANGANA,WARANGAL URBAN,2021-03-20,0,2552,0,2552
TELANGANA,YADADRI BHUVANAGIRI,2021-03-16,0,502,0,502
TELANGANA,YADADRI BHUVANAGIRI,2021-03-17,0,613,0,613
TELANGANA,YADADRI BHUVANAGIRI,2021-03-18,0,607,0,607
TELANGANA,YADADRI BHUVANAGIRI,2021-03-20,0,931,0,931
TRIPURA,DHALAI,2021-03-16,1,11,0,12
TRIPURA,DHALAI,2021-03-17,0,32,0,32
TRIPURA,DHALAI,2021-03-18,0,16,0,16
TRIPURA,DHALAI,2021-03-19,1,35,0,36
TRIPURA,DHALAI,2021-03-20,0,14,0,14
TRIPURA,GOMATI,2021-03-16,0,26,0,26
TRIPURA,GOMATI,2021-03-17,0,38,0,38
TRIPURA,GOMATI,2021-03-18,0,14,0,14
TRIPURA,GOMATI,2021-03-19,0,19,0,19
TRIPURA,GOMATI,2021-03-20,0,38,0,38
TRIPURA,KHOWAI,2021-03-16,0,6,0,6
TRIPURA,KHOWAI,2021-03-17,0,18,0,18
TRIPURA,KHOWAI,2021-03-18,0,11,0,11
TRIPURA,KHOWAI,2021-03-19,0,11,0,11
TRIPURA,KHOWAI,2021-03-20,0,47,0,47
TRIPURA,NORTH TRIPURA,2021-03-16,0,117,0,117
TRIPURA,NORTH TRIPURA,2021-03-17,0,84,0,84
TRIPURA,NORTH TRIPURA,2021-03-18,0,112,0,112
TRIPURA,NORTH TRIPURA,2021-03-19,1,135,0,136
TRIPURA,NORTH TRIPURA,2021-03-20,0,133,0,133
TRIPURA,SEPAHIJALA,2021-03-16,0,85,0,85
TRIPURA,SEPAHIJALA,2021-03-17,0,68,0,68
TRIPURA,SEPAHIJALA,2021-03-18,0,57,0,57
TRIPURA,SEPAHIJALA,2021-03-19,0,73,0,73
TRIPURA,SEPAHIJALA,2021-03-20,0,73,0,73
TRIPURA,SOUTH TRIPURA,2021-03-16,0,42,0,42
TRIPURA,SOUTH TRIPURA,2021-03-17,0,54,0,54
TRIPURA,SOUTH TRIPURA,2021-03-18,0,74,0,74
TRIPURA,SOUTH TRIPURA,2021-03-19,0,48,0,48
TRIPURA,SOUTH TRIPURA,2021-03-20,0,76,0,76
TRIPURA,UNAKOTI,2021-03-16,0,3,0,3
TRIPURA,UNAKOTI,2021-03-17,0,2,0,2
TRIPURA,UNAKOTI,2021-03-18,0,3,0,3
TRIPURA,UNAKOTI,2021-03-19,0,1,0,1
TRIPURA,UNAKOTI,2021-03-20,0,10,0,10
TRIPURA,WEST TRIPURA,2021-03-16,1,128,0,129
TRIPURA,WEST TRIPURA,2021-03-17,4,264,0,268
TRIPURA,WEST TRIPURA,2021-03-18,11,214,0,225
TRIPURA,WEST TRIPURA,2021-03-19,5,222,0,227
TRIPURA,WEST TRIPURA,2021-03-20,3,162,0,165
UTTAR PRADESH,AGRA,2021-03-16,3,1902,1,1906
UTTAR PRADESH,AGRA,2021-03-17,12,1548,6,1566
UTTAR PRADESH,AGRA,2021-03-18,8,2621,3,2632
UTTAR PRADESH,AGRA,2021-03-19,11,2446,2,2459
UTTAR PRADESH,AGRA,2021-03-20,18,2496,2,2516
UTTAR PRADESH,ALIGARH,2021-03-16,30,3328,13,3371
UTTAR PRADESH,ALIGARH,2021-03-17,25,2758,0,2783
UTTAR PRADESH,ALIGARH,2021-03-18,16,4253,0,4269
UTTAR PRADESH,ALIGARH,2021-03-19,7,4111,8,4126
UTTAR PRADESH,ALIGARH,2021-03-20,2,3841,150,3993
UTTAR PRADESH,AMBEDKAR NAGAR,2021-03-16,1,828,48,877
UTTAR PRADESH,AMBEDKAR NAGAR,2021-03-17,3,1365,8,1376
UTTAR PRADESH,AMBEDKAR NAGAR,2021-03-18,1,1103,0,1104
UTTAR PRADESH,AMBEDKAR NAGAR,2021-03-19,1,1261,0,1262
UTTAR PRADESH,AMBEDKAR NAGAR,2021-03-20,1,1038,6,1045
UTTAR PRADESH,AMETHI,2021-03-16,1,1191,1,1193
UTTAR PRADESH,AMETHI,2021-03-17,2,2136,1,2139
UTTAR PRADESH,AMETHI,2021-03-18,2,1064,1,1067
UTTAR PRADESH,AMETHI,2021-03-19,1,1319,0,1320
UTTAR PRADESH,AMETHI,2021-03-20,0,1462,0,1462
UTTAR PRADESH,AMROHA,2021-03-16,2,839,1,842
UTTAR PRADESH,AMROHA,2021-03-17,2,1213,0,1215
UTTAR PRADESH,AMROHA,2021-03-18,1,955,1,957
UTTAR PRADESH,AMROHA,2021-03-19,0,1822,0,1822
UTTAR PRADESH,AMROHA,2021-03-20,5,1132,0,1137
UTTAR PRADESH,AURAIYA,2021-03-16,0,701,103,804
UTTAR PRADESH,AURAIYA,2021-03-17,0,1146,20,1166
UTTAR PRADESH,AURAIYA,2021-03-18,1,842,20,863
UTTAR PRADESH,AURAIYA,2021-03-19,0,1118,20,1138
UTTAR PRADESH,AURAIYA,2021-03-20,0,622,45,667
UTTAR PRADESH,AYODHYA,2021-03-16,2,1038,1,1041
UTTAR PRADESH,AYODHYA,2021-03-17,1,1271,0,1272
UTTAR PRADESH,AYODHYA,2021-03-18,5,1527,0,1532
UTTAR PRADESH,AYODHYA,2021-03-19,1,1817,1,1819
UTTAR PRADESH,AYODHYA,2021-03-20,2,1662,0,1664
UTTAR PRADESH,AZAMGARH,2021-03-16,2,1411,6,1419
UTTAR PRADESH,AZAMGARH,2021-03-17,3,487,1,491
UTTAR PRADESH,AZAMGARH,2021-03-18,4,1027,15,1046
UTTAR PRADESH,AZAMGARH,2021-03-19,7,846,24,877
UTTAR PRADESH,AZAMGARH,2021-03-20,6,1016,16,1038
UTTAR PRADESH,BAGHPAT,2021-03-16,0,1140,16,1156
UTTAR PRADESH,BAGHPAT,2021-03-17,0,1292,34,1326
UTTAR PRADESH,BAGHPAT,2021-03-18,0,1006,1,1007
UTTAR PRADESH,BAGHPAT,2021-03-19,3,1734,102,1839
UTTAR PRADESH,BAGHPAT,2021-03-20,1,1403,43,1447
UTTAR PRADESH,BAHRAICH,2021-03-16,0,1701,1,1702
UTTAR PRADESH,BAHRAICH,2021-03-17,6,1786,8,1800
UTTAR PRADESH,BAHRAICH,2021-03-18,2,1546,97,1645
UTTAR PRADESH,BAHRAICH,2021-03-19,2,1740,8,1750
UTTAR PRADESH,BAHRAICH,2021-03-20,2,1731,23,1756
UTTAR PRADESH,BALLIA,2021-03-16,7,1502,3,1512
UTTAR PRADESH,BALLIA,2021-03-17,2,1200,1,1203
UTTAR PRADESH,BALLIA,2021-03-18,2,1334,2,1338
UTTAR PRADESH,BALLIA,2021-03-19,3,1325,45,1373
UTTAR PRADESH,BALLIA,2021-03-20,1,1351,88,1440
UTTAR PRADESH,BALRAMPUR,2021-03-16,2,973,2,977
UTTAR PRADESH,BALRAMPUR,2021-03-17,2,1053,0,1055
UTTAR PRADESH,BALRAMPUR,2021-03-18,5,1211,0,1216
UTTAR PRADESH,BALRAMPUR,2021-03-19,24,924,0,948
UTTAR PRADESH,BALRAMPUR,2021-03-20,8,1385,0,1393
UTTAR PRADESH,BANDA,2021-03-16,1,1825,90,1916
UTTAR PRADESH,BANDA,2021-03-17,4,2220,31,2255
UTTAR PRADESH,BANDA,2021-03-18,1,2018,32,2051
UTTAR PRADESH,BANDA,2021-03-19,1,1908,15,1924
UTTAR PRADESH,BANDA,2021-03-20,0,2001,35,2036
UTTAR PRADESH,BARABANKI,2021-03-16,1,1777,1,1779
UTTAR PRADESH,BARABANKI,2021-03-17,12,1364,2,1378
UTTAR PRADESH,BARABANKI,2021-03-18,3,1055,0,1058
UTTAR PRADESH,BARABANKI,2021-03-19,9,1374,0,1383
UTTAR PRADESH,BARABANKI,2021-03-20,6,1437,17,1460
UTTAR PRADESH,BAREILLY,2021-03-16,25,2749,12,2786
UTTAR PRADESH,BAREILLY,2021-03-17,17,1812,7,1836
UTTAR PRADESH,BAREILLY,2021-03-18,23,2498,2,2523
UTTAR PRADESH,BAREILLY,2021-03-19,14,2096,2,2112
UTTAR PRADESH,BAREILLY,2021-03-20,15,3022,13,3050
UTTAR PRADESH,BASTI,2021-03-16,3,1056,1,1060
UTTAR PRADESH,BASTI,2021-03-17,6,831,80,917
UTTAR PRADESH,BASTI,2021-03-18,1,933,60,994
UTTAR PRADESH,BASTI,2021-03-19,4,943,2,949
UTTAR PRADESH,BASTI,2021-03-20,8,747,2,757
UTTAR PRADESH,BHADOHI,2021-03-16,0,1525,1,1526
UTTAR PRADESH,BHADOHI,2021-03-17,0,1528,1,1529
UTTAR PRADESH,BHADOHI,2021-03-18,5,1531,1,1537
UTTAR PRADESH,BHADOHI,2021-03-19,0,1531,1,1532
UTTAR PRADESH,BHADOHI,2021-03-20,3,1548,0,1551
UTTAR PRADESH,BIJNOR,2021-03-16,5,1415,1,1421
UTTAR PRADESH,BIJNOR,2021-03-17,3,1327,0,1330
UTTAR PRADESH,BIJNOR,2021-03-18,9,1606,2,1617
UTTAR PRADESH,BIJNOR,2021-03-19,4,1693,0,1697
UTTAR PRADESH,BIJNOR,2021-03-20,2,1782,4,1788
UTTAR PRADESH,BUDAUN,2021-03-16,0,3075,40,3115
UTTAR PRADESH,BUDAUN,2021-03-17,0,489,1,490
UTTAR PRADESH,BUDAUN,2021-03-18,0,517,1,518
UTTAR PRADESH,BUDAUN,2021-03-19,6,1084,10,1100
UTTAR PRADESH,BUDAUN,2021-03-20,4,672,1,677
UTTAR PRADESH,BULANDSHAHR,2021-03-16,0,1941,72,2013
UTTAR PRADESH,BULANDSHAHR,2021-03-17,1,1786,13,1800
UTTAR PRADESH,BULANDSHAHR,2021-03-18,1,1564,0,1565
UTTAR PRADESH,BULANDSHAHR,2021-03-19,9,2244,164,2417
UTTAR PRADESH,BULANDSHAHR,2021-03-20,2,2120,22,2144
UTTAR PRADESH,CHANDAULI,2021-03-16,3,1276,13,1292
UTTAR PRADESH,CHANDAULI,2021-03-17,0,875,0,875
UTTAR PRADESH,CHANDAULI,2021-03-18,8,939,2,949
UTTAR PRADESH,CHANDAULI,2021-03-19,13,727,3,743
UTTAR PRADESH,CHANDAULI,2021-03-20,8,980,4,992
UTTAR PRADESH,CHITRAKOOT,2021-03-16,0,786,27,813
UTTAR PRADESH,CHITRAKOOT,2021-03-17,0,768,15,783
UTTAR PRADESH,CHITRAKOOT,2021-03-18,6,868,0,874
UTTAR PRADESH,CHITRAKOOT,2021-03-19,0,1012,22,1034
UTTAR PRADESH,CHITRAKOOT,2021-03-20,1,832,0,833
UTTAR PRADESH,DEORIA,2021-03-16,2,1391,0,1393
UTTAR PRADESH,DEORIA,2021-03-17,4,1569,84,1657
UTTAR PRADESH,DEORIA,2021-03-18,5,2365,15,2385
UTTAR PRADESH,DEORIA,2021-03-19,1,1912,41,1954
UTTAR PRADESH,DEORIA,2021-03-20,0,1978,64,2042
UTTAR PRADESH,ETAH,2021-03-16,0,1345,6,1351
UTTAR PRADESH,ETAH,2021-03-17,0,1314,9,1323
UTTAR PRADESH,ETAH,2021-03-18,0,768,3,771
UTTAR PRADESH,ETAH,2021-03-19,1,1350,9,1360
UTTAR PRADESH,ETAH,2021-03-20,0,755,9,764
UTTAR PRADESH,ETAWAH,2021-03-16,0,851,1,852
UTTAR PRADESH,ETAWAH,2021-03-17,0,1009,20,1029
UTTAR PRADESH,ETAWAH,2021-03-18,0,1093,5,1098
UTTAR PRADESH,ETAWAH,2021-03-19,0,1211,25,1236
UTTAR PRADESH,ETAWAH,2021-03-20,1,689,16,706
UTTAR PRADESH,FARRUKHABAD,2021-03-16,1,906,27,934
UTTAR PRADESH,FARRUKHABAD,2021-03-17,1,1614,19,1634
UTTAR PRADESH,FARRUKHABAD,2021-03-18,1,995,10,1006
UTTAR PRADESH,FARRUKHABAD,2021-03-19,1,578,27,606
UTTAR PRADESH,FARRUKHABAD,2021-03-20,1,1464,30,1495
UTTAR PRADESH,FATEHPUR,2021-03-16,0,725,1,726
UTTAR PRADESH,FATEHPUR,2021-03-17,1,1319,62,1382
UTTAR PRADESH,FATEHPUR,2021-03-18,5,1053,93,1151
UTTAR PRADESH,FATEHPUR,2021-03-19,4,2082,255,2341
UTTAR PRADESH,FATEHPUR,2021-03-20,2,1198,50,1250
UTTAR PRADESH,FIROZABAD,2021-03-16,2,2080,1,2083
UTTAR PRADESH,FIROZABAD,2021-03-17,8,2234,4,2246
UTTAR PRADESH,FIROZABAD,2021-03-18,7,2017,0,2024
UTTAR PRADESH,FIROZABAD,2021-03-19,30,2143,1,2174
UTTAR PRADESH,FIROZABAD,2021-03-20,13,875,42,930
UTTAR PRADESH,GAUTAM BUDDHA NAGAR,2021-03-16,62,1808,38,1908
UTTAR PRADESH,GAUTAM BUDDHA NAGAR,2021-03-17,71,3667,110,3848
UTTAR PRADESH,GAUTAM BUDDHA NAGAR,2021-03-18,112,3201,31,3344
UTTAR PRADESH,GAUTAM BUDDHA NAGAR,2021-03-19,107,3774,50,3931
UTTAR PRADESH,GAUTAM BUDDHA NAGAR,2021-03-20,103,3197,49,3349
UTTAR PRADESH,GHAZIABAD,2021-03-16,40,3268,122,3430
UTTAR PRADESH,GHAZIABAD,2021-03-17,75,3229,52,3356
UTTAR PRADESH,GHAZIABAD,2021-03-18,71,4465,44,4580
UTTAR PRADESH,GHAZIABAD,2021-03-19,82,4309,102,4493
UTTAR PRADESH,GHAZIABAD,2021-03-20,108,2482,40,2630
UTTAR PRADESH,GHAZIPUR,2021-03-16,2,1263,36,1301
UTTAR PRADESH,GHAZIPUR,2021-03-17,3,929,21,953
UTTAR PRADESH,GHAZIPUR,2021-03-18,2,1900,107,2009
UTTAR PRADESH,GHAZIPUR,2021-03-19,2,969,67,1038
UTTAR PRADESH,GHAZIPUR,2021-03-20,10,1043,93,1146
UTTAR PRADESH,GONDA,2021-03-16,1,1018,1,1020
UTTAR PRADESH,GONDA,2021-03-17,0,1143,1,1144
UTTAR PRADESH,GONDA,2021-03-18,5,1239,195,1439
UTTAR PRADESH,GONDA,2021-03-19,8,1193,0,1201
UTTAR PRADESH,GONDA,2021-03-20,8,1341,0,1349
UTTAR PRADESH,GORAKHPUR,2021-03-16,0,1337,5,1342
UTTAR PRADESH,GORAKHPUR,2021-03-17,13,2120,52,2185
UTTAR PRADESH,GORAKHPUR,2021-03-18,6,1794,16,1816
UTTAR PRADESH,GORAKHPUR,2021-03-19,4,2175,61,2240
UTTAR PRADESH,GORAKHPUR,2021-03-20,11,2582,47,2640
UTTAR PRADESH,HAMIRPUR,2021-03-16,1,823,0,824
UTTAR PRADESH,HAMIRPUR,2021-03-17,1,998,34,1033
UTTAR PRADESH,HAMIRPUR,2021-03-18,1,1077,5,1083
UTTAR PRADESH,HAMIRPUR,2021-03-19,0,1163,24,1187
UTTAR PRADESH,HAMIRPUR,2021-03-20,1,895,10,906
UTTAR PRADESH,HAPUR,2021-03-16,3,929,56,988
UTTAR PRADESH,HAPUR,2021-03-17,11,721,72,804
UTTAR PRADESH,HAPUR,2021-03-18,3,1467,0,1470
UTTAR PRADESH,HAPUR,2021-03-19,0,577,12,589
UTTAR PRADESH,HAPUR,2021-03-20,2,1836,4,1842
UTTAR PRADESH,HARDOI,2021-03-16,1,1442,2,1445
UTTAR PRADESH,HARDOI,2021-03-17,2,1505,0,1507
UTTAR PRADESH,HARDOI,2021-03-18,1,1597,10,1608
UTTAR PRADESH,HARDOI,2021-03-19,2,1299,36,1337
UTTAR PRADESH,HARDOI,2021-03-20,5,1768,0,1773
UTTAR PRADESH,HATHRAS,2021-03-16,0,1495,0,1495
UTTAR PRADESH,HATHRAS,2021-03-17,0,1199,0,1199
UTTAR PRADESH,HATHRAS,2021-03-18,0,760,0,760
UTTAR PRADESH,HATHRAS,2021-03-19,0,1338,0,1338
UTTAR PRADESH,HATHRAS,2021-03-20,0,1191,1,1192
UTTAR PRADESH,JALAUN,2021-03-16,1,1299,3,1303
UTTAR PRADESH,JALAUN,2021-03-17,2,1429,2,1433
UTTAR PRADESH,JALAUN,2021-03-18,5,1270,7,1282
UTTAR PRADESH,JALAUN,2021-03-19,2,1438,0,1440
UTTAR PRADESH,JALAUN,2021-03-20,3,1378,6,1387
UTTAR PRADESH,JAUNPUR,2021-03-16,2,587,0,589
UTTAR PRADESH,JAUNPUR,2021-03-17,4,855,1,860
UTTAR PRADESH,JAUNPUR,2021-03-18,4,806,4,814
UTTAR PRADESH,JAUNPUR,2021-03-19,1,666,1,668
UTTAR PRADESH,JAUNPUR,2021-03-20,3,675,19,697
UTTAR PRADESH,JHANSI,2021-03-16,11,1744,1,1756
UTTAR PRADESH,JHANSI,2021-03-17,13,2246,6,2265
UTTAR PRADESH,JHANSI,2021-03-18,10,1958,6,1974
UTTAR PRADESH,JHANSI,2021-03-19,13,2556,1,2570
UTTAR PRADESH,JHANSI,2021-03-20,18,2740,4,2762
UTTAR PRADESH,KANNAUJ,2021-03-16,0,1704,98,1802
UTTAR PRADESH,KANNAUJ,2021-03-17,0,1837,0,1837
UTTAR PRADESH,KANNAUJ,2021-03-18,0,2094,0,2094
UTTAR PRADESH,KANNAUJ,2021-03-19,0,1839,0,1839
UTTAR PRADESH,KANNAUJ,2021-03-20,0,1806,0,1806
UTTAR PRADESH,KANPUR DEHAT,2021-03-16,1,1244,0,1245
UTTAR PRADESH,KANPUR DEHAT,2021-03-17,3,1797,0,1800
UTTAR PRADESH,KANPUR DEHAT,2021-03-18,1,1433,0,1434
UTTAR PRADESH,KANPUR DEHAT,2021-03-19,3,772,0,775
UTTAR PRADESH,KANPUR DEHAT,2021-03-20,1,1080,0,1081
UTTAR PRADESH,KANPUR NAGAR,2021-03-16,20,3029,7,3056
UTTAR PRADESH,KANPUR NAGAR,2021-03-17,20,3442,2,3464
UTTAR PRADESH,KANPUR NAGAR,2021-03-18,16,4053,12,4081
UTTAR PRADESH,KANPUR NAGAR,2021-03-19,13,3729,4,3746
UTTAR PRADESH,KANPUR NAGAR,2021-03-20,14,2902,8,2924
UTTAR PRADESH,KASGANJ,2021-03-16,0,4408,6,4414
UTTAR PRADESH,KASGANJ,2021-03-17,0,757,14,771
UTTAR PRADESH,KASGANJ,2021-03-18,0,491,1,492
UTTAR PRADESH,KASGANJ,2021-03-19,0,770,8,778
UTTAR PRADESH,KASGANJ,2021-03-20,0,3325,7,3332
UTTAR PRADESH,KAUSHAMBI,2021-03-16,0,1128,0,1128
UTTAR PRADESH,KAUSHAMBI,2021-03-17,0,2093,0,2093
UTTAR PRADESH,KAUSHAMBI,2021-03-18,1,1025,0,1026
UTTAR PRADESH,KAUSHAMBI,2021-03-19,1,1341,0,1342
UTTAR PRADESH,KAUSHAMBI,2021-03-20,0,1237,0,1237
UTTAR PRADESH,KHERI,2021-03-16,0,957,2,959
UTTAR PRADESH,KHERI,2021-03-17,0,2205,0,2205
UTTAR PRADESH,KHERI,2021-03-18,1,1444,63,1508
UTTAR PRADESH,KHERI,2021-03-19,2,2261,0,2263
UTTAR PRADESH,KHERI,2021-03-20,0,848,0,848
UTTAR PRADESH,KUSHI NAGAR,2021-03-16,3,1105,20,1128
UTTAR PRADESH,KUSHI NAGAR,2021-03-17,4,986,57,1047
UTTAR PRADESH,KUSHI NAGAR,2021-03-18,4,1088,9,1101
UTTAR PRADESH,KUSHI NAGAR,2021-03-19,2,1212,6,1220
UTTAR PRADESH,KUSHI NAGAR,2021-03-20,0,1352,6,1358
UTTAR PRADESH,LALITPUR,2021-03-16,0,1411,3,1414
UTTAR PRADESH,LALITPUR,2021-03-17,5,1448,1,1454
UTTAR PRADESH,LALITPUR,2021-03-18,1,1831,0,1832
UTTAR PRADESH,LALITPUR,2021-03-19,4,1753,0,1757
UTTAR PRADESH,LALITPUR,2021-03-20,9,1814,0,1823
UTTAR PRADESH,LUCKNOW,2021-03-16,61,6489,61,6611
UTTAR PRADESH,LUCKNOW,2021-03-17,87,7034,129,7250
UTTAR PRADESH,LUCKNOW,2021-03-18,99,6832,103,7034
UTTAR PRADESH,LUCKNOW,2021-03-19,110,6606,121,6837
UTTAR PRADESH,LUCKNOW,2021-03-20,156,8237,31,8424
UTTAR PRADESH,MAHARAJGANJ,2021-03-16,0,1212,130,1342
UTTAR PRADESH,MAHARAJGANJ,2021-03-17,1,2153,157,2311
UTTAR PRADESH,MAHARAJGANJ,2021-03-18,2,1901,74,1977
UTTAR PRADESH,MAHARAJGANJ,2021-03-19,2,2909,120,3031
UTTAR PRADESH,MAHARAJGANJ,2021-03-20,1,2855,180,3036
UTTAR PRADESH,MAHOBA,2021-03-16,1,616,15,632
UTTAR PRADESH,MAHOBA,2021-03-17,0,486,27,513
UTTAR PRADESH,MAHOBA,2021-03-18,1,669,16,686
UTTAR PRADESH,MAHOBA,2021-03-19,1,658,0,659
UTTAR PRADESH,MAHOBA,2021-03-20,0,647,5,652
UTTAR PRADESH,MAINPURI,2021-03-16,1,1528,2,1531
UTTAR PRADESH,MAINPURI,2021-03-17,0,1612,0,1612
UTTAR PRADESH,MAINPURI,2021-03-18,1,1501,1,1503
UTTAR PRADESH,MAINPURI,2021-03-19,5,1699,1,1705
UTTAR PRADESH,MAINPURI,2021-03-20,1,1735,4,1740
UTTAR PRADESH,MATHURA,2021-03-16,1,1711,2,1714
UTTAR PRADESH,MATHURA,2021-03-17,5,1561,2,1568
UTTAR PRADESH,MATHURA,2021-03-18,4,1690,4,1698
UTTAR PRADESH,MATHURA,2021-03-19,7,1136,6,1149
UTTAR PRADESH,MATHURA,2021-03-20,9,1948,9,1966
UTTAR PRADESH,MAU,2021-03-16,2,826,9,837
UTTAR PRADESH,MAU,2021-03-17,2,974,0,976
UTTAR PRADESH,MAU,2021-03-18,0,669,4,673
UTTAR PRADESH,MAU,2021-03-19,3,1280,6,1289
UTTAR PRADESH,MAU,2021-03-20,2,832,13,847
UTTAR PRADESH,MEERUT,2021-03-16,10,3951,5,3966
UTTAR PRADESH,MEERUT,2021-03-17,6,3905,12,3923
UTTAR PRADESH,MEERUT,2021-03-18,25,3891,8,3924
UTTAR PRADESH,MEERUT,2021-03-19,12,3621,3,3636
UTTAR PRADESH,MEERUT,2021-03-20,14,3357,9,3380
UTTAR PRADESH,MIRZAPUR,2021-03-16,1,1170,0,1171
UTTAR PRADESH,MIRZAPUR,2021-03-17,1,1610,0,1611
UTTAR PRADESH,MIRZAPUR,2021-03-18,2,1544,0,1546
UTTAR PRADESH,MIRZAPUR,2021-03-19,2,1412,0,1414
UTTAR PRADESH,MIRZAPUR,2021-03-20,2,1579,0,1581
UTTAR PRADESH,MORADABAD,2021-03-16,9,1804,1,1814
UTTAR PRADESH,MORADABAD,2021-03-17,10,2635,15,2660
UTTAR PRADESH,MORADABAD,2021-03-18,2,1979,17,1998
UTTAR PRADESH,MORADABAD,2021-03-19,20,3842,20,3882
UTTAR PRADESH,MORADABAD,2021-03-20,5,1715,12,1732
UTTAR PRADESH,MUZAFFARNAGAR,2021-03-16,9,1722,0,1731
UTTAR PRADESH,MUZAFFARNAGAR,2021-03-17,8,2606,0,2614
UTTAR PRADESH,MUZAFFARNAGAR,2021-03-18,7,1909,1,1917
UTTAR PRADESH,MUZAFFARNAGAR,2021-03-19,12,2356,12,2380
UTTAR PRADESH,MUZAFFARNAGAR,2021-03-20,3,2184,8,2195
UTTAR PRADESH,PILIBHIT,2021-03-16,2,1191,0,1193
UTTAR PRADESH,PILIBHIT,2021-03-17,5,1203,2,1210
UTTAR PRADESH,PILIBHIT,2021-03-18,2,1416,0,1418
UTTAR PRADESH,PILIBHIT,2021-03-19,0,1579,168,1747
UTTAR PRADESH,PILIBHIT,2021-03-20,1,1056,0,1057
UTTAR PRADESH,PRATAPGARH,2021-03-16,2,1598,0,1600
UTTAR PRADESH,PRATAPGARH,2021-03-17,2,1353,79,1434
UTTAR PRADESH,PRATAPGARH,2021-03-18,2,1571,0,1573
UTTAR PRADESH,PRATAPGARH,2021-03-19,6,1409,36,1451
UTTAR PRADESH,PRATAPGARH,2021-03-20,10,1797,5,1812
UTTAR PRADESH,PRAYAGRAJ,2021-03-16,5,5183,1,5189
UTTAR PRADESH,PRAYAGRAJ,2021-03-17,9,3650,0,3659
UTTAR PRADESH,PRAYAGRAJ,2021-03-18,9,3649,1,3659
UTTAR PRADESH,PRAYAGRAJ,2021-03-19,13,2332,1,2346
UTTAR PRADESH,PRAYAGRAJ,2021-03-20,31,3364,1,3396
UTTAR PRADESH,RAE BARELI,2021-03-16,6,1839,22,1867
UTTAR PRADESH,RAE BARELI,2021-03-17,5,2222,5,2232
UTTAR PRADESH,RAE BARELI,2021-03-18,9,2005,1,2015
UTTAR PRADESH,RAE BARELI,2021-03-19,14,2259,4,2277
UTTAR PRADESH,RAE BARELI,2021-03-20,2,1849,0,1851
UTTAR PRADESH,RAMPUR,2021-03-16,2,1411,21,1434
UTTAR PRADESH,RAMPUR,2021-03-17,1,1506,34,1541
UTTAR PRADESH,RAMPUR,2021-03-18,0,796,1,797
UTTAR PRADESH,RAMPUR,2021-03-19,0,2063,36,2099
UTTAR PRADESH,RAMPUR,2021-03-20,5,1238,48,1291
UTTAR PRADESH,SAHARANPUR,2021-03-16,6,1850,46,1902
UTTAR PRADESH,SAHARANPUR,2021-03-17,5,1997,0,2002
UTTAR PRADESH,SAHARANPUR,2021-03-18,18,2030,2,2050
UTTAR PRADESH,SAHARANPUR,2021-03-19,14,5702,177,5893
UTTAR PRADESH,SAHARANPUR,2021-03-20,19,3297,55,3371
UTTAR PRADESH,SAMBHAL,2021-03-16,0,1503,61,1564
UTTAR PRADESH,SAMBHAL,2021-03-17,0,1158,42,1200
UTTAR PRADESH,SAMBHAL,2021-03-18,1,496,0,497
UTTAR PRADESH,SAMBHAL,2021-03-19,2,1518,21,1541
UTTAR PRADESH,SAMBHAL,2021-03-20,1,1256,131,1388
UTTAR PRADESH,SANT KABEER NAGAR,2021-03-16,4,959,0,963
UTTAR PRADESH,SANT KABEER NAGAR,2021-03-17,1,1184,0,1185
UTTAR PRADESH,SANT KABEER NAGAR,2021-03-18,5,1173,2,1180
UTTAR PRADESH,SANT KABEER NAGAR,2021-03-19,14,914,1,929
UTTAR PRADESH,SANT KABEER NAGAR,2021-03-20,5,1700,0,1705
UTTAR PRADESH,SHAHJAHANPUR,2021-03-16,1,1680,0,1681
UTTAR PRADESH,SHAHJAHANPUR,2021-03-17,0,2786,11,2797
UTTAR PRADESH,SHAHJAHANPUR,2021-03-18,4,1586,25,1615
UTTAR PRADESH,SHAHJAHANPUR,2021-03-19,2,1617,215,1834
UTTAR PRADESH,SHAHJAHANPUR,2021-03-20,3,1238,7,1248
UTTAR PRADESH,SHAMLI,2021-03-16,0,935,0,935
UTTAR PRADESH,SHAMLI,2021-03-17,1,1982,0,1983
UTTAR PRADESH,SHAMLI,2021-03-18,1,1526,1,1528
UTTAR PRADESH,SHAMLI,2021-03-19,2,1645,3,1650
UTTAR PRADESH,SHAMLI,2021-03-20,2,1563,0,1565
UTTAR PRADESH,SHRAVASTI,2021-03-16,3,895,0,898
UTTAR PRADESH,SHRAVASTI,2021-03-17,1,1044,0,1045
UTTAR PRADESH,SHRAVASTI,2021-03-18,0,919,0,919
UTTAR PRADESH,SHRAVASTI,2021-03-19,2,912,0,914
UTTAR PRADESH,SHRAVASTI,2021-03-20,3,858,0,861
UTTAR PRADESH,SIDDHARTH NAGAR,2021-03-16,5,666,162,833
UTTAR PRADESH,SIDDHARTH NAGAR,2021-03-17,0,1032,1,1033
UTTAR PRADESH,SIDDHARTH NAGAR,2021-03-18,1,795,1,797
UTTAR PRADESH,SIDDHARTH NAGAR,2021-03-19,2,995,3,1000
UTTAR PRADESH,SIDDHARTH NAGAR,2021-03-20,3,957,0,960
UTTAR PRADESH,SITAPUR,2021-03-16,0,1342,3,1345
UTTAR PRADESH,SITAPUR,2021-03-17,0,1555,3,1558
UTTAR PRADESH,SITAPUR,2021-03-18,4,708,9,721
UTTAR PRADESH,SITAPUR,2021-03-19,1,1923,46,1970
UTTAR PRADESH,SITAPUR,2021-03-20,2,1406,16,1424
UTTAR PRADESH,SONBHADRA,2021-03-16,1,1210,0,1211
UTTAR PRADESH,SONBHADRA,2021-03-17,5,1139,15,1159
UTTAR PRADESH,SONBHADRA,2021-03-18,1,1607,40,1648
UTTAR PRADESH,SONBHADRA,2021-03-19,0,1569,2,1571
UTTAR PRADESH,SONBHADRA,2021-03-20,10,847,0,857
UTTAR PRADESH,SULTANPUR,2021-03-16,7,760,0,767
UTTAR PRADESH,SULTANPUR,2021-03-17,1,1252,1,1254
UTTAR PRADESH,SULTANPUR,2021-03-18,8,1754,3,1765
UTTAR PRADESH,SULTANPUR,2021-03-19,4,693,202,899
UTTAR PRADESH,SULTANPUR,2021-03-20,2,2213,48,2263
UTTAR PRADESH,UNNAO,2021-03-16,0,1994,14,2008
UTTAR PRADESH,UNNAO,2021-03-17,1,1875,6,1882
UTTAR PRADESH,UNNAO,2021-03-18,4,2093,66,2163
UTTAR PRADESH,UNNAO,2021-03-19,1,1695,18,1714
UTTAR PRADESH,UNNAO,2021-03-20,7,1974,43,2024
UTTAR PRADESH,VARANASI,2021-03-16,5,4458,3,4466
UTTAR PRADESH,VARANASI,2021-03-17,38,4174,4,4216
UTTAR PRADESH,VARANASI,2021-03-18,28,4582,0,4610
UTTAR PRADESH,VARANASI,2021-03-19,39,3814,5,3858
UTTAR PRADESH,VARANASI,2021-03-20,32,4113,1,4146
UTTARAKHAND,ALMORA,2021-03-16,2,168,0,170
UTTARAKHAND,ALMORA,2021-03-17,4,178,0,182
UTTARAKHAND,ALMORA,2021-03-18,2,192,2,196
UTTARAKHAND,ALMORA,2021-03-19,6,73,0,79
UTTARAKHAND,ALMORA,2021-03-20,2,51,0,53
UTTARAKHAND,BAGESHWAR,2021-03-16,1,250,0,251
UTTARAKHAND,BAGESHWAR,2021-03-17,0,341,12,353
UTTARAKHAND,BAGESHWAR,2021-03-18,1,214,0,215
UTTARAKHAND,BAGESHWAR,2021-03-19,0,229,4,233
UTTARAKHAND,BAGESHWAR,2021-03-20,0,285,0,285
UTTARAKHAND,CHAMOLI,2021-03-16,0,123,3,126
UTTARAKHAND,CHAMOLI,2021-03-17,0,53,0,53
UTTARAKHAND,CHAMOLI,2021-03-18,0,23,0,23
UTTARAKHAND,CHAMOLI,2021-03-19,0,118,0,118
UTTARAKHAND,CHAMOLI,2021-03-20,4,129,0,133
UTTARAKHAND,CHAMPAWAT,2021-03-16,0,20,0,20
UTTARAKHAND,CHAMPAWAT,2021-03-17,0,65,0,65
UTTARAKHAND,CHAMPAWAT,2021-03-18,0,19,0,19
UTTARAKHAND,CHAMPAWAT,2021-03-19,0,8,0,8
UTTARAKHAND,CHAMPAWAT,2021-03-20,1,83,0,84
UTTARAKHAND,DEHRADUN,2021-03-16,35,1915,8,1958
UTTARAKHAND,DEHRADUN,2021-03-17,39,1322,4,1365
UTTARAKHAND,DEHRADUN,2021-03-18,26,1346,0,1372
UTTARAKHAND,DEHRADUN,2021-03-19,25,1809,13,1847
UTTARAKHAND,DEHRADUN,2021-03-20,47,1395,6,1448
UTTARAKHAND,HARIDWAR,2021-03-16,41,4206,10,4257
UTTARAKHAND,HARIDWAR,2021-03-17,17,4321,1,4339
UTTARAKHAND,HARIDWAR,2021-03-18,21,4340,1,4362
UTTARAKHAND,HARIDWAR,2021-03-19,33,6024,0,6057
UTTARAKHAND,HARIDWAR,2021-03-20,22,6286,5,6313
UTTARAKHAND,NAINITAL,2021-03-16,11,813,2,826
UTTARAKHAND,NAINITAL,2021-03-17,8,681,3,692
UTTARAKHAND,NAINITAL,2021-03-18,9,867,4,880
UTTARAKHAND,NAINITAL,2021-03-19,25,631,5,661
UTTARAKHAND,NAINITAL,2021-03-20,8,653,0,661
UTTARAKHAND,PAURI GARHWAL,2021-03-16,2,1128,7,1137
UTTARAKHAND,PAURI GARHWAL,2021-03-17,2,1332,3,1337
UTTARAKHAND,PAURI GARHWAL,2021-03-18,4,584,0,588
UTTARAKHAND,PAURI GARHWAL,2021-03-19,2,890,4,896
UTTARAKHAND,PAURI GARHWAL,2021-03-20,1,602,2,605
UTTARAKHAND,PITHORAGARH,2021-03-16,2,32,0,34
UTTARAKHAND,PITHORAGARH,2021-03-17,0,404,0,404
UTTARAKHAND,PITHORAGARH,2021-03-18,0,65,0,65
UTTARAKHAND,PITHORAGARH,2021-03-19,0,22,0,22
UTTARAKHAND,PITHORAGARH,2021-03-20,0,454,0,454
UTTARAKHAND,RUDRA PRAYAG,2021-03-16,0,83,3,86
UTTARAKHAND,RUDRA PRAYAG,2021-03-17,0,116,2,118
UTTARAKHAND,RUDRA PRAYAG,2021-03-18,0,22,0,22
UTTARAKHAND,RUDRA PRAYAG,2021-03-19,5,108,6,119
UTTARAKHAND,RUDRA PRAYAG,2021-03-20,0,163,4,167
UTTARAKHAND,TEHRI GARHWAL,2021-03-16,2,110,0,112
UTTARAKHAND,TEHRI GARHWAL,2021-03-17,0,349,2,351
UTTARAKHAND,TEHRI GARHWAL,2021-03-18,3,111,0,114
UTTARAKHAND,TEHRI GARHWAL,2021-03-19,3,129,0,132
UTTARAKHAND,TEHRI GARHWAL,2021-03-20,1,190,0,191
UTTARAKHAND,UDAM SINGH NAGAR,2021-03-16,15,1159,290,1464
UTTARAKHAND,UDAM SINGH NAGAR,2021-03-17,17,1180,20,1217
UTTARAKHAND,UDAM SINGH NAGAR,2021-03-18,10,1263,129,1402
UTTARAKHAND,UDAM SINGH NAGAR,2021-03-19,11,1125,187,1323
UTTARAKHAND,UDAM SINGH NAGAR,2021-03-20,5,885,55,945
UTTARAKHAND,UTTAR KASHI,2021-03-16,0,184,3,187
UTTARAKHAND,UTTAR KASHI,2021-03-17,1,146,13,160
UTTARAKHAND,UTTAR KASHI,2021-03-18,0,217,16,233
UTTARAKHAND,UTTAR KASHI,2021-03-19,3,248,16,267
UTTARAKHAND,UTTAR KASHI,2021-03-20,1,320,5,326
WEST BENGAL,24 PARAGANAS NORTH,2021-03-16,94,3077,25,3196
WEST BENGAL,24 PARAGANAS NORTH,2021-03-17,51,2688,7,2746
WEST BENGAL,24 PARAGANAS NORTH,2021-03-18,71,3277,7,3355
WEST BENGAL,24 PARAGANAS NORTH,2021-03-19,117,3651,20,3788
WEST BENGAL,24 PARAGANAS NORTH,2021-03-20,107,3263,17,3387
WEST BENGAL,24 PARAGANAS SOUTH,2021-03-16,14,2406,5,2425
WEST BENGAL,24 PARAGANAS SOUTH,2021-03-17,17,2733,7,2757
WEST BENGAL,24 PARAGANAS SOUTH,2021-03-18,18,2572,26,2616
WEST BENGAL,24 PARAGANAS SOUTH,2021-03-19,14,2600,6,2620
WEST BENGAL,24 PARAGANAS SOUTH,2021-03-20,34,2500,12,2546
WEST BENGAL,ALIPURDUAR,2021-03-16,0,54,0,54
WEST BENGAL,ALIPURDUAR,2021-03-17,0,214,0,214
WEST BENGAL,ALIPURDUAR,2021-03-18,7,341,0,348
WEST BENGAL,ALIPURDUAR,2021-03-19,1,658,1,660
WEST BENGAL,ALIPURDUAR,2021-03-20,1,580,0,581
WEST BENGAL,BANKURA,2021-03-16,5,321,0,326
WEST BENGAL,BANKURA,2021-03-17,5,296,0,301
WEST BENGAL,BANKURA,2021-03-18,4,348,0,352
WEST BENGAL,BANKURA,2021-03-19,6,482,0,488
WEST BENGAL,BANKURA,2021-03-20,13,377,2,392
WEST BENGAL,BIRBHUM,2021-03-16,8,549,2,559
WEST BENGAL,BIRBHUM,2021-03-17,4,625,0,629
WEST BENGAL,BIRBHUM,2021-03-18,11,561,4,576
WEST BENGAL,BIRBHUM,2021-03-19,14,606,3,623
WEST BENGAL,BIRBHUM,2021-03-20,12,432,1,445
WEST BENGAL,COOCHBEHAR,2021-03-16,3,830,1,834
WEST BENGAL,COOCHBEHAR,2021-03-17,1,1241,0,1242
WEST BENGAL,COOCHBEHAR,2021-03-18,0,1247,0,1247
WEST BENGAL,COOCHBEHAR,2021-03-19,1,1913,0,1914
WEST BENGAL,COOCHBEHAR,2021-03-20,1,1225,9,1235
WEST BENGAL,DARJEELING,2021-03-16,6,157,1,164
WEST BENGAL,DARJEELING,2021-03-17,10,471,0,481
WEST BENGAL,DARJEELING,2021-03-18,4,219,0,223
WEST BENGAL,DARJEELING,2021-03-19,4,938,0,942
WEST BENGAL,DARJEELING,2021-03-20,12,438,4,454
WEST BENGAL,DINAJPUR DAKSHIN,2021-03-16,0,653,9,662
WEST BENGAL,DINAJPUR DAKSHIN,2021-03-17,1,626,55,682
WEST BENGAL,DINAJPUR DAKSHIN,2021-03-18,1,676,0,677
WEST BENGAL,DINAJPUR DAKSHIN,2021-03-19,2,574,2,578
WEST BENGAL,DINAJPUR DAKSHIN,2021-03-20,1,646,3,650
WEST BENGAL,DINAJPUR UTTAR,2021-03-16,7,213,0,220
WEST BENGAL,DINAJPUR UTTAR,2021-03-17,10,244,1,255
WEST BENGAL,DINAJPUR UTTAR,2021-03-18,1,235,0,236
WEST BENGAL,DINAJPUR UTTAR,2021-03-19,4,173,0,177
WEST BENGAL,DINAJPUR UTTAR,2021-03-20,4,318,0,322
WEST BENGAL,HOOGHLY,2021-03-16,8,457,3,468
WEST BENGAL,HOOGHLY,2021-03-17,11,544,0,555
WEST BENGAL,HOOGHLY,2021-03-18,14,672,5,691
WEST BENGAL,HOOGHLY,2021-03-19,12,591,0,603
WEST BENGAL,HOOGHLY,2021-03-20,18,637,5,660
WEST BENGAL,HOWRAH,2021-03-16,32,791,27,850
WEST BENGAL,HOWRAH,2021-03-17,21,771,21,813
WEST BENGAL,HOWRAH,2021-03-18,25,829,26,880
WEST BENGAL,HOWRAH,2021-03-19,33,1042,20,1095
WEST BENGAL,HOWRAH,2021-03-20,22,802,24,848
WEST BENGAL,JALPAIGURI,2021-03-16,2,80,0,82
WEST BENGAL,JALPAIGURI,2021-03-17,2,356,1,359
WEST BENGAL,JALPAIGURI,2021-03-18,2,445,0,447
WEST BENGAL,JALPAIGURI,2021-03-19,1,828,0,829
WEST BENGAL,JALPAIGURI,2021-03-20,5,395,0,400
WEST BENGAL,JHARGRAM,2021-03-16,1,119,0,120
WEST BENGAL,JHARGRAM,2021-03-17,0,25,0,25
WEST BENGAL,JHARGRAM,2021-03-18,0,22,0,22
WEST BENGAL,JHARGRAM,2021-03-19,0,51,1,52
WEST BENGAL,JHARGRAM,2021-03-20,0,31,0,31
WEST BENGAL,KALIMPONG,2021-03-16,0,56,1,57
WEST BENGAL,KALIMPONG,2021-03-17,0,57,0,57
WEST BENGAL,KALIMPONG,2021-03-18,0,187,0,187
WEST BENGAL,KALIMPONG,2021-03-19,1,107,0,108
WEST BENGAL,KALIMPONG,2021-03-20,0,79,0,79
WEST BENGAL,KOLKATA,2021-03-16,212,3436,9,3657
WEST BENGAL,KOLKATA,2021-03-17,142,3292,9,3443
WEST BENGAL,KOLKATA,2021-03-18,192,3672,7,3871
WEST BENGAL,KOLKATA,2021-03-19,231,3281,7,3519
WEST BENGAL,KOLKATA,2021-03-20,243,3688,36,3967
WEST BENGAL,MALDAH,2021-03-16,3,423,2,428
WEST BENGAL,MALDAH,2021-03-17,6,433,19,458
WEST BENGAL,MALDAH,2021-03-18,4,464,10,478
WEST BENGAL,MALDAH,2021-03-19,7,502,9,518
WEST BENGAL,MALDAH,2021-03-20,3,320,7,330
WEST BENGAL,MEDINIPUR EAST,2021-03-16,2,560,7,569
WEST BENGAL,MEDINIPUR EAST,2021-03-17,4,789,2,795
WEST BENGAL,MEDINIPUR EAST,2021-03-18,4,672,1,677
WEST BENGAL,MEDINIPUR EAST,2021-03-19,3,846,1,850
WEST BENGAL,MEDINIPUR EAST,2021-03-20,3,675,0,678
WEST BENGAL,MEDINIPUR WEST,2021-03-16,4,402,1,407
WEST BENGAL,MEDINIPUR WEST,2021-03-17,4,310,5,319
WEST BENGAL,MEDINIPUR WEST,2021-03-18,10,498,4,512
WEST BENGAL,MEDINIPUR WEST,2021-03-19,4,515,6,525
WEST BENGAL,MEDINIPUR WEST,2021-03-20,3,167,1,171
WEST BENGAL,MURSHIDABAD,2021-03-16,1,848,0,849
WEST BENGAL,MURSHIDABAD,2021-03-17,3,818,3,824
WEST BENGAL,MURSHIDABAD,2021-03-18,2,768,1,771
WEST BENGAL,MURSHIDABAD,2021-03-19,4,743,2,749
WEST BENGAL,MURSHIDABAD,2021-03-20,7,874,4,885
WEST BENGAL,NADIA,2021-03-16,7,540,5,552
WEST BENGAL,NADIA,2021-03-17,4,766,13,783
WEST BENGAL,NADIA,2021-03-18,12,573,3,588
WEST BENGAL,NADIA,2021-03-19,7,655,14,676
WEST BENGAL,NADIA,2021-03-20,8,598,9,615
WEST BENGAL,PASCHIM BARDHAMAN,2021-03-16,16,407,2,425
WEST BENGAL,PASCHIM BARDHAMAN,2021-03-17,26,624,4,654
WEST BENGAL,PASCHIM BARDHAMAN,2021-03-18,7,499,3,509
WEST BENGAL,PASCHIM BARDHAMAN,2021-03-19,16,521,0,537
WEST BENGAL,PASCHIM BARDHAMAN,2021-03-20,18,628,3,649
WEST BENGAL,PURBA BARDHAMAN,2021-03-16,0,655,0,655
WEST BENGAL,PURBA BARDHAMAN,2021-03-17,4,635,2,641
WEST BENGAL,PURBA BARDHAMAN,2021-03-18,4,635,0,639
WEST BENGAL,PURBA BARDHAMAN,2021-03-19,10,514,0,524
WEST BENGAL,PURBA BARDHAMAN,2021-03-20,2,725,0,727
WEST BENGAL,PURULIA,2021-03-16,3,319,0,322
WEST BENGAL,PURULIA,2021-03-17,4,467,1,472
WEST BENGAL,PURULIA,2021-03-18,3,514,0,517
WEST BENGAL,PURULIA,2021-03-19,1,404,0,405
WEST BENGAL,PURULIA,2021-03-20,53,559,0,612
ANDAMAN AND NICOBAR ISLANDS,NICOBARS,2021-03-21,0,9,0,9
ANDAMAN AND NICOBAR ISLANDS,NICOBARS,2021-03-22,0,10,0,10
ANDAMAN AND NICOBAR ISLANDS,NICOBARS,2021-03-23,0,7,0,7
ANDAMAN AND NICOBAR ISLANDS,NICOBARS,2021-03-24,0,14,0,14
ANDAMAN AND NICOBAR ISLANDS,NICOBARS,2021-03-25,0,18,0,18
ANDAMAN AND NICOBAR ISLANDS,NORTH AND MIDDLE ANDAMAN,2021-03-21,0,3,0,3
ANDAMAN AND NICOBAR ISLANDS,NORTH AND MIDDLE ANDAMAN,2021-03-22,0,12,0,12
ANDAMAN AND NICOBAR ISLANDS,NORTH AND MIDDLE ANDAMAN,2021-03-23,0,11,0,11
ANDAMAN AND NICOBAR ISLANDS,NORTH AND MIDDLE ANDAMAN,2021-03-24,0,9,0,9
ANDAMAN AND NICOBAR ISLANDS,NORTH AND MIDDLE ANDAMAN,2021-03-25,0,17,0,17
ANDAMAN AND NICOBAR ISLANDS,SOUTH ANDAMANS,2021-03-21,0,78,0,78
ANDAMAN AND NICOBAR ISLANDS,SOUTH ANDAMANS,2021-03-22,1,176,1,178
ANDAMAN AND NICOBAR ISLANDS,SOUTH ANDAMANS,2021-03-23,1,411,0,412
ANDAMAN AND NICOBAR ISLANDS,SOUTH ANDAMANS,2021-03-24,2,309,0,311
ANDAMAN AND NICOBAR ISLANDS,SOUTH ANDAMANS,2021-03-25,5,269,0,274
ANDHRA PRADESH,ANANTAPUR,2021-03-21,75,7888,1,7964
ANDHRA PRADESH,ANANTAPUR,2021-03-22,54,5182,0,5236
ANDHRA PRADESH,ANANTAPUR,2021-03-23,30,2616,2,2648
ANDHRA PRADESH,ANANTAPUR,2021-03-24,90,6355,1,6446
ANDHRA PRADESH,ANANTAPUR,2021-03-25,49,11071,0,11120
ANDHRA PRADESH,CHITTOOR,2021-03-21,47,8741,0,8788
ANDHRA PRADESH,CHITTOOR,2021-03-22,104,4107,2,4213
ANDHRA PRADESH,CHITTOOR,2021-03-23,208,2586,1,2795
ANDHRA PRADESH,CHITTOOR,2021-03-24,201,5422,0,5623
ANDHRA PRADESH,CHITTOOR,2021-03-25,190,4490,0,4680
ANDHRA PRADESH,EAST GODAVARI,2021-03-21,75,11021,0,11096
ANDHRA PRADESH,EAST GODAVARI,2021-03-22,214,7794,0,8008
ANDHRA PRADESH,EAST GODAVARI,2021-03-23,140,3751,0,3891
ANDHRA PRADESH,EAST GODAVARI,2021-03-24,145,7844,0,7989
ANDHRA PRADESH,EAST GODAVARI,2021-03-25,125,5705,0,5830
ANDHRA PRADESH,GUNTUR,2021-03-21,60,4884,0,4944
ANDHRA PRADESH,GUNTUR,2021-03-22,84,3338,0,3422
ANDHRA PRADESH,GUNTUR,2021-03-23,149,1939,0,2088
ANDHRA PRADESH,GUNTUR,2021-03-24,137,4324,0,4461
ANDHRA PRADESH,GUNTUR,2021-03-25,149,6659,0,6808
ANDHRA PRADESH,KRISHNA,2021-03-21,82,7424,0,7506
ANDHRA PRADESH,KRISHNA,2021-03-22,66,2440,0,2506
ANDHRA PRADESH,KRISHNA,2021-03-23,132,1080,0,1212
ANDHRA PRADESH,KRISHNA,2021-03-24,109,6540,0,6649
ANDHRA PRADESH,KRISHNA,2021-03-25,145,3942,0,4087
ANDHRA PRADESH,KURNOOL,2021-03-21,11,2957,0,2968
ANDHRA PRADESH,KURNOOL,2021-03-22,46,3722,0,3768
ANDHRA PRADESH,KURNOOL,2021-03-23,50,4722,0,4772
ANDHRA PRADESH,KURNOOL,2021-03-24,51,7487,0,7538
ANDHRA PRADESH,KURNOOL,2021-03-25,73,5128,0,5201
ANDHRA PRADESH,PRAKASAM,2021-03-21,11,6973,0,6984
ANDHRA PRADESH,PRAKASAM,2021-03-22,21,3035,0,3056
ANDHRA PRADESH,PRAKASAM,2021-03-23,16,3423,0,3439
ANDHRA PRADESH,PRAKASAM,2021-03-24,19,5736,1,5756
ANDHRA PRADESH,PRAKASAM,2021-03-25,47,9494,0,9541
ANDHRA PRADESH,SPSR NELLORE,2021-03-21,19,5890,0,5909
ANDHRA PRADESH,SPSR NELLORE,2021-03-22,42,5338,0,5380
ANDHRA PRADESH,SPSR NELLORE,2021-03-23,45,3524,1,3570
ANDHRA PRADESH,SPSR NELLORE,2021-03-24,43,5044,0,5087
ANDHRA PRADESH,SPSR NELLORE,2021-03-25,81,5420,1,5502
ANDHRA PRADESH,SRIKAKULAM,2021-03-21,18,4543,0,4561
ANDHRA PRADESH,SRIKAKULAM,2021-03-22,16,3176,0,3192
ANDHRA PRADESH,SRIKAKULAM,2021-03-23,19,2677,0,2696
ANDHRA PRADESH,SRIKAKULAM,2021-03-24,32,3584,0,3616
ANDHRA PRADESH,SRIKAKULAM,2021-03-25,53,4663,0,4716
ANDHRA PRADESH,VISAKHAPATANAM,2021-03-21,43,14449,0,14492
ANDHRA PRADESH,VISAKHAPATANAM,2021-03-22,70,4010,0,4080
ANDHRA PRADESH,VISAKHAPATANAM,2021-03-23,156,4385,0,4541
ANDHRA PRADESH,VISAKHAPATANAM,2021-03-24,104,8731,1,8836
ANDHRA PRADESH,VISAKHAPATANAM,2021-03-25,167,7559,1,7727
ANDHRA PRADESH,VIZIANAGARAM,2021-03-21,4,1880,0,1884
ANDHRA PRADESH,VIZIANAGARAM,2021-03-22,3,2777,0,2780
ANDHRA PRADESH,VIZIANAGARAM,2021-03-23,30,1121,0,1151
ANDHRA PRADESH,VIZIANAGARAM,2021-03-24,15,3319,0,3334
ANDHRA PRADESH,VIZIANAGARAM,2021-03-25,2,4177,0,4179
ANDHRA PRADESH,WEST GODAVARI,2021-03-21,14,2195,0,2209
ANDHRA PRADESH,WEST GODAVARI,2021-03-22,25,3475,0,3500
ANDHRA PRADESH,WEST GODAVARI,2021-03-23,51,2134,0,2185
ANDHRA PRADESH,WEST GODAVARI,2021-03-24,23,6902,0,6925
ANDHRA PRADESH,WEST GODAVARI,2021-03-25,29,9634,0,9663
ANDHRA PRADESH,Y.S.R.,2021-03-21,25,8196,0,8221
ANDHRA PRADESH,Y.S.R.,2021-03-22,10,2345,0,2355
ANDHRA PRADESH,Y.S.R.,2021-03-23,18,3063,0,3081
ANDHRA PRADESH,Y.S.R.,2021-03-24,34,3955,0,3989
ANDHRA PRADESH,Y.S.R.,2021-03-25,26,7132,0,7158
ARUNACHAL PRADESH,ANJAW,2021-03-22,0,2,0,2
ARUNACHAL PRADESH,ANJAW,2021-03-23,0,12,0,12
ARUNACHAL PRADESH,ANJAW,2021-03-24,0,20,0,20
ARUNACHAL PRADESH,ANJAW,2021-03-25,0,5,0,5
ARUNACHAL PRADESH,CHANGLANG,2021-03-21,0,4,0,4
ARUNACHAL PRADESH,CHANGLANG,2021-03-22,0,2,0,2
ARUNACHAL PRADESH,CHANGLANG,2021-03-23,0,3,0,3
ARUNACHAL PRADESH,CHANGLANG,2021-03-24,0,1,0,1
ARUNACHAL PRADESH,CHANGLANG,2021-03-25,0,1,0,1
ARUNACHAL PRADESH,DIBANG VALLEY,2021-03-21,0,1,0,1
ARUNACHAL PRADESH,DIBANG VALLEY,2021-03-25,0,1,0,1
ARUNACHAL PRADESH,EAST KAMENG,2021-03-21,0,1,0,1
ARUNACHAL PRADESH,EAST KAMENG,2021-03-24,0,2,0,2
ARUNACHAL PRADESH,EAST KAMENG,2021-03-25,0,2,0,2
ARUNACHAL PRADESH,EAST SIANG,2021-03-22,0,17,0,17
ARUNACHAL PRADESH,EAST SIANG,2021-03-23,0,14,0,14
ARUNACHAL PRADESH,EAST SIANG,2021-03-24,0,23,0,23
ARUNACHAL PRADESH,EAST SIANG,2021-03-25,0,17,0,17
ARUNACHAL PRADESH,KURUNG KUMEY,2021-03-25,0,1,0,1
ARUNACHAL PRADESH,LEPARADA,2021-03-25,0,2,0,2
ARUNACHAL PRADESH,LOHIT,2021-03-21,0,3,0,3
ARUNACHAL PRADESH,LOHIT,2021-03-23,0,1,0,1
ARUNACHAL PRADESH,LOHIT,2021-03-24,0,1,0,1
ARUNACHAL PRADESH,LOHIT,2021-03-25,0,6,0,6
ARUNACHAL PRADESH,LONGDING,2021-03-25,0,4,0,4
ARUNACHAL PRADESH,LOWER DIBANG VALLEY,2021-03-22,0,1,0,1
ARUNACHAL PRADESH,LOWER DIBANG VALLEY,2021-03-23,0,1,0,1
ARUNACHAL PRADESH,LOWER SIANG,2021-03-21,0,6,4,10
ARUNACHAL PRADESH,LOWER SIANG,2021-03-22,0,12,2,14
ARUNACHAL PRADESH,LOWER SIANG,2021-03-23,0,7,0,7
ARUNACHAL PRADESH,LOWER SIANG,2021-03-24,1,13,1,15
ARUNACHAL PRADESH,LOWER SIANG,2021-03-25,0,12,0,12
ARUNACHAL PRADESH,LOWER SUBANSIRI,2021-03-22,0,1,0,1
ARUNACHAL PRADESH,LOWER SUBANSIRI,2021-03-23,0,13,0,13
ARUNACHAL PRADESH,LOWER SUBANSIRI,2021-03-24,0,2,0,2
ARUNACHAL PRADESH,LOWER SUBANSIRI,2021-03-25,0,10,0,10
ARUNACHAL PRADESH,NAMSAI,2021-03-21,0,1,0,1
ARUNACHAL PRADESH,NAMSAI,2021-03-22,0,2,0,2
ARUNACHAL PRADESH,NAMSAI,2021-03-24,0,1,0,1
ARUNACHAL PRADESH,PAPUM PARE,2021-03-21,0,2,0,2
ARUNACHAL PRADESH,PAPUM PARE,2021-03-22,0,4,0,4
ARUNACHAL PRADESH,PAPUM PARE,2021-03-23,0,19,0,19
ARUNACHAL PRADESH,PAPUM PARE,2021-03-24,0,1,0,1
ARUNACHAL PRADESH,PAPUM PARE,2021-03-25,0,33,0,33
ARUNACHAL PRADESH,SHI YOMI,2021-03-21,0,1,0,1
ARUNACHAL PRADESH,SHI YOMI,2021-03-22,0,1,0,1
ARUNACHAL PRADESH,SIANG,2021-03-21,0,1,0,1
ARUNACHAL PRADESH,SIANG,2021-03-23,0,1,0,1
ARUNACHAL PRADESH,SIANG,2021-03-24,0,1,0,1
ARUNACHAL PRADESH,TAWANG,2021-03-21,0,1,0,1
ARUNACHAL PRADESH,TAWANG,2021-03-23,0,4,0,4
ARUNACHAL PRADESH,TAWANG,2021-03-25,0,4,0,4
ARUNACHAL PRADESH,TIRAP,2021-03-23,0,3,0,3
ARUNACHAL PRADESH,TIRAP,2021-03-24,0,2,0,2
ARUNACHAL PRADESH,WEST KAMENG,2021-03-21,0,26,0,26
ARUNACHAL PRADESH,WEST KAMENG,2021-03-22,0,6,0,6
ARUNACHAL PRADESH,WEST KAMENG,2021-03-23,0,26,0,26
ARUNACHAL PRADESH,WEST KAMENG,2021-03-24,0,96,0,96
ARUNACHAL PRADESH,WEST KAMENG,2021-03-25,0,40,0,40
ARUNACHAL PRADESH,WEST SIANG,2021-03-22,0,6,0,6
ARUNACHAL PRADESH,WEST SIANG,2021-03-25,0,1,0,1
ASSAM,BAKSA,2021-03-21,0,7,0,7
ASSAM,BAKSA,2021-03-22,0,29,0,29
ASSAM,BAKSA,2021-03-23,0,86,0,86
ASSAM,BAKSA,2021-03-24,0,59,0,59
ASSAM,BAKSA,2021-03-25,0,46,0,46
ASSAM,BARPETA,2021-03-21,0,15,0,15
ASSAM,BARPETA,2021-03-22,0,330,0,330
ASSAM,BARPETA,2021-03-23,1,238,0,239
ASSAM,BARPETA,2021-03-24,0,267,0,267
ASSAM,BARPETA,2021-03-25,0,243,1,244
ASSAM,BISWANATH,2021-03-21,0,4,0,4
ASSAM,BISWANATH,2021-03-22,0,39,0,39
ASSAM,BISWANATH,2021-03-23,0,97,0,97
ASSAM,BISWANATH,2021-03-24,0,169,0,169
ASSAM,BISWANATH,2021-03-25,0,86,0,86
ASSAM,BONGAIGAON,2021-03-21,0,8,0,8
ASSAM,BONGAIGAON,2021-03-22,0,220,0,220
ASSAM,BONGAIGAON,2021-03-23,0,112,0,112
ASSAM,BONGAIGAON,2021-03-24,0,80,0,80
ASSAM,BONGAIGAON,2021-03-25,0,64,0,64
ASSAM,CACHAR,2021-03-21,1,71,0,72
ASSAM,CACHAR,2021-03-22,0,221,19,240
ASSAM,CACHAR,2021-03-23,1,178,53,232
ASSAM,CACHAR,2021-03-24,1,171,43,215
ASSAM,CACHAR,2021-03-25,0,86,46,132
ASSAM,CHARAIDEO,2021-03-21,0,8,0,8
ASSAM,CHARAIDEO,2021-03-22,1,97,0,98
ASSAM,CHARAIDEO,2021-03-23,0,181,0,181
ASSAM,CHARAIDEO,2021-03-24,0,133,0,133
ASSAM,CHARAIDEO,2021-03-25,0,99,0,99
ASSAM,CHIRANG,2021-03-21,0,1,0,1
ASSAM,CHIRANG,2021-03-22,0,102,0,102
ASSAM,CHIRANG,2021-03-23,0,125,0,125
ASSAM,CHIRANG,2021-03-24,0,10,0,10
ASSAM,CHIRANG,2021-03-25,0,109,0,109
ASSAM,DARRANG,2021-03-21,1,107,0,108
ASSAM,DARRANG,2021-03-22,0,502,0,502
ASSAM,DARRANG,2021-03-23,0,490,0,490
ASSAM,DARRANG,2021-03-24,0,403,0,403
ASSAM,DARRANG,2021-03-25,0,375,0,375
ASSAM,DHEMAJI,2021-03-21,0,12,0,12
ASSAM,DHEMAJI,2021-03-22,0,31,0,31
ASSAM,DHEMAJI,2021-03-23,1,25,0,26
ASSAM,DHEMAJI,2021-03-24,0,35,0,35
ASSAM,DHEMAJI,2021-03-25,0,324,0,324
ASSAM,DHUBRI,2021-03-21,0,20,0,20
ASSAM,DHUBRI,2021-03-22,0,251,1,252
ASSAM,DHUBRI,2021-03-23,1,169,0,170
ASSAM,DHUBRI,2021-03-24,0,183,0,183
ASSAM,DHUBRI,2021-03-25,0,90,0,90
ASSAM,DIBRUGARH,2021-03-21,1,149,0,150
ASSAM,DIBRUGARH,2021-03-22,3,238,0,241
ASSAM,DIBRUGARH,2021-03-23,3,217,1,221
ASSAM,DIBRUGARH,2021-03-24,5,133,2,140
ASSAM,DIBRUGARH,2021-03-25,7,180,0,187
ASSAM,DIMA HASAO,2021-03-21,0,5,0,5
ASSAM,DIMA HASAO,2021-03-22,0,24,0,24
ASSAM,DIMA HASAO,2021-03-23,0,30,0,30
ASSAM,DIMA HASAO,2021-03-24,0,22,0,22
ASSAM,DIMA HASAO,2021-03-25,1,13,0,14
ASSAM,GOALPARA,2021-03-21,0,75,0,75
ASSAM,GOALPARA,2021-03-22,0,269,0,269
ASSAM,GOALPARA,2021-03-23,0,322,0,322
ASSAM,GOALPARA,2021-03-24,0,273,0,273
ASSAM,GOALPARA,2021-03-25,0,298,0,298
ASSAM,GOLAGHAT,2021-03-21,0,63,0,63
ASSAM,GOLAGHAT,2021-03-22,2,110,0,112
ASSAM,GOLAGHAT,2021-03-23,1,134,0,135
ASSAM,GOLAGHAT,2021-03-24,0,125,0,125
ASSAM,GOLAGHAT,2021-03-25,0,77,0,77
ASSAM,HAILAKANDI,2021-03-21,0,33,0,33
ASSAM,HAILAKANDI,2021-03-22,0,369,1,370
ASSAM,HAILAKANDI,2021-03-23,0,287,64,351
ASSAM,HAILAKANDI,2021-03-24,0,366,16,382
ASSAM,HAILAKANDI,2021-03-25,0,231,15,246
ASSAM,HOJAI,2021-03-21,0,21,0,21
ASSAM,HOJAI,2021-03-22,0,126,0,126
ASSAM,HOJAI,2021-03-23,0,115,0,115
ASSAM,HOJAI,2021-03-24,0,115,0,115
ASSAM,HOJAI,2021-03-25,1,132,1,134
ASSAM,JORHAT,2021-03-21,4,116,0,120
ASSAM,JORHAT,2021-03-22,2,364,0,366
ASSAM,JORHAT,2021-03-23,0,315,0,315
ASSAM,JORHAT,2021-03-24,2,258,0,260
ASSAM,JORHAT,2021-03-25,5,285,0,290
ASSAM,KAMRUP,2021-03-21,1,116,0,117
ASSAM,KAMRUP,2021-03-22,1,548,1,550
ASSAM,KAMRUP,2021-03-23,0,571,0,571
ASSAM,KAMRUP,2021-03-24,0,658,0,658
ASSAM,KAMRUP,2021-03-25,7,521,1,529
ASSAM,KAMRUP METRO,2021-03-21,15,1391,0,1406
ASSAM,KAMRUP METRO,2021-03-22,15,1887,0,1902
ASSAM,KAMRUP METRO,2021-03-23,28,1463,0,1491
ASSAM,KAMRUP METRO,2021-03-24,20,1629,0,1649
ASSAM,KAMRUP METRO,2021-03-25,17,1640,0,1657
ASSAM,KARBI ANGLONG,2021-03-21,0,3,0,3
ASSAM,KARBI ANGLONG,2021-03-22,0,46,0,46
ASSAM,KARBI ANGLONG,2021-03-23,1,27,0,28
ASSAM,KARBI ANGLONG,2021-03-24,0,7,0,7
ASSAM,KARBI ANGLONG,2021-03-25,1,26,0,27
ASSAM,KARIMGANJ,2021-03-21,0,47,0,47
ASSAM,KARIMGANJ,2021-03-22,1,232,0,233
ASSAM,KARIMGANJ,2021-03-23,0,148,0,148
ASSAM,KARIMGANJ,2021-03-24,0,137,0,137
ASSAM,KARIMGANJ,2021-03-25,0,134,0,134
ASSAM,KOKRAJHAR,2021-03-21,0,4,0,4
ASSAM,KOKRAJHAR,2021-03-22,1,30,0,31
ASSAM,KOKRAJHAR,2021-03-23,0,16,0,16
ASSAM,KOKRAJHAR,2021-03-24,0,25,0,25
ASSAM,KOKRAJHAR,2021-03-25,1,17,0,18
ASSAM,LAKHIMPUR,2021-03-21,0,60,0,60
ASSAM,LAKHIMPUR,2021-03-22,1,204,0,205
ASSAM,LAKHIMPUR,2021-03-23,0,267,0,267
ASSAM,LAKHIMPUR,2021-03-24,0,204,0,204
ASSAM,LAKHIMPUR,2021-03-25,0,190,0,190
ASSAM,MAJULI,2021-03-21,0,4,0,4
ASSAM,MAJULI,2021-03-22,0,2,0,2
ASSAM,MAJULI,2021-03-23,0,7,0,7
ASSAM,MAJULI,2021-03-24,0,2,0,2
ASSAM,MAJULI,2021-03-25,0,1,0,1
ASSAM,MARIGAON,2021-03-21,0,36,0,36
ASSAM,MARIGAON,2021-03-22,0,91,0,91
ASSAM,MARIGAON,2021-03-23,0,96,0,96
ASSAM,MARIGAON,2021-03-24,0,91,0,91
ASSAM,MARIGAON,2021-03-25,0,85,0,85
ASSAM,NAGAON,2021-03-21,4,270,0,274
ASSAM,NAGAON,2021-03-22,1,300,0,301
ASSAM,NAGAON,2021-03-23,3,342,0,345
ASSAM,NAGAON,2021-03-24,0,338,0,338
ASSAM,NAGAON,2021-03-25,2,291,0,293
ASSAM,NALBARI,2021-03-21,0,10,0,10
ASSAM,NALBARI,2021-03-22,0,206,0,206
ASSAM,NALBARI,2021-03-23,0,94,0,94
ASSAM,NALBARI,2021-03-24,1,127,0,128
ASSAM,NALBARI,2021-03-25,1,149,0,150
ASSAM,SIVASAGAR,2021-03-21,1,53,0,54
ASSAM,SIVASAGAR,2021-03-22,0,327,0,327
ASSAM,SIVASAGAR,2021-03-23,0,212,0,212
ASSAM,SIVASAGAR,2021-03-24,1,110,0,111
ASSAM,SIVASAGAR,2021-03-25,3,214,0,217
ASSAM,SONITPUR,2021-03-21,1,65,0,66
ASSAM,SONITPUR,2021-03-22,6,120,0,126
ASSAM,SONITPUR,2021-03-23,3,282,0,285
ASSAM,SONITPUR,2021-03-24,4,354,0,358
ASSAM,SONITPUR,2021-03-25,1,287,0,288
ASSAM,SOUTH SALMARA MANCACHAR,2021-03-21,0,12,0,12
ASSAM,SOUTH SALMARA MANCACHAR,2021-03-22,0,21,0,21
ASSAM,SOUTH SALMARA MANCACHAR,2021-03-23,0,19,0,19
ASSAM,SOUTH SALMARA MANCACHAR,2021-03-24,0,18,0,18
ASSAM,SOUTH SALMARA MANCACHAR,2021-03-25,0,5,0,5
ASSAM,TINSUKIA,2021-03-21,0,132,0,132
ASSAM,TINSUKIA,2021-03-22,0,67,0,67
ASSAM,TINSUKIA,2021-03-23,0,50,0,50
ASSAM,TINSUKIA,2021-03-24,3,54,1,58
ASSAM,TINSUKIA,2021-03-25,1,50,0,51
ASSAM,UDALGURI,2021-03-21,0,9,0,9
ASSAM,UDALGURI,2021-03-22,0,11,0,11
ASSAM,UDALGURI,2021-03-23,0,8,0,8
ASSAM,UDALGURI,2021-03-24,0,13,0,13
ASSAM,UDALGURI,2021-03-25,0,4,0,4
ASSAM,WEST KARBI ANGLONG,2021-03-21,0,2,0,2
ASSAM,WEST KARBI ANGLONG,2021-03-22,0,6,0,6
ASSAM,WEST KARBI ANGLONG,2021-03-23,0,6,0,6
ASSAM,WEST KARBI ANGLONG,2021-03-25,0,4,0,4
BIHAR,ARARIA,2021-03-21,2,1133,0,1135
BIHAR,ARARIA,2021-03-22,0,386,0,386
BIHAR,ARARIA,2021-03-23,5,282,1,288
BIHAR,ARARIA,2021-03-24,5,491,0,496
BIHAR,ARARIA,2021-03-25,47,664,0,711
BIHAR,ARWAL,2021-03-21,0,404,1,405
BIHAR,ARWAL,2021-03-22,1,514,0,515
BIHAR,ARWAL,2021-03-23,0,1065,0,1065
BIHAR,ARWAL,2021-03-24,4,343,7,354
BIHAR,ARWAL,2021-03-25,1,653,0,654
BIHAR,AURANGABAD,2021-03-21,3,674,0,677
BIHAR,AURANGABAD,2021-03-22,3,2252,0,2255
BIHAR,AURANGABAD,2021-03-23,2,2609,2,2613
BIHAR,AURANGABAD,2021-03-24,5,3467,0,3472
BIHAR,AURANGABAD,2021-03-25,1,2273,0,2274
BIHAR,BANKA,2021-03-21,2,698,2,702
BIHAR,BANKA,2021-03-22,1,442,56,499
BIHAR,BANKA,2021-03-23,0,187,0,187
BIHAR,BANKA,2021-03-24,0,138,0,138
BIHAR,BANKA,2021-03-25,4,214,2,220
BIHAR,BEGUSARAI,2021-03-21,2,865,0,867
BIHAR,BEGUSARAI,2021-03-22,12,1788,0,1800
BIHAR,BEGUSARAI,2021-03-23,7,1393,0,1400
BIHAR,BEGUSARAI,2021-03-24,23,421,1,445
BIHAR,BEGUSARAI,2021-03-25,2,813,0,815
BIHAR,BHAGALPUR,2021-03-21,9,1536,18,1563
BIHAR,BHAGALPUR,2021-03-22,10,1148,116,1274
BIHAR,BHAGALPUR,2021-03-23,8,722,2,732
BIHAR,BHAGALPUR,2021-03-24,15,1342,77,1434
BIHAR,BHAGALPUR,2021-03-25,9,1191,45,1245
BIHAR,BHOJPUR,2021-03-21,4,1700,0,1704
BIHAR,BHOJPUR,2021-03-22,2,1772,0,1774
BIHAR,BHOJPUR,2021-03-23,4,1996,15,2015
BIHAR,BHOJPUR,2021-03-24,1,2454,27,2482
BIHAR,BHOJPUR,2021-03-25,1,3277,269,3547
BIHAR,BUXAR,2021-03-21,0,229,0,229
BIHAR,BUXAR,2021-03-22,1,512,1,514
BIHAR,BUXAR,2021-03-23,4,1956,3,1963
BIHAR,BUXAR,2021-03-24,0,562,0,562
BIHAR,BUXAR,2021-03-25,3,1317,1,1321
BIHAR,DARBHANGA,2021-03-21,7,830,0,837
BIHAR,DARBHANGA,2021-03-22,3,1167,2,1172
BIHAR,DARBHANGA,2021-03-23,6,1068,84,1158
BIHAR,DARBHANGA,2021-03-24,5,1675,201,1881
BIHAR,DARBHANGA,2021-03-25,11,1607,3,1621
BIHAR,GAYA,2021-03-21,13,8312,1,8326
BIHAR,GAYA,2021-03-22,2,7383,0,7385
BIHAR,GAYA,2021-03-23,14,2210,79,2303
BIHAR,GAYA,2021-03-24,5,1331,7,1343
BIHAR,GAYA,2021-03-25,18,1746,19,1783
BIHAR,GOPALGANJ,2021-03-21,2,826,36,864
BIHAR,GOPALGANJ,2021-03-22,3,1688,6,1697
BIHAR,GOPALGANJ,2021-03-23,6,1376,9,1391
BIHAR,GOPALGANJ,2021-03-24,11,1359,5,1375
BIHAR,GOPALGANJ,2021-03-25,5,704,32,741
BIHAR,JAMUI,2021-03-21,1,342,0,343
BIHAR,JAMUI,2021-03-22,0,776,2,778
BIHAR,JAMUI,2021-03-23,2,483,1,486
BIHAR,JAMUI,2021-03-24,0,609,1,610
BIHAR,JAMUI,2021-03-25,0,348,0,348
BIHAR,JEHANABAD,2021-03-21,1,319,15,335
BIHAR,JEHANABAD,2021-03-22,0,345,14,359
BIHAR,JEHANABAD,2021-03-23,4,548,14,566
BIHAR,JEHANABAD,2021-03-24,7,749,25,781
BIHAR,JEHANABAD,2021-03-25,12,930,85,1027
BIHAR,KAIMUR (BHABUA),2021-03-21,1,657,0,658
BIHAR,KAIMUR (BHABUA),2021-03-22,0,1444,0,1444
BIHAR,KAIMUR (BHABUA),2021-03-23,2,1471,132,1605
BIHAR,KAIMUR (BHABUA),2021-03-24,2,1899,7,1908
BIHAR,KAIMUR (BHABUA),2021-03-25,2,1012,2,1016
BIHAR,KATIHAR,2021-03-21,6,1801,3,1810
BIHAR,KATIHAR,2021-03-22,0,1420,2,1422
BIHAR,KATIHAR,2021-03-23,3,898,0,901
BIHAR,KATIHAR,2021-03-24,6,1269,1,1276
BIHAR,KATIHAR,2021-03-25,3,1404,0,1407
BIHAR,KHAGARIA,2021-03-21,0,448,0,448
BIHAR,KHAGARIA,2021-03-22,0,616,0,616
BIHAR,KHAGARIA,2021-03-23,0,295,0,295
BIHAR,KHAGARIA,2021-03-24,3,1160,0,1163
BIHAR,KHAGARIA,2021-03-25,1,150,0,151
BIHAR,KISHANGANJ,2021-03-21,2,115,0,117
BIHAR,KISHANGANJ,2021-03-22,3,433,0,436
BIHAR,KISHANGANJ,2021-03-23,2,595,0,597
BIHAR,KISHANGANJ,2021-03-24,6,981,0,987
BIHAR,KISHANGANJ,2021-03-25,2,910,0,912
BIHAR,LAKHISARAI,2021-03-21,1,191,0,192
BIHAR,LAKHISARAI,2021-03-22,1,168,0,169
BIHAR,LAKHISARAI,2021-03-23,0,134,0,134
BIHAR,LAKHISARAI,2021-03-24,3,551,0,554
BIHAR,LAKHISARAI,2021-03-25,1,146,0,147
BIHAR,MADHEPURA,2021-03-21,0,773,0,773
BIHAR,MADHEPURA,2021-03-22,0,779,0,779
BIHAR,MADHEPURA,2021-03-23,1,468,0,469
BIHAR,MADHEPURA,2021-03-24,4,431,0,435
BIHAR,MADHEPURA,2021-03-25,0,1417,0,1417
BIHAR,MADHUBANI,2021-03-21,1,118,1,120
BIHAR,MADHUBANI,2021-03-22,4,1221,8,1233
BIHAR,MADHUBANI,2021-03-23,2,1226,6,1234
BIHAR,MADHUBANI,2021-03-24,6,1340,13,1359
BIHAR,MADHUBANI,2021-03-25,2,1020,4,1026
BIHAR,MUNGER,2021-03-21,1,907,2,910
BIHAR,MUNGER,2021-03-22,3,1605,15,1623
BIHAR,MUNGER,2021-03-23,2,1370,6,1378
BIHAR,MUNGER,2021-03-24,5,1092,248,1345
BIHAR,MUNGER,2021-03-25,5,721,22,748
BIHAR,MUZAFFARPUR,2021-03-21,5,1406,1,1412
BIHAR,MUZAFFARPUR,2021-03-22,2,1742,0,1744
BIHAR,MUZAFFARPUR,2021-03-23,3,1179,0,1182
BIHAR,MUZAFFARPUR,2021-03-24,6,1737,1,1744
BIHAR,MUZAFFARPUR,2021-03-25,3,1488,10,1501
BIHAR,NALANDA,2021-03-21,0,1701,4,1705
BIHAR,NALANDA,2021-03-22,2,2999,120,3121
BIHAR,NALANDA,2021-03-23,1,2862,1,2864
BIHAR,NALANDA,2021-03-24,1,3012,6,3019
BIHAR,NALANDA,2021-03-25,7,2933,25,2965
BIHAR,NAWADA,2021-03-21,0,1484,0,1484
BIHAR,NAWADA,2021-03-22,3,968,0,971
BIHAR,NAWADA,2021-03-23,0,754,0,754
BIHAR,NAWADA,2021-03-24,3,1548,0,1551
BIHAR,NAWADA,2021-03-25,2,797,0,799
BIHAR,PASHCHIM CHAMPARAN,2021-03-21,7,833,1,841
BIHAR,PASHCHIM CHAMPARAN,2021-03-22,6,1498,1,1505
BIHAR,PASHCHIM CHAMPARAN,2021-03-23,7,1616,0,1623
BIHAR,PASHCHIM CHAMPARAN,2021-03-24,3,1376,0,1379
BIHAR,PASHCHIM CHAMPARAN,2021-03-25,11,1463,3,1477
BIHAR,PATNA,2021-03-21,58,1698,0,1756
BIHAR,PATNA,2021-03-22,75,2229,4,2308
BIHAR,PATNA,2021-03-23,97,3598,5,3700
BIHAR,PATNA,2021-03-24,82,3859,2,3943
BIHAR,PATNA,2021-03-25,96,3101,0,3197
BIHAR,PURBI CHAMPARAN,2021-03-21,1,1361,0,1362
BIHAR,PURBI CHAMPARAN,2021-03-22,1,2160,3,2164
BIHAR,PURBI CHAMPARAN,2021-03-23,1,1850,8,1859
BIHAR,PURBI CHAMPARAN,2021-03-24,3,1020,1,1024
BIHAR,PURBI CHAMPARAN,2021-03-25,3,2442,4,2449
BIHAR,PURNIA,2021-03-21,3,649,0,652
BIHAR,PURNIA,2021-03-22,4,1127,285,1416
BIHAR,PURNIA,2021-03-23,3,1453,0,1456
BIHAR,PURNIA,2021-03-24,3,547,206,756
BIHAR,PURNIA,2021-03-25,4,1129,126,1259
BIHAR,ROHTAS,2021-03-21,0,1875,0,1875
BIHAR,ROHTAS,2021-03-22,4,1442,8,1454
BIHAR,ROHTAS,2021-03-23,3,2459,21,2483
BIHAR,ROHTAS,2021-03-24,13,2441,0,2454
BIHAR,ROHTAS,2021-03-25,10,2334,0,2344
BIHAR,SAHARSA,2021-03-21,1,713,0,714
BIHAR,SAHARSA,2021-03-22,0,703,0,703
BIHAR,SAHARSA,2021-03-23,1,1047,2,1050
BIHAR,SAHARSA,2021-03-24,0,117,1,118
BIHAR,SAHARSA,2021-03-25,1,85,0,86
BIHAR,SAMASTIPUR,2021-03-21,3,874,35,912
BIHAR,SAMASTIPUR,2021-03-22,2,1246,3,1251
BIHAR,SAMASTIPUR,2021-03-23,1,1942,16,1959
BIHAR,SAMASTIPUR,2021-03-24,16,1526,130,1672
BIHAR,SAMASTIPUR,2021-03-25,4,1850,20,1874
BIHAR,SARAN,2021-03-21,2,283,0,285
BIHAR,SARAN,2021-03-22,0,1777,0,1777
BIHAR,SARAN,2021-03-23,4,1485,1,1490
BIHAR,SARAN,2021-03-24,2,1609,1,1612
BIHAR,SARAN,2021-03-25,3,1333,3,1339
BIHAR,SHEIKHPURA,2021-03-21,0,39,0,39
BIHAR,SHEIKHPURA,2021-03-22,0,523,0,523
BIHAR,SHEIKHPURA,2021-03-23,0,384,9,393
BIHAR,SHEIKHPURA,2021-03-24,0,807,2,809
BIHAR,SHEIKHPURA,2021-03-25,0,143,2,145
BIHAR,SHEOHAR,2021-03-21,1,71,0,72
BIHAR,SHEOHAR,2021-03-22,2,229,0,231
BIHAR,SHEOHAR,2021-03-23,0,387,0,387
BIHAR,SHEOHAR,2021-03-24,0,829,0,829
BIHAR,SHEOHAR,2021-03-25,2,250,0,252
BIHAR,SITAMARHI,2021-03-21,2,939,2,943
BIHAR,SITAMARHI,2021-03-22,2,920,0,922
BIHAR,SITAMARHI,2021-03-23,0,848,3,851
BIHAR,SITAMARHI,2021-03-24,5,865,3,873
BIHAR,SITAMARHI,2021-03-25,2,1574,4,1580
BIHAR,SIWAN,2021-03-21,3,1350,0,1353
BIHAR,SIWAN,2021-03-22,5,1332,0,1337
BIHAR,SIWAN,2021-03-23,6,2245,0,2251
BIHAR,SIWAN,2021-03-24,6,1160,0,1166
BIHAR,SIWAN,2021-03-25,3,2198,0,2201
BIHAR,SUPAUL,2021-03-21,1,880,7,888
BIHAR,SUPAUL,2021-03-22,0,976,0,976
BIHAR,SUPAUL,2021-03-23,5,918,18,941
BIHAR,SUPAUL,2021-03-24,2,864,97,963
BIHAR,SUPAUL,2021-03-25,0,1159,111,1270
BIHAR,VAISHALI,2021-03-21,1,1131,1,1133
BIHAR,VAISHALI,2021-03-22,3,1879,0,1882
BIHAR,VAISHALI,2021-03-23,4,1879,4,1887
BIHAR,VAISHALI,2021-03-24,1,2535,0,2536
BIHAR,VAISHALI,2021-03-25,4,1174,0,1178
CHANDIGARH,CHANDIGARH,2021-03-21,207,1074,59,1340
CHANDIGARH,CHANDIGARH,2021-03-22,290,1847,24,2161
CHANDIGARH,CHANDIGARH,2021-03-23,283,1707,19,2009
CHANDIGARH,CHANDIGARH,2021-03-24,275,1904,11,2190
CHANDIGARH,CHANDIGARH,2021-03-25,312,1608,23,1943
CHHATTISGARH,BALOD,2021-03-21,9,1440,0,1449
CHHATTISGARH,BALOD,2021-03-22,19,1500,0,1519
CHHATTISGARH,BALOD,2021-03-23,25,1728,0,1753
CHHATTISGARH,BALOD,2021-03-24,22,1688,1,1711
CHHATTISGARH,BALOD,2021-03-25,61,1644,0,1705
CHHATTISGARH,BALODA BAZAR,2021-03-21,17,296,4,317
CHHATTISGARH,BALODA BAZAR,2021-03-22,24,327,4,355
CHHATTISGARH,BALODA BAZAR,2021-03-23,39,518,14,571
CHHATTISGARH,BALODA BAZAR,2021-03-24,39,1074,23,1136
CHHATTISGARH,BALODA BAZAR,2021-03-25,38,830,4,872
CHHATTISGARH,BALRAMPUR,2021-03-21,1,140,0,141
CHHATTISGARH,BALRAMPUR,2021-03-22,5,746,4,755
CHHATTISGARH,BALRAMPUR,2021-03-23,9,921,7,937
CHHATTISGARH,BALRAMPUR,2021-03-24,5,525,0,530
CHHATTISGARH,BALRAMPUR,2021-03-25,7,639,0,646
CHHATTISGARH,BASTAR,2021-03-21,8,1068,0,1076
CHHATTISGARH,BASTAR,2021-03-22,12,1446,0,1458
CHHATTISGARH,BASTAR,2021-03-23,21,1643,0,1664
CHHATTISGARH,BASTAR,2021-03-24,23,1622,0,1645
CHHATTISGARH,BASTAR,2021-03-25,30,2311,0,2341
CHHATTISGARH,BEMETARA,2021-03-21,14,1440,2,1456
CHHATTISGARH,BEMETARA,2021-03-22,55,367,0,422
CHHATTISGARH,BEMETARA,2021-03-23,73,738,0,811
CHHATTISGARH,BEMETARA,2021-03-24,55,412,0,467
CHHATTISGARH,BEMETARA,2021-03-25,125,549,1,675
CHHATTISGARH,BIJAPUR,2021-03-21,4,257,0,261
CHHATTISGARH,BIJAPUR,2021-03-22,5,120,0,125
CHHATTISGARH,BIJAPUR,2021-03-23,2,185,0,187
CHHATTISGARH,BIJAPUR,2021-03-24,2,404,0,406
CHHATTISGARH,BIJAPUR,2021-03-25,3,625,0,628
CHHATTISGARH,BILASPUR,2021-03-21,90,861,2,953
CHHATTISGARH,BILASPUR,2021-03-22,108,2583,14,2705
CHHATTISGARH,BILASPUR,2021-03-23,116,2615,16,2747
CHHATTISGARH,BILASPUR,2021-03-24,111,2124,20,2255
CHHATTISGARH,BILASPUR,2021-03-25,140,2257,48,2445
CHHATTISGARH,DANTEWADA,2021-03-21,1,377,0,378
CHHATTISGARH,DANTEWADA,2021-03-22,3,218,0,221
CHHATTISGARH,DANTEWADA,2021-03-23,2,437,0,439
CHHATTISGARH,DANTEWADA,2021-03-24,3,377,0,380
CHHATTISGARH,DANTEWADA,2021-03-25,5,550,2,557
CHHATTISGARH,DHAMTARI,2021-03-21,25,529,18,572
CHHATTISGARH,DHAMTARI,2021-03-22,19,857,40,916
CHHATTISGARH,DHAMTARI,2021-03-23,44,1101,59,1204
CHHATTISGARH,DHAMTARI,2021-03-24,49,1077,5,1131
CHHATTISGARH,DHAMTARI,2021-03-25,53,801,43,897
CHHATTISGARH,DURG,2021-03-21,344,824,3,1171
CHHATTISGARH,DURG,2021-03-22,535,1165,5,1705
CHHATTISGARH,DURG,2021-03-23,733,1190,7,1930
CHHATTISGARH,DURG,2021-03-24,847,1411,17,2275
CHHATTISGARH,DURG,2021-03-25,1013,1420,14,2447
CHHATTISGARH,GARIYABAND,2021-03-21,8,411,4,423
CHHATTISGARH,GARIYABAND,2021-03-22,11,136,2,149
CHHATTISGARH,GARIYABAND,2021-03-23,22,350,3,375
CHHATTISGARH,GARIYABAND,2021-03-24,26,433,3,462
CHHATTISGARH,GARIYABAND,2021-03-25,15,281,1,297
CHHATTISGARH,GAURELLA PENDRA MARWAHI,2021-03-21,5,288,0,293
CHHATTISGARH,GAURELLA PENDRA MARWAHI,2021-03-22,3,449,0,452
CHHATTISGARH,GAURELLA PENDRA MARWAHI,2021-03-23,4,374,0,378
CHHATTISGARH,GAURELLA PENDRA MARWAHI,2021-03-24,4,659,0,663
CHHATTISGARH,GAURELLA PENDRA MARWAHI,2021-03-25,4,698,1,703
CHHATTISGARH,JANJGIR CHAMPA,2021-03-21,2,1756,1,1759
CHHATTISGARH,JANJGIR CHAMPA,2021-03-22,22,2052,7,2081
CHHATTISGARH,JANJGIR CHAMPA,2021-03-23,25,2474,0,2499
CHHATTISGARH,JANJGIR CHAMPA,2021-03-24,17,2208,0,2225
CHHATTISGARH,JANJGIR CHAMPA,2021-03-25,27,2063,0,2090
CHHATTISGARH,JASHPUR,2021-03-21,18,219,1,238
CHHATTISGARH,JASHPUR,2021-03-22,53,665,4,722
CHHATTISGARH,JASHPUR,2021-03-23,37,438,2,477
CHHATTISGARH,JASHPUR,2021-03-24,37,636,2,675
CHHATTISGARH,JASHPUR,2021-03-25,43,638,2,683
CHHATTISGARH,KABIRDHAM,2021-03-21,3,400,0,403
CHHATTISGARH,KABIRDHAM,2021-03-22,22,1370,0,1392
CHHATTISGARH,KABIRDHAM,2021-03-23,19,656,0,675
CHHATTISGARH,KABIRDHAM,2021-03-24,10,649,7,666
CHHATTISGARH,KABIRDHAM,2021-03-25,23,330,0,353
CHHATTISGARH,KANKER,2021-03-21,5,1307,0,1312
CHHATTISGARH,KANKER,2021-03-22,22,2167,0,2189
CHHATTISGARH,KANKER,2021-03-23,9,1966,0,1975
CHHATTISGARH,KANKER,2021-03-24,17,2229,0,2246
CHHATTISGARH,KANKER,2021-03-25,13,1637,0,1650
CHHATTISGARH,KONDAGAON,2021-03-21,1,218,0,219
CHHATTISGARH,KONDAGAON,2021-03-22,1,521,0,522
CHHATTISGARH,KONDAGAON,2021-03-23,5,689,0,694
CHHATTISGARH,KONDAGAON,2021-03-24,4,995,0,999
CHHATTISGARH,KONDAGAON,2021-03-25,14,433,0,447
CHHATTISGARH,KORBA,2021-03-21,13,1481,10,1504
CHHATTISGARH,KORBA,2021-03-22,46,2883,8,2937
CHHATTISGARH,KORBA,2021-03-23,42,2133,1,2176
CHHATTISGARH,KORBA,2021-03-24,25,1830,1,1856
CHHATTISGARH,KORBA,2021-03-25,52,1938,1,1991
CHHATTISGARH,KOREA,2021-03-21,20,391,0,411
CHHATTISGARH,KOREA,2021-03-22,51,666,2,719
CHHATTISGARH,KOREA,2021-03-23,27,996,3,1026
CHHATTISGARH,KOREA,2021-03-24,28,762,4,794
CHHATTISGARH,KOREA,2021-03-25,44,878,2,924
CHHATTISGARH,MAHASAMUND,2021-03-21,18,760,5,783
CHHATTISGARH,MAHASAMUND,2021-03-22,42,957,3,1002
CHHATTISGARH,MAHASAMUND,2021-03-23,31,1233,7,1271
CHHATTISGARH,MAHASAMUND,2021-03-24,74,1199,13,1286
CHHATTISGARH,MAHASAMUND,2021-03-25,48,1178,4,1230
CHHATTISGARH,MUNGELI,2021-03-21,1,400,0,401
CHHATTISGARH,MUNGELI,2021-03-22,7,368,0,375
CHHATTISGARH,MUNGELI,2021-03-23,2,646,0,648
CHHATTISGARH,MUNGELI,2021-03-24,7,564,2,573
CHHATTISGARH,MUNGELI,2021-03-25,10,511,0,521
CHHATTISGARH,NARAYANPUR,2021-03-21,0,146,0,146
CHHATTISGARH,NARAYANPUR,2021-03-22,1,98,0,99
CHHATTISGARH,NARAYANPUR,2021-03-23,1,296,0,297
CHHATTISGARH,NARAYANPUR,2021-03-24,3,99,0,102
CHHATTISGARH,NARAYANPUR,2021-03-25,0,130,0,130
CHHATTISGARH,RAIGARH,2021-03-21,12,729,0,741
CHHATTISGARH,RAIGARH,2021-03-22,17,1006,0,1023
CHHATTISGARH,RAIGARH,2021-03-23,26,1148,3,1177
CHHATTISGARH,RAIGARH,2021-03-24,22,1554,1,1577
CHHATTISGARH,RAIGARH,2021-03-25,25,878,26,929
CHHATTISGARH,RAIPUR,2021-03-21,466,1289,72,1827
CHHATTISGARH,RAIPUR,2021-03-22,497,2595,50,3142
CHHATTISGARH,RAIPUR,2021-03-23,556,2210,14,2780
CHHATTISGARH,RAIPUR,2021-03-24,615,1941,44,2600
CHHATTISGARH,RAIPUR,2021-03-25,821,2395,47,3263
CHHATTISGARH,RAJNANDGAON,2021-03-21,33,857,3,893
CHHATTISGARH,RAJNANDGAON,2021-03-22,111,1399,7,1517
CHHATTISGARH,RAJNANDGAON,2021-03-23,101,1182,1,1284
CHHATTISGARH,RAJNANDGAON,2021-03-24,136,1321,11,1468
CHHATTISGARH,RAJNANDGAON,2021-03-25,177,1744,1,1922
CHHATTISGARH,SUKMA,2021-03-21,1,379,0,380
CHHATTISGARH,SUKMA,2021-03-22,1,122,0,123
CHHATTISGARH,SUKMA,2021-03-23,1,411,0,412
CHHATTISGARH,SUKMA,2021-03-24,2,59,0,61
CHHATTISGARH,SUKMA,2021-03-25,3,442,0,445
CHHATTISGARH,SURAJPUR,2021-03-21,4,768,0,772
CHHATTISGARH,SURAJPUR,2021-03-22,22,858,4,884
CHHATTISGARH,SURAJPUR,2021-03-23,36,1351,2,1389
CHHATTISGARH,SURAJPUR,2021-03-24,39,994,2,1035
CHHATTISGARH,SURAJPUR,2021-03-25,35,831,1,867
CHHATTISGARH,SURGUJA,2021-03-21,20,1162,3,1185
CHHATTISGARH,SURGUJA,2021-03-22,65,1731,2,1798
CHHATTISGARH,SURGUJA,2021-03-23,35,1937,12,1984
CHHATTISGARH,SURGUJA,2021-03-24,46,1284,7,1337
CHHATTISGARH,SURGUJA,2021-03-25,65,1670,1,1736
DADRA AND NAGAR HAVELI,DADRA AND NAGAR HAVELI,2021-03-21,2,90,0,92
DADRA AND NAGAR HAVELI,DADRA AND NAGAR HAVELI,2021-03-22,0,114,0,114
DADRA AND NAGAR HAVELI,DADRA AND NAGAR HAVELI,2021-03-23,9,276,0,285
DADRA AND NAGAR HAVELI,DADRA AND NAGAR HAVELI,2021-03-24,11,266,0,277
DADRA AND NAGAR HAVELI,DADRA AND NAGAR HAVELI,2021-03-25,8,391,0,399
DAMAN AND DIU,DAMAN,2021-03-21,7,190,0,197
DAMAN AND DIU,DAMAN,2021-03-22,1,33,1,35
DAMAN AND DIU,DAMAN,2021-03-23,6,146,0,152
DAMAN AND DIU,DAMAN,2021-03-24,3,153,0,156
DAMAN AND DIU,DAMAN,2021-03-25,15,169,0,184
DAMAN AND DIU,DIU,2021-03-21,0,36,0,36
DAMAN AND DIU,DIU,2021-03-22,0,2,0,2
DAMAN AND DIU,DIU,2021-03-23,0,37,0,37
DAMAN AND DIU,DIU,2021-03-24,0,32,0,32
DAMAN AND DIU,DIU,2021-03-25,0,19,0,19
DELHI,CENTRAL,2021-03-21,41,5526,51,5618
DELHI,CENTRAL,2021-03-22,47,6590,9,6646
DELHI,CENTRAL,2021-03-23,38,5812,24,5874
DELHI,CENTRAL,2021-03-24,52,7568,21,7641
DELHI,CENTRAL,2021-03-25,58,6782,12,6852
DELHI,EAST,2021-03-21,75,3867,5,3947
DELHI,EAST,2021-03-22,55,4980,17,5052
DELHI,EAST,2021-03-23,132,9883,20,10035
DELHI,EAST,2021-03-24,126,8626,8,8760
DELHI,EAST,2021-03-25,154,5793,20,5967
DELHI,NEW DELHI,2021-03-21,83,5273,2,5358
DELHI,NEW DELHI,2021-03-22,135,7346,6,7487
DELHI,NEW DELHI,2021-03-23,172,8308,18,8498
DELHI,NEW DELHI,2021-03-24,205,7024,14,7243
DELHI,NEW DELHI,2021-03-25,146,5974,19,6139
DELHI,NORTH,2021-03-21,89,6243,3,6335
DELHI,NORTH,2021-03-22,67,7474,0,7541
DELHI,NORTH,2021-03-23,87,8593,10,8690
DELHI,NORTH,2021-03-24,64,7056,11,7131
DELHI,NORTH,2021-03-25,118,8758,34,8910
DELHI,NORTH EAST,2021-03-21,12,3809,1,3822
DELHI,NORTH EAST,2021-03-22,32,5932,0,5964
DELHI,NORTH EAST,2021-03-23,18,3412,6,3436
DELHI,NORTH EAST,2021-03-24,28,5167,7,5202
DELHI,NORTH EAST,2021-03-25,44,4782,1,4827
DELHI,NORTH WEST,2021-03-21,150,7754,4,7908
DELHI,NORTH WEST,2021-03-22,169,9387,18,9574
DELHI,NORTH WEST,2021-03-23,143,7824,16,7983
DELHI,NORTH WEST,2021-03-24,231,6805,8,7044
DELHI,NORTH WEST,2021-03-25,335,10704,37,11076
DELHI,SHAHDARA,2021-03-21,25,3796,11,3832
DELHI,SHAHDARA,2021-03-22,43,8266,4,8313
DELHI,SHAHDARA,2021-03-23,54,7287,4,7345
DELHI,SHAHDARA,2021-03-24,66,7351,14,7431
DELHI,SHAHDARA,2021-03-25,66,8338,8,8412
DELHI,SOUTH,2021-03-21,148,6096,7,6251
DELHI,SOUTH,2021-03-22,232,9744,83,10059
DELHI,SOUTH,2021-03-23,272,5863,82,6217
DELHI,SOUTH,2021-03-24,308,10329,80,10717
DELHI,SOUTH,2021-03-25,257,6919,70,7246
DELHI,SOUTH EAST,2021-03-21,71,7073,1,7145
DELHI,SOUTH EAST,2021-03-22,75,6427,2,6504
DELHI,SOUTH EAST,2021-03-23,82,5681,3,5766
DELHI,SOUTH EAST,2021-03-24,108,7847,0,7955
DELHI,SOUTH EAST,2021-03-25,74,6424,16,6514
DELHI,SOUTH WEST,2021-03-21,103,8532,3,8638
DELHI,SOUTH WEST,2021-03-22,131,8107,5,8243
DELHI,SOUTH WEST,2021-03-23,148,8293,3,8444
DELHI,SOUTH WEST,2021-03-24,168,10366,5,10539
DELHI,SOUTH WEST,2021-03-25,146,8730,2,8878
DELHI,WEST,2021-03-21,134,8424,3,8561
DELHI,WEST,2021-03-22,201,8546,3,8750
DELHI,WEST,2021-03-23,228,9798,10,10036
DELHI,WEST,2021-03-24,263,9814,11,10088
DELHI,WEST,2021-03-25,247,9981,10,10238
GOA,NORTH GOA,2021-03-21,44,528,1,573
GOA,NORTH GOA,2021-03-22,61,556,0,617
GOA,NORTH GOA,2021-03-23,71,874,0,945
GOA,NORTH GOA,2021-03-24,110,830,0,940
GOA,NORTH GOA,2021-03-25,76,804,1,881
GOA,SOUTH GOA,2021-03-21,35,663,2,700
GOA,SOUTH GOA,2021-03-22,57,689,2,748
GOA,SOUTH GOA,2021-03-23,66,985,0,1051
GOA,SOUTH GOA,2021-03-24,86,908,1,995
GOA,SOUTH GOA,2021-03-25,60,1125,0,1185
GUJARAT,AHMADABAD,2021-03-21,369,1572,5,1946
GUJARAT,AHMADABAD,2021-03-22,515,4185,84,4784
GUJARAT,AHMADABAD,2021-03-23,502,5416,162,6080
GUJARAT,AHMADABAD,2021-03-24,524,5509,92,6125
GUJARAT,AHMADABAD,2021-03-25,621,6562,39,7222
GUJARAT,AMRELI,2021-03-21,8,306,0,314
GUJARAT,AMRELI,2021-03-22,35,949,0,984
GUJARAT,AMRELI,2021-03-23,14,975,0,989
GUJARAT,AMRELI,2021-03-24,23,1138,1,1162
GUJARAT,AMRELI,2021-03-25,23,911,0,934
GUJARAT,ANAND,2021-03-21,20,1456,0,1476
GUJARAT,ANAND,2021-03-22,44,1471,41,1556
GUJARAT,ANAND,2021-03-23,19,1560,2,1581
GUJARAT,ANAND,2021-03-24,29,1456,15,1500
GUJARAT,ANAND,2021-03-25,37,1772,1,1810
GUJARAT,ARVALLI,2021-03-21,1,124,0,125
GUJARAT,ARVALLI,2021-03-22,11,316,0,327
GUJARAT,ARVALLI,2021-03-23,4,306,8,318
GUJARAT,ARVALLI,2021-03-24,12,269,1,282
GUJARAT,ARVALLI,2021-03-25,16,1574,16,1606
GUJARAT,BANAS KANTHA,2021-03-21,1,31,0,32
GUJARAT,BANAS KANTHA,2021-03-22,27,724,0,751
GUJARAT,BANAS KANTHA,2021-03-23,25,655,0,680
GUJARAT,BANAS KANTHA,2021-03-24,15,774,1,790
GUJARAT,BANAS KANTHA,2021-03-25,14,690,0,704
GUJARAT,BHARUCH,2021-03-21,7,182,1,190
GUJARAT,BHARUCH,2021-03-22,57,446,10,513
GUJARAT,BHARUCH,2021-03-23,61,510,5,576
GUJARAT,BHARUCH,2021-03-24,94,620,32,746
GUJARAT,BHARUCH,2021-03-25,107,1857,2,1966
GUJARAT,BHAVNAGAR,2021-03-21,32,463,0,495
GUJARAT,BHAVNAGAR,2021-03-22,34,955,3,992
GUJARAT,BHAVNAGAR,2021-03-23,33,1228,5,1266
GUJARAT,BHAVNAGAR,2021-03-24,46,793,0,839
GUJARAT,BHAVNAGAR,2021-03-25,47,4853,0,4900
GUJARAT,BOTAD,2021-03-21,1,40,0,41
GUJARAT,BOTAD,2021-03-22,3,148,0,151
GUJARAT,BOTAD,2021-03-23,1,155,0,156
GUJARAT,BOTAD,2021-03-24,1,103,0,104
GUJARAT,BOTAD,2021-03-25,0,1280,0,1280
GUJARAT,CHHOTAUDEPUR,2021-03-21,16,133,1,150
GUJARAT,CHHOTAUDEPUR,2021-03-22,2,134,1,137
GUJARAT,CHHOTAUDEPUR,2021-03-23,2,154,0,156
GUJARAT,CHHOTAUDEPUR,2021-03-24,4,223,0,227
GUJARAT,CHHOTAUDEPUR,2021-03-25,13,385,20,418
GUJARAT,DANG,2021-03-21,1,148,0,149
GUJARAT,DANG,2021-03-22,1,54,0,55
GUJARAT,DANG,2021-03-23,3,80,0,83
GUJARAT,DANG,2021-03-24,2,74,0,76
GUJARAT,DANG,2021-03-25,2,409,0,411
GUJARAT,DEVBHUMI DWARKA,2021-03-21,9,94,0,103
GUJARAT,DEVBHUMI DWARKA,2021-03-22,17,52,0,69
GUJARAT,DEVBHUMI DWARKA,2021-03-23,13,225,1,239
GUJARAT,DEVBHUMI DWARKA,2021-03-24,20,150,6,176
GUJARAT,DEVBHUMI DWARKA,2021-03-25,13,1268,1,1282
GUJARAT,DOHAD,2021-03-21,13,407,0,420
GUJARAT,DOHAD,2021-03-22,20,334,10,364
GUJARAT,DOHAD,2021-03-23,8,212,4,224
GUJARAT,DOHAD,2021-03-24,17,280,1,298
GUJARAT,DOHAD,2021-03-25,42,3966,3,4011
GUJARAT,GANDHINAGAR,2021-03-21,46,414,4,464
GUJARAT,GANDHINAGAR,2021-03-22,61,670,13,744
GUJARAT,GANDHINAGAR,2021-03-23,31,1199,18,1248
GUJARAT,GANDHINAGAR,2021-03-24,43,841,3,887
GUJARAT,GANDHINAGAR,2021-03-25,66,2071,6,2143
GUJARAT,GIR SOMNATH,2021-03-21,10,30,0,40
GUJARAT,GIR SOMNATH,2021-03-22,29,79,0,108
GUJARAT,GIR SOMNATH,2021-03-23,11,276,0,287
GUJARAT,GIR SOMNATH,2021-03-24,21,131,0,152
GUJARAT,GIR SOMNATH,2021-03-25,26,1121,0,1147
GUJARAT,JAMNAGAR,2021-03-21,22,459,1,482
GUJARAT,JAMNAGAR,2021-03-22,35,864,12,911
GUJARAT,JAMNAGAR,2021-03-23,49,1238,10,1297
GUJARAT,JAMNAGAR,2021-03-24,47,1024,11,1082
GUJARAT,JAMNAGAR,2021-03-25,48,2156,12,2216
GUJARAT,JUNAGADH,2021-03-21,4,324,1,329
GUJARAT,JUNAGADH,2021-03-22,12,646,0,658
GUJARAT,JUNAGADH,2021-03-23,5,578,1,584
GUJARAT,JUNAGADH,2021-03-24,8,673,0,681
GUJARAT,JUNAGADH,2021-03-25,15,2235,2,2252
GUJARAT,KACHCHH,2021-03-21,36,551,7,594
GUJARAT,KACHCHH,2021-03-22,25,548,6,579
GUJARAT,KACHCHH,2021-03-23,36,724,26,786
GUJARAT,KACHCHH,2021-03-24,46,700,15,761
GUJARAT,KACHCHH,2021-03-25,35,2095,10,2140
GUJARAT,KHEDA,2021-03-21,15,629,4,648
GUJARAT,KHEDA,2021-03-22,11,857,14,882
GUJARAT,KHEDA,2021-03-23,24,876,53,953
GUJARAT,KHEDA,2021-03-24,56,1003,37,1096
GUJARAT,KHEDA,2021-03-25,83,1926,24,2033
GUJARAT,MAHESANA,2021-03-21,20,246,0,266
GUJARAT,MAHESANA,2021-03-22,12,232,6,250
GUJARAT,MAHESANA,2021-03-23,26,293,8,327
GUJARAT,MAHESANA,2021-03-24,29,395,7,431
GUJARAT,MAHESANA,2021-03-25,39,710,2,751
GUJARAT,MAHISAGAR,2021-03-21,16,139,0,155
GUJARAT,MAHISAGAR,2021-03-22,21,525,6,552
GUJARAT,MAHISAGAR,2021-03-23,47,591,5,643
GUJARAT,MAHISAGAR,2021-03-24,63,533,65,661
GUJARAT,MAHISAGAR,2021-03-25,69,837,64,970
GUJARAT,MORBI,2021-03-21,14,255,1,270
GUJARAT,MORBI,2021-03-22,8,474,2,484
GUJARAT,MORBI,2021-03-23,21,520,1,542
GUJARAT,MORBI,2021-03-24,17,524,0,541
GUJARAT,MORBI,2021-03-25,33,1816,2,1851
GUJARAT,NARMADA,2021-03-21,17,44,0,61
GUJARAT,NARMADA,2021-03-22,21,100,0,121
GUJARAT,NARMADA,2021-03-23,39,118,2,159
GUJARAT,NARMADA,2021-03-24,28,122,7,157
GUJARAT,NARMADA,2021-03-25,39,450,0,489
GUJARAT,NAVSARI,2021-03-21,4,212,0,216
GUJARAT,NAVSARI,2021-03-22,12,399,1,412
GUJARAT,NAVSARI,2021-03-23,17,488,1,506
GUJARAT,NAVSARI,2021-03-24,17,432,4,453
GUJARAT,NAVSARI,2021-03-25,28,1003,0,1031
GUJARAT,PANCH MAHALS,2021-03-21,5,240,1,246
GUJARAT,PANCH MAHALS,2021-03-22,103,346,4,453
GUJARAT,PANCH MAHALS,2021-03-23,34,672,6,712
GUJARAT,PANCH MAHALS,2021-03-24,61,564,2,627
GUJARAT,PANCH MAHALS,2021-03-25,36,1164,6,1206
GUJARAT,PATAN,2021-03-21,11,186,0,197
GUJARAT,PATAN,2021-03-22,15,454,2,471
GUJARAT,PATAN,2021-03-23,25,343,1,369
GUJARAT,PATAN,2021-03-24,28,444,0,472
GUJARAT,PATAN,2021-03-25,47,456,1,504
GUJARAT,PORBANDAR,2021-03-21,0,194,0,194
GUJARAT,PORBANDAR,2021-03-22,0,192,0,192
GUJARAT,PORBANDAR,2021-03-23,1,262,1,264
GUJARAT,PORBANDAR,2021-03-24,2,257,0,259
GUJARAT,PORBANDAR,2021-03-25,1,1777,0,1778
GUJARAT,RAJKOT,2021-03-21,76,670,1,747
GUJARAT,RAJKOT,2021-03-22,118,1600,7,1725
GUJARAT,RAJKOT,2021-03-23,115,1842,0,1957
GUJARAT,RAJKOT,2021-03-24,161,1909,6,2076
GUJARAT,RAJKOT,2021-03-25,181,2822,2,3005
GUJARAT,SABAR KANTHA,2021-03-21,6,147,0,153
GUJARAT,SABAR KANTHA,2021-03-22,14,237,11,262
GUJARAT,SABAR KANTHA,2021-03-23,16,336,28,380
GUJARAT,SABAR KANTHA,2021-03-24,32,285,3,320
GUJARAT,SABAR KANTHA,2021-03-25,17,4242,14,4273
GUJARAT,SURAT,2021-03-21,204,727,34,965
GUJARAT,SURAT,2021-03-22,396,2592,73,3061
GUJARAT,SURAT,2021-03-23,395,4113,9,4517
GUJARAT,SURAT,2021-03-24,471,4909,171,5551
GUJARAT,SURAT,2021-03-25,665,7933,10,8608
GUJARAT,SURENDRANAGAR,2021-03-21,2,110,0,112
GUJARAT,SURENDRANAGAR,2021-03-22,19,309,0,328
GUJARAT,SURENDRANAGAR,2021-03-23,27,394,2,423
GUJARAT,SURENDRANAGAR,2021-03-24,13,158,0,171
GUJARAT,SURENDRANAGAR,2021-03-25,35,484,1,520
GUJARAT,TAPI,2021-03-21,24,226,0,250
GUJARAT,TAPI,2021-03-22,40,297,1,338
GUJARAT,TAPI,2021-03-23,56,166,0,222
GUJARAT,TAPI,2021-03-24,50,341,11,402
GUJARAT,TAPI,2021-03-25,52,482,1,535
GUJARAT,VADODARA,2021-03-21,160,1135,106,1401
GUJARAT,VADODARA,2021-03-22,246,1412,90,1748
GUJARAT,VADODARA,2021-03-23,202,1544,113,1859
GUJARAT,VADODARA,2021-03-24,236,1844,163,2243
GUJARAT,VADODARA,2021-03-25,267,3293,47,3607
GUJARAT,VALSAD,2021-03-21,26,276,0,302
GUJARAT,VALSAD,2021-03-22,27,482,0,509
GUJARAT,VALSAD,2021-03-23,48,716,0,764
GUJARAT,VALSAD,2021-03-24,30,685,0,715
GUJARAT,VALSAD,2021-03-25,36,1733,2,1771
HARYANA,AMBALA,2021-03-21,104,629,18,751
HARYANA,AMBALA,2021-03-22,132,684,21,837
HARYANA,AMBALA,2021-03-23,191,940,51,1182
HARYANA,AMBALA,2021-03-24,135,686,22,843
HARYANA,AMBALA,2021-03-25,179,1484,32,1695
HARYANA,BHIWANI,2021-03-21,7,274,0,281
HARYANA,BHIWANI,2021-03-22,5,268,0,273
HARYANA,BHIWANI,2021-03-23,6,103,0,109
HARYANA,BHIWANI,2021-03-24,5,249,0,254
HARYANA,BHIWANI,2021-03-25,3,404,0,407
HARYANA,CHARKI DADRI,2021-03-21,0,280,0,280
HARYANA,CHARKI DADRI,2021-03-22,3,571,3,577
HARYANA,CHARKI DADRI,2021-03-23,0,194,1,195
HARYANA,CHARKI DADRI,2021-03-24,1,482,1,484
HARYANA,CHARKI DADRI,2021-03-25,5,713,0,718
HARYANA,FARIDABAD,2021-03-21,49,617,2,668
HARYANA,FARIDABAD,2021-03-22,62,778,1,841
HARYANA,FARIDABAD,2021-03-23,87,896,2,985
HARYANA,FARIDABAD,2021-03-24,115,929,1,1045
HARYANA,FARIDABAD,2021-03-25,90,1188,2,1280
HARYANA,FATEHABAD,2021-03-21,36,162,0,198
HARYANA,FATEHABAD,2021-03-22,3,554,1,558
HARYANA,FATEHABAD,2021-03-23,5,291,0,296
HARYANA,FATEHABAD,2021-03-24,40,217,22,279
HARYANA,FATEHABAD,2021-03-25,54,335,0,389
HARYANA,GURUGRAM,2021-03-21,171,3486,31,3688
HARYANA,GURUGRAM,2021-03-22,223,3640,24,3887
HARYANA,GURUGRAM,2021-03-23,235,3586,14,3835
HARYANA,GURUGRAM,2021-03-24,326,4402,26,4754
HARYANA,GURUGRAM,2021-03-25,338,4893,14,5245
HARYANA,HISAR,2021-03-21,13,760,0,773
HARYANA,HISAR,2021-03-22,14,1420,0,1434
HARYANA,HISAR,2021-03-23,22,1151,1,1174
HARYANA,HISAR,2021-03-24,16,1004,0,1020
HARYANA,HISAR,2021-03-25,47,1260,0,1307
HARYANA,JHAJJAR,2021-03-21,6,733,1,740
HARYANA,JHAJJAR,2021-03-22,6,520,0,526
HARYANA,JHAJJAR,2021-03-23,8,566,1,575
HARYANA,JHAJJAR,2021-03-24,12,724,2,738
HARYANA,JHAJJAR,2021-03-25,10,1017,4,1031
HARYANA,JIND,2021-03-21,36,457,1,494
HARYANA,JIND,2021-03-22,24,465,8,497
HARYANA,JIND,2021-03-23,9,350,2,361
HARYANA,JIND,2021-03-24,55,660,2,717
HARYANA,JIND,2021-03-25,39,618,0,657
HARYANA,KAITHAL,2021-03-21,11,133,1,145
HARYANA,KAITHAL,2021-03-22,18,278,1,297
HARYANA,KAITHAL,2021-03-23,40,367,0,407
HARYANA,KAITHAL,2021-03-24,23,569,2,594
HARYANA,KAITHAL,2021-03-25,62,316,3,381
HARYANA,KARNAL,2021-03-21,29,155,1,185
HARYANA,KARNAL,2021-03-22,241,419,0,660
HARYANA,KARNAL,2021-03-23,35,233,0,268
HARYANA,KARNAL,2021-03-24,244,428,0,672
HARYANA,KARNAL,2021-03-25,122,947,1,1070
HARYANA,KURUKSHETRA,2021-03-21,104,158,0,262
HARYANA,KURUKSHETRA,2021-03-22,110,1035,2,1147
HARYANA,KURUKSHETRA,2021-03-23,101,861,3,965
HARYANA,KURUKSHETRA,2021-03-24,63,820,2,885
HARYANA,KURUKSHETRA,2021-03-25,111,823,5,939
HARYANA,MAHENDRAGARH,2021-03-21,0,122,2,124
HARYANA,MAHENDRAGARH,2021-03-22,11,529,0,540
HARYANA,MAHENDRAGARH,2021-03-23,0,211,0,211
HARYANA,MAHENDRAGARH,2021-03-24,1,620,2,623
HARYANA,MAHENDRAGARH,2021-03-25,0,501,0,501
HARYANA,NUH,2021-03-21,0,258,0,258
HARYANA,NUH,2021-03-22,0,411,1,412
HARYANA,NUH,2021-03-23,0,14,1,15
HARYANA,NUH,2021-03-24,0,26,1,27
HARYANA,NUH,2021-03-25,0,26,0,26
HARYANA,PALWAL,2021-03-21,2,48,0,50
HARYANA,PALWAL,2021-03-22,7,100,4,111
HARYANA,PALWAL,2021-03-23,2,49,0,51
HARYANA,PALWAL,2021-03-24,1,88,0,89
HARYANA,PALWAL,2021-03-25,4,464,0,468
HARYANA,PANCHKULA,2021-03-21,73,286,6,365
HARYANA,PANCHKULA,2021-03-22,279,847,15,1141
HARYANA,PANCHKULA,2021-03-23,232,942,14,1188
HARYANA,PANCHKULA,2021-03-24,111,2507,9,2627
HARYANA,PANCHKULA,2021-03-25,168,2093,4,2265
HARYANA,PANIPAT,2021-03-21,29,330,1,360
HARYANA,PANIPAT,2021-03-22,39,841,0,880
HARYANA,PANIPAT,2021-03-23,50,1138,0,1188
HARYANA,PANIPAT,2021-03-24,79,923,2,1004
HARYANA,PANIPAT,2021-03-25,56,921,2,979
HARYANA,REWARI,2021-03-21,8,742,1,751
HARYANA,REWARI,2021-03-22,6,1274,9,1289
HARYANA,REWARI,2021-03-23,5,612,11,628
HARYANA,REWARI,2021-03-24,4,449,4,457
HARYANA,REWARI,2021-03-25,2,527,0,529
HARYANA,ROHTAK,2021-03-21,10,581,0,591
HARYANA,ROHTAK,2021-03-22,34,702,0,736
HARYANA,ROHTAK,2021-03-23,1,548,4,553
HARYANA,ROHTAK,2021-03-24,27,1168,3,1198
HARYANA,ROHTAK,2021-03-25,45,915,1,961
HARYANA,SIRSA,2021-03-21,14,869,0,883
HARYANA,SIRSA,2021-03-22,17,931,3,951
HARYANA,SIRSA,2021-03-23,12,1137,29,1178
HARYANA,SIRSA,2021-03-24,19,410,0,429
HARYANA,SIRSA,2021-03-25,14,738,3,755
HARYANA,SONIPAT,2021-03-21,36,287,1,324
HARYANA,SONIPAT,2021-03-22,25,1255,1,1281
HARYANA,SONIPAT,2021-03-23,48,799,0,847
HARYANA,SONIPAT,2021-03-24,31,470,0,501
HARYANA,SONIPAT,2021-03-25,54,383,1,438
HARYANA,YAMUNANAGAR,2021-03-21,177,201,1,379
HARYANA,YAMUNANAGAR,2021-03-22,119,618,0,737
HARYANA,YAMUNANAGAR,2021-03-23,27,915,5,947
HARYANA,YAMUNANAGAR,2021-03-24,120,581,1,702
HARYANA,YAMUNANAGAR,2021-03-25,118,823,1,942
HIMACHAL PRADESH,BILASPUR,2021-03-21,3,143,1,147
HIMACHAL PRADESH,BILASPUR,2021-03-22,9,415,0,424
HIMACHAL PRADESH,BILASPUR,2021-03-23,15,431,2,448
HIMACHAL PRADESH,BILASPUR,2021-03-24,19,286,0,305
HIMACHAL PRADESH,BILASPUR,2021-03-25,15,383,3,401
HIMACHAL PRADESH,CHAMBA,2021-03-21,0,53,0,53
HIMACHAL PRADESH,CHAMBA,2021-03-22,2,566,16,584
HIMACHAL PRADESH,CHAMBA,2021-03-23,3,569,7,579
HIMACHAL PRADESH,CHAMBA,2021-03-24,0,700,3,703
HIMACHAL PRADESH,CHAMBA,2021-03-25,9,827,7,843
HIMACHAL PRADESH,HAMIRPUR,2021-03-21,6,466,3,475
HIMACHAL PRADESH,HAMIRPUR,2021-03-22,16,1231,0,1247
HIMACHAL PRADESH,HAMIRPUR,2021-03-23,35,443,2,480
HIMACHAL PRADESH,HAMIRPUR,2021-03-24,30,342,1,373
HIMACHAL PRADESH,HAMIRPUR,2021-03-25,66,336,1,403
HIMACHAL PRADESH,KANGRA,2021-03-21,25,563,0,588
HIMACHAL PRADESH,KANGRA,2021-03-22,38,1594,4,1636
HIMACHAL PRADESH,KANGRA,2021-03-23,25,674,1,700
HIMACHAL PRADESH,KANGRA,2021-03-24,57,622,0,679
HIMACHAL PRADESH,KANGRA,2021-03-25,47,1104,14,1165
HIMACHAL PRADESH,KINNAUR,2021-03-21,0,1,0,1
HIMACHAL PRADESH,KINNAUR,2021-03-22,0,57,0,57
HIMACHAL PRADESH,KINNAUR,2021-03-23,4,35,0,39
HIMACHAL PRADESH,KINNAUR,2021-03-24,0,34,0,34
HIMACHAL PRADESH,KINNAUR,2021-03-25,0,51,0,51
HIMACHAL PRADESH,KULLU,2021-03-21,2,40,8,50
HIMACHAL PRADESH,KULLU,2021-03-22,0,102,3,105
HIMACHAL PRADESH,KULLU,2021-03-23,2,221,0,223
HIMACHAL PRADESH,KULLU,2021-03-24,0,107,1,108
HIMACHAL PRADESH,KULLU,2021-03-25,15,117,2,134
HIMACHAL PRADESH,LAHUL AND SPITI,2021-03-21,0,2,0,2
HIMACHAL PRADESH,LAHUL AND SPITI,2021-03-22,0,1,0,1
HIMACHAL PRADESH,LAHUL AND SPITI,2021-03-23,0,2,0,2
HIMACHAL PRADESH,LAHUL AND SPITI,2021-03-24,1,0,0,1
HIMACHAL PRADESH,LAHUL AND SPITI,2021-03-25,0,1,0,1
HIMACHAL PRADESH,MANDI,2021-03-21,12,133,36,181
HIMACHAL PRADESH,MANDI,2021-03-22,7,290,6,303
HIMACHAL PRADESH,MANDI,2021-03-23,9,279,9,297
HIMACHAL PRADESH,MANDI,2021-03-24,11,307,7,325
HIMACHAL PRADESH,MANDI,2021-03-25,5,311,2,318
HIMACHAL PRADESH,SHIMLA,2021-03-21,17,284,7,308
HIMACHAL PRADESH,SHIMLA,2021-03-22,14,468,29,511
HIMACHAL PRADESH,SHIMLA,2021-03-23,20,622,6,648
HIMACHAL PRADESH,SHIMLA,2021-03-24,20,713,14,747
HIMACHAL PRADESH,SHIMLA,2021-03-25,23,819,19,861
HIMACHAL PRADESH,SIRMAUR,2021-03-21,19,126,0,145
HIMACHAL PRADESH,SIRMAUR,2021-03-22,8,193,2,203
HIMACHAL PRADESH,SIRMAUR,2021-03-23,33,523,2,558
HIMACHAL PRADESH,SIRMAUR,2021-03-24,37,470,4,511
HIMACHAL PRADESH,SIRMAUR,2021-03-25,34,744,7,785
HIMACHAL PRADESH,SOLAN,2021-03-21,24,479,0,503
HIMACHAL PRADESH,SOLAN,2021-03-22,7,388,2,397
HIMACHAL PRADESH,SOLAN,2021-03-23,41,702,4,747
HIMACHAL PRADESH,SOLAN,2021-03-24,62,568,0,630
HIMACHAL PRADESH,SOLAN,2021-03-25,50,726,2,778
HIMACHAL PRADESH,UNA,2021-03-21,25,338,1,364
HIMACHAL PRADESH,UNA,2021-03-22,36,348,1,385
HIMACHAL PRADESH,UNA,2021-03-23,88,910,6,1004
HIMACHAL PRADESH,UNA,2021-03-24,105,791,0,896
HIMACHAL PRADESH,UNA,2021-03-25,55,464,0,519
INDIA,INDIA,2021-03-21,8,2,0,10
INDIA,INDIA,2021-03-22,29,1,0,30
INDIA,INDIA,2021-03-23,22,1,0,23
INDIA,INDIA,2021-03-24,26,3,0,29
INDIA,INDIA,2021-03-25,27,3,0,30
JAMMU AND KASHMIR,ANANTNAG,2021-03-21,1,194,1,196
JAMMU AND KASHMIR,ANANTNAG,2021-03-22,3,287,0,290
JAMMU AND KASHMIR,ANANTNAG,2021-03-23,2,294,0,296
JAMMU AND KASHMIR,ANANTNAG,2021-03-24,13,358,0,371
JAMMU AND KASHMIR,ANANTNAG,2021-03-25,5,368,0,373
JAMMU AND KASHMIR,BANDIPORA,2021-03-21,0,4,0,4
JAMMU AND KASHMIR,BANDIPORA,2021-03-22,2,214,0,216
JAMMU AND KASHMIR,BANDIPORA,2021-03-23,0,310,6,316
JAMMU AND KASHMIR,BANDIPORA,2021-03-24,1,306,3,310
JAMMU AND KASHMIR,BANDIPORA,2021-03-25,0,242,2,244
JAMMU AND KASHMIR,BARAMULLA,2021-03-21,1,79,0,80
JAMMU AND KASHMIR,BARAMULLA,2021-03-22,4,409,0,413
JAMMU AND KASHMIR,BARAMULLA,2021-03-23,18,290,1,309
JAMMU AND KASHMIR,BARAMULLA,2021-03-24,11,369,0,380
JAMMU AND KASHMIR,BARAMULLA,2021-03-25,9,284,0,293
JAMMU AND KASHMIR,BUDGAM,2021-03-21,1,151,0,152
JAMMU AND KASHMIR,BUDGAM,2021-03-22,1,851,0,852
JAMMU AND KASHMIR,BUDGAM,2021-03-23,11,952,0,963
JAMMU AND KASHMIR,BUDGAM,2021-03-24,19,1040,0,1059
JAMMU AND KASHMIR,BUDGAM,2021-03-25,4,795,0,799
JAMMU AND KASHMIR,DODA,2021-03-21,0,30,0,30
JAMMU AND KASHMIR,DODA,2021-03-22,0,20,1,21
JAMMU AND KASHMIR,DODA,2021-03-23,0,16,0,16
JAMMU AND KASHMIR,DODA,2021-03-24,0,27,0,27
JAMMU AND KASHMIR,DODA,2021-03-25,0,15,0,15
JAMMU AND KASHMIR,GANDERBAL,2021-03-21,0,24,0,24
JAMMU AND KASHMIR,GANDERBAL,2021-03-22,0,110,0,110
JAMMU AND KASHMIR,GANDERBAL,2021-03-23,0,168,0,168
JAMMU AND KASHMIR,GANDERBAL,2021-03-24,7,115,0,122
JAMMU AND KASHMIR,GANDERBAL,2021-03-25,0,213,0,213
JAMMU AND KASHMIR,JAMMU,2021-03-21,10,442,2,454
JAMMU AND KASHMIR,JAMMU,2021-03-22,17,792,6,815
JAMMU AND KASHMIR,JAMMU,2021-03-23,24,712,2,738
JAMMU AND KASHMIR,JAMMU,2021-03-24,34,822,1,857
JAMMU AND KASHMIR,JAMMU,2021-03-25,12,677,1,690
JAMMU AND KASHMIR,KATHUA,2021-03-21,0,9,0,9
JAMMU AND KASHMIR,KATHUA,2021-03-22,1,29,0,30
JAMMU AND KASHMIR,KATHUA,2021-03-23,4,79,0,83
JAMMU AND KASHMIR,KATHUA,2021-03-24,4,100,0,104
JAMMU AND KASHMIR,KATHUA,2021-03-25,6,294,0,300
JAMMU AND KASHMIR,KISHTWAR,2021-03-21,0,73,0,73
JAMMU AND KASHMIR,KISHTWAR,2021-03-22,0,36,0,36
JAMMU AND KASHMIR,KISHTWAR,2021-03-23,0,35,0,35
JAMMU AND KASHMIR,KISHTWAR,2021-03-24,0,30,0,30
JAMMU AND KASHMIR,KISHTWAR,2021-03-25,0,18,0,18
JAMMU AND KASHMIR,KULGAM,2021-03-21,0,68,0,68
JAMMU AND KASHMIR,KULGAM,2021-03-22,2,260,0,262
JAMMU AND KASHMIR,KULGAM,2021-03-23,0,376,0,376
JAMMU AND KASHMIR,KULGAM,2021-03-24,2,458,0,460
JAMMU AND KASHMIR,KULGAM,2021-03-25,4,487,0,491
JAMMU AND KASHMIR,KUPWARA,2021-03-21,1,11,0,12
JAMMU AND KASHMIR,KUPWARA,2021-03-22,4,316,0,320
JAMMU AND KASHMIR,KUPWARA,2021-03-23,1,285,0,286
JAMMU AND KASHMIR,KUPWARA,2021-03-24,3,200,0,203
JAMMU AND KASHMIR,KUPWARA,2021-03-25,1,183,0,184
JAMMU AND KASHMIR,POONCH,2021-03-21,0,28,0,28
JAMMU AND KASHMIR,POONCH,2021-03-22,1,271,0,272
JAMMU AND KASHMIR,POONCH,2021-03-23,0,295,0,295
JAMMU AND KASHMIR,POONCH,2021-03-24,5,356,0,361
JAMMU AND KASHMIR,POONCH,2021-03-25,0,226,0,226
JAMMU AND KASHMIR,PULWAMA,2021-03-21,0,120,0,120
JAMMU AND KASHMIR,PULWAMA,2021-03-22,11,791,6,808
JAMMU AND KASHMIR,PULWAMA,2021-03-23,8,869,2,879
JAMMU AND KASHMIR,PULWAMA,2021-03-24,18,540,0,558
JAMMU AND KASHMIR,PULWAMA,2021-03-25,18,509,1,528
JAMMU AND KASHMIR,RAJOURI,2021-03-21,0,93,1,94
JAMMU AND KASHMIR,RAJOURI,2021-03-22,1,136,0,137
JAMMU AND KASHMIR,RAJOURI,2021-03-23,1,205,2,208
JAMMU AND KASHMIR,RAJOURI,2021-03-24,1,216,0,217
JAMMU AND KASHMIR,RAJOURI,2021-03-25,1,104,0,105
JAMMU AND KASHMIR,RAMBAN,2021-03-21,0,99,0,99
JAMMU AND KASHMIR,RAMBAN,2021-03-22,0,61,0,61
JAMMU AND KASHMIR,RAMBAN,2021-03-23,0,135,0,135
JAMMU AND KASHMIR,RAMBAN,2021-03-24,0,43,0,43
JAMMU AND KASHMIR,RAMBAN,2021-03-25,1,124,0,125
JAMMU AND KASHMIR,REASI,2021-03-21,0,6,0,6
JAMMU AND KASHMIR,REASI,2021-03-22,2,94,0,96
JAMMU AND KASHMIR,REASI,2021-03-23,1,105,0,106
JAMMU AND KASHMIR,REASI,2021-03-24,8,103,0,111
JAMMU AND KASHMIR,REASI,2021-03-25,1,62,0,63
JAMMU AND KASHMIR,SAMBA,2021-03-21,1,88,0,89
JAMMU AND KASHMIR,SAMBA,2021-03-22,0,225,0,225
JAMMU AND KASHMIR,SAMBA,2021-03-23,0,138,0,138
JAMMU AND KASHMIR,SAMBA,2021-03-24,2,130,0,132
JAMMU AND KASHMIR,SAMBA,2021-03-25,1,45,0,46
JAMMU AND KASHMIR,SHOPIAN,2021-03-21,0,181,0,181
JAMMU AND KASHMIR,SHOPIAN,2021-03-22,0,92,0,92
JAMMU AND KASHMIR,SHOPIAN,2021-03-23,0,242,0,242
JAMMU AND KASHMIR,SHOPIAN,2021-03-24,0,233,0,233
JAMMU AND KASHMIR,SHOPIAN,2021-03-25,1,328,1,330
JAMMU AND KASHMIR,SRINAGAR,2021-03-21,16,1756,0,1772
JAMMU AND KASHMIR,SRINAGAR,2021-03-22,107,4240,15,4362
JAMMU AND KASHMIR,SRINAGAR,2021-03-23,45,4733,3,4781
JAMMU AND KASHMIR,SRINAGAR,2021-03-24,86,4016,1,4103
JAMMU AND KASHMIR,SRINAGAR,2021-03-25,63,4783,2,4848
JAMMU AND KASHMIR,UDHAMPUR,2021-03-21,0,232,0,232
JAMMU AND KASHMIR,UDHAMPUR,2021-03-22,4,573,0,577
JAMMU AND KASHMIR,UDHAMPUR,2021-03-23,5,827,0,832
JAMMU AND KASHMIR,UDHAMPUR,2021-03-24,3,525,0,528
JAMMU AND KASHMIR,UDHAMPUR,2021-03-25,0,754,0,754
JHARKHAND,BOKARO,2021-03-21,1,152,0,153
JHARKHAND,BOKARO,2021-03-22,5,851,23,879
JHARKHAND,BOKARO,2021-03-23,9,758,1,768
JHARKHAND,BOKARO,2021-03-24,17,676,31,724
JHARKHAND,BOKARO,2021-03-25,20,680,14,714
JHARKHAND,CHATRA,2021-03-21,0,74,0,74
JHARKHAND,CHATRA,2021-03-22,0,132,0,132
JHARKHAND,CHATRA,2021-03-23,0,527,0,527
JHARKHAND,CHATRA,2021-03-24,1,253,14,268
JHARKHAND,CHATRA,2021-03-25,1,443,25,469
JHARKHAND,DEOGHAR,2021-03-21,0,497,0,497
JHARKHAND,DEOGHAR,2021-03-22,5,529,0,534
JHARKHAND,DEOGHAR,2021-03-23,5,548,2,555
JHARKHAND,DEOGHAR,2021-03-24,1,1105,1,1107
JHARKHAND,DEOGHAR,2021-03-25,7,598,0,605
JHARKHAND,DHANBAD,2021-03-21,7,136,0,143
JHARKHAND,DHANBAD,2021-03-22,1,401,0,402
JHARKHAND,DHANBAD,2021-03-23,6,85,1,92
JHARKHAND,DHANBAD,2021-03-24,4,175,0,179
JHARKHAND,DHANBAD,2021-03-25,8,1006,0,1014
JHARKHAND,DUMKA,2021-03-21,1,277,0,278
JHARKHAND,DUMKA,2021-03-22,3,57,1,61
JHARKHAND,DUMKA,2021-03-23,6,840,5,851
JHARKHAND,DUMKA,2021-03-24,7,383,14,404
JHARKHAND,DUMKA,2021-03-25,10,180,13,203
JHARKHAND,EAST SINGHBUM,2021-03-21,9,517,1,527
JHARKHAND,EAST SINGHBUM,2021-03-22,22,2639,3,2664
JHARKHAND,EAST SINGHBUM,2021-03-23,29,2251,1,2281
JHARKHAND,EAST SINGHBUM,2021-03-24,30,1611,1,1642
JHARKHAND,EAST SINGHBUM,2021-03-25,48,2015,1,2064
JHARKHAND,GARHWA,2021-03-21,0,458,1,459
JHARKHAND,GARHWA,2021-03-22,0,179,1,180
JHARKHAND,GARHWA,2021-03-23,0,115,1,116
JHARKHAND,GARHWA,2021-03-24,1,111,0,112
JHARKHAND,GARHWA,2021-03-25,0,158,0,158
JHARKHAND,GIRIDIH,2021-03-21,0,17,0,17
JHARKHAND,GIRIDIH,2021-03-22,0,979,0,979
JHARKHAND,GIRIDIH,2021-03-23,2,1202,0,1204
JHARKHAND,GIRIDIH,2021-03-24,0,1361,0,1361
JHARKHAND,GIRIDIH,2021-03-25,2,421,0,423
JHARKHAND,GODDA,2021-03-21,0,145,0,145
JHARKHAND,GODDA,2021-03-22,1,350,0,351
JHARKHAND,GODDA,2021-03-23,0,90,0,90
JHARKHAND,GODDA,2021-03-24,1,52,0,53
JHARKHAND,GODDA,2021-03-25,2,889,0,891
JHARKHAND,GUMLA,2021-03-21,1,101,0,102
JHARKHAND,GUMLA,2021-03-22,2,440,0,442
JHARKHAND,GUMLA,2021-03-23,12,723,0,735
JHARKHAND,GUMLA,2021-03-24,7,495,0,502
JHARKHAND,GUMLA,2021-03-25,4,125,0,129
JHARKHAND,HAZARIBAGH,2021-03-21,3,31,0,34
JHARKHAND,HAZARIBAGH,2021-03-22,1,677,0,678
JHARKHAND,HAZARIBAGH,2021-03-23,6,790,3,799
JHARKHAND,HAZARIBAGH,2021-03-24,5,698,10,713
JHARKHAND,HAZARIBAGH,2021-03-25,3,274,4,281
JHARKHAND,JAMTARA,2021-03-21,1,78,0,79
JHARKHAND,JAMTARA,2021-03-22,1,276,0,277
JHARKHAND,JAMTARA,2021-03-23,1,90,0,91
JHARKHAND,JAMTARA,2021-03-24,8,263,1,272
JHARKHAND,JAMTARA,2021-03-25,0,150,0,150
JHARKHAND,KHUNTI,2021-03-21,0,51,0,51
JHARKHAND,KHUNTI,2021-03-22,7,420,0,427
JHARKHAND,KHUNTI,2021-03-23,3,511,0,514
JHARKHAND,KHUNTI,2021-03-24,1,204,0,205
JHARKHAND,KHUNTI,2021-03-25,0,162,0,162
JHARKHAND,KODERMA,2021-03-21,0,50,0,50
JHARKHAND,KODERMA,2021-03-22,2,633,0,635
JHARKHAND,KODERMA,2021-03-23,4,513,0,517
JHARKHAND,KODERMA,2021-03-24,0,607,0,607
JHARKHAND,KODERMA,2021-03-25,4,311,2,317
JHARKHAND,LATEHAR,2021-03-21,0,12,0,12
JHARKHAND,LATEHAR,2021-03-22,0,628,2,630
JHARKHAND,LATEHAR,2021-03-23,1,608,0,609
JHARKHAND,LATEHAR,2021-03-24,0,42,0,42
JHARKHAND,LATEHAR,2021-03-25,2,146,0,148
JHARKHAND,LOHARDAGA,2021-03-21,0,38,0,38
JHARKHAND,LOHARDAGA,2021-03-22,1,220,0,221
JHARKHAND,LOHARDAGA,2021-03-23,0,104,0,104
JHARKHAND,LOHARDAGA,2021-03-24,3,49,0,52
JHARKHAND,LOHARDAGA,2021-03-25,1,266,0,267
JHARKHAND,PAKUR,2021-03-21,0,11,0,11
JHARKHAND,PAKUR,2021-03-22,5,859,2,866
JHARKHAND,PAKUR,2021-03-23,2,889,0,891
JHARKHAND,PAKUR,2021-03-24,5,166,0,171
JHARKHAND,PAKUR,2021-03-25,19,785,56,860
JHARKHAND,PALAMU,2021-03-21,1,157,0,158
JHARKHAND,PALAMU,2021-03-22,0,91,0,91
JHARKHAND,PALAMU,2021-03-23,2,187,0,189
JHARKHAND,PALAMU,2021-03-24,2,215,0,217
JHARKHAND,PALAMU,2021-03-25,4,85,0,89
JHARKHAND,RAMGARH,2021-03-21,0,25,0,25
JHARKHAND,RAMGARH,2021-03-22,0,78,0,78
JHARKHAND,RAMGARH,2021-03-23,3,54,0,57
JHARKHAND,RAMGARH,2021-03-24,3,121,0,124
JHARKHAND,RAMGARH,2021-03-25,1,58,0,59
JHARKHAND,RANCHI,2021-03-21,126,546,3,675
JHARKHAND,RANCHI,2021-03-22,170,675,1,846
JHARKHAND,RANCHI,2021-03-23,156,1242,0,1398
JHARKHAND,RANCHI,2021-03-24,172,1087,0,1259
JHARKHAND,RANCHI,2021-03-25,224,1330,0,1554
JHARKHAND,SAHEBGANJ,2021-03-21,0,48,0,48
JHARKHAND,SAHEBGANJ,2021-03-22,6,520,0,526
JHARKHAND,SAHEBGANJ,2021-03-23,5,297,0,302
JHARKHAND,SAHEBGANJ,2021-03-24,0,50,0,50
JHARKHAND,SAHEBGANJ,2021-03-25,6,147,0,153
JHARKHAND,SARAIKELA KHARSAWAN,2021-03-21,0,36,0,36
JHARKHAND,SARAIKELA KHARSAWAN,2021-03-22,0,117,0,117
JHARKHAND,SARAIKELA KHARSAWAN,2021-03-23,0,30,0,30
JHARKHAND,SARAIKELA KHARSAWAN,2021-03-24,0,48,0,48
JHARKHAND,SARAIKELA KHARSAWAN,2021-03-25,1,73,0,74
JHARKHAND,SIMDEGA,2021-03-21,0,245,0,245
JHARKHAND,SIMDEGA,2021-03-22,2,732,0,734
JHARKHAND,SIMDEGA,2021-03-23,0,505,0,505
JHARKHAND,SIMDEGA,2021-03-24,2,637,0,639
JHARKHAND,SIMDEGA,2021-03-25,3,474,0,477
JHARKHAND,WEST SINGHBHUM,2021-03-21,0,469,0,469
JHARKHAND,WEST SINGHBHUM,2021-03-22,3,121,0,124
JHARKHAND,WEST SINGHBHUM,2021-03-23,7,403,0,410
JHARKHAND,WEST SINGHBHUM,2021-03-24,4,217,0,221
JHARKHAND,WEST SINGHBHUM,2021-03-25,9,547,0,556
KARNATAKA,BAGALKOTE,2021-03-21,8,2829,6,2843
KARNATAKA,BAGALKOTE,2021-03-22,6,2153,3,2162
KARNATAKA,BAGALKOTE,2021-03-23,23,2807,0,2830
KARNATAKA,BAGALKOTE,2021-03-24,7,2965,4,2976
KARNATAKA,BAGALKOTE,2021-03-25,11,3331,9,3351
KARNATAKA,BALLARI,2021-03-21,11,2729,10,2750
KARNATAKA,BALLARI,2021-03-22,44,3019,16,3079
KARNATAKA,BALLARI,2021-03-23,34,3019,11,3064
KARNATAKA,BALLARI,2021-03-24,21,2889,19,2929
KARNATAKA,BALLARI,2021-03-25,23,2924,29,2976
KARNATAKA,BELAGAVI,2021-03-21,8,683,2,693
KARNATAKA,BELAGAVI,2021-03-22,12,2166,1,2179
KARNATAKA,BELAGAVI,2021-03-23,19,2273,8,2300
KARNATAKA,BELAGAVI,2021-03-24,32,2160,3,2195
KARNATAKA,BELAGAVI,2021-03-25,30,2519,14,2563
KARNATAKA,BENGALURU RURAL,2021-03-21,12,3186,1,3199
KARNATAKA,BENGALURU RURAL,2021-03-22,41,1775,0,1816
KARNATAKA,BENGALURU RURAL,2021-03-23,65,4273,1,4339
KARNATAKA,BENGALURU RURAL,2021-03-24,26,719,0,745
KARNATAKA,BENGALURU RURAL,2021-03-25,82,1131,2,1215
KARNATAKA,BENGALURU URBAN,2021-03-21,937,30022,22,30981
KARNATAKA,BENGALURU URBAN,2021-03-22,1306,47752,212,49270
KARNATAKA,BENGALURU URBAN,2021-03-23,1497,52244,176,53917
KARNATAKA,BENGALURU URBAN,2021-03-24,1712,50190,332,52234
KARNATAKA,BENGALURU URBAN,2021-03-25,1568,44042,97,45707
KARNATAKA,BIDAR,2021-03-21,64,2013,0,2077
KARNATAKA,BIDAR,2021-03-22,83,2124,2,2209
KARNATAKA,BIDAR,2021-03-23,92,1630,2,1724
KARNATAKA,BIDAR,2021-03-24,94,2117,0,2211
KARNATAKA,BIDAR,2021-03-25,85,2038,0,2123
KARNATAKA,CHAMARAJANAGARA,2021-03-21,2,828,3,833
KARNATAKA,CHAMARAJANAGARA,2021-03-22,0,662,0,662
KARNATAKA,CHAMARAJANAGARA,2021-03-23,8,1071,5,1084
KARNATAKA,CHAMARAJANAGARA,2021-03-24,4,1297,2,1303
KARNATAKA,CHAMARAJANAGARA,2021-03-25,1,1266,1,1268
KARNATAKA,CHIKKABALLAPURA,2021-03-21,4,1254,1,1259
KARNATAKA,CHIKKABALLAPURA,2021-03-22,13,2308,1,2322
KARNATAKA,CHIKKABALLAPURA,2021-03-23,4,1343,0,1347
KARNATAKA,CHIKKABALLAPURA,2021-03-24,14,1297,8,1319
KARNATAKA,CHIKKABALLAPURA,2021-03-25,3,1563,3,1569
KARNATAKA,CHIKKAMAGALURU,2021-03-21,6,832,0,838
KARNATAKA,CHIKKAMAGALURU,2021-03-22,5,502,0,507
KARNATAKA,CHIKKAMAGALURU,2021-03-23,16,981,4,1001
KARNATAKA,CHIKKAMAGALURU,2021-03-24,11,826,1,838
KARNATAKA,CHIKKAMAGALURU,2021-03-25,7,919,0,926
KARNATAKA,CHITRADURGA,2021-03-21,5,1363,6,1374
KARNATAKA,CHITRADURGA,2021-03-22,6,916,0,922
KARNATAKA,CHITRADURGA,2021-03-23,9,704,1,714
KARNATAKA,CHITRADURGA,2021-03-24,8,1438,2,1448
KARNATAKA,CHITRADURGA,2021-03-25,14,1539,1,1554
KARNATAKA,DAKSHINA KANNADA,2021-03-21,23,982,0,1005
KARNATAKA,DAKSHINA KANNADA,2021-03-22,79,2646,10,2735
KARNATAKA,DAKSHINA KANNADA,2021-03-23,67,2744,4,2815
KARNATAKA,DAKSHINA KANNADA,2021-03-24,82,2962,2,3046
KARNATAKA,DAKSHINA KANNADA,2021-03-25,86,2645,7,2738
KARNATAKA,DAVANGERE,2021-03-21,5,1844,74,1923
KARNATAKA,DAVANGERE,2021-03-22,7,1880,4,1891
KARNATAKA,DAVANGERE,2021-03-23,10,1606,16,1632
KARNATAKA,DAVANGERE,2021-03-24,3,768,35,806
KARNATAKA,DAVANGERE,2021-03-25,5,1417,25,1447
KARNATAKA,DHARWAD,2021-03-21,14,1675,19,1708
KARNATAKA,DHARWAD,2021-03-22,19,2702,109,2830
KARNATAKA,DHARWAD,2021-03-23,41,2401,3,2445
KARNATAKA,DHARWAD,2021-03-24,31,3145,21,3197
KARNATAKA,DHARWAD,2021-03-25,70,4498,9,4577
KARNATAKA,GADAG,2021-03-21,8,1112,42,1162
KARNATAKA,GADAG,2021-03-22,2,843,369,1214
KARNATAKA,GADAG,2021-03-23,7,1265,124,1396
KARNATAKA,GADAG,2021-03-24,19,1474,183,1676
KARNATAKA,GADAG,2021-03-25,15,1212,97,1324
KARNATAKA,HASSAN,2021-03-21,22,1621,4,1647
KARNATAKA,HASSAN,2021-03-22,24,2585,22,2631
KARNATAKA,HASSAN,2021-03-23,63,1263,68,1394
KARNATAKA,HASSAN,2021-03-24,50,1689,13,1752
KARNATAKA,HASSAN,2021-03-25,38,7548,10,7596
KARNATAKA,HAVERI,2021-03-21,3,598,0,601
KARNATAKA,HAVERI,2021-03-22,4,697,0,701
KARNATAKA,HAVERI,2021-03-23,0,663,1,664
KARNATAKA,HAVERI,2021-03-24,3,508,0,511
KARNATAKA,HAVERI,2021-03-25,5,585,1,591
KARNATAKA,KALABURAGI,2021-03-21,63,2911,8,2982
KARNATAKA,KALABURAGI,2021-03-22,123,3412,7,3542
KARNATAKA,KALABURAGI,2021-03-23,85,1908,2,1995
KARNATAKA,KALABURAGI,2021-03-24,201,3711,5,3917
KARNATAKA,KALABURAGI,2021-03-25,182,3435,23,3640
KARNATAKA,KODAGU,2021-03-21,1,23,0,24
KARNATAKA,KODAGU,2021-03-22,16,589,35,640
KARNATAKA,KODAGU,2021-03-23,16,695,93,804
KARNATAKA,KODAGU,2021-03-24,12,908,17,937
KARNATAKA,KODAGU,2021-03-25,11,1288,24,1323
KARNATAKA,KOLAR,2021-03-21,19,2656,28,2703
KARNATAKA,KOLAR,2021-03-22,10,1249,3,1262
KARNATAKA,KOLAR,2021-03-23,33,1624,0,1657
KARNATAKA,KOLAR,2021-03-24,24,2043,0,2067
KARNATAKA,KOLAR,2021-03-25,39,1869,0,1908
KARNATAKA,KOPPAL,2021-03-21,3,459,5,467
KARNATAKA,KOPPAL,2021-03-22,3,532,0,535
KARNATAKA,KOPPAL,2021-03-23,7,881,4,892
KARNATAKA,KOPPAL,2021-03-24,4,669,0,673
KARNATAKA,KOPPAL,2021-03-25,4,852,4,860
KARNATAKA,MANDYA,2021-03-21,19,1417,5,1441
KARNATAKA,MANDYA,2021-03-22,20,1538,14,1572
KARNATAKA,MANDYA,2021-03-23,19,2018,9,2046
KARNATAKA,MANDYA,2021-03-24,38,2055,3,2096
KARNATAKA,MANDYA,2021-03-25,35,2156,3,2194
KARNATAKA,MYSURU,2021-03-21,76,3988,3,4067
KARNATAKA,MYSURU,2021-03-22,83,2538,3,2624
KARNATAKA,MYSURU,2021-03-23,87,4757,12,4856
KARNATAKA,MYSURU,2021-03-24,100,5634,1,5735
KARNATAKA,MYSURU,2021-03-25,106,5631,2,5739
KARNATAKA,RAICHUR,2021-03-21,8,839,10,857
KARNATAKA,RAICHUR,2021-03-22,20,929,5,954
KARNATAKA,RAICHUR,2021-03-23,13,874,3,890
KARNATAKA,RAICHUR,2021-03-24,15,1167,36,1218
KARNATAKA,RAICHUR,2021-03-25,16,1220,13,1249
KARNATAKA,RAMANAGARA,2021-03-21,1,50,0,51
KARNATAKA,RAMANAGARA,2021-03-22,1,645,0,646
KARNATAKA,RAMANAGARA,2021-03-23,3,774,0,777
KARNATAKA,RAMANAGARA,2021-03-24,11,189,1,201
KARNATAKA,RAMANAGARA,2021-03-25,2,800,0,802
KARNATAKA,SHIVAMOGGA,2021-03-21,0,1128,0,1128
KARNATAKA,SHIVAMOGGA,2021-03-22,24,1510,8,1542
KARNATAKA,SHIVAMOGGA,2021-03-23,15,2033,26,2074
KARNATAKA,SHIVAMOGGA,2021-03-24,20,1561,14,1595
KARNATAKA,SHIVAMOGGA,2021-03-25,14,1919,14,1947
KARNATAKA,TUMAKURU,2021-03-21,53,1995,7,2055
KARNATAKA,TUMAKURU,2021-03-22,48,2919,0,2967
KARNATAKA,TUMAKURU,2021-03-23,90,2155,12,2257
KARNATAKA,TUMAKURU,2021-03-24,33,2989,23,3045
KARNATAKA,TUMAKURU,2021-03-25,142,1633,4,1779
KARNATAKA,UDUPI,2021-03-21,118,2620,2,2740
KARNATAKA,UDUPI,2021-03-22,28,1824,1,1853
KARNATAKA,UDUPI,2021-03-23,82,2239,3,2324
KARNATAKA,UDUPI,2021-03-24,144,2724,1,2869
KARNATAKA,UDUPI,2021-03-25,215,3910,3,4128
KARNATAKA,UTTARA KANNADA,2021-03-21,11,1263,75,1349
KARNATAKA,UTTARA KANNADA,2021-03-22,12,736,69,817
KARNATAKA,UTTARA KANNADA,2021-03-23,18,1356,188,1562
KARNATAKA,UTTARA KANNADA,2021-03-24,11,1460,79,1550
KARNATAKA,UTTARA KANNADA,2021-03-25,17,1281,40,1338
KARNATAKA,VIJAYAPURA,2021-03-21,10,2467,0,2477
KARNATAKA,VIJAYAPURA,2021-03-22,19,2026,0,2045
KARNATAKA,VIJAYAPURA,2021-03-23,50,2158,1,2209
KARNATAKA,VIJAYAPURA,2021-03-24,35,2444,0,2479
KARNATAKA,VIJAYAPURA,2021-03-25,46,2776,1,2823
KARNATAKA,YADGIR,2021-03-21,5,1026,0,1031
KARNATAKA,YADGIR,2021-03-22,7,653,0,660
KARNATAKA,YADGIR,2021-03-23,8,1142,0,1150
KARNATAKA,YADGIR,2021-03-24,9,921,0,930
KARNATAKA,YADGIR,2021-03-25,15,1073,0,1088
KERALA,ALAPPUZHA,2021-03-21,129,4992,49,5170
KERALA,ALAPPUZHA,2021-03-22,374,5662,24,6060
KERALA,ALAPPUZHA,2021-03-23,218,3836,15,4069
KERALA,ALAPPUZHA,2021-03-24,109,3434,16,3559
KERALA,ALAPPUZHA,2021-03-25,120,3128,12,3260
KERALA,ERNAKULAM,2021-03-21,115,9433,106,9654
KERALA,ERNAKULAM,2021-03-22,466,10663,50,11179
KERALA,ERNAKULAM,2021-03-23,540,8536,51,9127
KERALA,ERNAKULAM,2021-03-24,231,7274,60,7565
KERALA,ERNAKULAM,2021-03-25,218,8299,35,8552
KERALA,IDUKKI,2021-03-21,112,2052,20,2184
KERALA,IDUKKI,2021-03-22,124,1813,15,1952
KERALA,IDUKKI,2021-03-23,99,1732,12,1843
KERALA,IDUKKI,2021-03-24,110,1464,7,1581
KERALA,IDUKKI,2021-03-25,66,1359,8,1433
KERALA,KANNUR,2021-03-21,200,5032,39,5271
KERALA,KANNUR,2021-03-22,256,5132,19,5407
KERALA,KANNUR,2021-03-23,382,4827,56,5265
KERALA,KANNUR,2021-03-24,328,3468,10,3806
KERALA,KANNUR,2021-03-25,201,3468,19,3688
KERALA,KASARAGOD,2021-03-21,89,2352,31,2472
KERALA,KASARAGOD,2021-03-22,127,2381,28,2536
KERALA,KASARAGOD,2021-03-23,165,2438,27,2630
KERALA,KASARAGOD,2021-03-24,132,2308,30,2470
KERALA,KASARAGOD,2021-03-25,95,2011,32,2138
KERALA,KOLLAM,2021-03-21,82,5151,25,5258
KERALA,KOLLAM,2021-03-22,437,6197,65,6699
KERALA,KOLLAM,2021-03-23,403,5024,44,5471
KERALA,KOLLAM,2021-03-24,187,3860,51,4098
KERALA,KOLLAM,2021-03-25,159,3521,32,3712
KERALA,KOTTAYAM,2021-03-21,132,4975,49,5156
KERALA,KOTTAYAM,2021-03-22,255,4823,13,5091
KERALA,KOTTAYAM,2021-03-23,301,4285,52,4638
KERALA,KOTTAYAM,2021-03-24,181,3400,27,3608
KERALA,KOTTAYAM,2021-03-25,151,3044,22,3217
KERALA,KOZHIKODE,2021-03-21,197,7147,131,7475
KERALA,KOZHIKODE,2021-03-22,456,8555,25,9036
KERALA,KOZHIKODE,2021-03-23,448,6326,106,6880
KERALA,KOZHIKODE,2021-03-24,417,5220,52,5689
KERALA,KOZHIKODE,2021-03-25,304,4427,42,4773
KERALA,MALAPPURAM,2021-03-21,81,7805,105,7991
KERALA,MALAPPURAM,2021-03-22,847,6073,22,6942
KERALA,MALAPPURAM,2021-03-23,242,5488,53,5783
KERALA,MALAPPURAM,2021-03-24,266,4591,15,4872
KERALA,MALAPPURAM,2021-03-25,146,4040,5,4191
KERALA,PALAKKAD,2021-03-21,69,4225,37,4331
KERALA,PALAKKAD,2021-03-22,230,5019,15,5264
KERALA,PALAKKAD,2021-03-23,248,4231,67,4546
KERALA,PALAKKAD,2021-03-24,102,3081,3,3186
KERALA,PALAKKAD,2021-03-25,84,2682,2,2768
KERALA,PATHANAMTHITTA,2021-03-21,48,4735,77,4860
KERALA,PATHANAMTHITTA,2021-03-22,123,3518,8,3649
KERALA,PATHANAMTHITTA,2021-03-23,249,3257,20,3526
KERALA,PATHANAMTHITTA,2021-03-24,95,2469,4,2568
KERALA,PATHANAMTHITTA,2021-03-25,93,2293,3,2389
KERALA,THIRUVANANTHAPURAM,2021-03-21,174,8236,42,8452
KERALA,THIRUVANANTHAPURAM,2021-03-22,629,9079,35,9743
KERALA,THIRUVANANTHAPURAM,2021-03-23,414,6612,57,7083
KERALA,THIRUVANANTHAPURAM,2021-03-24,313,6054,30,6397
KERALA,THIRUVANANTHAPURAM,2021-03-25,235,6532,59,6826
KERALA,THRISSUR,2021-03-21,149,7321,18,7488
KERALA,THRISSUR,2021-03-22,428,9937,15,10380
KERALA,THRISSUR,2021-03-23,462,8814,29,9305
KERALA,THRISSUR,2021-03-24,172,6698,3,6873
KERALA,THRISSUR,2021-03-25,117,4563,8,4688
KERALA,WAYANAD,2021-03-21,11,1605,16,1632
KERALA,WAYANAD,2021-03-22,110,2036,11,2157
KERALA,WAYANAD,2021-03-23,110,1565,22,1697
KERALA,WAYANAD,2021-03-24,71,1225,10,1306
KERALA,WAYANAD,2021-03-25,47,782,9,838
LADAKH,KARGIL,2021-03-21,0,21,0,21
LADAKH,KARGIL,2021-03-22,0,168,0,168
LADAKH,KARGIL,2021-03-23,0,312,0,312
LADAKH,KARGIL,2021-03-24,0,102,0,102
LADAKH,KARGIL,2021-03-25,1,127,0,128
LADAKH,LEH LADAKH,2021-03-21,1,142,0,143
LADAKH,LEH LADAKH,2021-03-22,15,525,2,542
LADAKH,LEH LADAKH,2021-03-23,9,436,2,447
LADAKH,LEH LADAKH,2021-03-24,11,379,0,390
LADAKH,LEH LADAKH,2021-03-25,4,287,0,291
LAKSHADWEEP,LAKSHADWEEP DISTRICT,2021-03-21,1,87,0,88
LAKSHADWEEP,LAKSHADWEEP DISTRICT,2021-03-22,7,305,0,312
LAKSHADWEEP,LAKSHADWEEP DISTRICT,2021-03-23,0,210,0,210
LAKSHADWEEP,LAKSHADWEEP DISTRICT,2021-03-24,3,473,0,476
LAKSHADWEEP,LAKSHADWEEP DISTRICT,2021-03-25,5,264,0,269
MADHYA PRADESH,AGAR MALWA,2021-03-21,1,181,0,182
MADHYA PRADESH,AGAR MALWA,2021-03-22,7,215,0,222
MADHYA PRADESH,AGAR MALWA,2021-03-23,4,473,0,477
MADHYA PRADESH,AGAR MALWA,2021-03-24,8,258,0,266
MADHYA PRADESH,AGAR MALWA,2021-03-25,4,315,0,319
MADHYA PRADESH,ALIRAJPUR,2021-03-21,1,44,0,45
MADHYA PRADESH,ALIRAJPUR,2021-03-22,16,329,0,345
MADHYA PRADESH,ALIRAJPUR,2021-03-23,6,349,0,355
MADHYA PRADESH,ALIRAJPUR,2021-03-24,10,273,0,283
MADHYA PRADESH,ALIRAJPUR,2021-03-25,7,521,0,528
MADHYA PRADESH,ANUPPUR,2021-03-21,2,136,0,138
MADHYA PRADESH,ANUPPUR,2021-03-22,4,132,0,136
MADHYA PRADESH,ANUPPUR,2021-03-23,1,18,0,19
MADHYA PRADESH,ANUPPUR,2021-03-24,0,20,0,20
MADHYA PRADESH,ANUPPUR,2021-03-25,8,40,0,48
MADHYA PRADESH,ASHOKNAGAR,2021-03-21,4,139,1,144
MADHYA PRADESH,ASHOKNAGAR,2021-03-22,1,74,0,75
MADHYA PRADESH,ASHOKNAGAR,2021-03-23,6,55,0,61
MADHYA PRADESH,ASHOKNAGAR,2021-03-24,2,57,0,59
MADHYA PRADESH,ASHOKNAGAR,2021-03-25,5,286,0,291
MADHYA PRADESH,BALAGHAT,2021-03-21,8,276,1,285
MADHYA PRADESH,BALAGHAT,2021-03-22,10,422,0,432
MADHYA PRADESH,BALAGHAT,2021-03-23,8,411,0,419
MADHYA PRADESH,BALAGHAT,2021-03-24,23,387,0,410
MADHYA PRADESH,BALAGHAT,2021-03-25,43,437,2,482
MADHYA PRADESH,BARWANI,2021-03-21,11,156,0,167
MADHYA PRADESH,BARWANI,2021-03-22,24,155,0,179
MADHYA PRADESH,BARWANI,2021-03-23,28,180,0,208
MADHYA PRADESH,BARWANI,2021-03-24,35,347,2,384
MADHYA PRADESH,BARWANI,2021-03-25,57,261,0,318
MADHYA PRADESH,BETUL,2021-03-21,93,310,3,406
MADHYA PRADESH,BETUL,2021-03-22,89,275,0,364
MADHYA PRADESH,BETUL,2021-03-23,16,274,4,294
MADHYA PRADESH,BETUL,2021-03-24,84,118,3,205
MADHYA PRADESH,BETUL,2021-03-25,62,357,2,421
MADHYA PRADESH,BHIND,2021-03-21,2,313,1,316
MADHYA PRADESH,BHIND,2021-03-22,0,333,0,333
MADHYA PRADESH,BHIND,2021-03-23,3,135,0,138
MADHYA PRADESH,BHIND,2021-03-24,4,263,0,267
MADHYA PRADESH,BHIND,2021-03-25,3,349,0,352
MADHYA PRADESH,BHOPAL,2021-03-21,525,1320,67,1912
MADHYA PRADESH,BHOPAL,2021-03-22,499,2161,141,2801
MADHYA PRADESH,BHOPAL,2021-03-23,739,1993,121,2853
MADHYA PRADESH,BHOPAL,2021-03-24,701,2077,135,2913
MADHYA PRADESH,BHOPAL,2021-03-25,851,2159,203,3213
MADHYA PRADESH,BURHANPUR,2021-03-21,2,226,0,228
MADHYA PRADESH,BURHANPUR,2021-03-22,28,653,5,686
MADHYA PRADESH,BURHANPUR,2021-03-23,12,774,1,787
MADHYA PRADESH,BURHANPUR,2021-03-24,30,262,1,293
MADHYA PRADESH,BURHANPUR,2021-03-25,30,626,7,663
MADHYA PRADESH,CHHATARPUR,2021-03-21,2,100,2,104
MADHYA PRADESH,CHHATARPUR,2021-03-22,3,256,0,259
MADHYA PRADESH,CHHATARPUR,2021-03-23,9,68,0,77
MADHYA PRADESH,CHHATARPUR,2021-03-24,3,233,0,236
MADHYA PRADESH,CHHATARPUR,2021-03-25,12,470,2,484
MADHYA PRADESH,CHHINDWARA,2021-03-21,34,654,45,733
MADHYA PRADESH,CHHINDWARA,2021-03-22,71,460,128,659
MADHYA PRADESH,CHHINDWARA,2021-03-23,100,837,91,1028
MADHYA PRADESH,CHHINDWARA,2021-03-24,66,724,105,895
MADHYA PRADESH,CHHINDWARA,2021-03-25,104,585,113,802
MADHYA PRADESH,DAMOH,2021-03-21,3,71,0,74
MADHYA PRADESH,DAMOH,2021-03-22,6,142,0,148
MADHYA PRADESH,DAMOH,2021-03-23,24,168,0,192
MADHYA PRADESH,DAMOH,2021-03-24,17,52,0,69
MADHYA PRADESH,DAMOH,2021-03-25,35,291,0,326
MADHYA PRADESH,DATIA,2021-03-21,2,56,1,59
MADHYA PRADESH,DATIA,2021-03-22,5,138,6,149
MADHYA PRADESH,DATIA,2021-03-23,6,211,6,223
MADHYA PRADESH,DATIA,2021-03-24,10,137,9,156
MADHYA PRADESH,DATIA,2021-03-25,6,226,16,248
MADHYA PRADESH,DEWAS,2021-03-21,4,238,0,242
MADHYA PRADESH,DEWAS,2021-03-22,31,429,0,460
MADHYA PRADESH,DEWAS,2021-03-23,29,421,0,450
MADHYA PRADESH,DEWAS,2021-03-24,54,579,2,635
MADHYA PRADESH,DEWAS,2021-03-25,23,655,2,680
MADHYA PRADESH,DHAR,2021-03-21,29,578,3,610
MADHYA PRADESH,DHAR,2021-03-22,110,495,6,611
MADHYA PRADESH,DHAR,2021-03-23,26,282,1,309
MADHYA PRADESH,DHAR,2021-03-24,39,343,12,394
MADHYA PRADESH,DHAR,2021-03-25,78,830,14,922
MADHYA PRADESH,DINDORI,2021-03-21,10,60,0,70
MADHYA PRADESH,DINDORI,2021-03-22,2,81,0,83
MADHYA PRADESH,DINDORI,2021-03-23,1,127,0,128
MADHYA PRADESH,DINDORI,2021-03-24,6,412,0,418
MADHYA PRADESH,DINDORI,2021-03-25,2,399,2,403
MADHYA PRADESH,EAST NIMAR,2021-03-21,13,696,8,717
MADHYA PRADESH,EAST NIMAR,2021-03-22,18,531,2,551
MADHYA PRADESH,EAST NIMAR,2021-03-23,17,431,2,450
MADHYA PRADESH,EAST NIMAR,2021-03-24,27,300,3,330
MADHYA PRADESH,EAST NIMAR,2021-03-25,27,654,11,692
MADHYA PRADESH,GUNA,2021-03-21,13,292,0,305
MADHYA PRADESH,GUNA,2021-03-22,8,278,0,286
MADHYA PRADESH,GUNA,2021-03-23,8,235,0,243
MADHYA PRADESH,GUNA,2021-03-24,4,187,0,191
MADHYA PRADESH,GUNA,2021-03-25,14,399,1,414
MADHYA PRADESH,GWALIOR,2021-03-21,42,1047,2,1091
MADHYA PRADESH,GWALIOR,2021-03-22,51,928,1,980
MADHYA PRADESH,GWALIOR,2021-03-23,53,790,14,857
MADHYA PRADESH,GWALIOR,2021-03-24,51,1109,8,1168
MADHYA PRADESH,GWALIOR,2021-03-25,66,1469,0,1535
MADHYA PRADESH,HARDA,2021-03-21,3,220,6,229
MADHYA PRADESH,HARDA,2021-03-22,10,203,0,213
MADHYA PRADESH,HARDA,2021-03-23,8,87,0,95
MADHYA PRADESH,HARDA,2021-03-24,8,230,110,348
MADHYA PRADESH,HARDA,2021-03-25,10,210,4,224
MADHYA PRADESH,HOSHANGABAD,2021-03-21,16,208,8,232
MADHYA PRADESH,HOSHANGABAD,2021-03-22,4,116,0,120
MADHYA PRADESH,HOSHANGABAD,2021-03-23,25,211,1,237
MADHYA PRADESH,HOSHANGABAD,2021-03-24,48,276,11,335
MADHYA PRADESH,HOSHANGABAD,2021-03-25,44,39,16,99
MADHYA PRADESH,INDORE,2021-03-21,618,2782,5,3405
MADHYA PRADESH,INDORE,2021-03-22,1536,2063,25,3624
MADHYA PRADESH,INDORE,2021-03-23,1183,3171,112,4466
MADHYA PRADESH,INDORE,2021-03-24,1999,3848,9,5856
MADHYA PRADESH,INDORE,2021-03-25,2075,4070,10,6155
MADHYA PRADESH,JABALPUR,2021-03-21,89,366,1,456
MADHYA PRADESH,JABALPUR,2021-03-22,129,725,1,855
MADHYA PRADESH,JABALPUR,2021-03-23,193,803,10,1006
MADHYA PRADESH,JABALPUR,2021-03-24,103,586,0,689
MADHYA PRADESH,JABALPUR,2021-03-25,242,850,11,1103
MADHYA PRADESH,JHABUA,2021-03-21,27,166,0,193
MADHYA PRADESH,JHABUA,2021-03-22,20,201,0,221
MADHYA PRADESH,JHABUA,2021-03-23,26,174,0,200
MADHYA PRADESH,JHABUA,2021-03-24,20,175,1,196
MADHYA PRADESH,JHABUA,2021-03-25,27,319,0,346
MADHYA PRADESH,KATNI,2021-03-21,1,103,0,104
MADHYA PRADESH,KATNI,2021-03-22,6,478,2,486
MADHYA PRADESH,KATNI,2021-03-23,4,99,0,103
MADHYA PRADESH,KATNI,2021-03-24,11,158,0,169
MADHYA PRADESH,KATNI,2021-03-25,17,405,1,423
MADHYA PRADESH,KHARGONE,2021-03-21,51,325,0,376
MADHYA PRADESH,KHARGONE,2021-03-22,64,384,0,448
MADHYA PRADESH,KHARGONE,2021-03-23,94,388,0,482
MADHYA PRADESH,KHARGONE,2021-03-24,27,165,1,193
MADHYA PRADESH,KHARGONE,2021-03-25,30,529,0,559
MADHYA PRADESH,MANDLA,2021-03-21,1,23,0,24
MADHYA PRADESH,MANDLA,2021-03-22,10,16,0,26
MADHYA PRADESH,MANDLA,2021-03-23,4,469,1,474
MADHYA PRADESH,MANDLA,2021-03-24,4,306,0,310
MADHYA PRADESH,MANDLA,2021-03-25,6,240,1,247
MADHYA PRADESH,MANDSAUR,2021-03-21,15,243,7,265
MADHYA PRADESH,MANDSAUR,2021-03-22,32,1070,6,1108
MADHYA PRADESH,MANDSAUR,2021-03-23,32,1458,6,1496
MADHYA PRADESH,MANDSAUR,2021-03-24,28,750,5,783
MADHYA PRADESH,MANDSAUR,2021-03-25,30,501,2,533
MADHYA PRADESH,MORENA,2021-03-21,3,310,0,313
MADHYA PRADESH,MORENA,2021-03-22,0,259,0,259
MADHYA PRADESH,MORENA,2021-03-23,2,205,0,207
MADHYA PRADESH,MORENA,2021-03-24,3,141,0,144
MADHYA PRADESH,MORENA,2021-03-25,3,600,0,603
MADHYA PRADESH,NARSINGHPUR,2021-03-21,4,156,0,160
MADHYA PRADESH,NARSINGHPUR,2021-03-22,10,586,1,597
MADHYA PRADESH,NARSINGHPUR,2021-03-23,53,190,2,245
MADHYA PRADESH,NARSINGHPUR,2021-03-24,9,87,0,96
MADHYA PRADESH,NARSINGHPUR,2021-03-25,44,288,0,332
MADHYA PRADESH,NEEMUCH,2021-03-21,7,234,0,241
MADHYA PRADESH,NEEMUCH,2021-03-22,17,270,1,288
MADHYA PRADESH,NEEMUCH,2021-03-23,12,439,4,455
MADHYA PRADESH,NEEMUCH,2021-03-24,7,476,4,487
MADHYA PRADESH,NEEMUCH,2021-03-25,10,524,1,535
MADHYA PRADESH,NIWARI,2021-03-21,0,172,0,172
MADHYA PRADESH,NIWARI,2021-03-22,1,219,0,220
MADHYA PRADESH,NIWARI,2021-03-23,0,122,0,122
MADHYA PRADESH,NIWARI,2021-03-24,1,129,6,136
MADHYA PRADESH,NIWARI,2021-03-25,0,160,1,161
MADHYA PRADESH,PANNA,2021-03-21,5,55,0,60
MADHYA PRADESH,PANNA,2021-03-22,10,379,0,389
MADHYA PRADESH,PANNA,2021-03-23,5,175,0,180
MADHYA PRADESH,PANNA,2021-03-24,8,333,2,343
MADHYA PRADESH,PANNA,2021-03-25,12,265,9,286
MADHYA PRADESH,RAISEN,2021-03-21,6,57,0,63
MADHYA PRADESH,RAISEN,2021-03-22,17,133,0,150
MADHYA PRADESH,RAISEN,2021-03-23,21,202,0,223
MADHYA PRADESH,RAISEN,2021-03-24,24,207,0,231
MADHYA PRADESH,RAISEN,2021-03-25,17,108,0,125
MADHYA PRADESH,RAJGARH,2021-03-21,4,110,1,115
MADHYA PRADESH,RAJGARH,2021-03-22,11,242,0,253
MADHYA PRADESH,RAJGARH,2021-03-23,13,170,2,185
MADHYA PRADESH,RAJGARH,2021-03-24,10,117,1,128
MADHYA PRADESH,RAJGARH,2021-03-25,13,192,0,205
MADHYA PRADESH,RATLAM,2021-03-21,26,191,18,235
MADHYA PRADESH,RATLAM,2021-03-22,69,292,4,365
MADHYA PRADESH,RATLAM,2021-03-23,76,468,8,552
MADHYA PRADESH,RATLAM,2021-03-24,71,825,26,922
MADHYA PRADESH,RATLAM,2021-03-25,62,444,9,515
MADHYA PRADESH,REWA,2021-03-21,8,326,3,337
MADHYA PRADESH,REWA,2021-03-22,14,501,9,524
MADHYA PRADESH,REWA,2021-03-23,14,505,6,525
MADHYA PRADESH,REWA,2021-03-24,19,568,5,592
MADHYA PRADESH,REWA,2021-03-25,12,533,6,551
MADHYA PRADESH,SAGAR,2021-03-21,32,718,7,757
MADHYA PRADESH,SAGAR,2021-03-22,41,396,1,438
MADHYA PRADESH,SAGAR,2021-03-23,55,455,2,512
MADHYA PRADESH,SAGAR,2021-03-24,62,306,0,368
MADHYA PRADESH,SAGAR,2021-03-25,40,511,4,555
MADHYA PRADESH,SATNA,2021-03-21,5,222,0,227
MADHYA PRADESH,SATNA,2021-03-22,14,379,5,398
MADHYA PRADESH,SATNA,2021-03-23,4,251,0,255
MADHYA PRADESH,SATNA,2021-03-24,10,259,0,269
MADHYA PRADESH,SATNA,2021-03-25,27,177,0,204
MADHYA PRADESH,SEHORE,2021-03-21,4,361,9,374
MADHYA PRADESH,SEHORE,2021-03-22,20,208,0,228
MADHYA PRADESH,SEHORE,2021-03-23,11,383,0,394
MADHYA PRADESH,SEHORE,2021-03-24,17,79,2,98
MADHYA PRADESH,SEHORE,2021-03-25,16,285,54,355
MADHYA PRADESH,SEONI,2021-03-21,7,258,4,269
MADHYA PRADESH,SEONI,2021-03-22,2,167,10,179
MADHYA PRADESH,SEONI,2021-03-23,8,155,128,291
MADHYA PRADESH,SEONI,2021-03-24,26,253,16,295
MADHYA PRADESH,SEONI,2021-03-25,24,198,146,368
MADHYA PRADESH,SHAHDOL,2021-03-21,1,33,3,37
MADHYA PRADESH,SHAHDOL,2021-03-22,9,91,12,112
MADHYA PRADESH,SHAHDOL,2021-03-23,3,68,6,77
MADHYA PRADESH,SHAHDOL,2021-03-24,1,71,1,73
MADHYA PRADESH,SHAHDOL,2021-03-25,1,8,0,9
MADHYA PRADESH,SHAJAPUR,2021-03-21,0,158,0,158
MADHYA PRADESH,SHAJAPUR,2021-03-22,10,341,0,351
MADHYA PRADESH,SHAJAPUR,2021-03-23,23,484,1,508
MADHYA PRADESH,SHAJAPUR,2021-03-24,22,494,0,516
MADHYA PRADESH,SHAJAPUR,2021-03-25,30,714,2,746
MADHYA PRADESH,SHEOPUR,2021-03-21,2,306,0,308
MADHYA PRADESH,SHEOPUR,2021-03-22,3,125,0,128
MADHYA PRADESH,SHEOPUR,2021-03-23,3,49,0,52
MADHYA PRADESH,SHEOPUR,2021-03-24,6,184,0,190
MADHYA PRADESH,SHEOPUR,2021-03-25,1,36,1,38
MADHYA PRADESH,SHIVPURI,2021-03-21,4,136,9,149
MADHYA PRADESH,SHIVPURI,2021-03-22,8,267,3,278
MADHYA PRADESH,SHIVPURI,2021-03-23,10,183,5,198
MADHYA PRADESH,SHIVPURI,2021-03-24,1,302,4,307
MADHYA PRADESH,SHIVPURI,2021-03-25,9,94,1,104
MADHYA PRADESH,SIDHI,2021-03-21,4,154,0,158
MADHYA PRADESH,SIDHI,2021-03-22,0,136,0,136
MADHYA PRADESH,SIDHI,2021-03-23,14,294,0,308
MADHYA PRADESH,SIDHI,2021-03-24,6,177,4,187
MADHYA PRADESH,SIDHI,2021-03-25,10,208,0,218
MADHYA PRADESH,SINGRAULI,2021-03-21,0,127,0,127
MADHYA PRADESH,SINGRAULI,2021-03-22,1,327,0,328
MADHYA PRADESH,SINGRAULI,2021-03-23,4,238,0,242
MADHYA PRADESH,SINGRAULI,2021-03-24,5,93,0,98
MADHYA PRADESH,SINGRAULI,2021-03-25,5,182,2,189
MADHYA PRADESH,TIKAMGARH,2021-03-21,2,213,0,215
MADHYA PRADESH,TIKAMGARH,2021-03-22,6,126,0,132
MADHYA PRADESH,TIKAMGARH,2021-03-23,4,242,2,248
MADHYA PRADESH,TIKAMGARH,2021-03-24,4,98,0,102
MADHYA PRADESH,TIKAMGARH,2021-03-25,4,167,1,172
MADHYA PRADESH,UJJAIN,2021-03-21,35,20,0,55
MADHYA PRADESH,UJJAIN,2021-03-22,52,566,0,618
MADHYA PRADESH,UJJAIN,2021-03-23,83,737,0,820
MADHYA PRADESH,UJJAIN,2021-03-24,41,358,1,400
MADHYA PRADESH,UJJAIN,2021-03-25,147,91,2,240
MADHYA PRADESH,UMARIA,2021-03-21,13,11,0,24
MADHYA PRADESH,UMARIA,2021-03-22,7,47,0,54
MADHYA PRADESH,UMARIA,2021-03-23,5,34,0,39
MADHYA PRADESH,UMARIA,2021-03-24,1,52,0,53
MADHYA PRADESH,UMARIA,2021-03-25,19,71,0,90
MADHYA PRADESH,VIDISHA,2021-03-21,23,53,1,77
MADHYA PRADESH,VIDISHA,2021-03-22,30,151,0,181
MADHYA PRADESH,VIDISHA,2021-03-23,9,52,0,61
MADHYA PRADESH,VIDISHA,2021-03-24,37,212,6,255
MADHYA PRADESH,VIDISHA,2021-03-25,23,130,10,163
MAHARASHTRA,AHMEDNAGAR,2021-03-21,762,1599,52,2413
MAHARASHTRA,AHMEDNAGAR,2021-03-22,692,1763,4,2459
MAHARASHTRA,AHMEDNAGAR,2021-03-23,599,725,113,1437
MAHARASHTRA,AHMEDNAGAR,2021-03-24,1333,2442,74,3849
MAHARASHTRA,AHMEDNAGAR,2021-03-25,870,2361,15,3246
MAHARASHTRA,AKOLA,2021-03-21,624,1268,7,1899
MAHARASHTRA,AKOLA,2021-03-22,493,1958,5,2456
MAHARASHTRA,AKOLA,2021-03-23,690,2398,4,3092
MAHARASHTRA,AKOLA,2021-03-24,463,1449,1,1913
MAHARASHTRA,AKOLA,2021-03-25,509,1933,4,2446
MAHARASHTRA,AMRAVATI,2021-03-21,274,2153,3,2430
MAHARASHTRA,AMRAVATI,2021-03-22,217,1972,0,2189
MAHARASHTRA,AMRAVATI,2021-03-23,258,2307,3,2568
MAHARASHTRA,AMRAVATI,2021-03-24,294,2686,2,2982
MAHARASHTRA,AMRAVATI,2021-03-25,294,2425,2,2721
MAHARASHTRA,AURANGABAD,2021-03-21,1430,1549,5,2984
MAHARASHTRA,AURANGABAD,2021-03-22,1890,1746,5,3641
MAHARASHTRA,AURANGABAD,2021-03-23,1481,2365,19,3865
MAHARASHTRA,AURANGABAD,2021-03-24,2013,1418,188,3619
MAHARASHTRA,AURANGABAD,2021-03-25,1963,2341,13,4317
MAHARASHTRA,BEED,2021-03-21,249,1929,3,2181
MAHARASHTRA,BEED,2021-03-22,213,1730,3,1946
MAHARASHTRA,BEED,2021-03-23,315,1739,2,2056
MAHARASHTRA,BEED,2021-03-24,360,1916,0,2276
MAHARASHTRA,BEED,2021-03-25,397,2207,1,2605
MAHARASHTRA,BHANDARA,2021-03-21,113,1125,0,1238
MAHARASHTRA,BHANDARA,2021-03-22,198,1585,3,1786
MAHARASHTRA,BHANDARA,2021-03-23,226,1236,0,1462
MAHARASHTRA,BHANDARA,2021-03-24,247,1806,0,2053
MAHARASHTRA,BHANDARA,2021-03-25,286,1742,1,2029
MAHARASHTRA,BULDHANA,2021-03-21,459,531,4,994
MAHARASHTRA,BULDHANA,2021-03-22,337,1029,15,1381
MAHARASHTRA,BULDHANA,2021-03-23,271,617,16,904
MAHARASHTRA,BULDHANA,2021-03-24,603,980,10,1593
MAHARASHTRA,BULDHANA,2021-03-25,351,655,15,1021
MAHARASHTRA,CHANDRAPUR,2021-03-21,143,2054,2,2199
MAHARASHTRA,CHANDRAPUR,2021-03-22,208,2494,2,2704
MAHARASHTRA,CHANDRAPUR,2021-03-23,263,3408,10,3681
MAHARASHTRA,CHANDRAPUR,2021-03-24,238,2693,11,2942
MAHARASHTRA,CHANDRAPUR,2021-03-25,227,3134,2,3363
MAHARASHTRA,DHULE,2021-03-21,303,498,0,801
MAHARASHTRA,DHULE,2021-03-22,456,549,3,1008
MAHARASHTRA,DHULE,2021-03-23,435,703,2,1140
MAHARASHTRA,DHULE,2021-03-24,385,365,3,753
MAHARASHTRA,DHULE,2021-03-25,464,660,5,1129
MAHARASHTRA,GADCHIROLI,2021-03-21,21,532,0,553
MAHARASHTRA,GADCHIROLI,2021-03-22,65,1462,1,1528
MAHARASHTRA,GADCHIROLI,2021-03-23,41,1371,1,1413
MAHARASHTRA,GADCHIROLI,2021-03-24,36,1736,0,1772
MAHARASHTRA,GADCHIROLI,2021-03-25,63,1876,3,1942
MAHARASHTRA,GONDIA,2021-03-21,59,1160,0,1219
MAHARASHTRA,GONDIA,2021-03-22,50,3342,4,3396
MAHARASHTRA,GONDIA,2021-03-23,52,3134,1,3187
MAHARASHTRA,GONDIA,2021-03-24,89,3491,3,3583
MAHARASHTRA,GONDIA,2021-03-25,96,2670,5,2771
MAHARASHTRA,HINGOLI,2021-03-21,98,459,0,557
MAHARASHTRA,HINGOLI,2021-03-22,116,227,0,343
MAHARASHTRA,HINGOLI,2021-03-23,132,509,0,641
MAHARASHTRA,HINGOLI,2021-03-24,39,82,0,121
MAHARASHTRA,HINGOLI,2021-03-25,111,472,0,583
MAHARASHTRA,JALGAON,2021-03-21,737,2041,9,2787
MAHARASHTRA,JALGAON,2021-03-22,1039,3163,3,4205
MAHARASHTRA,JALGAON,2021-03-23,1108,7872,2,8982
MAHARASHTRA,JALGAON,2021-03-24,969,7318,1,8288
MAHARASHTRA,JALGAON,2021-03-25,1104,6470,1,7575
MAHARASHTRA,JALNA,2021-03-21,286,578,0,864
MAHARASHTRA,JALNA,2021-03-22,409,1000,0,1409
MAHARASHTRA,JALNA,2021-03-23,441,1331,0,1772
MAHARASHTRA,JALNA,2021-03-24,353,894,0,1247
MAHARASHTRA,JALNA,2021-03-25,631,793,0,1424
MAHARASHTRA,KOLHAPUR,2021-03-21,81,1159,10,1250
MAHARASHTRA,KOLHAPUR,2021-03-22,69,1105,21,1195
MAHARASHTRA,KOLHAPUR,2021-03-23,65,1305,35,1405
MAHARASHTRA,KOLHAPUR,2021-03-24,94,1647,13,1754
MAHARASHTRA,KOLHAPUR,2021-03-25,78,1338,15,1431
MAHARASHTRA,LATUR,2021-03-21,355,1806,15,2176
MAHARASHTRA,LATUR,2021-03-22,320,1884,5,2209
MAHARASHTRA,LATUR,2021-03-23,430,1930,8,2368
MAHARASHTRA,LATUR,2021-03-24,490,1837,12,2339
MAHARASHTRA,LATUR,2021-03-25,487,1882,9,2378
MAHARASHTRA,MUMBAI,2021-03-21,2660,11969,43,14672
MAHARASHTRA,MUMBAI,2021-03-22,2817,15282,27,18126
MAHARASHTRA,MUMBAI,2021-03-23,4255,16304,42,20601
MAHARASHTRA,MUMBAI,2021-03-24,4658,18654,56,23368
MAHARASHTRA,MUMBAI,2021-03-25,4681,19270,33,23984
MAHARASHTRA,MUMBAI SUBURBAN,2021-03-21,835,3793,28,4656
MAHARASHTRA,MUMBAI SUBURBAN,2021-03-22,932,3424,4,4360
MAHARASHTRA,MUMBAI SUBURBAN,2021-03-23,1097,3191,9,4297
MAHARASHTRA,MUMBAI SUBURBAN,2021-03-24,1086,4266,7,5359
MAHARASHTRA,MUMBAI SUBURBAN,2021-03-25,1156,3667,17,4840
MAHARASHTRA,NAGPUR,2021-03-21,3648,6017,33,9698
MAHARASHTRA,NAGPUR,2021-03-22,3108,6306,22,9436
MAHARASHTRA,NAGPUR,2021-03-23,4181,8060,106,12347
MAHARASHTRA,NAGPUR,2021-03-24,3728,7775,70,11573
MAHARASHTRA,NAGPUR,2021-03-25,4130,7727,67,11924
MAHARASHTRA,NANDED,2021-03-21,1112,3081,219,4412
MAHARASHTRA,NANDED,2021-03-22,1394,3197,174,4765
MAHARASHTRA,NANDED,2021-03-23,1060,2764,119,3943
MAHARASHTRA,NANDED,2021-03-24,1486,3230,163,4879
MAHARASHTRA,NANDED,2021-03-25,1150,2982,145,4277
MAHARASHTRA,NANDURBAR,2021-03-21,248,524,0,772
MAHARASHTRA,NANDURBAR,2021-03-22,661,1459,2,2122
MAHARASHTRA,NANDURBAR,2021-03-23,516,1422,0,1938
MAHARASHTRA,NANDURBAR,2021-03-24,573,1049,0,1622
MAHARASHTRA,NANDURBAR,2021-03-25,229,609,3,841
MAHARASHTRA,NASHIK,2021-03-21,1381,2438,85,3904
MAHARASHTRA,NASHIK,2021-03-22,1523,2894,73,4490
MAHARASHTRA,NASHIK,2021-03-23,1738,3061,89,4888
MAHARASHTRA,NASHIK,2021-03-24,3547,4805,55,8407
MAHARASHTRA,NASHIK,2021-03-25,3596,4652,119,8367
MAHARASHTRA,OSMANABAD,2021-03-21,160,167,3,330
MAHARASHTRA,OSMANABAD,2021-03-22,186,282,1,469
MAHARASHTRA,OSMANABAD,2021-03-23,156,227,2,385
MAHARASHTRA,OSMANABAD,2021-03-24,180,439,6,625
MAHARASHTRA,OSMANABAD,2021-03-25,195,310,1,506
MAHARASHTRA,PALGHAR,2021-03-21,129,389,0,518
MAHARASHTRA,PALGHAR,2021-03-22,252,906,6,1164
MAHARASHTRA,PALGHAR,2021-03-23,366,934,12,1312
MAHARASHTRA,PALGHAR,2021-03-24,373,922,9,1304
MAHARASHTRA,PALGHAR,2021-03-25,387,1306,7,1700
MAHARASHTRA,PARBHANI,2021-03-21,287,1078,3,1368
MAHARASHTRA,PARBHANI,2021-03-22,372,776,0,1148
MAHARASHTRA,PARBHANI,2021-03-23,304,1127,1,1432
MAHARASHTRA,PARBHANI,2021-03-24,429,2326,0,2755
MAHARASHTRA,PARBHANI,2021-03-25,349,1944,3,2296
MAHARASHTRA,PUNE,2021-03-21,4239,7225,363,11827
MAHARASHTRA,PUNE,2021-03-22,6199,8360,358,14917
MAHARASHTRA,PUNE,2021-03-23,7261,10774,419,18454
MAHARASHTRA,PUNE,2021-03-24,7061,11165,440,18666
MAHARASHTRA,PUNE,2021-03-25,7671,12349,289,20309
MAHARASHTRA,RAIGAD,2021-03-21,478,1303,0,1781
MAHARASHTRA,RAIGAD,2021-03-22,387,1253,2,1642
MAHARASHTRA,RAIGAD,2021-03-23,598,1712,1,2311
MAHARASHTRA,RAIGAD,2021-03-24,670,1883,0,2553
MAHARASHTRA,RAIGAD,2021-03-25,608,1897,3,2508
MAHARASHTRA,RATNAGIRI,2021-03-21,8,53,0,61
MAHARASHTRA,RATNAGIRI,2021-03-22,135,431,4,570
MAHARASHTRA,RATNAGIRI,2021-03-23,34,179,2,215
MAHARASHTRA,RATNAGIRI,2021-03-24,23,288,1,312
MAHARASHTRA,RATNAGIRI,2021-03-25,72,560,2,634
MAHARASHTRA,SANGLI,2021-03-21,145,1357,30,1532
MAHARASHTRA,SANGLI,2021-03-22,225,1678,77,1980
MAHARASHTRA,SANGLI,2021-03-23,164,1341,22,1527
MAHARASHTRA,SANGLI,2021-03-24,160,1418,24,1602
MAHARASHTRA,SANGLI,2021-03-25,215,1463,61,1739
MAHARASHTRA,SATARA,2021-03-21,137,1588,38,1763
MAHARASHTRA,SATARA,2021-03-22,161,976,6,1143
MAHARASHTRA,SATARA,2021-03-23,293,1965,26,2284
MAHARASHTRA,SATARA,2021-03-24,373,2314,14,2701
MAHARASHTRA,SATARA,2021-03-25,508,2361,59,2928
MAHARASHTRA,SINDHUDURG,2021-03-21,18,1096,0,1114
MAHARASHTRA,SINDHUDURG,2021-03-22,23,305,0,328
MAHARASHTRA,SINDHUDURG,2021-03-23,28,382,1,411
MAHARASHTRA,SINDHUDURG,2021-03-24,48,415,0,463
MAHARASHTRA,SINDHUDURG,2021-03-25,30,433,0,463
MAHARASHTRA,SOLAPUR,2021-03-21,237,2509,91,2837
MAHARASHTRA,SOLAPUR,2021-03-22,459,2414,26,2899
MAHARASHTRA,SOLAPUR,2021-03-23,564,2946,31,3541
MAHARASHTRA,SOLAPUR,2021-03-24,615,2828,29,3472
MAHARASHTRA,SOLAPUR,2021-03-25,631,2842,9,3482
MAHARASHTRA,THANE,2021-03-21,2610,8150,10,10770
MAHARASHTRA,THANE,2021-03-22,3044,7799,32,10875
MAHARASHTRA,THANE,2021-03-23,3364,8788,18,12170
MAHARASHTRA,THANE,2021-03-24,3909,9286,43,13238
MAHARASHTRA,THANE,2021-03-25,3759,9776,19,13554
MAHARASHTRA,WARDHA,2021-03-21,210,1237,1,1448
MAHARASHTRA,WARDHA,2021-03-22,339,1842,15,2196
MAHARASHTRA,WARDHA,2021-03-23,396,1856,5,2257
MAHARASHTRA,WARDHA,2021-03-24,304,1989,5,2298
MAHARASHTRA,WARDHA,2021-03-25,311,1750,2,2063
MAHARASHTRA,WASHIM,2021-03-21,249,1639,14,1902
MAHARASHTRA,WASHIM,2021-03-22,277,1564,47,1888
MAHARASHTRA,WASHIM,2021-03-23,231,1577,21,1829
MAHARASHTRA,WASHIM,2021-03-24,315,1531,20,1866
MAHARASHTRA,WASHIM,2021-03-25,327,1411,9,1747
MAHARASHTRA,YAVATMAL,2021-03-21,229,1217,0,1446
MAHARASHTRA,YAVATMAL,2021-03-22,477,2247,4,2728
MAHARASHTRA,YAVATMAL,2021-03-23,486,2815,2,3303
MAHARASHTRA,YAVATMAL,2021-03-24,371,2450,1,2822
MAHARASHTRA,YAVATMAL,2021-03-25,452,3442,4,3898
MANIPUR,BISHNUPUR,2021-03-21,0,23,0,23
MANIPUR,BISHNUPUR,2021-03-22,0,92,0,92
MANIPUR,BISHNUPUR,2021-03-23,1,65,0,66
MANIPUR,BISHNUPUR,2021-03-24,0,62,0,62
MANIPUR,BISHNUPUR,2021-03-25,1,116,0,117
MANIPUR,CHANDEL,2021-03-21,0,20,0,20
MANIPUR,CHANDEL,2021-03-22,0,15,0,15
MANIPUR,CHANDEL,2021-03-23,0,4,0,4
MANIPUR,CHANDEL,2021-03-24,0,12,0,12
MANIPUR,CHANDEL,2021-03-25,0,29,0,29
MANIPUR,CHURACHANDPUR,2021-03-21,0,46,0,46
MANIPUR,CHURACHANDPUR,2021-03-22,0,92,0,92
MANIPUR,CHURACHANDPUR,2021-03-23,0,109,0,109
MANIPUR,CHURACHANDPUR,2021-03-24,4,85,0,89
MANIPUR,CHURACHANDPUR,2021-03-25,0,38,0,38
MANIPUR,IMPHAL EAST,2021-03-21,0,147,0,147
MANIPUR,IMPHAL EAST,2021-03-22,1,100,0,101
MANIPUR,IMPHAL EAST,2021-03-23,4,127,0,131
MANIPUR,IMPHAL EAST,2021-03-24,3,126,0,129
MANIPUR,IMPHAL EAST,2021-03-25,3,132,0,135
MANIPUR,IMPHAL WEST,2021-03-21,0,240,0,240
MANIPUR,IMPHAL WEST,2021-03-22,1,407,0,408
MANIPUR,IMPHAL WEST,2021-03-23,2,428,0,430
MANIPUR,IMPHAL WEST,2021-03-24,1,396,0,397
MANIPUR,IMPHAL WEST,2021-03-25,4,468,0,472
MANIPUR,JIRIBAM,2021-03-21,0,3,0,3
MANIPUR,JIRIBAM,2021-03-22,0,2,0,2
MANIPUR,JIRIBAM,2021-03-23,0,1,0,1
MANIPUR,JIRIBAM,2021-03-24,0,2,0,2
MANIPUR,JIRIBAM,2021-03-25,0,1,0,1
MANIPUR,KAKCHING,2021-03-21,0,8,0,8
MANIPUR,KAKCHING,2021-03-22,1,20,0,21
MANIPUR,KAKCHING,2021-03-23,2,28,0,30
MANIPUR,KAKCHING,2021-03-24,0,24,0,24
MANIPUR,KAKCHING,2021-03-25,0,15,0,15
MANIPUR,KAMJONG,2021-03-23,0,2,0,2
MANIPUR,KAMJONG,2021-03-24,0,1,0,1
MANIPUR,KAMJONG,2021-03-25,0,3,1,4
MANIPUR,KANGPOKPI,2021-03-21,2,12,0,14
MANIPUR,KANGPOKPI,2021-03-22,0,33,0,33
MANIPUR,KANGPOKPI,2021-03-23,1,16,0,17
MANIPUR,KANGPOKPI,2021-03-24,1,13,0,14
MANIPUR,KANGPOKPI,2021-03-25,0,10,0,10
MANIPUR,NONEY,2021-03-21,0,2,0,2
MANIPUR,NONEY,2021-03-22,0,1,0,1
MANIPUR,NONEY,2021-03-24,0,5,0,5
MANIPUR,NONEY,2021-03-25,0,2,0,2
MANIPUR,SENAPATI,2021-03-21,0,20,0,20
MANIPUR,SENAPATI,2021-03-22,0,14,0,14
MANIPUR,SENAPATI,2021-03-23,0,22,0,22
MANIPUR,SENAPATI,2021-03-24,0,18,0,18
MANIPUR,SENAPATI,2021-03-25,0,9,0,9
MANIPUR,TAMENGLONG,2021-03-21,0,13,0,13
MANIPUR,TAMENGLONG,2021-03-22,0,29,0,29
MANIPUR,TAMENGLONG,2021-03-23,0,16,0,16
MANIPUR,TAMENGLONG,2021-03-24,1,19,0,20
MANIPUR,TAMENGLONG,2021-03-25,0,55,0,55
MANIPUR,TENGNOUPAL,2021-03-21,0,4,0,4
MANIPUR,TENGNOUPAL,2021-03-22,0,2,0,2
MANIPUR,TENGNOUPAL,2021-03-23,0,3,0,3
MANIPUR,TENGNOUPAL,2021-03-24,1,6,0,7
MANIPUR,TENGNOUPAL,2021-03-25,0,9,0,9
MANIPUR,THOUBAL,2021-03-21,0,41,0,41
MANIPUR,THOUBAL,2021-03-22,0,52,0,52
MANIPUR,THOUBAL,2021-03-23,0,101,0,101
MANIPUR,THOUBAL,2021-03-24,0,36,0,36
MANIPUR,THOUBAL,2021-03-25,0,63,0,63
MANIPUR,UKHRUL,2021-03-21,0,74,0,74
MANIPUR,UKHRUL,2021-03-22,0,10,0,10
MANIPUR,UKHRUL,2021-03-23,1,173,0,174
MANIPUR,UKHRUL,2021-03-24,0,84,0,84
MANIPUR,UKHRUL,2021-03-25,1,54,0,55
MEGHALAYA,EAST GARO HILLS,2021-03-21,0,3,0,3
MEGHALAYA,EAST GARO HILLS,2021-03-22,0,24,0,24
MEGHALAYA,EAST GARO HILLS,2021-03-23,0,24,0,24
MEGHALAYA,EAST GARO HILLS,2021-03-24,0,31,0,31
MEGHALAYA,EAST GARO HILLS,2021-03-25,0,31,0,31
MEGHALAYA,EAST JAINTIA HILLS,2021-03-21,0,7,0,7
MEGHALAYA,EAST JAINTIA HILLS,2021-03-22,0,89,0,89
MEGHALAYA,EAST JAINTIA HILLS,2021-03-23,0,208,0,208
MEGHALAYA,EAST JAINTIA HILLS,2021-03-24,0,169,0,169
MEGHALAYA,EAST JAINTIA HILLS,2021-03-25,0,80,0,80
MEGHALAYA,EAST KHASI HILLS,2021-03-21,0,281,0,281
MEGHALAYA,EAST KHASI HILLS,2021-03-22,0,755,0,755
MEGHALAYA,EAST KHASI HILLS,2021-03-23,3,414,2,419
MEGHALAYA,EAST KHASI HILLS,2021-03-24,1,566,0,567
MEGHALAYA,EAST KHASI HILLS,2021-03-25,3,664,0,667
MEGHALAYA,NORTH GARO HILLS,2021-03-21,0,4,0,4
MEGHALAYA,NORTH GARO HILLS,2021-03-22,0,1,0,1
MEGHALAYA,NORTH GARO HILLS,2021-03-23,0,24,0,24
MEGHALAYA,NORTH GARO HILLS,2021-03-24,0,4,0,4
MEGHALAYA,NORTH GARO HILLS,2021-03-25,0,4,0,4
MEGHALAYA,RI BHOI,2021-03-21,0,15,0,15
MEGHALAYA,RI BHOI,2021-03-22,3,132,0,135
MEGHALAYA,RI BHOI,2021-03-23,2,114,0,116
MEGHALAYA,RI BHOI,2021-03-24,0,85,0,85
MEGHALAYA,RI BHOI,2021-03-25,0,95,0,95
MEGHALAYA,SOUTH GARO HILLS,2021-03-21,0,2,0,2
MEGHALAYA,SOUTH GARO HILLS,2021-03-22,0,2,0,2
MEGHALAYA,SOUTH GARO HILLS,2021-03-23,0,9,0,9
MEGHALAYA,SOUTH GARO HILLS,2021-03-24,0,4,0,4
MEGHALAYA,SOUTH GARO HILLS,2021-03-25,0,11,0,11
MEGHALAYA,SOUTH WEST GARO HILLS,2021-03-21,0,4,0,4
MEGHALAYA,SOUTH WEST GARO HILLS,2021-03-22,0,38,0,38
MEGHALAYA,SOUTH WEST GARO HILLS,2021-03-23,0,46,0,46
MEGHALAYA,SOUTH WEST GARO HILLS,2021-03-24,0,30,0,30
MEGHALAYA,SOUTH WEST GARO HILLS,2021-03-25,0,22,0,22
MEGHALAYA,SOUTH WEST KHASI HILLS,2021-03-22,0,22,0,22
MEGHALAYA,SOUTH WEST KHASI HILLS,2021-03-23,0,16,0,16
MEGHALAYA,SOUTH WEST KHASI HILLS,2021-03-24,0,17,0,17
MEGHALAYA,SOUTH WEST KHASI HILLS,2021-03-25,0,29,0,29
MEGHALAYA,WEST GARO HILLS,2021-03-22,0,127,0,127
MEGHALAYA,WEST GARO HILLS,2021-03-23,0,60,0,60
MEGHALAYA,WEST GARO HILLS,2021-03-24,0,91,0,91
MEGHALAYA,WEST GARO HILLS,2021-03-25,0,79,0,79
MEGHALAYA,WEST JAINTIA HILLS,2021-03-21,0,26,0,26
MEGHALAYA,WEST JAINTIA HILLS,2021-03-22,0,48,0,48
MEGHALAYA,WEST JAINTIA HILLS,2021-03-23,0,55,0,55
MEGHALAYA,WEST JAINTIA HILLS,2021-03-24,0,58,0,58
MEGHALAYA,WEST JAINTIA HILLS,2021-03-25,0,79,0,79
MEGHALAYA,WEST KHASI HILLS,2021-03-21,1,4,0,5
MEGHALAYA,WEST KHASI HILLS,2021-03-22,0,37,0,37
MEGHALAYA,WEST KHASI HILLS,2021-03-23,0,40,0,40
MEGHALAYA,WEST KHASI HILLS,2021-03-24,0,26,0,26
MEGHALAYA,WEST KHASI HILLS,2021-03-25,0,43,0,43
MIZORAM,AIZAWL,2021-03-21,1,95,0,96
MIZORAM,AIZAWL,2021-03-22,3,433,0,436
MIZORAM,AIZAWL,2021-03-23,0,377,0,377
MIZORAM,AIZAWL,2021-03-24,2,507,0,509
MIZORAM,AIZAWL,2021-03-25,7,367,0,374
MIZORAM,CHAMPHAI,2021-03-21,0,2,0,2
MIZORAM,CHAMPHAI,2021-03-22,0,2,0,2
MIZORAM,CHAMPHAI,2021-03-24,0,15,0,15
MIZORAM,CHAMPHAI,2021-03-25,0,6,0,6
MIZORAM,HNAHTHIAL,2021-03-22,0,1,0,1
MIZORAM,HNAHTHIAL,2021-03-23,0,3,0,3
MIZORAM,HNAHTHIAL,2021-03-24,0,3,0,3
MIZORAM,HNAHTHIAL,2021-03-25,0,3,0,3
MIZORAM,KHAWZAWL,2021-03-25,0,2,0,2
MIZORAM,KOLASIB,2021-03-21,0,2,0,2
MIZORAM,KOLASIB,2021-03-22,1,71,0,72
MIZORAM,KOLASIB,2021-03-23,0,7,0,7
MIZORAM,KOLASIB,2021-03-24,0,91,0,91
MIZORAM,KOLASIB,2021-03-25,0,114,0,114
MIZORAM,LAWNGTLAI,2021-03-22,0,3,0,3
MIZORAM,LAWNGTLAI,2021-03-23,0,7,0,7
MIZORAM,LAWNGTLAI,2021-03-24,0,9,0,9
MIZORAM,LAWNGTLAI,2021-03-25,0,1,0,1
MIZORAM,LUNGLEI,2021-03-22,0,9,0,9
MIZORAM,LUNGLEI,2021-03-23,0,4,0,4
MIZORAM,LUNGLEI,2021-03-24,0,21,0,21
MIZORAM,LUNGLEI,2021-03-25,0,13,0,13
MIZORAM,MAMIT,2021-03-22,0,48,0,48
MIZORAM,MAMIT,2021-03-23,0,63,0,63
MIZORAM,MAMIT,2021-03-24,0,37,0,37
MIZORAM,MAMIT,2021-03-25,0,56,1,57
MIZORAM,SAIHA,2021-03-21,0,21,0,21
MIZORAM,SAIHA,2021-03-22,0,8,1,9
MIZORAM,SAIHA,2021-03-23,0,10,0,10
MIZORAM,SAIHA,2021-03-24,0,7,0,7
MIZORAM,SAIHA,2021-03-25,0,14,0,14
MIZORAM,SAITUAL,2021-03-21,0,170,0,170
MIZORAM,SAITUAL,2021-03-22,0,45,0,45
MIZORAM,SAITUAL,2021-03-23,0,75,0,75
MIZORAM,SAITUAL,2021-03-24,0,47,0,47
MIZORAM,SAITUAL,2021-03-25,0,33,0,33
MIZORAM,SERCHHIP,2021-03-22,0,6,0,6
MIZORAM,SERCHHIP,2021-03-23,0,26,0,26
MIZORAM,SERCHHIP,2021-03-24,0,5,0,5
MIZORAM,SERCHHIP,2021-03-25,0,1,0,1
NAGALAND,DIMAPUR,2021-03-21,0,6,0,6
NAGALAND,DIMAPUR,2021-03-22,0,104,0,104
NAGALAND,DIMAPUR,2021-03-23,0,72,0,72
NAGALAND,DIMAPUR,2021-03-24,0,81,0,81
NAGALAND,DIMAPUR,2021-03-25,2,96,0,98
NAGALAND,KIPHIRE,2021-03-22,0,21,0,21
NAGALAND,KIPHIRE,2021-03-23,0,3,0,3
NAGALAND,KIPHIRE,2021-03-24,0,2,0,2
NAGALAND,KIPHIRE,2021-03-25,0,15,0,15
NAGALAND,KOHIMA,2021-03-21,0,5,0,5
NAGALAND,KOHIMA,2021-03-22,0,22,0,22
NAGALAND,KOHIMA,2021-03-23,4,31,0,35
NAGALAND,KOHIMA,2021-03-24,0,47,0,47
NAGALAND,KOHIMA,2021-03-25,0,105,0,105
NAGALAND,LONGLENG,2021-03-22,0,2,0,2
NAGALAND,MOKOKCHUNG,2021-03-21,0,7,0,7
NAGALAND,MOKOKCHUNG,2021-03-22,0,16,0,16
NAGALAND,MOKOKCHUNG,2021-03-23,0,16,0,16
NAGALAND,MOKOKCHUNG,2021-03-24,0,5,0,5
NAGALAND,MOKOKCHUNG,2021-03-25,2,37,0,39
NAGALAND,MON,2021-03-22,0,1,0,1
NAGALAND,MON,2021-03-23,0,3,0,3
NAGALAND,PEREN,2021-03-22,0,2,0,2
NAGALAND,PEREN,2021-03-24,0,2,0,2
NAGALAND,PEREN,2021-03-25,0,4,0,4
NAGALAND,PHEK,2021-03-23,0,3,0,3
NAGALAND,PHEK,2021-03-25,0,1,0,1
NAGALAND,WOKHA,2021-03-23,0,1,0,1
NAGALAND,ZUNHEBOTO,2021-03-22,0,3,0,3
NAGALAND,ZUNHEBOTO,2021-03-24,0,1,0,1
NAGALAND,ZUNHEBOTO,2021-03-25,0,2,0,2
ODISHA,ANUGUL,2021-03-21,2,574,0,576
ODISHA,ANUGUL,2021-03-22,4,875,0,879
ODISHA,ANUGUL,2021-03-23,5,770,0,775
ODISHA,ANUGUL,2021-03-24,7,773,0,780
ODISHA,ANUGUL,2021-03-25,5,804,0,809
ODISHA,BALANGIR,2021-03-21,16,743,1,760
ODISHA,BALANGIR,2021-03-22,3,725,82,810
ODISHA,BALANGIR,2021-03-23,3,906,2,911
ODISHA,BALANGIR,2021-03-24,5,1168,1,1174
ODISHA,BALANGIR,2021-03-25,23,1189,3,1215
ODISHA,BALESHWAR,2021-03-21,10,1115,0,1125
ODISHA,BALESHWAR,2021-03-22,8,2069,0,2077
ODISHA,BALESHWAR,2021-03-23,19,2511,0,2530
ODISHA,BALESHWAR,2021-03-24,8,2205,0,2213
ODISHA,BALESHWAR,2021-03-25,5,2248,0,2253
ODISHA,BARGARH,2021-03-21,0,259,0,259
ODISHA,BARGARH,2021-03-22,7,423,0,430
ODISHA,BARGARH,2021-03-23,12,592,0,604
ODISHA,BARGARH,2021-03-24,12,411,1,424
ODISHA,BARGARH,2021-03-25,17,631,0,648
ODISHA,BHADRAK,2021-03-21,0,723,0,723
ODISHA,BHADRAK,2021-03-22,0,714,0,714
ODISHA,BHADRAK,2021-03-23,1,712,0,713
ODISHA,BHADRAK,2021-03-24,4,600,1,605
ODISHA,BHADRAK,2021-03-25,7,720,0,727
ODISHA,BOUDH,2021-03-21,0,192,0,192
ODISHA,BOUDH,2021-03-22,1,162,0,163
ODISHA,BOUDH,2021-03-23,0,481,0,481
ODISHA,BOUDH,2021-03-24,2,315,0,317
ODISHA,BOUDH,2021-03-25,0,303,0,303
ODISHA,CUTTACK,2021-03-21,12,426,1,439
ODISHA,CUTTACK,2021-03-22,27,2024,0,2051
ODISHA,CUTTACK,2021-03-23,41,1794,0,1835
ODISHA,CUTTACK,2021-03-24,27,1740,1,1768
ODISHA,CUTTACK,2021-03-25,28,1697,0,1725
ODISHA,DEOGARH,2021-03-21,2,69,0,71
ODISHA,DEOGARH,2021-03-22,0,68,0,68
ODISHA,DEOGARH,2021-03-23,3,49,0,52
ODISHA,DEOGARH,2021-03-24,0,215,0,215
ODISHA,DEOGARH,2021-03-25,1,292,0,293
ODISHA,DHENKANAL,2021-03-21,0,228,0,228
ODISHA,DHENKANAL,2021-03-22,1,584,0,585
ODISHA,DHENKANAL,2021-03-23,2,425,1,428
ODISHA,DHENKANAL,2021-03-24,8,290,0,298
ODISHA,DHENKANAL,2021-03-25,1,339,0,340
ODISHA,GAJAPATI,2021-03-21,0,131,0,131
ODISHA,GAJAPATI,2021-03-22,1,360,0,361
ODISHA,GAJAPATI,2021-03-23,0,387,1,388
ODISHA,GAJAPATI,2021-03-24,0,264,0,264
ODISHA,GAJAPATI,2021-03-25,1,504,0,505
ODISHA,GANJAM,2021-03-21,1,685,0,686
ODISHA,GANJAM,2021-03-22,4,1336,62,1402
ODISHA,GANJAM,2021-03-23,3,1432,162,1597
ODISHA,GANJAM,2021-03-24,2,1400,36,1438
ODISHA,GANJAM,2021-03-25,3,1639,4,1646
ODISHA,JAGATSINGHAPUR,2021-03-21,0,257,0,257
ODISHA,JAGATSINGHAPUR,2021-03-22,0,496,0,496
ODISHA,JAGATSINGHAPUR,2021-03-23,7,549,0,556
ODISHA,JAGATSINGHAPUR,2021-03-24,2,435,0,437
ODISHA,JAGATSINGHAPUR,2021-03-25,3,476,0,479
ODISHA,JAJAPUR,2021-03-21,5,107,0,112
ODISHA,JAJAPUR,2021-03-22,1,576,0,577
ODISHA,JAJAPUR,2021-03-23,33,911,0,944
ODISHA,JAJAPUR,2021-03-24,4,272,1,277
ODISHA,JAJAPUR,2021-03-25,5,712,0,717
ODISHA,JHARSUGUDA,2021-03-21,1,501,0,502
ODISHA,JHARSUGUDA,2021-03-22,9,451,0,460
ODISHA,JHARSUGUDA,2021-03-23,3,652,0,655
ODISHA,JHARSUGUDA,2021-03-24,6,613,4,623
ODISHA,JHARSUGUDA,2021-03-25,1,580,6,587
ODISHA,KALAHANDI,2021-03-21,2,360,0,362
ODISHA,KALAHANDI,2021-03-22,8,457,0,465
ODISHA,KALAHANDI,2021-03-23,8,392,0,400
ODISHA,KALAHANDI,2021-03-24,6,525,0,531
ODISHA,KALAHANDI,2021-03-25,7,513,0,520
ODISHA,KANDHAMAL,2021-03-21,0,582,0,582
ODISHA,KANDHAMAL,2021-03-22,0,942,0,942
ODISHA,KANDHAMAL,2021-03-23,0,768,0,768
ODISHA,KANDHAMAL,2021-03-24,1,685,0,686
ODISHA,KANDHAMAL,2021-03-25,0,626,0,626
ODISHA,KENDRAPARA,2021-03-21,1,970,0,971
ODISHA,KENDRAPARA,2021-03-22,1,1372,2,1375
ODISHA,KENDRAPARA,2021-03-23,0,1467,1,1468
ODISHA,KENDRAPARA,2021-03-24,0,1588,0,1588
ODISHA,KENDRAPARA,2021-03-25,4,1386,0,1390
ODISHA,KENDUJHAR,2021-03-21,0,601,0,601
ODISHA,KENDUJHAR,2021-03-22,2,829,0,831
ODISHA,KENDUJHAR,2021-03-23,3,718,0,721
ODISHA,KENDUJHAR,2021-03-24,0,692,1,693
ODISHA,KENDUJHAR,2021-03-25,2,1066,1,1069
ODISHA,KHORDHA,2021-03-21,38,864,0,902
ODISHA,KHORDHA,2021-03-22,38,1669,1,1708
ODISHA,KHORDHA,2021-03-23,23,1762,3,1788
ODISHA,KHORDHA,2021-03-24,38,1709,5,1752
ODISHA,KHORDHA,2021-03-25,45,1406,0,1451
ODISHA,KORAPUT,2021-03-21,0,1103,0,1103
ODISHA,KORAPUT,2021-03-22,0,1438,0,1438
ODISHA,KORAPUT,2021-03-23,12,1503,0,1515
ODISHA,KORAPUT,2021-03-24,0,1623,0,1623
ODISHA,KORAPUT,2021-03-25,0,1718,0,1718
ODISHA,MALKANGIRI,2021-03-21,0,100,0,100
ODISHA,MALKANGIRI,2021-03-22,0,286,0,286
ODISHA,MALKANGIRI,2021-03-23,0,321,0,321
ODISHA,MALKANGIRI,2021-03-24,0,455,0,455
ODISHA,MALKANGIRI,2021-03-25,0,335,0,335
ODISHA,MAYURBHANJ,2021-03-21,16,1190,0,1206
ODISHA,MAYURBHANJ,2021-03-22,12,1407,0,1419
ODISHA,MAYURBHANJ,2021-03-23,6,1415,0,1421
ODISHA,MAYURBHANJ,2021-03-24,10,1395,0,1405
ODISHA,MAYURBHANJ,2021-03-25,5,1578,0,1583
ODISHA,NABARANGPUR,2021-03-21,0,464,0,464
ODISHA,NABARANGPUR,2021-03-22,0,741,0,741
ODISHA,NABARANGPUR,2021-03-23,1,805,0,806
ODISHA,NABARANGPUR,2021-03-24,0,923,0,923
ODISHA,NABARANGPUR,2021-03-25,1,937,0,938
ODISHA,NAYAGARH,2021-03-21,0,632,4,636
ODISHA,NAYAGARH,2021-03-22,0,655,1,656
ODISHA,NAYAGARH,2021-03-23,0,701,1,702
ODISHA,NAYAGARH,2021-03-24,1,520,0,521
ODISHA,NAYAGARH,2021-03-25,0,534,1,535
ODISHA,NUAPADA,2021-03-21,2,291,0,293
ODISHA,NUAPADA,2021-03-22,6,229,0,235
ODISHA,NUAPADA,2021-03-23,23,229,0,252
ODISHA,NUAPADA,2021-03-24,17,236,0,253
ODISHA,NUAPADA,2021-03-25,36,380,0,416
ODISHA,PURI,2021-03-21,1,842,0,843
ODISHA,PURI,2021-03-22,4,836,0,840
ODISHA,PURI,2021-03-23,5,515,0,520
ODISHA,PURI,2021-03-24,6,529,0,535
ODISHA,PURI,2021-03-25,5,548,0,553
ODISHA,RAYAGADA,2021-03-21,0,165,0,165
ODISHA,RAYAGADA,2021-03-22,4,499,0,503
ODISHA,RAYAGADA,2021-03-23,2,689,0,691
ODISHA,RAYAGADA,2021-03-24,4,349,1,354
ODISHA,RAYAGADA,2021-03-25,1,766,0,767
ODISHA,SAMBALPUR,2021-03-21,1,398,0,399
ODISHA,SAMBALPUR,2021-03-22,6,560,0,566
ODISHA,SAMBALPUR,2021-03-23,4,550,1,555
ODISHA,SAMBALPUR,2021-03-24,23,474,0,497
ODISHA,SAMBALPUR,2021-03-25,7,431,0,438
ODISHA,SONEPUR,2021-03-21,0,103,1,104
ODISHA,SONEPUR,2021-03-22,0,102,0,102
ODISHA,SONEPUR,2021-03-23,0,251,0,251
ODISHA,SONEPUR,2021-03-24,0,630,0,630
ODISHA,SONEPUR,2021-03-25,0,327,0,327
ODISHA,SUNDARGARH,2021-03-21,12,192,0,204
ODISHA,SUNDARGARH,2021-03-22,14,665,0,679
ODISHA,SUNDARGARH,2021-03-23,18,494,1,513
ODISHA,SUNDARGARH,2021-03-24,18,291,1,310
ODISHA,SUNDARGARH,2021-03-25,38,560,1,599
PUDUCHERRY,KARAIKAL,2021-03-21,0,23,0,23
PUDUCHERRY,KARAIKAL,2021-03-22,34,364,0,398
PUDUCHERRY,KARAIKAL,2021-03-23,39,368,1,408
PUDUCHERRY,KARAIKAL,2021-03-24,31,398,0,429
PUDUCHERRY,KARAIKAL,2021-03-25,30,250,0,280
PUDUCHERRY,MAHE,2021-03-21,0,20,0,20
PUDUCHERRY,MAHE,2021-03-22,3,69,0,72
PUDUCHERRY,MAHE,2021-03-23,1,142,0,143
PUDUCHERRY,MAHE,2021-03-24,2,87,0,89
PUDUCHERRY,MAHE,2021-03-25,2,117,0,119
PUDUCHERRY,PONDICHERRY,2021-03-21,54,213,4,271
PUDUCHERRY,PONDICHERRY,2021-03-22,66,665,2,733
PUDUCHERRY,PONDICHERRY,2021-03-23,72,745,6,823
PUDUCHERRY,PONDICHERRY,2021-03-24,80,807,8,895
PUDUCHERRY,PONDICHERRY,2021-03-25,57,693,0,750
PUDUCHERRY,YANAM,2021-03-22,0,123,0,123
PUDUCHERRY,YANAM,2021-03-23,6,0,0,6
PUDUCHERRY,YANAM,2021-03-24,3,73,0,76
PUDUCHERRY,YANAM,2021-03-25,2,2,0,4
PUNJAB,AMRITSAR,2021-03-21,253,2192,17,2462
PUNJAB,AMRITSAR,2021-03-22,261,1795,15,2071
PUNJAB,AMRITSAR,2021-03-23,426,2288,6,2720
PUNJAB,AMRITSAR,2021-03-24,444,2305,29,2778
PUNJAB,AMRITSAR,2021-03-25,316,2384,43,2743
PUNJAB,BARNALA,2021-03-21,12,65,10,87
PUNJAB,BARNALA,2021-03-22,19,275,10,304
PUNJAB,BARNALA,2021-03-23,8,400,8,416
PUNJAB,BARNALA,2021-03-24,11,417,0,428
PUNJAB,BARNALA,2021-03-25,45,124,5,174
PUNJAB,BATHINDA,2021-03-21,69,1214,12,1295
PUNJAB,BATHINDA,2021-03-22,48,616,30,694
PUNJAB,BATHINDA,2021-03-23,114,971,8,1093
PUNJAB,BATHINDA,2021-03-24,90,844,10,944
PUNJAB,BATHINDA,2021-03-25,116,679,2,797
PUNJAB,FARIDKOT,2021-03-21,59,412,7,478
PUNJAB,FARIDKOT,2021-03-22,43,75,8,126
PUNJAB,FARIDKOT,2021-03-23,17,975,1,993
PUNJAB,FARIDKOT,2021-03-24,71,337,2,410
PUNJAB,FARIDKOT,2021-03-25,21,284,6,311
PUNJAB,FATEHGARH SAHIB,2021-03-21,36,327,3,366
PUNJAB,FATEHGARH SAHIB,2021-03-22,21,805,0,826
PUNJAB,FATEHGARH SAHIB,2021-03-23,28,492,4,524
PUNJAB,FATEHGARH SAHIB,2021-03-24,65,1335,1,1401
PUNJAB,FATEHGARH SAHIB,2021-03-25,75,564,2,641
PUNJAB,FAZILKA,2021-03-21,35,129,2,166
PUNJAB,FAZILKA,2021-03-22,39,1058,13,1110
PUNJAB,FAZILKA,2021-03-23,22,321,0,343
PUNJAB,FAZILKA,2021-03-24,24,121,0,145
PUNJAB,FAZILKA,2021-03-25,33,167,10,210
PUNJAB,FIROZEPUR,2021-03-21,29,368,10,407
PUNJAB,FIROZEPUR,2021-03-22,12,708,12,732
PUNJAB,FIROZEPUR,2021-03-23,12,560,1,573
PUNJAB,FIROZEPUR,2021-03-24,42,377,16,435
PUNJAB,FIROZEPUR,2021-03-25,50,608,63,721
PUNJAB,GURDASPUR,2021-03-21,168,308,0,476
PUNJAB,GURDASPUR,2021-03-22,152,548,1,701
PUNJAB,GURDASPUR,2021-03-23,126,1028,23,1177
PUNJAB,GURDASPUR,2021-03-24,130,656,2,788
PUNJAB,GURDASPUR,2021-03-25,103,493,1,597
PUNJAB,HOSHIARPUR,2021-03-21,250,2461,33,2744
PUNJAB,HOSHIARPUR,2021-03-22,267,1889,7,2163
PUNJAB,HOSHIARPUR,2021-03-23,303,2446,32,2781
PUNJAB,HOSHIARPUR,2021-03-24,273,2665,26,2964
PUNJAB,HOSHIARPUR,2021-03-25,248,2432,21,2701
PUNJAB,JALANDHAR,2021-03-21,316,2740,164,3220
PUNJAB,JALANDHAR,2021-03-22,507,3557,158,4222
PUNJAB,JALANDHAR,2021-03-23,409,3414,8,3831
PUNJAB,JALANDHAR,2021-03-24,545,4529,86,5160
PUNJAB,JALANDHAR,2021-03-25,507,5000,161,5668
PUNJAB,KAPURTHALA,2021-03-21,36,265,5,306
PUNJAB,KAPURTHALA,2021-03-22,168,1576,6,1750
PUNJAB,KAPURTHALA,2021-03-23,107,750,2,859
PUNJAB,KAPURTHALA,2021-03-24,165,1310,3,1478
PUNJAB,KAPURTHALA,2021-03-25,61,900,5,966
PUNJAB,LUDHIANA,2021-03-21,333,4262,11,4606
PUNJAB,LUDHIANA,2021-03-22,470,4743,2,5215
PUNJAB,LUDHIANA,2021-03-23,384,3136,10,3530
PUNJAB,LUDHIANA,2021-03-24,337,4213,3,4553
PUNJAB,LUDHIANA,2021-03-25,391,4354,18,4763
PUNJAB,MANSA,2021-03-21,0,765,0,765
PUNJAB,MANSA,2021-03-22,56,617,0,673
PUNJAB,MANSA,2021-03-23,3,1057,0,1060
PUNJAB,MANSA,2021-03-24,47,679,1,727
PUNJAB,MANSA,2021-03-25,3,438,1,442
PUNJAB,MOGA,2021-03-21,46,245,44,335
PUNJAB,MOGA,2021-03-22,41,816,10,867
PUNJAB,MOGA,2021-03-23,33,253,1,287
PUNJAB,MOGA,2021-03-24,52,715,9,776
PUNJAB,MOGA,2021-03-25,27,181,25,233
PUNJAB,PATHANKOT,2021-03-21,33,705,6,744
PUNJAB,PATHANKOT,2021-03-22,22,536,1,559
PUNJAB,PATHANKOT,2021-03-23,19,162,0,181
PUNJAB,PATHANKOT,2021-03-24,35,145,0,180
PUNJAB,PATHANKOT,2021-03-25,51,1451,3,1505
PUNJAB,PATIALA,2021-03-21,187,1520,0,1707
PUNJAB,PATIALA,2021-03-22,315,2102,4,2421
PUNJAB,PATIALA,2021-03-23,215,3011,3,3229
PUNJAB,PATIALA,2021-03-24,345,2656,0,3001
PUNJAB,PATIALA,2021-03-25,253,1963,6,2222
PUNJAB,RUPNAGAR,2021-03-21,82,1191,4,1277
PUNJAB,RUPNAGAR,2021-03-22,44,795,0,839
PUNJAB,RUPNAGAR,2021-03-23,122,916,2,1040
PUNJAB,RUPNAGAR,2021-03-24,41,534,0,575
PUNJAB,RUPNAGAR,2021-03-25,57,817,4,878
PUNJAB,S.A.S NAGAR,2021-03-21,258,1201,18,1477
PUNJAB,S.A.S NAGAR,2021-03-22,359,1405,22,1786
PUNJAB,S.A.S NAGAR,2021-03-23,375,1472,11,1858
PUNJAB,S.A.S NAGAR,2021-03-24,372,1620,15,2007
PUNJAB,S.A.S NAGAR,2021-03-25,453,1806,14,2273
PUNJAB,SANGRUR,2021-03-21,15,1416,1,1432
PUNJAB,SANGRUR,2021-03-22,90,1468,3,1561
PUNJAB,SANGRUR,2021-03-23,20,1676,0,1696
PUNJAB,SANGRUR,2021-03-24,100,1627,0,1727
PUNJAB,SANGRUR,2021-03-25,18,1754,1,1773
PUNJAB,SHAHID BHAGAT SINGH NAGAR,2021-03-21,116,1359,2,1477
PUNJAB,SHAHID BHAGAT SINGH NAGAR,2021-03-22,174,1024,0,1198
PUNJAB,SHAHID BHAGAT SINGH NAGAR,2021-03-23,26,1629,1,1656
PUNJAB,SHAHID BHAGAT SINGH NAGAR,2021-03-24,100,1366,1,1467
PUNJAB,SHAHID BHAGAT SINGH NAGAR,2021-03-25,14,1356,2,1372
PUNJAB,SRI MUKTSAR SAHIB,2021-03-21,16,196,12,224
PUNJAB,SRI MUKTSAR SAHIB,2021-03-22,44,198,1,243
PUNJAB,SRI MUKTSAR SAHIB,2021-03-23,21,442,6,469
PUNJAB,SRI MUKTSAR SAHIB,2021-03-24,16,166,23,205
PUNJAB,SRI MUKTSAR SAHIB,2021-03-25,21,423,11,455
PUNJAB,TARN TARAN,2021-03-21,46,599,2,647
PUNJAB,TARN TARAN,2021-03-22,16,555,2,573
PUNJAB,TARN TARAN,2021-03-23,38,439,0,477
PUNJAB,TARN TARAN,2021-03-24,80,1217,1,1298
PUNJAB,TARN TARAN,2021-03-25,15,213,0,228
RAJASTHAN,AJMER,2021-03-21,1,15,789,805
RAJASTHAN,AJMER,2021-03-22,5,37,1109,1151
RAJASTHAN,AJMER,2021-03-23,5,39,985,1029
RAJASTHAN,AJMER,2021-03-24,0,45,978,1023
RAJASTHAN,AJMER,2021-03-25,8,111,1077,1196
RAJASTHAN,ALWAR,2021-03-21,9,1518,59,1586
RAJASTHAN,ALWAR,2021-03-22,22,1064,35,1121
RAJASTHAN,ALWAR,2021-03-23,21,1400,39,1460
RAJASTHAN,ALWAR,2021-03-24,31,1236,36,1303
RAJASTHAN,ALWAR,2021-03-25,4,1348,24,1376
RAJASTHAN,BANSWARA,2021-03-21,0,30,0,30
RAJASTHAN,BANSWARA,2021-03-22,5,52,0,57
RAJASTHAN,BANSWARA,2021-03-23,1,52,2,55
RAJASTHAN,BANSWARA,2021-03-24,2,53,0,55
RAJASTHAN,BANSWARA,2021-03-25,7,68,0,75
RAJASTHAN,BARAN,2021-03-21,4,71,0,75
RAJASTHAN,BARAN,2021-03-22,7,215,1,223
RAJASTHAN,BARAN,2021-03-23,1,98,0,99
RAJASTHAN,BARAN,2021-03-24,4,204,1,209
RAJASTHAN,BARAN,2021-03-25,0,8,0,8
RAJASTHAN,BARMER,2021-03-21,6,56,0,62
RAJASTHAN,BARMER,2021-03-22,2,166,0,168
RAJASTHAN,BARMER,2021-03-23,0,203,2,205
RAJASTHAN,BARMER,2021-03-24,2,193,0,195
RAJASTHAN,BARMER,2021-03-25,0,211,1,212
RAJASTHAN,BHARATPUR,2021-03-21,6,601,7,614
RAJASTHAN,BHARATPUR,2021-03-22,2,499,4,505
RAJASTHAN,BHARATPUR,2021-03-23,8,269,4,281
RAJASTHAN,BHARATPUR,2021-03-24,1,276,3,280
RAJASTHAN,BHARATPUR,2021-03-25,0,82,1,83
RAJASTHAN,BHILWARA,2021-03-21,14,420,10,444
RAJASTHAN,BHILWARA,2021-03-22,39,408,5,452
RAJASTHAN,BHILWARA,2021-03-23,23,652,3,678
RAJASTHAN,BHILWARA,2021-03-24,51,962,3,1016
RAJASTHAN,BHILWARA,2021-03-25,46,627,3,676
RAJASTHAN,BIKANER,2021-03-21,2,431,1,434
RAJASTHAN,BIKANER,2021-03-22,26,661,1,688
RAJASTHAN,BIKANER,2021-03-23,2,410,2,414
RAJASTHAN,BIKANER,2021-03-24,2,650,4,656
RAJASTHAN,BIKANER,2021-03-25,3,964,2,969
RAJASTHAN,BUNDI,2021-03-21,0,241,2,243
RAJASTHAN,BUNDI,2021-03-22,2,94,2,98
RAJASTHAN,BUNDI,2021-03-23,0,58,1,59
RAJASTHAN,BUNDI,2021-03-24,1,274,1,276
RAJASTHAN,BUNDI,2021-03-25,0,152,3,155
RAJASTHAN,CHITTORGARH,2021-03-21,0,227,1,228
RAJASTHAN,CHITTORGARH,2021-03-22,38,478,11,527
RAJASTHAN,CHITTORGARH,2021-03-23,30,490,2,522
RAJASTHAN,CHITTORGARH,2021-03-24,20,545,5,570
RAJASTHAN,CHITTORGARH,2021-03-25,13,511,6,530
RAJASTHAN,CHURU,2021-03-21,4,288,4,296
RAJASTHAN,CHURU,2021-03-22,0,152,5,157
RAJASTHAN,CHURU,2021-03-23,1,610,2,613
RAJASTHAN,CHURU,2021-03-24,0,844,6,850
RAJASTHAN,CHURU,2021-03-25,2,649,2,653
RAJASTHAN,DAUSA,2021-03-21,2,298,13,313
RAJASTHAN,DAUSA,2021-03-22,3,249,14,266
RAJASTHAN,DAUSA,2021-03-23,0,392,11,403
RAJASTHAN,DAUSA,2021-03-24,1,715,9,725
RAJASTHAN,DAUSA,2021-03-25,0,454,10,464
RAJASTHAN,DHOLPUR,2021-03-21,0,13,2,15
RAJASTHAN,DHOLPUR,2021-03-22,2,10,1,13
RAJASTHAN,DHOLPUR,2021-03-23,2,17,0,19
RAJASTHAN,DHOLPUR,2021-03-24,1,12,0,13
RAJASTHAN,DHOLPUR,2021-03-25,0,42,3,45
RAJASTHAN,DUNGARPUR,2021-03-21,21,166,0,187
RAJASTHAN,DUNGARPUR,2021-03-22,36,255,0,291
RAJASTHAN,DUNGARPUR,2021-03-23,47,398,0,445
RAJASTHAN,DUNGARPUR,2021-03-24,65,510,0,575
RAJASTHAN,DUNGARPUR,2021-03-25,9,289,0,298
RAJASTHAN,GANGANAGAR,2021-03-21,83,164,18,265
RAJASTHAN,GANGANAGAR,2021-03-22,70,97,4,171
RAJASTHAN,GANGANAGAR,2021-03-23,10,83,3,96
RAJASTHAN,GANGANAGAR,2021-03-24,36,102,5,143
RAJASTHAN,GANGANAGAR,2021-03-25,39,100,3,142
RAJASTHAN,HANUMANGARH,2021-03-21,5,690,1,696
RAJASTHAN,HANUMANGARH,2021-03-22,4,305,4,313
RAJASTHAN,HANUMANGARH,2021-03-23,7,659,1,667
RAJASTHAN,HANUMANGARH,2021-03-24,3,812,1,816
RAJASTHAN,HANUMANGARH,2021-03-25,5,215,1,221
RAJASTHAN,JAIPUR,2021-03-21,99,1054,522,1675
RAJASTHAN,JAIPUR,2021-03-22,88,2711,389,3188
RAJASTHAN,JAIPUR,2021-03-23,149,5018,546,5713
RAJASTHAN,JAIPUR,2021-03-24,92,3572,538,4202
RAJASTHAN,JAIPUR,2021-03-25,144,3656,522,4322
RAJASTHAN,JAISALMER,2021-03-21,0,166,0,166
RAJASTHAN,JAISALMER,2021-03-22,0,120,1,121
RAJASTHAN,JAISALMER,2021-03-23,2,154,1,157
RAJASTHAN,JAISALMER,2021-03-24,1,210,3,214
RAJASTHAN,JAISALMER,2021-03-25,1,158,0,159
RAJASTHAN,JALORE,2021-03-21,4,188,1,193
RAJASTHAN,JALORE,2021-03-22,1,258,2,261
RAJASTHAN,JALORE,2021-03-23,2,40,2,44
RAJASTHAN,JALORE,2021-03-24,3,442,2,447
RAJASTHAN,JALORE,2021-03-25,6,578,1,585
RAJASTHAN,JHALAWAR,2021-03-21,9,267,7,283
RAJASTHAN,JHALAWAR,2021-03-22,28,250,1,279
RAJASTHAN,JHALAWAR,2021-03-23,35,447,2,484
RAJASTHAN,JHALAWAR,2021-03-24,0,467,0,467
RAJASTHAN,JHALAWAR,2021-03-25,22,171,2,195
RAJASTHAN,JHUNJHUNU,2021-03-21,2,63,8,73
RAJASTHAN,JHUNJHUNU,2021-03-22,4,72,1,77
RAJASTHAN,JHUNJHUNU,2021-03-23,1,101,3,105
RAJASTHAN,JHUNJHUNU,2021-03-24,1,110,4,115
RAJASTHAN,JHUNJHUNU,2021-03-25,4,102,6,112
RAJASTHAN,JODHPUR,2021-03-21,46,967,12,1025
RAJASTHAN,JODHPUR,2021-03-22,67,817,5,889
RAJASTHAN,JODHPUR,2021-03-23,55,1008,2,1065
RAJASTHAN,JODHPUR,2021-03-24,150,1825,4,1979
RAJASTHAN,JODHPUR,2021-03-25,51,1393,7,1451
RAJASTHAN,KARAULI,2021-03-21,3,89,3,95
RAJASTHAN,KARAULI,2021-03-22,0,105,5,110
RAJASTHAN,KARAULI,2021-03-23,3,215,4,222
RAJASTHAN,KARAULI,2021-03-24,7,314,8,329
RAJASTHAN,KARAULI,2021-03-25,5,622,2,629
RAJASTHAN,KOTA,2021-03-21,9,1215,9,1233
RAJASTHAN,KOTA,2021-03-22,85,1424,6,1515
RAJASTHAN,KOTA,2021-03-23,88,1940,0,2028
RAJASTHAN,KOTA,2021-03-24,81,1730,6,1817
RAJASTHAN,KOTA,2021-03-25,7,1562,8,1577
RAJASTHAN,NAGAUR,2021-03-21,0,43,165,208
RAJASTHAN,NAGAUR,2021-03-22,4,87,10,101
RAJASTHAN,NAGAUR,2021-03-23,0,148,98,246
RAJASTHAN,NAGAUR,2021-03-24,0,138,22,160
RAJASTHAN,NAGAUR,2021-03-25,3,160,23,186
RAJASTHAN,PALI,2021-03-21,2,16,0,18
RAJASTHAN,PALI,2021-03-22,3,18,4,25
RAJASTHAN,PALI,2021-03-23,6,32,1,39
RAJASTHAN,PALI,2021-03-24,4,168,2,174
RAJASTHAN,PALI,2021-03-25,5,572,4,581
RAJASTHAN,PRATAPGARH,2021-03-21,2,2,0,4
RAJASTHAN,PRATAPGARH,2021-03-22,2,9,0,11
RAJASTHAN,PRATAPGARH,2021-03-23,0,9,0,9
RAJASTHAN,PRATAPGARH,2021-03-24,26,6,0,32
RAJASTHAN,PRATAPGARH,2021-03-25,17,14,0,31
RAJASTHAN,RAJSAMAND,2021-03-21,19,152,1,172
RAJASTHAN,RAJSAMAND,2021-03-22,38,235,4,277
RAJASTHAN,RAJSAMAND,2021-03-23,1,31,0,32
RAJASTHAN,RAJSAMAND,2021-03-24,3,67,0,70
RAJASTHAN,RAJSAMAND,2021-03-25,2,91,1,94
RAJASTHAN,SAWAI MADHOPUR,2021-03-21,0,122,2,124
RAJASTHAN,SAWAI MADHOPUR,2021-03-22,1,139,7,147
RAJASTHAN,SAWAI MADHOPUR,2021-03-23,0,229,5,234
RAJASTHAN,SAWAI MADHOPUR,2021-03-24,0,133,10,143
RAJASTHAN,SAWAI MADHOPUR,2021-03-25,2,211,9,222
RAJASTHAN,SIKAR,2021-03-21,8,285,7,300
RAJASTHAN,SIKAR,2021-03-22,2,214,9,225
RAJASTHAN,SIKAR,2021-03-23,5,140,6,151
RAJASTHAN,SIKAR,2021-03-24,3,160,7,170
RAJASTHAN,SIKAR,2021-03-25,3,135,8,146
RAJASTHAN,SIROHI,2021-03-21,0,22,0,22
RAJASTHAN,SIROHI,2021-03-22,6,50,1,57
RAJASTHAN,SIROHI,2021-03-23,0,14,0,14
RAJASTHAN,SIROHI,2021-03-24,0,10,1,11
RAJASTHAN,SIROHI,2021-03-25,1,9,1,11
RAJASTHAN,TONK,2021-03-21,0,295,30,325
RAJASTHAN,TONK,2021-03-22,0,169,31,200
RAJASTHAN,TONK,2021-03-23,0,115,6,121
RAJASTHAN,TONK,2021-03-24,0,74,14,88
RAJASTHAN,TONK,2021-03-25,1,159,17,177
RAJASTHAN,UDAIPUR,2021-03-21,159,738,1,898
RAJASTHAN,UDAIPUR,2021-03-22,176,905,2,1083
RAJASTHAN,UDAIPUR,2021-03-23,199,1309,0,1508
RAJASTHAN,UDAIPUR,2021-03-24,248,1633,2,1883
RAJASTHAN,UDAIPUR,2021-03-25,241,1395,2,1638
SIKKIM,EAST DISTRICT,2021-03-21,0,4,0,4
SIKKIM,EAST DISTRICT,2021-03-22,2,112,0,114
SIKKIM,EAST DISTRICT,2021-03-23,2,136,0,138
SIKKIM,EAST DISTRICT,2021-03-24,3,100,0,103
SIKKIM,EAST DISTRICT,2021-03-25,1,138,0,139
SIKKIM,NORTH DISTRICT,2021-03-21,0,1,0,1
SIKKIM,NORTH DISTRICT,2021-03-22,0,4,0,4
SIKKIM,NORTH DISTRICT,2021-03-23,0,6,0,6
SIKKIM,NORTH DISTRICT,2021-03-24,0,5,0,5
SIKKIM,NORTH DISTRICT,2021-03-25,0,5,0,5
SIKKIM,SOUTH DISTRICT,2021-03-21,0,4,0,4
SIKKIM,SOUTH DISTRICT,2021-03-22,0,5,0,5
SIKKIM,SOUTH DISTRICT,2021-03-23,0,33,0,33
SIKKIM,SOUTH DISTRICT,2021-03-24,0,6,0,6
SIKKIM,SOUTH DISTRICT,2021-03-25,0,14,0,14
SIKKIM,WEST DISTRICT,2021-03-21,0,1,0,1
SIKKIM,WEST DISTRICT,2021-03-22,0,7,0,7
SIKKIM,WEST DISTRICT,2021-03-23,0,8,0,8
SIKKIM,WEST DISTRICT,2021-03-24,0,3,0,3
SIKKIM,WEST DISTRICT,2021-03-25,0,6,0,6
TAMIL NADU,ARIYALUR,2021-03-21,1,70,1,72
TAMIL NADU,ARIYALUR,2021-03-22,14,529,0,543
TAMIL NADU,ARIYALUR,2021-03-23,6,846,2,854
TAMIL NADU,ARIYALUR,2021-03-24,8,526,0,534
TAMIL NADU,ARIYALUR,2021-03-25,6,745,0,751
TAMIL NADU,CHENGALPATTU,2021-03-21,125,4280,0,4405
TAMIL NADU,CHENGALPATTU,2021-03-22,144,5669,2,5815
TAMIL NADU,CHENGALPATTU,2021-03-23,201,4066,0,4267
TAMIL NADU,CHENGALPATTU,2021-03-24,172,5999,1,6172
TAMIL NADU,CHENGALPATTU,2021-03-25,198,5127,2,5327
TAMIL NADU,CHENNAI,2021-03-21,730,11836,91,12657
TAMIL NADU,CHENNAI,2021-03-22,702,10050,89,10841
TAMIL NADU,CHENNAI,2021-03-23,866,15010,42,15918
TAMIL NADU,CHENNAI,2021-03-24,971,13830,30,14831
TAMIL NADU,CHENNAI,2021-03-25,1059,14094,18,15171
TAMIL NADU,COIMBATORE,2021-03-21,175,2386,0,2561
TAMIL NADU,COIMBATORE,2021-03-22,147,3596,5,3748
TAMIL NADU,COIMBATORE,2021-03-23,191,3210,0,3401
TAMIL NADU,COIMBATORE,2021-03-24,206,4051,0,4257
TAMIL NADU,COIMBATORE,2021-03-25,214,3105,3,3322
TAMIL NADU,CUDDALORE,2021-03-21,30,584,0,614
TAMIL NADU,CUDDALORE,2021-03-22,32,2605,0,2637
TAMIL NADU,CUDDALORE,2021-03-23,35,2869,2,2906
TAMIL NADU,CUDDALORE,2021-03-24,23,2410,3,2436
TAMIL NADU,CUDDALORE,2021-03-25,23,2986,0,3009
TAMIL NADU,DHARMAPURI,2021-03-21,9,713,0,722
TAMIL NADU,DHARMAPURI,2021-03-22,4,421,0,425
TAMIL NADU,DHARMAPURI,2021-03-23,13,750,0,763
TAMIL NADU,DHARMAPURI,2021-03-24,4,668,0,672
TAMIL NADU,DHARMAPURI,2021-03-25,11,1001,0,1012
TAMIL NADU,DINDIGUL,2021-03-21,16,452,0,468
TAMIL NADU,DINDIGUL,2021-03-22,16,1341,2,1359
TAMIL NADU,DINDIGUL,2021-03-23,18,1768,7,1793
TAMIL NADU,DINDIGUL,2021-03-24,21,1316,1,1338
TAMIL NADU,DINDIGUL,2021-03-25,19,2111,0,2130
TAMIL NADU,ERODE,2021-03-21,24,1980,0,2004
TAMIL NADU,ERODE,2021-03-22,24,864,1,889
TAMIL NADU,ERODE,2021-03-23,32,2412,0,2444
TAMIL NADU,ERODE,2021-03-24,36,1711,1,1748
TAMIL NADU,ERODE,2021-03-25,28,2271,0,2299
TAMIL NADU,KALLAKURICHI,2021-03-21,3,153,0,156
TAMIL NADU,KALLAKURICHI,2021-03-22,3,629,0,632
TAMIL NADU,KALLAKURICHI,2021-03-23,6,149,0,155
TAMIL NADU,KALLAKURICHI,2021-03-24,3,399,0,402
TAMIL NADU,KALLAKURICHI,2021-03-25,5,333,1,339
TAMIL NADU,KANCHIPURAM,2021-03-21,34,2106,1,2141
TAMIL NADU,KANCHIPURAM,2021-03-22,84,1906,1,1991
TAMIL NADU,KANCHIPURAM,2021-03-23,66,3252,1,3319
TAMIL NADU,KANCHIPURAM,2021-03-24,35,2606,3,2644
TAMIL NADU,KANCHIPURAM,2021-03-25,69,2917,2,2988
TAMIL NADU,KANNIYAKUMARI,2021-03-21,11,807,3,821
TAMIL NADU,KANNIYAKUMARI,2021-03-22,30,1379,6,1415
TAMIL NADU,KANNIYAKUMARI,2021-03-23,11,1905,7,1923
TAMIL NADU,KANNIYAKUMARI,2021-03-24,26,1607,1,1634
TAMIL NADU,KANNIYAKUMARI,2021-03-25,36,1358,6,1400
TAMIL NADU,KARUR,2021-03-21,8,1064,0,1072
TAMIL NADU,KARUR,2021-03-22,4,595,0,599
TAMIL NADU,KARUR,2021-03-23,4,1226,1,1231
TAMIL NADU,KARUR,2021-03-24,9,1116,2,1127
TAMIL NADU,KARUR,2021-03-25,14,1076,4,1094
TAMIL NADU,KRISHNAGIRI,2021-03-21,16,507,3,526
TAMIL NADU,KRISHNAGIRI,2021-03-22,9,1047,1,1057
TAMIL NADU,KRISHNAGIRI,2021-03-23,28,690,1,719
TAMIL NADU,KRISHNAGIRI,2021-03-24,20,1014,2,1036
TAMIL NADU,KRISHNAGIRI,2021-03-25,28,1301,0,1329
TAMIL NADU,MADURAI,2021-03-21,35,2607,3,2645
TAMIL NADU,MADURAI,2021-03-22,48,1831,1,1880
TAMIL NADU,MADURAI,2021-03-23,47,1640,0,1687
TAMIL NADU,MADURAI,2021-03-24,42,2622,7,2671
TAMIL NADU,MADURAI,2021-03-25,23,3001,0,3024
TAMIL NADU,NAGAPATTINAM,2021-03-21,19,453,0,472
TAMIL NADU,NAGAPATTINAM,2021-03-22,30,291,0,321
TAMIL NADU,NAGAPATTINAM,2021-03-23,38,1279,0,1317
TAMIL NADU,NAGAPATTINAM,2021-03-24,38,1231,0,1269
TAMIL NADU,NAGAPATTINAM,2021-03-25,54,1105,0,1159
TAMIL NADU,NAMAKKAL,2021-03-21,10,936,0,946
TAMIL NADU,NAMAKKAL,2021-03-22,16,869,0,885
TAMIL NADU,NAMAKKAL,2021-03-23,14,1170,4,1188
TAMIL NADU,NAMAKKAL,2021-03-24,25,1405,0,1430
TAMIL NADU,NAMAKKAL,2021-03-25,15,918,0,933
TAMIL NADU,PERAMBALUR,2021-03-21,3,357,0,360
TAMIL NADU,PERAMBALUR,2021-03-22,0,300,0,300
TAMIL NADU,PERAMBALUR,2021-03-23,2,587,0,589
TAMIL NADU,PERAMBALUR,2021-03-24,0,508,0,508
TAMIL NADU,PERAMBALUR,2021-03-25,0,461,0,461
TAMIL NADU,PUDUKKOTTAI,2021-03-21,5,854,1,860
TAMIL NADU,PUDUKKOTTAI,2021-03-22,5,572,0,577
TAMIL NADU,PUDUKKOTTAI,2021-03-23,9,1213,1,1223
TAMIL NADU,PUDUKKOTTAI,2021-03-24,12,1247,0,1259
TAMIL NADU,PUDUKKOTTAI,2021-03-25,24,1136,0,1160
TAMIL NADU,RAMANATHAPURAM,2021-03-21,4,766,0,770
TAMIL NADU,RAMANATHAPURAM,2021-03-22,7,717,0,724
TAMIL NADU,RAMANATHAPURAM,2021-03-23,3,1035,0,1038
TAMIL NADU,RAMANATHAPURAM,2021-03-24,7,870,0,877
TAMIL NADU,RAMANATHAPURAM,2021-03-25,8,931,0,939
TAMIL NADU,RANIPET,2021-03-21,14,287,2,303
TAMIL NADU,RANIPET,2021-03-22,6,638,0,644
TAMIL NADU,RANIPET,2021-03-23,13,546,0,559
TAMIL NADU,RANIPET,2021-03-24,22,257,2,281
TAMIL NADU,RANIPET,2021-03-25,22,413,0,435
TAMIL NADU,SALEM,2021-03-21,36,1139,1,1176
TAMIL NADU,SALEM,2021-03-22,34,1790,6,1830
TAMIL NADU,SALEM,2021-03-23,41,1858,5,1904
TAMIL NADU,SALEM,2021-03-24,30,2205,4,2239
TAMIL NADU,SALEM,2021-03-25,57,4402,5,4464
TAMIL NADU,SIVAGANGA,2021-03-21,9,441,0,450
TAMIL NADU,SIVAGANGA,2021-03-22,10,817,0,827
TAMIL NADU,SIVAGANGA,2021-03-23,11,932,0,943
TAMIL NADU,SIVAGANGA,2021-03-24,13,874,0,887
TAMIL NADU,SIVAGANGA,2021-03-25,11,931,0,942
TAMIL NADU,TENKASI,2021-03-21,18,451,2,471
TAMIL NADU,TENKASI,2021-03-22,9,516,5,530
TAMIL NADU,TENKASI,2021-03-23,9,654,1,664
TAMIL NADU,TENKASI,2021-03-24,7,676,4,687
TAMIL NADU,TENKASI,2021-03-25,9,748,3,760
TAMIL NADU,THANJAVUR,2021-03-21,80,7975,11,8066
TAMIL NADU,THANJAVUR,2021-03-22,62,9333,0,9395
TAMIL NADU,THANJAVUR,2021-03-23,78,6160,0,6238
TAMIL NADU,THANJAVUR,2021-03-24,118,6263,0,6381
TAMIL NADU,THANJAVUR,2021-03-25,125,5679,1,5805
TAMIL NADU,THE NILGIRIS,2021-03-21,14,967,3,984
TAMIL NADU,THE NILGIRIS,2021-03-22,24,971,3,998
TAMIL NADU,THE NILGIRIS,2021-03-23,24,1183,5,1212
TAMIL NADU,THE NILGIRIS,2021-03-24,15,852,6,873
TAMIL NADU,THE NILGIRIS,2021-03-25,25,1027,8,1060
TAMIL NADU,THENI,2021-03-21,9,296,0,305
TAMIL NADU,THENI,2021-03-22,1,587,0,588
TAMIL NADU,THENI,2021-03-23,12,608,0,620
TAMIL NADU,THENI,2021-03-24,1,564,0,565
TAMIL NADU,THENI,2021-03-25,9,587,0,596
TAMIL NADU,THIRUVALLUR,2021-03-21,70,1580,6,1656
TAMIL NADU,THIRUVALLUR,2021-03-22,97,2198,8,2303
TAMIL NADU,THIRUVALLUR,2021-03-23,141,3285,13,3439
TAMIL NADU,THIRUVALLUR,2021-03-24,117,2892,9,3018
TAMIL NADU,THIRUVALLUR,2021-03-25,150,2914,4,3068
TAMIL NADU,THIRUVARUR,2021-03-21,38,155,1,194
TAMIL NADU,THIRUVARUR,2021-03-22,22,1690,0,1712
TAMIL NADU,THIRUVARUR,2021-03-23,36,1146,0,1182
TAMIL NADU,THIRUVARUR,2021-03-24,54,1229,0,1283
TAMIL NADU,THIRUVARUR,2021-03-25,41,949,0,990
TAMIL NADU,TIRUCHIRAPPALLI,2021-03-21,29,2445,0,2474
TAMIL NADU,TIRUCHIRAPPALLI,2021-03-22,25,2339,2,2366
TAMIL NADU,TIRUCHIRAPPALLI,2021-03-23,23,2680,4,2707
TAMIL NADU,TIRUCHIRAPPALLI,2021-03-24,36,2748,1,2785
TAMIL NADU,TIRUCHIRAPPALLI,2021-03-25,33,2709,3,2745
TAMIL NADU,TIRUNELVELI,2021-03-21,16,354,2,372
TAMIL NADU,TIRUNELVELI,2021-03-22,21,1378,2,1401
TAMIL NADU,TIRUNELVELI,2021-03-23,22,1480,1,1503
TAMIL NADU,TIRUNELVELI,2021-03-24,15,1372,1,1388
TAMIL NADU,TIRUNELVELI,2021-03-25,25,1325,0,1350
TAMIL NADU,TIRUPATHUR,2021-03-21,10,1749,20,1779
TAMIL NADU,TIRUPATHUR,2021-03-22,9,2133,0,2142
TAMIL NADU,TIRUPATHUR,2021-03-23,21,3736,0,3757
TAMIL NADU,TIRUPATHUR,2021-03-24,13,2858,4,2875
TAMIL NADU,TIRUPATHUR,2021-03-25,16,2712,10,2738
TAMIL NADU,TIRUPPUR,2021-03-21,42,831,0,873
TAMIL NADU,TIRUPPUR,2021-03-22,25,758,0,783
TAMIL NADU,TIRUPPUR,2021-03-23,63,1738,1,1802
TAMIL NADU,TIRUPPUR,2021-03-24,45,1822,3,1870
TAMIL NADU,TIRUPPUR,2021-03-25,46,1794,0,1840
TAMIL NADU,TIRUVANNAMALAI,2021-03-21,8,224,2,234
TAMIL NADU,TIRUVANNAMALAI,2021-03-22,4,955,0,959
TAMIL NADU,TIRUVANNAMALAI,2021-03-23,8,1044,1,1053
TAMIL NADU,TIRUVANNAMALAI,2021-03-24,16,1068,1,1085
TAMIL NADU,TIRUVANNAMALAI,2021-03-25,11,821,0,832
TAMIL NADU,TUTICORIN,2021-03-21,10,638,2,650
TAMIL NADU,TUTICORIN,2021-03-22,4,313,1,318
TAMIL NADU,TUTICORIN,2021-03-23,17,930,0,947
TAMIL NADU,TUTICORIN,2021-03-24,12,1078,4,1094
TAMIL NADU,TUTICORIN,2021-03-25,24,977,0,1001
TAMIL NADU,VELLORE,2021-03-21,9,571,7,587
TAMIL NADU,VELLORE,2021-03-22,30,1309,4,1343
TAMIL NADU,VELLORE,2021-03-23,36,1718,2,1756
TAMIL NADU,VELLORE,2021-03-24,25,2132,1,2158
TAMIL NADU,VELLORE,2021-03-25,36,1537,0,1573
TAMIL NADU,VILLUPURAM,2021-03-21,9,660,0,669
TAMIL NADU,VILLUPURAM,2021-03-22,4,627,0,631
TAMIL NADU,VILLUPURAM,2021-03-23,15,1043,2,1060
TAMIL NADU,VILLUPURAM,2021-03-24,20,1096,1,1117
TAMIL NADU,VILLUPURAM,2021-03-25,17,1070,0,1087
TAMIL NADU,VIRUDHUNAGAR,2021-03-21,11,717,0,728
TAMIL NADU,VIRUDHUNAGAR,2021-03-22,8,362,0,370
TAMIL NADU,VIRUDHUNAGAR,2021-03-23,7,699,1,707
TAMIL NADU,VIRUDHUNAGAR,2021-03-24,10,960,1,971
TAMIL NADU,VIRUDHUNAGAR,2021-03-25,26,1270,1,1297
TELANGANA,ADILABAD,2021-03-21,0,1784,0,1784
TELANGANA,ADILABAD,2021-03-22,0,853,0,853
TELANGANA,ADILABAD,2021-03-23,1,918,0,919
TELANGANA,ADILABAD,2021-03-24,0,920,0,920
TELANGANA,ADILABAD,2021-03-25,2,1032,0,1034
TELANGANA,BHADRADRI KOTHAGUDEM,2021-03-21,0,760,0,760
TELANGANA,BHADRADRI KOTHAGUDEM,2021-03-22,0,619,0,619
TELANGANA,BHADRADRI KOTHAGUDEM,2021-03-23,0,594,0,594
TELANGANA,BHADRADRI KOTHAGUDEM,2021-03-24,0,673,0,673
TELANGANA,BHADRADRI KOTHAGUDEM,2021-03-25,0,584,0,584
TELANGANA,HYDERABAD,2021-03-21,50,13372,3,13425
TELANGANA,HYDERABAD,2021-03-22,76,8061,7,8144
TELANGANA,HYDERABAD,2021-03-23,69,9495,3,9567
TELANGANA,HYDERABAD,2021-03-24,73,10126,5,10204
TELANGANA,HYDERABAD,2021-03-25,94,9952,5,10051
TELANGANA,JAGITIAL,2021-03-21,0,2230,0,2230
TELANGANA,JAGITIAL,2021-03-22,0,1564,0,1564
TELANGANA,JAGITIAL,2021-03-23,0,1322,0,1322
TELANGANA,JAGITIAL,2021-03-24,0,1336,0,1336
TELANGANA,JAGITIAL,2021-03-25,0,1095,0,1095
TELANGANA,JANGOAN,2021-03-21,0,1235,0,1235
TELANGANA,JANGOAN,2021-03-22,0,751,0,751
TELANGANA,JANGOAN,2021-03-23,0,803,0,803
TELANGANA,JANGOAN,2021-03-24,0,754,0,754
TELANGANA,JANGOAN,2021-03-25,0,648,0,648
TELANGANA,JAYASHANKAR BHUPALAPALLY,2021-03-21,0,842,0,842
TELANGANA,JAYASHANKAR BHUPALAPALLY,2021-03-22,0,798,0,798
TELANGANA,JAYASHANKAR BHUPALAPALLY,2021-03-23,0,916,0,916
TELANGANA,JAYASHANKAR BHUPALAPALLY,2021-03-24,0,630,0,630
TELANGANA,JAYASHANKAR BHUPALAPALLY,2021-03-25,0,645,0,645
TELANGANA,JOGULAMBA GADWAL,2021-03-21,0,1874,0,1874
TELANGANA,JOGULAMBA GADWAL,2021-03-22,0,611,0,611
TELANGANA,JOGULAMBA GADWAL,2021-03-23,1,812,0,813
TELANGANA,JOGULAMBA GADWAL,2021-03-24,0,772,0,772
TELANGANA,JOGULAMBA GADWAL,2021-03-25,0,623,0,623
TELANGANA,KAMAREDDY,2021-03-21,0,1810,0,1810
TELANGANA,KAMAREDDY,2021-03-22,0,1575,0,1575
TELANGANA,KAMAREDDY,2021-03-23,1,1490,0,1491
TELANGANA,KAMAREDDY,2021-03-24,0,861,0,861
TELANGANA,KAMAREDDY,2021-03-25,0,1105,0,1105
TELANGANA,KARIMNAGAR,2021-03-21,0,3061,0,3061
TELANGANA,KARIMNAGAR,2021-03-22,0,1694,0,1694
TELANGANA,KARIMNAGAR,2021-03-23,0,2426,0,2426
TELANGANA,KARIMNAGAR,2021-03-24,2,1841,0,1843
TELANGANA,KARIMNAGAR,2021-03-25,0,1982,0,1982
TELANGANA,KHAMMAM,2021-03-21,13,2121,0,2134
TELANGANA,KHAMMAM,2021-03-22,4,1726,0,1730
TELANGANA,KHAMMAM,2021-03-23,0,1955,0,1955
TELANGANA,KHAMMAM,2021-03-24,4,925,0,929
TELANGANA,KHAMMAM,2021-03-25,1,1109,0,1110
TELANGANA,KUMURAM BHEEM ASIFABAD,2021-03-21,0,773,0,773
TELANGANA,KUMURAM BHEEM ASIFABAD,2021-03-22,0,435,0,435
TELANGANA,KUMURAM BHEEM ASIFABAD,2021-03-23,0,510,0,510
TELANGANA,KUMURAM BHEEM ASIFABAD,2021-03-24,0,497,0,497
TELANGANA,KUMURAM BHEEM ASIFABAD,2021-03-25,0,413,0,413
TELANGANA,MAHABUBABAD,2021-03-21,0,694,0,694
TELANGANA,MAHABUBABAD,2021-03-22,0,295,0,295
TELANGANA,MAHABUBABAD,2021-03-23,0,402,0,402
TELANGANA,MAHABUBABAD,2021-03-24,0,324,0,324
TELANGANA,MAHABUBABAD,2021-03-25,1,324,0,325
TELANGANA,MAHABUBNAGAR,2021-03-21,0,4595,0,4595
TELANGANA,MAHABUBNAGAR,2021-03-22,1,2078,0,2079
TELANGANA,MAHABUBNAGAR,2021-03-23,0,2607,0,2607
TELANGANA,MAHABUBNAGAR,2021-03-24,1,1698,0,1699
TELANGANA,MAHABUBNAGAR,2021-03-25,1,1715,0,1716
TELANGANA,MANCHERIAL,2021-03-21,0,1891,0,1891
TELANGANA,MANCHERIAL,2021-03-22,0,1247,0,1247
TELANGANA,MANCHERIAL,2021-03-23,0,1248,0,1248
TELANGANA,MANCHERIAL,2021-03-24,0,900,0,900
TELANGANA,MANCHERIAL,2021-03-25,0,712,0,712
TELANGANA,MEDAK,2021-03-21,2,872,0,874
TELANGANA,MEDAK,2021-03-22,3,978,1,982
TELANGANA,MEDAK,2021-03-23,1,849,0,850
TELANGANA,MEDAK,2021-03-24,1,273,0,274
TELANGANA,MEDAK,2021-03-25,1,370,0,371
TELANGANA,MEDCHAL MALKAJGIRI,2021-03-21,2,3922,0,3924
TELANGANA,MEDCHAL MALKAJGIRI,2021-03-22,1,2872,0,2873
TELANGANA,MEDCHAL MALKAJGIRI,2021-03-23,5,2857,1,2863
TELANGANA,MEDCHAL MALKAJGIRI,2021-03-24,0,3477,1,3478
TELANGANA,MEDCHAL MALKAJGIRI,2021-03-25,1,3153,0,3154
TELANGANA,MULUGU,2021-03-21,0,996,0,996
TELANGANA,MULUGU,2021-03-22,0,571,0,571
TELANGANA,MULUGU,2021-03-23,0,851,0,851
TELANGANA,MULUGU,2021-03-24,0,734,0,734
TELANGANA,MULUGU,2021-03-25,0,518,0,518
TELANGANA,NAGARKURNOOL,2021-03-21,0,3267,0,3267
TELANGANA,NAGARKURNOOL,2021-03-22,0,1672,0,1672
TELANGANA,NAGARKURNOOL,2021-03-23,0,1689,0,1689
TELANGANA,NAGARKURNOOL,2021-03-24,0,1773,0,1773
TELANGANA,NAGARKURNOOL,2021-03-25,0,1671,0,1671
TELANGANA,NALGONDA,2021-03-21,0,4279,0,4279
TELANGANA,NALGONDA,2021-03-22,0,2563,0,2563
TELANGANA,NALGONDA,2021-03-23,2,2428,0,2430
TELANGANA,NALGONDA,2021-03-24,2,1893,0,1895
TELANGANA,NALGONDA,2021-03-25,0,2584,0,2584
TELANGANA,NARAYANPET,2021-03-21,0,584,0,584
TELANGANA,NARAYANPET,2021-03-22,0,394,0,394
TELANGANA,NARAYANPET,2021-03-23,0,161,0,161
TELANGANA,NARAYANPET,2021-03-24,0,376,0,376
TELANGANA,NARAYANPET,2021-03-25,0,172,0,172
TELANGANA,NIRMAL,2021-03-21,0,1588,0,1588
TELANGANA,NIRMAL,2021-03-22,0,1073,0,1073
TELANGANA,NIRMAL,2021-03-23,2,906,0,908
TELANGANA,NIRMAL,2021-03-24,0,1223,0,1223
TELANGANA,NIRMAL,2021-03-25,0,681,0,681
TELANGANA,NIZAMABAD,2021-03-21,1,2332,0,2333
TELANGANA,NIZAMABAD,2021-03-22,0,2441,0,2441
TELANGANA,NIZAMABAD,2021-03-23,0,2705,0,2705
TELANGANA,NIZAMABAD,2021-03-24,1,1236,0,1237
TELANGANA,NIZAMABAD,2021-03-25,0,1258,0,1258
TELANGANA,PEDDAPALLI,2021-03-21,0,2982,0,2982
TELANGANA,PEDDAPALLI,2021-03-22,0,2072,0,2072
TELANGANA,PEDDAPALLI,2021-03-23,0,2723,0,2723
TELANGANA,PEDDAPALLI,2021-03-24,0,1510,0,1510
TELANGANA,PEDDAPALLI,2021-03-25,0,1627,0,1627
TELANGANA,RAJANNA SIRCILLA,2021-03-21,0,755,0,755
TELANGANA,RAJANNA SIRCILLA,2021-03-22,0,316,0,316
TELANGANA,RAJANNA SIRCILLA,2021-03-23,0,464,0,464
TELANGANA,RAJANNA SIRCILLA,2021-03-24,0,374,0,374
TELANGANA,RAJANNA SIRCILLA,2021-03-25,0,550,0,550
TELANGANA,RANGA REDDY,2021-03-21,12,5943,0,5955
TELANGANA,RANGA REDDY,2021-03-22,17,3546,1,3564
TELANGANA,RANGA REDDY,2021-03-23,11,4597,2,4610
TELANGANA,RANGA REDDY,2021-03-24,14,3412,0,3426
TELANGANA,RANGA REDDY,2021-03-25,23,3457,1,3481
TELANGANA,SANGAREDDY,2021-03-21,0,1332,0,1332
TELANGANA,SANGAREDDY,2021-03-22,0,959,0,959
TELANGANA,SANGAREDDY,2021-03-23,0,1031,0,1031
TELANGANA,SANGAREDDY,2021-03-24,0,940,1,941
TELANGANA,SANGAREDDY,2021-03-25,2,1182,0,1184
TELANGANA,SIDDIPET,2021-03-21,0,3264,0,3264
TELANGANA,SIDDIPET,2021-03-22,0,2038,0,2038
TELANGANA,SIDDIPET,2021-03-23,0,1958,0,1958
TELANGANA,SIDDIPET,2021-03-24,5,1376,0,1381
TELANGANA,SIDDIPET,2021-03-25,0,1836,0,1836
TELANGANA,SURYAPET,2021-03-21,0,1608,0,1608
TELANGANA,SURYAPET,2021-03-22,0,1329,0,1329
TELANGANA,SURYAPET,2021-03-23,1,865,0,866
TELANGANA,SURYAPET,2021-03-24,0,642,0,642
TELANGANA,SURYAPET,2021-03-25,0,740,0,740
TELANGANA,VIKARABAD,2021-03-21,0,1348,0,1348
TELANGANA,VIKARABAD,2021-03-22,1,914,0,915
TELANGANA,VIKARABAD,2021-03-23,2,858,0,860
TELANGANA,VIKARABAD,2021-03-24,1,879,0,880
TELANGANA,VIKARABAD,2021-03-25,1,810,0,811
TELANGANA,WANAPARTHY,2021-03-21,0,550,0,550
TELANGANA,WANAPARTHY,2021-03-22,0,751,0,751
TELANGANA,WANAPARTHY,2021-03-23,0,1047,0,1047
TELANGANA,WANAPARTHY,2021-03-24,0,433,0,433
TELANGANA,WANAPARTHY,2021-03-25,0,541,0,541
TELANGANA,WARANGAL RURAL,2021-03-21,0,1798,0,1798
TELANGANA,WARANGAL RURAL,2021-03-22,5,989,0,994
TELANGANA,WARANGAL RURAL,2021-03-23,2,886,0,888
TELANGANA,WARANGAL RURAL,2021-03-24,1,694,0,695
TELANGANA,WARANGAL RURAL,2021-03-25,0,751,0,751
TELANGANA,WARANGAL URBAN,2021-03-21,0,3976,0,3976
TELANGANA,WARANGAL URBAN,2021-03-22,2,2454,0,2456
TELANGANA,WARANGAL URBAN,2021-03-23,1,2692,0,2693
TELANGANA,WARANGAL URBAN,2021-03-24,0,2320,0,2320
TELANGANA,WARANGAL URBAN,2021-03-25,3,3447,0,3450
TELANGANA,YADADRI BHUVANAGIRI,2021-03-21,0,816,0,816
TELANGANA,YADADRI BHUVANAGIRI,2021-03-22,0,446,0,446
TELANGANA,YADADRI BHUVANAGIRI,2021-03-23,0,1056,0,1056
TELANGANA,YADADRI BHUVANAGIRI,2021-03-24,1,421,0,422
TELANGANA,YADADRI BHUVANAGIRI,2021-03-25,0,493,0,493
TRIPURA,DHALAI,2021-03-21,0,2,0,2
TRIPURA,DHALAI,2021-03-22,0,24,0,24
TRIPURA,DHALAI,2021-03-23,4,87,0,91
TRIPURA,DHALAI,2021-03-24,0,10,0,10
TRIPURA,DHALAI,2021-03-25,0,27,0,27
TRIPURA,GOMATI,2021-03-21,0,4,0,4
TRIPURA,GOMATI,2021-03-22,0,40,0,40
TRIPURA,GOMATI,2021-03-23,0,32,0,32
TRIPURA,GOMATI,2021-03-24,0,43,0,43
TRIPURA,GOMATI,2021-03-25,0,32,0,32
TRIPURA,KHOWAI,2021-03-21,0,7,0,7
TRIPURA,KHOWAI,2021-03-22,0,30,0,30
TRIPURA,KHOWAI,2021-03-23,0,36,0,36
TRIPURA,KHOWAI,2021-03-24,0,65,0,65
TRIPURA,KHOWAI,2021-03-25,0,18,0,18
TRIPURA,NORTH TRIPURA,2021-03-21,0,47,0,47
TRIPURA,NORTH TRIPURA,2021-03-22,0,93,0,93
TRIPURA,NORTH TRIPURA,2021-03-23,0,75,0,75
TRIPURA,NORTH TRIPURA,2021-03-24,0,170,0,170
TRIPURA,NORTH TRIPURA,2021-03-25,1,135,0,136
TRIPURA,SEPAHIJALA,2021-03-21,0,8,0,8
TRIPURA,SEPAHIJALA,2021-03-22,0,94,0,94
TRIPURA,SEPAHIJALA,2021-03-23,0,62,0,62
TRIPURA,SEPAHIJALA,2021-03-24,0,92,0,92
TRIPURA,SEPAHIJALA,2021-03-25,1,50,0,51
TRIPURA,SOUTH TRIPURA,2021-03-21,0,16,0,16
TRIPURA,SOUTH TRIPURA,2021-03-22,0,79,0,79
TRIPURA,SOUTH TRIPURA,2021-03-23,0,81,0,81
TRIPURA,SOUTH TRIPURA,2021-03-24,0,78,0,78
TRIPURA,SOUTH TRIPURA,2021-03-25,0,40,0,40
TRIPURA,UNAKOTI,2021-03-22,0,6,0,6
TRIPURA,UNAKOTI,2021-03-23,0,7,0,7
TRIPURA,UNAKOTI,2021-03-24,0,5,0,5
TRIPURA,UNAKOTI,2021-03-25,0,5,0,5
TRIPURA,WEST TRIPURA,2021-03-21,0,101,0,101
TRIPURA,WEST TRIPURA,2021-03-22,6,311,0,317
TRIPURA,WEST TRIPURA,2021-03-23,3,195,0,198
TRIPURA,WEST TRIPURA,2021-03-24,2,354,0,356
TRIPURA,WEST TRIPURA,2021-03-25,2,226,0,228
UTTAR PRADESH,AGRA,2021-03-21,18,2246,9,2273
UTTAR PRADESH,AGRA,2021-03-22,14,2203,7,2224
UTTAR PRADESH,AGRA,2021-03-23,13,3259,12,3284
UTTAR PRADESH,AGRA,2021-03-24,13,2543,2,2558
UTTAR PRADESH,AGRA,2021-03-25,13,3317,2,3332
UTTAR PRADESH,ALIGARH,2021-03-21,6,2340,126,2472
UTTAR PRADESH,ALIGARH,2021-03-22,14,2164,117,2295
UTTAR PRADESH,ALIGARH,2021-03-23,8,3887,19,3914
UTTAR PRADESH,ALIGARH,2021-03-24,7,2865,0,2872
UTTAR PRADESH,ALIGARH,2021-03-25,4,3151,1,3156
UTTAR PRADESH,AMBEDKAR NAGAR,2021-03-21,1,863,7,871
UTTAR PRADESH,AMBEDKAR NAGAR,2021-03-22,1,1095,3,1099
UTTAR PRADESH,AMBEDKAR NAGAR,2021-03-23,1,1158,16,1175
UTTAR PRADESH,AMBEDKAR NAGAR,2021-03-24,5,1321,1,1327
UTTAR PRADESH,AMBEDKAR NAGAR,2021-03-25,8,946,2,956
UTTAR PRADESH,AMETHI,2021-03-21,0,759,10,769
UTTAR PRADESH,AMETHI,2021-03-22,4,1110,0,1114
UTTAR PRADESH,AMETHI,2021-03-23,7,1051,21,1079
UTTAR PRADESH,AMETHI,2021-03-24,3,930,0,933
UTTAR PRADESH,AMETHI,2021-03-25,8,1150,1,1159
UTTAR PRADESH,AMROHA,2021-03-21,2,940,2,944
UTTAR PRADESH,AMROHA,2021-03-22,0,974,0,974
UTTAR PRADESH,AMROHA,2021-03-23,0,415,1,416
UTTAR PRADESH,AMROHA,2021-03-24,4,997,0,1001
UTTAR PRADESH,AMROHA,2021-03-25,4,1193,1,1198
UTTAR PRADESH,AURAIYA,2021-03-21,2,1094,29,1125
UTTAR PRADESH,AURAIYA,2021-03-22,6,774,5,785
UTTAR PRADESH,AURAIYA,2021-03-23,1,735,50,786
UTTAR PRADESH,AURAIYA,2021-03-24,1,1058,17,1076
UTTAR PRADESH,AURAIYA,2021-03-25,10,991,14,1015
UTTAR PRADESH,AYODHYA,2021-03-21,0,1793,0,1793
UTTAR PRADESH,AYODHYA,2021-03-22,9,1974,2,1985
UTTAR PRADESH,AYODHYA,2021-03-23,29,1953,0,1982
UTTAR PRADESH,AYODHYA,2021-03-24,5,2158,3,2166
UTTAR PRADESH,AYODHYA,2021-03-25,1,2009,0,2010
UTTAR PRADESH,AZAMGARH,2021-03-21,12,936,7,955
UTTAR PRADESH,AZAMGARH,2021-03-22,18,216,1,235
UTTAR PRADESH,AZAMGARH,2021-03-23,9,1276,6,1291
UTTAR PRADESH,AZAMGARH,2021-03-24,18,1654,1,1673
UTTAR PRADESH,AZAMGARH,2021-03-25,23,972,7,1002
UTTAR PRADESH,BAGHPAT,2021-03-21,0,1733,66,1799
UTTAR PRADESH,BAGHPAT,2021-03-22,3,1853,5,1861
UTTAR PRADESH,BAGHPAT,2021-03-23,2,2116,74,2192
UTTAR PRADESH,BAGHPAT,2021-03-24,3,1163,13,1179
UTTAR PRADESH,BAGHPAT,2021-03-25,2,1530,69,1601
UTTAR PRADESH,BAHRAICH,2021-03-21,2,1740,27,1769
UTTAR PRADESH,BAHRAICH,2021-03-22,3,1630,51,1684
UTTAR PRADESH,BAHRAICH,2021-03-23,5,1614,23,1642
UTTAR PRADESH,BAHRAICH,2021-03-24,9,1627,78,1714
UTTAR PRADESH,BAHRAICH,2021-03-25,6,1572,23,1601
UTTAR PRADESH,BALLIA,2021-03-21,2,2255,1,2258
UTTAR PRADESH,BALLIA,2021-03-22,4,998,27,1029
UTTAR PRADESH,BALLIA,2021-03-23,6,1113,0,1119
UTTAR PRADESH,BALLIA,2021-03-24,4,1832,1,1837
UTTAR PRADESH,BALLIA,2021-03-25,2,1155,89,1246
UTTAR PRADESH,BALRAMPUR,2021-03-21,7,1008,0,1015
UTTAR PRADESH,BALRAMPUR,2021-03-22,7,1097,0,1104
UTTAR PRADESH,BALRAMPUR,2021-03-23,4,1243,1,1248
UTTAR PRADESH,BALRAMPUR,2021-03-24,11,1676,0,1687
UTTAR PRADESH,BALRAMPUR,2021-03-25,20,1215,3,1238
UTTAR PRADESH,BANDA,2021-03-21,2,1783,19,1804
UTTAR PRADESH,BANDA,2021-03-22,0,1869,26,1895
UTTAR PRADESH,BANDA,2021-03-23,1,1907,54,1962
UTTAR PRADESH,BANDA,2021-03-24,2,1998,37,2037
UTTAR PRADESH,BANDA,2021-03-25,4,1840,45,1889
UTTAR PRADESH,BARABANKI,2021-03-21,4,1221,1,1226
UTTAR PRADESH,BARABANKI,2021-03-22,6,1238,2,1246
UTTAR PRADESH,BARABANKI,2021-03-23,6,1821,10,1837
UTTAR PRADESH,BARABANKI,2021-03-24,5,1672,17,1694
UTTAR PRADESH,BARABANKI,2021-03-25,6,1566,54,1626
UTTAR PRADESH,BAREILLY,2021-03-21,10,1525,41,1576
UTTAR PRADESH,BAREILLY,2021-03-22,18,2641,2,2661
UTTAR PRADESH,BAREILLY,2021-03-23,13,1724,12,1749
UTTAR PRADESH,BAREILLY,2021-03-24,12,1893,12,1917
UTTAR PRADESH,BAREILLY,2021-03-25,18,3752,7,3777
UTTAR PRADESH,BASTI,2021-03-21,1,968,0,969
UTTAR PRADESH,BASTI,2021-03-22,2,1165,1,1168
UTTAR PRADESH,BASTI,2021-03-23,3,2155,6,2164
UTTAR PRADESH,BASTI,2021-03-24,6,1887,51,1944
UTTAR PRADESH,BASTI,2021-03-25,4,2336,2,2342
UTTAR PRADESH,BHADOHI,2021-03-21,3,1518,0,1521
UTTAR PRADESH,BHADOHI,2021-03-22,1,1500,0,1501
UTTAR PRADESH,BHADOHI,2021-03-23,4,1540,9,1553
UTTAR PRADESH,BHADOHI,2021-03-24,2,1538,2,1542
UTTAR PRADESH,BHADOHI,2021-03-25,6,1670,2,1678
UTTAR PRADESH,BIJNOR,2021-03-21,9,1859,7,1875
UTTAR PRADESH,BIJNOR,2021-03-22,8,1299,9,1316
UTTAR PRADESH,BIJNOR,2021-03-23,6,1689,5,1700
UTTAR PRADESH,BIJNOR,2021-03-24,2,1480,4,1486
UTTAR PRADESH,BIJNOR,2021-03-25,2,1544,7,1553
UTTAR PRADESH,BUDAUN,2021-03-21,3,3327,22,3352
UTTAR PRADESH,BUDAUN,2021-03-22,7,2248,1,2256
UTTAR PRADESH,BUDAUN,2021-03-23,7,4530,39,4576
UTTAR PRADESH,BUDAUN,2021-03-24,8,1145,1,1154
UTTAR PRADESH,BUDAUN,2021-03-25,6,3751,12,3769
UTTAR PRADESH,BULANDSHAHR,2021-03-21,5,828,21,854
UTTAR PRADESH,BULANDSHAHR,2021-03-22,2,3146,0,3148
UTTAR PRADESH,BULANDSHAHR,2021-03-23,0,830,102,932
UTTAR PRADESH,BULANDSHAHR,2021-03-24,7,3102,24,3133
UTTAR PRADESH,BULANDSHAHR,2021-03-25,5,1013,105,1123
UTTAR PRADESH,CHANDAULI,2021-03-21,2,522,0,524
UTTAR PRADESH,CHANDAULI,2021-03-22,9,562,13,584
UTTAR PRADESH,CHANDAULI,2021-03-23,5,1094,4,1103
UTTAR PRADESH,CHANDAULI,2021-03-24,12,793,5,810
UTTAR PRADESH,CHANDAULI,2021-03-25,7,790,10,807
UTTAR PRADESH,CHITRAKOOT,2021-03-21,1,679,10,690
UTTAR PRADESH,CHITRAKOOT,2021-03-22,0,929,63,992
UTTAR PRADESH,CHITRAKOOT,2021-03-23,0,1099,69,1168
UTTAR PRADESH,CHITRAKOOT,2021-03-24,0,1177,27,1204
UTTAR PRADESH,CHITRAKOOT,2021-03-25,3,1188,16,1207
UTTAR PRADESH,DEORIA,2021-03-21,1,3454,256,3711
UTTAR PRADESH,DEORIA,2021-03-22,1,2627,56,2684
UTTAR PRADESH,DEORIA,2021-03-23,5,2476,74,2555
UTTAR PRADESH,DEORIA,2021-03-24,5,2167,117,2289
UTTAR PRADESH,DEORIA,2021-03-25,1,2909,278,3188
UTTAR PRADESH,ETAH,2021-03-21,0,1318,15,1333
UTTAR PRADESH,ETAH,2021-03-22,1,678,122,801
UTTAR PRADESH,ETAH,2021-03-23,0,1379,84,1463
UTTAR PRADESH,ETAH,2021-03-24,1,773,19,793
UTTAR PRADESH,ETAH,2021-03-25,2,711,4,717
UTTAR PRADESH,ETAWAH,2021-03-21,8,1039,23,1070
UTTAR PRADESH,ETAWAH,2021-03-22,1,1513,3,1517
UTTAR PRADESH,ETAWAH,2021-03-23,1,1504,54,1559
UTTAR PRADESH,ETAWAH,2021-03-24,3,842,67,912
UTTAR PRADESH,ETAWAH,2021-03-25,6,1779,68,1853
UTTAR PRADESH,FARRUKHABAD,2021-03-21,3,1122,83,1208
UTTAR PRADESH,FARRUKHABAD,2021-03-22,2,576,66,644
UTTAR PRADESH,FARRUKHABAD,2021-03-23,4,1169,33,1206
UTTAR PRADESH,FARRUKHABAD,2021-03-24,1,971,6,978
UTTAR PRADESH,FARRUKHABAD,2021-03-25,2,958,22,982
UTTAR PRADESH,FATEHPUR,2021-03-21,0,1144,128,1272
UTTAR PRADESH,FATEHPUR,2021-03-22,1,1336,96,1433
UTTAR PRADESH,FATEHPUR,2021-03-23,2,1044,19,1065
UTTAR PRADESH,FATEHPUR,2021-03-24,5,1690,34,1729
UTTAR PRADESH,FATEHPUR,2021-03-25,5,1132,96,1233
UTTAR PRADESH,FIROZABAD,2021-03-21,14,2600,11,2625
UTTAR PRADESH,FIROZABAD,2021-03-22,8,1838,0,1846
UTTAR PRADESH,FIROZABAD,2021-03-23,19,610,14,643
UTTAR PRADESH,FIROZABAD,2021-03-24,13,686,15,714
UTTAR PRADESH,FIROZABAD,2021-03-25,15,4160,0,4175
UTTAR PRADESH,GAUTAM BUDDHA NAGAR,2021-03-21,104,3171,12,3287
UTTAR PRADESH,GAUTAM BUDDHA NAGAR,2021-03-22,135,3165,24,3324
UTTAR PRADESH,GAUTAM BUDDHA NAGAR,2021-03-23,153,3767,28,3948
UTTAR PRADESH,GAUTAM BUDDHA NAGAR,2021-03-24,151,3864,28,4043
UTTAR PRADESH,GAUTAM BUDDHA NAGAR,2021-03-25,167,3070,32,3269
UTTAR PRADESH,GHAZIABAD,2021-03-21,43,5041,88,5172
UTTAR PRADESH,GHAZIABAD,2021-03-22,139,3194,113,3446
UTTAR PRADESH,GHAZIABAD,2021-03-23,140,5052,99,5291
UTTAR PRADESH,GHAZIABAD,2021-03-24,174,5257,143,5574
UTTAR PRADESH,GHAZIABAD,2021-03-25,150,5101,149,5400
UTTAR PRADESH,GHAZIPUR,2021-03-21,3,713,83,799
UTTAR PRADESH,GHAZIPUR,2021-03-22,6,767,83,856
UTTAR PRADESH,GHAZIPUR,2021-03-23,5,1270,25,1300
UTTAR PRADESH,GHAZIPUR,2021-03-24,5,1004,70,1079
UTTAR PRADESH,GHAZIPUR,2021-03-25,3,804,89,896
UTTAR PRADESH,GONDA,2021-03-21,7,937,2,946
UTTAR PRADESH,GONDA,2021-03-22,2,1228,0,1230
UTTAR PRADESH,GONDA,2021-03-23,3,1423,22,1448
UTTAR PRADESH,GONDA,2021-03-24,8,1331,2,1341
UTTAR PRADESH,GONDA,2021-03-25,15,1400,0,1415
UTTAR PRADESH,GORAKHPUR,2021-03-21,8,1784,7,1799
UTTAR PRADESH,GORAKHPUR,2021-03-22,13,1591,8,1612
UTTAR PRADESH,GORAKHPUR,2021-03-23,16,1621,33,1670
UTTAR PRADESH,GORAKHPUR,2021-03-24,16,2668,1,2685
UTTAR PRADESH,GORAKHPUR,2021-03-25,15,2246,143,2404
UTTAR PRADESH,HAMIRPUR,2021-03-21,3,671,48,722
UTTAR PRADESH,HAMIRPUR,2021-03-22,1,1101,25,1127
UTTAR PRADESH,HAMIRPUR,2021-03-23,0,425,31,456
UTTAR PRADESH,HAMIRPUR,2021-03-24,3,1484,6,1493
UTTAR PRADESH,HAMIRPUR,2021-03-25,1,1009,26,1036
UTTAR PRADESH,HAPUR,2021-03-21,2,2156,42,2200
UTTAR PRADESH,HAPUR,2021-03-22,6,37,0,43
UTTAR PRADESH,HAPUR,2021-03-23,28,1457,9,1494
UTTAR PRADESH,HAPUR,2021-03-24,4,965,0,969
UTTAR PRADESH,HAPUR,2021-03-25,4,2287,44,2335
UTTAR PRADESH,HARDOI,2021-03-21,0,3247,3,3250
UTTAR PRADESH,HARDOI,2021-03-22,3,1143,16,1162
UTTAR PRADESH,HARDOI,2021-03-23,3,1573,2,1578
UTTAR PRADESH,HARDOI,2021-03-24,7,1616,10,1633
UTTAR PRADESH,HARDOI,2021-03-25,6,1751,10,1767
UTTAR PRADESH,HATHRAS,2021-03-21,1,1053,0,1054
UTTAR PRADESH,HATHRAS,2021-03-22,0,1516,0,1516
UTTAR PRADESH,HATHRAS,2021-03-23,1,1151,0,1152
UTTAR PRADESH,HATHRAS,2021-03-24,1,1122,0,1123
UTTAR PRADESH,HATHRAS,2021-03-25,0,887,0,887
UTTAR PRADESH,JALAUN,2021-03-21,3,1071,2,1076
UTTAR PRADESH,JALAUN,2021-03-22,8,1391,6,1405
UTTAR PRADESH,JALAUN,2021-03-23,3,1576,7,1586
UTTAR PRADESH,JALAUN,2021-03-24,4,1353,9,1366
UTTAR PRADESH,JALAUN,2021-03-25,5,1443,0,1448
UTTAR PRADESH,JAUNPUR,2021-03-21,4,4014,9,4027
UTTAR PRADESH,JAUNPUR,2021-03-22,6,3024,0,3030
UTTAR PRADESH,JAUNPUR,2021-03-23,8,773,48,829
UTTAR PRADESH,JAUNPUR,2021-03-24,10,2384,60,2454
UTTAR PRADESH,JAUNPUR,2021-03-25,8,749,6,763
UTTAR PRADESH,JHANSI,2021-03-21,40,3513,1,3554
UTTAR PRADESH,JHANSI,2021-03-22,29,2546,3,2578
UTTAR PRADESH,JHANSI,2021-03-23,18,2887,0,2905
UTTAR PRADESH,JHANSI,2021-03-24,22,2898,3,2923
UTTAR PRADESH,JHANSI,2021-03-25,12,2314,7,2333
UTTAR PRADESH,KANNAUJ,2021-03-21,1,1549,2,1552
UTTAR PRADESH,KANNAUJ,2021-03-22,0,1806,2,1808
UTTAR PRADESH,KANNAUJ,2021-03-23,5,1559,0,1564
UTTAR PRADESH,KANNAUJ,2021-03-24,9,1990,1,2000
UTTAR PRADESH,KANNAUJ,2021-03-25,5,1672,0,1677
UTTAR PRADESH,KANPUR DEHAT,2021-03-21,0,904,0,904
UTTAR PRADESH,KANPUR DEHAT,2021-03-22,0,811,0,811
UTTAR PRADESH,KANPUR DEHAT,2021-03-23,0,1891,0,1891
UTTAR PRADESH,KANPUR DEHAT,2021-03-24,0,1569,1,1570
UTTAR PRADESH,KANPUR DEHAT,2021-03-25,3,1109,0,1112
UTTAR PRADESH,KANPUR NAGAR,2021-03-21,22,3607,8,3637
UTTAR PRADESH,KANPUR NAGAR,2021-03-22,25,2992,1,3018
UTTAR PRADESH,KANPUR NAGAR,2021-03-23,21,3017,0,3038
UTTAR PRADESH,KANPUR NAGAR,2021-03-24,47,6115,23,6185
UTTAR PRADESH,KANPUR NAGAR,2021-03-25,21,4271,43,4335
UTTAR PRADESH,KASGANJ,2021-03-21,0,506,31,537
UTTAR PRADESH,KASGANJ,2021-03-22,3,894,8,905
UTTAR PRADESH,KASGANJ,2021-03-23,0,3114,9,3123
UTTAR PRADESH,KASGANJ,2021-03-24,0,549,3,552
UTTAR PRADESH,KASGANJ,2021-03-25,0,4973,54,5027
UTTAR PRADESH,KAUSHAMBI,2021-03-21,0,843,0,843
UTTAR PRADESH,KAUSHAMBI,2021-03-22,0,2214,0,2214
UTTAR PRADESH,KAUSHAMBI,2021-03-23,1,1873,0,1874
UTTAR PRADESH,KAUSHAMBI,2021-03-24,1,1005,0,1006
UTTAR PRADESH,KAUSHAMBI,2021-03-25,1,1562,1,1564
UTTAR PRADESH,KHERI,2021-03-21,3,1869,21,1893
UTTAR PRADESH,KHERI,2021-03-22,2,1377,0,1379
UTTAR PRADESH,KHERI,2021-03-23,3,1720,26,1749
UTTAR PRADESH,KHERI,2021-03-24,4,1372,5,1381
UTTAR PRADESH,KHERI,2021-03-25,13,1411,9,1433
UTTAR PRADESH,KUSHI NAGAR,2021-03-21,1,4656,51,4708
UTTAR PRADESH,KUSHI NAGAR,2021-03-22,6,1125,17,1148
UTTAR PRADESH,KUSHI NAGAR,2021-03-23,1,1083,18,1102
UTTAR PRADESH,KUSHI NAGAR,2021-03-24,7,1522,76,1605
UTTAR PRADESH,KUSHI NAGAR,2021-03-25,8,1374,7,1389
UTTAR PRADESH,LALITPUR,2021-03-21,2,1466,0,1468
UTTAR PRADESH,LALITPUR,2021-03-22,4,1751,0,1755
UTTAR PRADESH,LALITPUR,2021-03-23,5,1634,1,1640
UTTAR PRADESH,LALITPUR,2021-03-24,8,1577,2,1587
UTTAR PRADESH,LALITPUR,2021-03-25,7,1297,1,1305
UTTAR PRADESH,LUCKNOW,2021-03-21,164,8322,63,8549
UTTAR PRADESH,LUCKNOW,2021-03-22,224,7870,57,8151
UTTAR PRADESH,LUCKNOW,2021-03-23,248,8896,74,9218
UTTAR PRADESH,LUCKNOW,2021-03-24,213,11676,47,11936
UTTAR PRADESH,LUCKNOW,2021-03-25,450,10312,102,10864
UTTAR PRADESH,MAHARAJGANJ,2021-03-21,7,1733,105,1845
UTTAR PRADESH,MAHARAJGANJ,2021-03-22,3,1743,0,1746
UTTAR PRADESH,MAHARAJGANJ,2021-03-23,10,2262,165,2437
UTTAR PRADESH,MAHARAJGANJ,2021-03-24,6,2447,30,2483
UTTAR PRADESH,MAHARAJGANJ,2021-03-25,6,1592,153,1751
UTTAR PRADESH,MAHOBA,2021-03-21,0,318,0,318
UTTAR PRADESH,MAHOBA,2021-03-22,1,471,34,506
UTTAR PRADESH,MAHOBA,2021-03-23,0,656,26,682
UTTAR PRADESH,MAHOBA,2021-03-24,0,586,25,611
UTTAR PRADESH,MAHOBA,2021-03-25,0,1086,53,1139
UTTAR PRADESH,MAINPURI,2021-03-21,2,1561,1,1564
UTTAR PRADESH,MAINPURI,2021-03-22,0,1333,0,1333
UTTAR PRADESH,MAINPURI,2021-03-23,2,1700,1,1703
UTTAR PRADESH,MAINPURI,2021-03-24,0,1520,4,1524
UTTAR PRADESH,MAINPURI,2021-03-25,0,1505,3,1508
UTTAR PRADESH,MATHURA,2021-03-21,12,1521,11,1544
UTTAR PRADESH,MATHURA,2021-03-22,14,1775,9,1798
UTTAR PRADESH,MATHURA,2021-03-23,14,1904,5,1923
UTTAR PRADESH,MATHURA,2021-03-24,9,1896,3,1908
UTTAR PRADESH,MATHURA,2021-03-25,23,1662,9,1694
UTTAR PRADESH,MAU,2021-03-21,1,696,4,701
UTTAR PRADESH,MAU,2021-03-22,6,542,4,552
UTTAR PRADESH,MAU,2021-03-23,2,565,2,569
UTTAR PRADESH,MAU,2021-03-24,9,736,2,747
UTTAR PRADESH,MAU,2021-03-25,4,495,16,515
UTTAR PRADESH,MEERUT,2021-03-21,23,3764,9,3796
UTTAR PRADESH,MEERUT,2021-03-22,28,2874,7,2909
UTTAR PRADESH,MEERUT,2021-03-23,31,3504,48,3583
UTTAR PRADESH,MEERUT,2021-03-24,30,4145,20,4195
UTTAR PRADESH,MEERUT,2021-03-25,49,4752,15,4816
UTTAR PRADESH,MIRZAPUR,2021-03-21,1,1400,0,1401
UTTAR PRADESH,MIRZAPUR,2021-03-22,2,1554,0,1556
UTTAR PRADESH,MIRZAPUR,2021-03-23,3,1344,0,1347
UTTAR PRADESH,MIRZAPUR,2021-03-24,6,1504,1,1511
UTTAR PRADESH,MIRZAPUR,2021-03-25,16,1427,5,1448
UTTAR PRADESH,MORADABAD,2021-03-21,0,2803,11,2814
UTTAR PRADESH,MORADABAD,2021-03-22,10,2224,2,2236
UTTAR PRADESH,MORADABAD,2021-03-23,7,1657,5,1669
UTTAR PRADESH,MORADABAD,2021-03-24,11,2760,7,2778
UTTAR PRADESH,MORADABAD,2021-03-25,7,2694,0,2701
UTTAR PRADESH,MUZAFFARNAGAR,2021-03-21,14,1875,10,1899
UTTAR PRADESH,MUZAFFARNAGAR,2021-03-22,5,2367,4,2376
UTTAR PRADESH,MUZAFFARNAGAR,2021-03-23,4,2214,0,2218
UTTAR PRADESH,MUZAFFARNAGAR,2021-03-24,28,1764,26,1818
UTTAR PRADESH,MUZAFFARNAGAR,2021-03-25,34,3167,26,3227
UTTAR PRADESH,PILIBHIT,2021-03-21,0,1173,0,1173
UTTAR PRADESH,PILIBHIT,2021-03-22,0,922,0,922
UTTAR PRADESH,PILIBHIT,2021-03-23,4,1431,1,1436
UTTAR PRADESH,PILIBHIT,2021-03-24,3,1342,0,1345
UTTAR PRADESH,PILIBHIT,2021-03-25,2,1304,3,1309
UTTAR PRADESH,PRATAPGARH,2021-03-21,6,1501,17,1524
UTTAR PRADESH,PRATAPGARH,2021-03-22,9,1745,10,1764
UTTAR PRADESH,PRATAPGARH,2021-03-23,6,1583,79,1668
UTTAR PRADESH,PRATAPGARH,2021-03-24,5,1573,2,1580
UTTAR PRADESH,PRATAPGARH,2021-03-25,17,1571,15,1603
UTTAR PRADESH,PRAYAGRAJ,2021-03-21,32,6064,2,6098
UTTAR PRADESH,PRAYAGRAJ,2021-03-22,31,1410,1,1442
UTTAR PRADESH,PRAYAGRAJ,2021-03-23,34,2421,0,2455
UTTAR PRADESH,PRAYAGRAJ,2021-03-24,43,3073,0,3116
UTTAR PRADESH,PRAYAGRAJ,2021-03-25,55,2449,12,2516
UTTAR PRADESH,RAE BARELI,2021-03-21,3,1536,7,1546
UTTAR PRADESH,RAE BARELI,2021-03-22,17,1605,6,1628
UTTAR PRADESH,RAE BARELI,2021-03-23,16,2536,9,2561
UTTAR PRADESH,RAE BARELI,2021-03-24,18,1942,5,1965
UTTAR PRADESH,RAE BARELI,2021-03-25,25,1967,8,2000
UTTAR PRADESH,RAMPUR,2021-03-21,6,1398,10,1414
UTTAR PRADESH,RAMPUR,2021-03-22,6,1274,32,1312
UTTAR PRADESH,RAMPUR,2021-03-23,5,1753,52,1810
UTTAR PRADESH,RAMPUR,2021-03-24,11,1561,34,1606
UTTAR PRADESH,RAMPUR,2021-03-25,4,1694,30,1728
UTTAR PRADESH,SAHARANPUR,2021-03-21,13,2885,200,3098
UTTAR PRADESH,SAHARANPUR,2021-03-22,6,1908,79,1993
UTTAR PRADESH,SAHARANPUR,2021-03-23,18,3413,70,3501
UTTAR PRADESH,SAHARANPUR,2021-03-24,34,3133,45,3212
UTTAR PRADESH,SAHARANPUR,2021-03-25,32,3082,38,3152
UTTAR PRADESH,SAMBHAL,2021-03-21,0,819,126,945
UTTAR PRADESH,SAMBHAL,2021-03-22,2,294,78,374
UTTAR PRADESH,SAMBHAL,2021-03-23,3,1544,110,1657
UTTAR PRADESH,SAMBHAL,2021-03-24,0,1113,0,1113
UTTAR PRADESH,SAMBHAL,2021-03-25,0,1861,11,1872
UTTAR PRADESH,SANT KABEER NAGAR,2021-03-21,6,1264,0,1270
UTTAR PRADESH,SANT KABEER NAGAR,2021-03-22,10,1613,0,1623
UTTAR PRADESH,SANT KABEER NAGAR,2021-03-23,11,1418,1,1430
UTTAR PRADESH,SANT KABEER NAGAR,2021-03-24,22,1221,0,1243
UTTAR PRADESH,SANT KABEER NAGAR,2021-03-25,11,1469,1,1481
UTTAR PRADESH,SHAHJAHANPUR,2021-03-21,1,1626,11,1638
UTTAR PRADESH,SHAHJAHANPUR,2021-03-22,0,1010,136,1146
UTTAR PRADESH,SHAHJAHANPUR,2021-03-23,7,1618,2,1627
UTTAR PRADESH,SHAHJAHANPUR,2021-03-24,7,2229,94,2330
UTTAR PRADESH,SHAHJAHANPUR,2021-03-25,13,1970,116,2099
UTTAR PRADESH,SHAMLI,2021-03-21,0,1974,2,1976
UTTAR PRADESH,SHAMLI,2021-03-22,3,769,2,774
UTTAR PRADESH,SHAMLI,2021-03-23,3,1186,0,1189
UTTAR PRADESH,SHAMLI,2021-03-24,5,2068,0,2073
UTTAR PRADESH,SHAMLI,2021-03-25,2,796,19,817
UTTAR PRADESH,SHRAVASTI,2021-03-21,2,808,0,810
UTTAR PRADESH,SHRAVASTI,2021-03-22,1,863,0,864
UTTAR PRADESH,SHRAVASTI,2021-03-23,1,824,0,825
UTTAR PRADESH,SHRAVASTI,2021-03-24,1,932,1,934
UTTAR PRADESH,SHRAVASTI,2021-03-25,4,846,0,850
UTTAR PRADESH,SIDDHARTH NAGAR,2021-03-21,2,881,0,883
UTTAR PRADESH,SIDDHARTH NAGAR,2021-03-22,7,530,0,537
UTTAR PRADESH,SIDDHARTH NAGAR,2021-03-23,3,901,1,905
UTTAR PRADESH,SIDDHARTH NAGAR,2021-03-24,5,1171,47,1223
UTTAR PRADESH,SIDDHARTH NAGAR,2021-03-25,8,1039,26,1073
UTTAR PRADESH,SITAPUR,2021-03-21,2,1371,6,1379
UTTAR PRADESH,SITAPUR,2021-03-22,4,1174,66,1244
UTTAR PRADESH,SITAPUR,2021-03-23,5,1191,0,1196
UTTAR PRADESH,SITAPUR,2021-03-24,3,1302,1,1306
UTTAR PRADESH,SITAPUR,2021-03-25,4,1507,6,1517
UTTAR PRADESH,SONBHADRA,2021-03-21,1,2098,9,2108
UTTAR PRADESH,SONBHADRA,2021-03-22,5,899,0,904
UTTAR PRADESH,SONBHADRA,2021-03-23,9,1728,7,1744
UTTAR PRADESH,SONBHADRA,2021-03-24,4,2129,0,2133
UTTAR PRADESH,SONBHADRA,2021-03-25,4,1448,61,1513
UTTAR PRADESH,SULTANPUR,2021-03-21,1,569,36,606
UTTAR PRADESH,SULTANPUR,2021-03-22,12,2130,18,2160
UTTAR PRADESH,SULTANPUR,2021-03-23,8,2204,30,2242
UTTAR PRADESH,SULTANPUR,2021-03-24,12,1984,67,2063
UTTAR PRADESH,SULTANPUR,2021-03-25,10,1722,32,1764
UTTAR PRADESH,UNNAO,2021-03-21,14,2039,30,2083
UTTAR PRADESH,UNNAO,2021-03-22,4,1992,30,2026
UTTAR PRADESH,UNNAO,2021-03-23,8,2019,56,2083
UTTAR PRADESH,UNNAO,2021-03-24,7,2074,7,2088
UTTAR PRADESH,UNNAO,2021-03-25,15,2017,6,2038
UTTAR PRADESH,VARANASI,2021-03-21,40,4294,0,4334
UTTAR PRADESH,VARANASI,2021-03-22,42,4737,6,4785
UTTAR PRADESH,VARANASI,2021-03-23,36,4576,1,4613
UTTAR PRADESH,VARANASI,2021-03-24,65,4286,12,4363
UTTAR PRADESH,VARANASI,2021-03-25,56,3962,87,4105
UTTARAKHAND,ALMORA,2021-03-21,1,8,1,10
UTTARAKHAND,ALMORA,2021-03-22,0,178,4,182
UTTARAKHAND,ALMORA,2021-03-23,0,274,0,274
UTTARAKHAND,ALMORA,2021-03-24,0,278,0,278
UTTARAKHAND,ALMORA,2021-03-25,8,161,0,169
UTTARAKHAND,BAGESHWAR,2021-03-21,1,67,0,68
UTTARAKHAND,BAGESHWAR,2021-03-22,0,230,2,232
UTTARAKHAND,BAGESHWAR,2021-03-23,0,47,0,47
UTTARAKHAND,BAGESHWAR,2021-03-24,0,440,0,440
UTTARAKHAND,BAGESHWAR,2021-03-25,2,115,3,120
UTTARAKHAND,CHAMOLI,2021-03-21,1,42,1,44
UTTARAKHAND,CHAMOLI,2021-03-22,0,41,0,41
UTTARAKHAND,CHAMOLI,2021-03-23,6,242,3,251
UTTARAKHAND,CHAMOLI,2021-03-24,1,174,0,175
UTTARAKHAND,CHAMOLI,2021-03-25,2,71,0,73
UTTARAKHAND,CHAMPAWAT,2021-03-21,0,3,0,3
UTTARAKHAND,CHAMPAWAT,2021-03-22,0,31,0,31
UTTARAKHAND,CHAMPAWAT,2021-03-23,0,18,0,18
UTTARAKHAND,CHAMPAWAT,2021-03-24,0,23,0,23
UTTARAKHAND,CHAMPAWAT,2021-03-25,0,8,0,8
UTTARAKHAND,DEHRADUN,2021-03-21,35,751,9,795
UTTARAKHAND,DEHRADUN,2021-03-22,48,1382,11,1441
UTTARAKHAND,DEHRADUN,2021-03-23,73,1281,6,1360
UTTARAKHAND,DEHRADUN,2021-03-24,75,1289,0,1364
UTTARAKHAND,DEHRADUN,2021-03-25,63,2165,2,2230
UTTARAKHAND,HARIDWAR,2021-03-21,42,6532,1,6575
UTTARAKHAND,HARIDWAR,2021-03-22,35,8491,6,8532
UTTARAKHAND,HARIDWAR,2021-03-23,55,7481,7,7543
UTTARAKHAND,HARIDWAR,2021-03-24,67,5508,17,5592
UTTARAKHAND,HARIDWAR,2021-03-25,42,4700,0,4742
UTTARAKHAND,NAINITAL,2021-03-21,10,90,0,100
UTTARAKHAND,NAINITAL,2021-03-22,12,528,1,541
UTTARAKHAND,NAINITAL,2021-03-23,24,709,4,737
UTTARAKHAND,NAINITAL,2021-03-24,13,651,4,668
UTTARAKHAND,NAINITAL,2021-03-25,14,726,1,741
UTTARAKHAND,PAURI GARHWAL,2021-03-21,2,412,2,416
UTTARAKHAND,PAURI GARHWAL,2021-03-22,1,378,0,379
UTTARAKHAND,PAURI GARHWAL,2021-03-23,5,547,0,552
UTTARAKHAND,PAURI GARHWAL,2021-03-24,6,710,0,716
UTTARAKHAND,PAURI GARHWAL,2021-03-25,4,567,2,573
UTTARAKHAND,PITHORAGARH,2021-03-21,0,7,0,7
UTTARAKHAND,PITHORAGARH,2021-03-22,3,21,0,24
UTTARAKHAND,PITHORAGARH,2021-03-23,2,263,0,265
UTTARAKHAND,PITHORAGARH,2021-03-24,5,254,0,259
UTTARAKHAND,PITHORAGARH,2021-03-25,0,57,0,57
UTTARAKHAND,RUDRA PRAYAG,2021-03-21,0,76,6,82
UTTARAKHAND,RUDRA PRAYAG,2021-03-22,1,22,0,23
UTTARAKHAND,RUDRA PRAYAG,2021-03-23,7,59,1,67
UTTARAKHAND,RUDRA PRAYAG,2021-03-24,2,185,0,187
UTTARAKHAND,RUDRA PRAYAG,2021-03-25,2,132,3,137
UTTARAKHAND,TEHRI GARHWAL,2021-03-21,7,120,2,129
UTTARAKHAND,TEHRI GARHWAL,2021-03-22,3,169,0,172
UTTARAKHAND,TEHRI GARHWAL,2021-03-23,12,129,0,141
UTTARAKHAND,TEHRI GARHWAL,2021-03-24,4,157,1,162
UTTARAKHAND,TEHRI GARHWAL,2021-03-25,21,193,0,214
UTTARAKHAND,UDAM SINGH NAGAR,2021-03-21,13,487,1,501
UTTARAKHAND,UDAM SINGH NAGAR,2021-03-22,10,1620,166,1796
UTTARAKHAND,UDAM SINGH NAGAR,2021-03-23,5,1232,194,1431
UTTARAKHAND,UDAM SINGH NAGAR,2021-03-24,11,1075,102,1188
UTTARAKHAND,UDAM SINGH NAGAR,2021-03-25,4,1417,98,1519
UTTARAKHAND,UTTAR KASHI,2021-03-21,1,284,14,299
UTTARAKHAND,UTTAR KASHI,2021-03-22,1,285,8,294
UTTARAKHAND,UTTAR KASHI,2021-03-23,0,87,0,87
UTTARAKHAND,UTTAR KASHI,2021-03-24,0,28,1,29
UTTARAKHAND,UTTAR KASHI,2021-03-25,8,519,0,527
WEST BENGAL,24 PARAGANAS NORTH,2021-03-21,98,2836,10,2944
WEST BENGAL,24 PARAGANAS NORTH,2021-03-22,113,2893,32,3038
WEST BENGAL,24 PARAGANAS NORTH,2021-03-23,112,3012,17,3141
WEST BENGAL,24 PARAGANAS NORTH,2021-03-24,189,3928,18,4135
WEST BENGAL,24 PARAGANAS NORTH,2021-03-25,147,3372,14,3533
WEST BENGAL,24 PARAGANAS SOUTH,2021-03-21,22,1949,5,1976
WEST BENGAL,24 PARAGANAS SOUTH,2021-03-22,25,2316,3,2344
WEST BENGAL,24 PARAGANAS SOUTH,2021-03-23,28,2540,11,2579
WEST BENGAL,24 PARAGANAS SOUTH,2021-03-24,52,2559,7,2618
WEST BENGAL,24 PARAGANAS SOUTH,2021-03-25,45,2998,17,3060
WEST BENGAL,ALIPURDUAR,2021-03-21,2,359,0,361
WEST BENGAL,ALIPURDUAR,2021-03-22,4,536,1,541
WEST BENGAL,ALIPURDUAR,2021-03-23,1,543,0,544
WEST BENGAL,ALIPURDUAR,2021-03-24,0,187,0,187
WEST BENGAL,ALIPURDUAR,2021-03-25,1,611,0,612
WEST BENGAL,BANKURA,2021-03-21,6,362,1,369
WEST BENGAL,BANKURA,2021-03-22,2,221,0,223
WEST BENGAL,BANKURA,2021-03-23,3,1050,2,1055
WEST BENGAL,BANKURA,2021-03-24,0,1001,2,1003
WEST BENGAL,BANKURA,2021-03-25,9,1432,29,1470
WEST BENGAL,BIRBHUM,2021-03-21,6,381,5,392
WEST BENGAL,BIRBHUM,2021-03-22,8,419,0,427
WEST BENGAL,BIRBHUM,2021-03-23,22,540,1,563
WEST BENGAL,BIRBHUM,2021-03-24,6,653,2,661
WEST BENGAL,BIRBHUM,2021-03-25,37,722,2,761
WEST BENGAL,COOCHBEHAR,2021-03-21,3,1750,0,1753
WEST BENGAL,COOCHBEHAR,2021-03-22,2,836,0,838
WEST BENGAL,COOCHBEHAR,2021-03-23,4,1428,0,1432
WEST BENGAL,COOCHBEHAR,2021-03-24,4,1221,10,1235
WEST BENGAL,COOCHBEHAR,2021-03-25,3,1167,1,1171
WEST BENGAL,DARJEELING,2021-03-21,3,194,1,198
WEST BENGAL,DARJEELING,2021-03-22,4,368,0,372
WEST BENGAL,DARJEELING,2021-03-23,8,482,0,490
WEST BENGAL,DARJEELING,2021-03-24,5,527,0,532
WEST BENGAL,DARJEELING,2021-03-25,10,397,19,426
WEST BENGAL,DINAJPUR DAKSHIN,2021-03-21,4,688,6,698
WEST BENGAL,DINAJPUR DAKSHIN,2021-03-22,3,468,4,475
WEST BENGAL,DINAJPUR DAKSHIN,2021-03-23,5,483,19,507
WEST BENGAL,DINAJPUR DAKSHIN,2021-03-24,0,466,4,470
WEST BENGAL,DINAJPUR DAKSHIN,2021-03-25,2,377,42,421
WEST BENGAL,DINAJPUR UTTAR,2021-03-21,10,260,0,270
WEST BENGAL,DINAJPUR UTTAR,2021-03-22,8,217,0,225
WEST BENGAL,DINAJPUR UTTAR,2021-03-23,6,314,0,320
WEST BENGAL,DINAJPUR UTTAR,2021-03-24,6,351,0,357
WEST BENGAL,DINAJPUR UTTAR,2021-03-25,6,323,0,329
WEST BENGAL,HOOGHLY,2021-03-21,21,433,1,455
WEST BENGAL,HOOGHLY,2021-03-22,7,525,0,532
WEST BENGAL,HOOGHLY,2021-03-23,27,402,3,432
WEST BENGAL,HOOGHLY,2021-03-24,36,595,1,632
WEST BENGAL,HOOGHLY,2021-03-25,20,689,4,713
WEST BENGAL,HOWRAH,2021-03-21,24,686,43,753
WEST BENGAL,HOWRAH,2021-03-22,24,701,32,757
WEST BENGAL,HOWRAH,2021-03-23,32,1113,16,1161
WEST BENGAL,HOWRAH,2021-03-24,44,847,10,901
WEST BENGAL,HOWRAH,2021-03-25,51,914,4,969
WEST BENGAL,JALPAIGURI,2021-03-21,4,282,0,286
WEST BENGAL,JALPAIGURI,2021-03-22,1,279,0,280
WEST BENGAL,JALPAIGURI,2021-03-23,7,523,1,531
WEST BENGAL,JALPAIGURI,2021-03-24,7,566,1,574
WEST BENGAL,JALPAIGURI,2021-03-25,0,459,0,459
WEST BENGAL,JHARGRAM,2021-03-21,0,6,0,6
WEST BENGAL,JHARGRAM,2021-03-22,0,49,1,50
WEST BENGAL,JHARGRAM,2021-03-23,0,20,1,21
WEST BENGAL,JHARGRAM,2021-03-24,0,60,0,60
WEST BENGAL,JHARGRAM,2021-03-25,0,85,0,85
WEST BENGAL,KALIMPONG,2021-03-21,0,58,0,58
WEST BENGAL,KALIMPONG,2021-03-22,0,57,0,57
WEST BENGAL,KALIMPONG,2021-03-23,0,157,0,157
WEST BENGAL,KALIMPONG,2021-03-24,0,124,0,124
WEST BENGAL,KALIMPONG,2021-03-25,0,123,0,123
WEST BENGAL,KOLKATA,2021-03-21,183,2463,3,2649
WEST BENGAL,KOLKATA,2021-03-22,224,3205,10,3439
WEST BENGAL,KOLKATA,2021-03-23,263,3677,20,3960
WEST BENGAL,KOLKATA,2021-03-24,275,3721,11,4007
WEST BENGAL,KOLKATA,2021-03-25,364,3892,19,4275
WEST BENGAL,MALDAH,2021-03-21,4,55,2,61
WEST BENGAL,MALDAH,2021-03-22,11,808,13,832
WEST BENGAL,MALDAH,2021-03-23,9,852,20,881
WEST BENGAL,MALDAH,2021-03-24,13,850,6,869
WEST BENGAL,MALDAH,2021-03-25,12,751,5,768
WEST BENGAL,MEDINIPUR EAST,2021-03-21,3,394,0,397
WEST BENGAL,MEDINIPUR EAST,2021-03-22,6,595,0,601
WEST BENGAL,MEDINIPUR EAST,2021-03-23,3,806,2,811
WEST BENGAL,MEDINIPUR EAST,2021-03-24,6,881,4,891
WEST BENGAL,MEDINIPUR EAST,2021-03-25,6,818,0,824
WEST BENGAL,MEDINIPUR WEST,2021-03-21,0,462,7,469
WEST BENGAL,MEDINIPUR WEST,2021-03-22,5,435,4,444
WEST BENGAL,MEDINIPUR WEST,2021-03-23,5,403,2,410
WEST BENGAL,MEDINIPUR WEST,2021-03-24,13,308,2,323
WEST BENGAL,MEDINIPUR WEST,2021-03-25,2,529,7,538
WEST BENGAL,MURSHIDABAD,2021-03-21,6,304,5,315
WEST BENGAL,MURSHIDABAD,2021-03-22,2,936,2,940
WEST BENGAL,MURSHIDABAD,2021-03-23,4,913,2,919
WEST BENGAL,MURSHIDABAD,2021-03-24,7,938,11,956
WEST BENGAL,MURSHIDABAD,2021-03-25,8,1111,6,1125
WEST BENGAL,NADIA,2021-03-21,4,467,9,480
WEST BENGAL,NADIA,2021-03-22,7,582,6,595
WEST BENGAL,NADIA,2021-03-23,3,662,8,673
WEST BENGAL,NADIA,2021-03-24,14,701,20,735
WEST BENGAL,NADIA,2021-03-25,6,839,14,859
WEST BENGAL,PASCHIM BARDHAMAN,2021-03-21,11,457,2,470
WEST BENGAL,PASCHIM BARDHAMAN,2021-03-22,15,224,2,241
WEST BENGAL,PASCHIM BARDHAMAN,2021-03-23,28,412,4,444
WEST BENGAL,PASCHIM BARDHAMAN,2021-03-24,37,472,9,518
WEST BENGAL,PASCHIM BARDHAMAN,2021-03-25,42,413,2,457
WEST BENGAL,PURBA BARDHAMAN,2021-03-21,0,513,1,514
WEST BENGAL,PURBA BARDHAMAN,2021-03-22,3,491,0,494
WEST BENGAL,PURBA BARDHAMAN,2021-03-23,6,666,1,673
WEST BENGAL,PURBA BARDHAMAN,2021-03-24,7,694,2,703
WEST BENGAL,PURBA BARDHAMAN,2021-03-25,4,598,0,602
WEST BENGAL,PURULIA,2021-03-21,1,23,1,25
WEST BENGAL,PURULIA,2021-03-22,8,488,0,496
WEST BENGAL,PURULIA,2021-03-23,7,456,0,463
WEST BENGAL,PURULIA,2021-03-24,8,476,0,484
WEST BENGAL,PURULIA,2021-03-25,15,436,0,451
ANDAMAN AND NICOBAR ISLANDS,NICOBARS,2021-03-31,1,10,0,11
ANDAMAN AND NICOBAR ISLANDS,NORTH AND MIDDLE ANDAMAN,2021-03-31,0,15,0,15
ANDAMAN AND NICOBAR ISLANDS,SOUTH ANDAMANS,2021-03-31,0,397,0,397
ANDHRA PRADESH,ANANTAPUR,2021-03-31,88,3020,0,3108
ANDHRA PRADESH,CHITTOOR,2021-03-31,268,2343,2,2613
ANDHRA PRADESH,EAST GODAVARI,2021-03-31,216,3074,0,3290
ANDHRA PRADESH,GUNTUR,2021-03-31,311,3350,0,3661
ANDHRA PRADESH,KRISHNA,2021-03-31,182,1878,0,2060
ANDHRA PRADESH,KURNOOL,2021-03-31,70,2512,0,2582
ANDHRA PRADESH,PRAKASAM,2021-03-31,64,2779,0,2843
ANDHRA PRADESH,SPSR NELLORE,2021-03-31,115,1691,0,1806
ANDHRA PRADESH,SRIKAKULAM,2021-03-31,46,1638,0,1684
ANDHRA PRADESH,VISAKHAPATANAM,2021-03-31,136,2609,0,2745
ANDHRA PRADESH,VIZIANAGARAM,2021-03-31,15,3546,1,3562
ANDHRA PRADESH,WEST GODAVARI,2021-03-31,33,4374,0,4407
ANDHRA PRADESH,Y.S.R.,2021-03-31,76,2891,0,2967
ARUNACHAL PRADESH,ANJAW,2021-03-31,0,7,0,7
ARUNACHAL PRADESH,CHANGLANG,2021-03-31,0,1,0,1
ARUNACHAL PRADESH,EAST SIANG,2021-03-31,0,12,0,12
ARUNACHAL PRADESH,LOWER SIANG,2021-03-31,0,3,0,3
ARUNACHAL PRADESH,LOWER SUBANSIRI,2021-03-31,0,36,0,36
ARUNACHAL PRADESH,PAPUM PARE,2021-03-31,0,10,0,10
ARUNACHAL PRADESH,UPPER SIANG,2021-03-31,0,1,0,1
ARUNACHAL PRADESH,UPPER SUBANSIRI,2021-03-31,0,2,0,2
ARUNACHAL PRADESH,WEST KAMENG,2021-03-31,12,41,0,53
ARUNACHAL PRADESH,WEST SIANG,2021-03-31,0,1,0,1
ASSAM,BAKSA,2021-03-31,0,52,1,53
ASSAM,BARPETA,2021-03-31,0,342,0,342
ASSAM,BISWANATH,2021-03-31,0,80,0,80
ASSAM,BONGAIGAON,2021-03-31,1,99,1,101
ASSAM,CACHAR,2021-03-31,2,128,80,210
ASSAM,CHARAIDEO,2021-03-31,0,48,0,48
ASSAM,CHIRANG,2021-03-31,1,48,0,49
ASSAM,DARRANG,2021-03-31,2,300,0,302
ASSAM,DHEMAJI,2021-03-31,0,34,0,34
ASSAM,DHUBRI,2021-03-31,1,188,0,189
ASSAM,DIBRUGARH,2021-03-31,1,319,0,320
ASSAM,DIMA HASAO,2021-03-31,0,18,0,18
ASSAM,GOALPARA,2021-03-31,0,297,0,297
ASSAM,GOLAGHAT,2021-03-31,1,149,0,150
ASSAM,HAILAKANDI,2021-03-31,2,256,27,285
ASSAM,HOJAI,2021-03-31,0,143,0,143
ASSAM,JORHAT,2021-03-31,3,210,0,213
ASSAM,KAMRUP,2021-03-31,4,684,4,692
ASSAM,KAMRUP METRO,2021-03-31,41,1723,2,1766
ASSAM,KARBI ANGLONG,2021-03-31,0,17,0,17
ASSAM,KARIMGANJ,2021-03-31,1,210,1,212
ASSAM,KOKRAJHAR,2021-03-31,0,122,0,122
ASSAM,LAKHIMPUR,2021-03-31,0,191,0,191
ASSAM,MAJULI,2021-03-31,1,3,0,4
ASSAM,MARIGAON,2021-03-31,1,118,0,119
ASSAM,NAGAON,2021-03-31,8,200,0,208
ASSAM,NALBARI,2021-03-31,0,107,0,107
ASSAM,SIVASAGAR,2021-03-31,0,127,0,127
ASSAM,SONITPUR,2021-03-31,1,88,0,89
ASSAM,SOUTH SALMARA MANCACHAR,2021-03-31,0,16,0,16
ASSAM,TINSUKIA,2021-03-31,0,339,1,340
ASSAM,UDALGURI,2021-03-31,1,9,0,10
BIHAR,ARARIA,2021-03-31,5,1209,0,1214
BIHAR,ARWAL,2021-03-31,0,1316,2,1318
BIHAR,AURANGABAD,2021-03-31,11,619,0,630
BIHAR,BANKA,2021-03-31,12,1254,8,1274
BIHAR,BEGUSARAI,2021-03-31,9,2879,0,2888
BIHAR,BHAGALPUR,2021-03-31,22,2873,0,2895
BIHAR,BHOJPUR,2021-03-31,11,1018,25,1054
BIHAR,BUXAR,2021-03-31,3,1346,0,1349
BIHAR,DARBHANGA,2021-03-31,10,767,2,779
BIHAR,GAYA,2021-03-31,26,2096,9,2131
BIHAR,GOPALGANJ,2021-03-31,8,727,35,770
BIHAR,JAMUI,2021-03-31,2,378,0,380
BIHAR,JEHANABAD,2021-03-31,33,1238,12,1283
BIHAR,KAIMUR (BHABUA),2021-03-31,1,1597,0,1598
BIHAR,KATIHAR,2021-03-31,3,1059,1,1063
BIHAR,KHAGARIA,2021-03-31,8,216,6,230
BIHAR,KISHANGANJ,2021-03-31,4,1328,0,1332
BIHAR,LAKHISARAI,2021-03-31,1,504,0,505
BIHAR,MADHEPURA,2021-03-31,4,1968,152,2124
BIHAR,MADHUBANI,2021-03-31,17,1103,11,1131
BIHAR,MUNGER,2021-03-31,13,251,3,267
BIHAR,MUZAFFARPUR,2021-03-31,10,1463,0,1473
BIHAR,NALANDA,2021-03-31,5,2988,0,2993
BIHAR,NAWADA,2021-03-31,4,1164,0,1168
BIHAR,PASHCHIM CHAMPARAN,2021-03-31,11,1579,1,1591
BIHAR,PATNA,2021-03-31,200,4991,3,5194
BIHAR,PURBI CHAMPARAN,2021-03-31,6,1185,5,1196
BIHAR,PURNIA,2021-03-31,7,1584,323,1914
BIHAR,ROHTAS,2021-03-31,13,2947,0,2960
BIHAR,SAHARSA,2021-03-31,7,1166,0,1173
BIHAR,SAMASTIPUR,2021-03-31,57,983,228,1268
BIHAR,SARAN,2021-03-31,5,1553,0,1558
BIHAR,SHEIKHPURA,2021-03-31,3,732,4,739
BIHAR,SHEOHAR,2021-03-31,5,619,0,624
BIHAR,SITAMARHI,2021-03-31,2,771,0,773
BIHAR,SIWAN,2021-03-31,4,1124,0,1128
BIHAR,SUPAUL,2021-03-31,1,789,35,825
BIHAR,VAISHALI,2021-03-31,16,1078,0,1094
CHANDIGARH,CHANDIGARH,2021-03-31,340,1664,27,2031
CHHATTISGARH,BALOD,2021-03-31,116,1123,0,1239
CHHATTISGARH,BALODA BAZAR,2021-03-31,99,349,7,455
CHHATTISGARH,BALRAMPUR,2021-03-31,26,844,1,871
CHHATTISGARH,BASTAR,2021-03-31,86,976,0,1062
CHHATTISGARH,BEMETARA,2021-03-31,146,222,2,370
CHHATTISGARH,BIJAPUR,2021-03-31,4,368,0,372
CHHATTISGARH,BILASPUR,2021-03-31,213,3272,5,3490
CHHATTISGARH,DANTEWADA,2021-03-31,4,154,0,158
CHHATTISGARH,DHAMTARI,2021-03-31,142,662,2,806
CHHATTISGARH,DURG,2021-03-31,1272,1436,23,2731
CHHATTISGARH,GARIYABAND,2021-03-31,42,331,10,383
CHHATTISGARH,GAURELLA PENDRA MARWAHI,2021-03-31,21,348,0,369
CHHATTISGARH,JANJGIR CHAMPA,2021-03-31,69,1398,3,1470
CHHATTISGARH,JASHPUR,2021-03-31,74,424,2,500
CHHATTISGARH,KABIRDHAM,2021-03-31,101,226,0,327
CHHATTISGARH,KANKER,2021-03-31,38,1635,0,1673
CHHATTISGARH,KONDAGAON,2021-03-31,17,552,0,569
CHHATTISGARH,KORBA,2021-03-31,81,1475,0,1556
CHHATTISGARH,KOREA,2021-03-31,47,648,1,696
CHHATTISGARH,MAHASAMUND,2021-03-31,135,858,11,1004
CHHATTISGARH,MUNGELI,2021-03-31,57,468,0,525
CHHATTISGARH,NARAYANPUR,2021-03-31,4,125,0,129
CHHATTISGARH,RAIGARH,2021-03-31,65,871,20,956
CHHATTISGARH,RAIPUR,2021-03-31,1509,2273,59,3841
CHHATTISGARH,RAJNANDGAON,2021-03-31,432,1703,3,2138
CHHATTISGARH,SUKMA,2021-03-31,2,678,0,680
CHHATTISGARH,SURAJPUR,2021-03-31,66,1043,0,1109
CHHATTISGARH,SURGUJA,2021-03-31,103,1526,1,1630
DADRA AND NAGAR HAVELI,DADRA AND NAGAR HAVELI,2021-03-31,5,267,2,274
DAMAN AND DIU,DAMAN,2021-03-31,4,191,0,195
DAMAN AND DIU,DIU,2021-03-31,0,14,0,14
DELHI,CENTRAL,2021-03-31,168,6630,25,6823
DELHI,EAST,2021-03-31,197,2369,4,2570
DELHI,NEW DELHI,2021-03-31,376,6376,8,6760
DELHI,NORTH,2021-03-31,159,7439,37,7635
DELHI,NORTH EAST,2021-03-31,82,4375,5,4462
DELHI,NORTH WEST,2021-03-31,473,9076,19,9568
DELHI,SHAHDARA,2021-03-31,101,5698,10,5809
DELHI,SOUTH,2021-03-31,508,7060,95,7663
DELHI,SOUTH EAST,2021-03-31,149,5984,92,6225
DELHI,SOUTH WEST,2021-03-31,304,9082,11,9397
DELHI,WEST,2021-03-31,415,10703,10,11128
GOA,NORTH GOA,2021-03-31,104,956,2,1062
GOA,SOUTH GOA,2021-03-31,93,965,0,1058
GUJARAT,AHMADABAD,2021-03-31,1128,14240,133,15501
GUJARAT,AMRELI,2021-03-31,53,1139,0,1192
GUJARAT,ANAND,2021-03-31,50,3308,3,3361
GUJARAT,ARVALLI,2021-03-31,35,522,1,558
GUJARAT,BANAS KANTHA,2021-03-31,25,699,0,724
GUJARAT,BHARUCH,2021-03-31,122,2872,35,3029
GUJARAT,BHAVNAGAR,2021-03-31,312,5729,0,6041
GUJARAT,BOTAD,2021-03-31,2,1210,0,1212
GUJARAT,CHHOTAUDEPUR,2021-03-31,19,465,0,484
GUJARAT,DANG,2021-03-31,1,363,0,364
GUJARAT,DEVBHUMI DWARKA,2021-03-31,37,1632,0,1669
GUJARAT,DOHAD,2021-03-31,40,2029,2,2071
GUJARAT,GANDHINAGAR,2021-03-31,131,5630,6,5767
GUJARAT,GIR SOMNATH,2021-03-31,85,2914,0,2999
GUJARAT,JAMNAGAR,2021-03-31,123,1743,12,1878
GUJARAT,JUNAGADH,2021-03-31,11,3743,3,3757
GUJARAT,KACHCHH,2021-03-31,100,9326,6,9432
GUJARAT,KHEDA,2021-03-31,58,2362,6,2426
GUJARAT,MAHESANA,2021-03-31,106,1900,2,2008
GUJARAT,MAHISAGAR,2021-03-31,50,493,1,544
GUJARAT,MORBI,2021-03-31,53,1503,0,1556
GUJARAT,NARMADA,2021-03-31,64,839,3,906
GUJARAT,NAVSARI,2021-03-31,30,1578,32,1640
GUJARAT,PANCH MAHALS,2021-03-31,93,948,8,1049
GUJARAT,PATAN,2021-03-31,56,732,2,790
GUJARAT,PORBANDAR,2021-03-31,2,388,2,392
GUJARAT,RAJKOT,2021-03-31,240,4837,1,5078
GUJARAT,SABAR KANTHA,2021-03-31,38,4076,5,4119
GUJARAT,SURAT,2021-03-31,850,43436,21,44307
GUJARAT,SURENDRANAGAR,2021-03-31,69,486,0,555
GUJARAT,TAPI,2021-03-31,77,387,50,514
GUJARAT,VADODARA,2021-03-31,342,3092,177,3611
GUJARAT,VALSAD,2021-03-31,73,1570,1,1644
HARYANA,AMBALA,2021-03-31,247,1347,80,1674
HARYANA,BHIWANI,2021-03-31,34,609,0,643
HARYANA,CHARKI DADRI,2021-03-31,2,621,0,623
HARYANA,FARIDABAD,2021-03-31,139,1251,5,1395
HARYANA,FATEHABAD,2021-03-31,22,329,0,351
HARYANA,GURUGRAM,2021-03-31,540,3807,15,4362
HARYANA,HISAR,2021-03-31,43,1395,2,1440
HARYANA,JHAJJAR,2021-03-31,7,481,0,488
HARYANA,JIND,2021-03-31,43,442,25,510
HARYANA,KAITHAL,2021-03-31,23,367,0,390
HARYANA,KARNAL,2021-03-31,135,545,0,680
HARYANA,KURUKSHETRA,2021-03-31,103,608,0,711
HARYANA,MAHENDRAGARH,2021-03-31,2,226,0,228
HARYANA,NUH,2021-03-31,1,275,0,276
HARYANA,PALWAL,2021-03-31,5,270,0,275
HARYANA,PANCHKULA,2021-03-31,434,1513,19,1966
HARYANA,PANIPAT,2021-03-31,106,686,4,796
HARYANA,REWARI,2021-03-31,13,195,1,209
HARYANA,ROHTAK,2021-03-31,27,902,1,930
HARYANA,SIRSA,2021-03-31,35,704,9,748
HARYANA,SONIPAT,2021-03-31,139,1197,0,1336
HARYANA,YAMUNANAGAR,2021-03-31,121,586,2,709
HIMACHAL PRADESH,BILASPUR,2021-03-31,60,381,4,445
HIMACHAL PRADESH,CHAMBA,2021-03-31,5,590,4,599
HIMACHAL PRADESH,HAMIRPUR,2021-03-31,65,223,252,540
HIMACHAL PRADESH,KANGRA,2021-03-31,67,678,3,748
HIMACHAL PRADESH,KINNAUR,2021-03-31,5,19,0,24
HIMACHAL PRADESH,KULLU,2021-03-31,3,214,5,222
HIMACHAL PRADESH,LAHUL AND SPITI,2021-03-31,0,3,0,3
HIMACHAL PRADESH,MANDI,2021-03-31,32,396,17,445
HIMACHAL PRADESH,SHIMLA,2021-03-31,49,693,34,776
HIMACHAL PRADESH,SIRMAUR,2021-03-31,19,554,1,574
HIMACHAL PRADESH,SOLAN,2021-03-31,54,1027,11,1092
HIMACHAL PRADESH,UNA,2021-03-31,60,639,1,700
INDIA,INDIA,2021-03-31,22,5,0,27
JAMMU AND KASHMIR,ANANTNAG,2021-03-31,27,476,0,503
JAMMU AND KASHMIR,BANDIPORA,2021-03-31,1,51,0,52
JAMMU AND KASHMIR,BARAMULLA,2021-03-31,9,170,0,179
JAMMU AND KASHMIR,BUDGAM,2021-03-31,22,1412,0,1434
JAMMU AND KASHMIR,DODA,2021-03-31,0,16,0,16
JAMMU AND KASHMIR,GANDERBAL,2021-03-31,6,377,0,383
JAMMU AND KASHMIR,JAMMU,2021-03-31,45,986,8,1039
JAMMU AND KASHMIR,KATHUA,2021-03-31,18,843,8,869
JAMMU AND KASHMIR,KISHTWAR,2021-03-31,0,35,0,35
JAMMU AND KASHMIR,KULGAM,2021-03-31,46,644,0,690
JAMMU AND KASHMIR,KUPWARA,2021-03-31,4,266,0,270
JAMMU AND KASHMIR,POONCH,2021-03-31,0,217,0,217
JAMMU AND KASHMIR,PULWAMA,2021-03-31,7,626,1,634
JAMMU AND KASHMIR,RAJOURI,2021-03-31,2,321,0,323
JAMMU AND KASHMIR,RAMBAN,2021-03-31,1,280,0,281
JAMMU AND KASHMIR,REASI,2021-03-31,7,56,0,63
JAMMU AND KASHMIR,SAMBA,2021-03-31,3,57,0,60
JAMMU AND KASHMIR,SHOPIAN,2021-03-31,0,410,0,410
JAMMU AND KASHMIR,SRINAGAR,2021-03-31,124,4495,7,4626
JAMMU AND KASHMIR,UDHAMPUR,2021-03-31,9,760,1,770
JHARKHAND,BOKARO,2021-03-31,17,1094,0,1111
JHARKHAND,CHATRA,2021-03-31,5,334,1,340
JHARKHAND,DEOGHAR,2021-03-31,14,231,0,245
JHARKHAND,DHANBAD,2021-03-31,9,919,0,928
JHARKHAND,DUMKA,2021-03-31,27,445,12,484
JHARKHAND,EAST SINGHBUM,2021-03-31,42,2856,3,2901
JHARKHAND,GARHWA,2021-03-31,0,782,0,782
JHARKHAND,GIRIDIH,2021-03-31,17,259,0,276
JHARKHAND,GODDA,2021-03-31,3,89,0,92
JHARKHAND,GUMLA,2021-03-31,14,151,0,165
JHARKHAND,HAZARIBAGH,2021-03-31,9,508,0,517
JHARKHAND,JAMTARA,2021-03-31,1,152,1,154
JHARKHAND,KHUNTI,2021-03-31,18,13,0,31
JHARKHAND,KODERMA,2021-03-31,17,543,0,560
JHARKHAND,LATEHAR,2021-03-31,9,496,2,507
JHARKHAND,LOHARDAGA,2021-03-31,5,26,0,31
JHARKHAND,PAKUR,2021-03-31,15,842,0,857
JHARKHAND,PALAMU,2021-03-31,0,616,1,617
JHARKHAND,RAMGARH,2021-03-31,11,224,0,235
JHARKHAND,RANCHI,2021-03-31,321,1379,3,1703
JHARKHAND,SAHEBGANJ,2021-03-31,15,90,0,105
JHARKHAND,SARAIKELA KHARSAWAN,2021-03-31,1,140,0,141
JHARKHAND,SIMDEGA,2021-03-31,8,405,1,414
JHARKHAND,WEST SINGHBHUM,2021-03-31,12,660,0,672
KARNATAKA,BAGALKOTE,2021-03-31,28,2759,22,2809
KARNATAKA,BALLARI,2021-03-31,25,3219,6,3250
KARNATAKA,BELAGAVI,2021-03-31,51,3393,3,3447
KARNATAKA,BENGALURU RURAL,2021-03-31,91,1789,2,1882
KARNATAKA,BENGALURU URBAN,2021-03-31,3109,49246,273,52628
KARNATAKA,BIDAR,2021-03-31,163,2802,0,2965
KARNATAKA,CHAMARAJANAGARA,2021-03-31,17,1369,1,1387
KARNATAKA,CHIKKABALLAPURA,2021-03-31,8,3485,14,3507
KARNATAKA,CHIKKAMAGALURU,2021-03-31,58,1540,1,1599
KARNATAKA,CHITRADURGA,2021-03-31,20,1092,2,1114
KARNATAKA,DAKSHINA KANNADA,2021-03-31,33,1863,7,1903
KARNATAKA,DAVANGERE,2021-03-31,12,1749,88,1849
KARNATAKA,DHARWAD,2021-03-31,64,3609,155,3828
KARNATAKA,GADAG,2021-03-31,16,981,542,1539
KARNATAKA,HASSAN,2021-03-31,73,3312,18,3403
KARNATAKA,HAVERI,2021-03-31,7,1363,0,1370
KARNATAKA,KALABURAGI,2021-03-31,179,3016,16,3211
KARNATAKA,KODAGU,2021-03-31,21,1145,31,1197
KARNATAKA,KOLAR,2021-03-31,33,2031,4,2068
KARNATAKA,KOPPAL,2021-03-31,21,1181,11,1213
KARNATAKA,MANDYA,2021-03-31,87,2604,10,2701
KARNATAKA,MYSURU,2021-03-31,160,5377,18,5555
KARNATAKA,RAICHUR,2021-03-31,26,1122,44,1192
KARNATAKA,RAMANAGARA,2021-03-31,2,545,0,547
KARNATAKA,SHIVAMOGGA,2021-03-31,26,1799,20,1845
KARNATAKA,TUMAKURU,2021-03-31,132,2441,4,2577
KARNATAKA,UDUPI,2021-03-31,61,1393,0,1454
KARNATAKA,UTTARA KANNADA,2021-03-31,30,1178,6,1214
KARNATAKA,VIJAYAPURA,2021-03-31,21,1699,1,1721
KARNATAKA,YADGIR,2021-03-31,10,830,0,840
KERALA,ALAPPUZHA,2021-03-31,88,2683,8,2779
KERALA,ERNAKULAM,2021-03-31,348,6073,22,6443
KERALA,IDUKKI,2021-03-31,107,1282,10,1399
KERALA,KANNUR,2021-03-31,357,3761,7,4125
KERALA,KASARAGOD,2021-03-31,190,2057,26,2273
KERALA,KOLLAM,2021-03-31,182,3952,15,4149
KERALA,KOTTAYAM,2021-03-31,190,2582,11,2783
KERALA,KOZHIKODE,2021-03-31,435,5155,28,5618
KERALA,MALAPPURAM,2021-03-31,242,3578,8,3828
KERALA,PALAKKAD,2021-03-31,123,2218,2,2343
KERALA,PATHANAMTHITTA,2021-03-31,98,1965,1,2064
KERALA,THIRUVANANTHAPURAM,2021-03-31,213,4611,12,4836
KERALA,THRISSUR,2021-03-31,224,4375,11,4610
KERALA,WAYANAD,2021-03-31,60,1105,19,1184
LADAKH,KARGIL,2021-03-31,5,179,1,185
LADAKH,LEH LADAKH,2021-03-31,34,712,4,750
LAKSHADWEEP,LAKSHADWEEP DISTRICT,2021-03-31,1,170,0,171
MADHYA PRADESH,AGAR MALWA,2021-03-31,13,67,0,80
MADHYA PRADESH,ALIRAJPUR,2021-03-31,9,247,0,256
MADHYA PRADESH,ANUPPUR,2021-03-31,14,60,0,74
MADHYA PRADESH,ASHOKNAGAR,2021-03-31,11,56,0,67
MADHYA PRADESH,BALAGHAT,2021-03-31,61,440,24,525
MADHYA PRADESH,BARWANI,2021-03-31,72,280,1,353
MADHYA PRADESH,BETUL,2021-03-31,49,343,0,392
MADHYA PRADESH,BHIND,2021-03-31,11,245,0,256
MADHYA PRADESH,BHOPAL,2021-03-31,1071,2275,135,3481
MADHYA PRADESH,BURHANPUR,2021-03-31,31,612,2,645
MADHYA PRADESH,CHHATARPUR,2021-03-31,9,59,0,68
MADHYA PRADESH,CHHINDWARA,2021-03-31,130,631,21,782
MADHYA PRADESH,DAMOH,2021-03-31,9,184,1,194
MADHYA PRADESH,DATIA,2021-03-31,13,55,2,70
MADHYA PRADESH,DEWAS,2021-03-31,61,381,0,442
MADHYA PRADESH,DHAR,2021-03-31,98,379,2,479
MADHYA PRADESH,DINDORI,2021-03-31,3,90,0,93
MADHYA PRADESH,EAST NIMAR,2021-03-31,65,299,3,367
MADHYA PRADESH,GUNA,2021-03-31,10,294,0,304
MADHYA PRADESH,GWALIOR,2021-03-31,153,836,0,989
MADHYA PRADESH,HARDA,2021-03-31,8,428,0,436
MADHYA PRADESH,HOSHANGABAD,2021-03-31,39,52,0,91
MADHYA PRADESH,INDORE,2021-03-31,2278,4461,9,6748
MADHYA PRADESH,JABALPUR,2021-03-31,104,1349,6,1459
MADHYA PRADESH,JHABUA,2021-03-31,61,115,0,176
MADHYA PRADESH,KATNI,2021-03-31,3,92,0,95
MADHYA PRADESH,KHARGONE,2021-03-31,48,268,3,319
MADHYA PRADESH,MANDLA,2021-03-31,9,433,0,442
MADHYA PRADESH,MANDSAUR,2021-03-31,33,206,8,247
MADHYA PRADESH,MORENA,2021-03-31,4,220,0,224
MADHYA PRADESH,NARSINGHPUR,2021-03-31,46,366,2,414
MADHYA PRADESH,NEEMUCH,2021-03-31,41,353,11,405
MADHYA PRADESH,NIWARI,2021-03-31,9,428,1,438
MADHYA PRADESH,PANNA,2021-03-31,17,296,0,313
MADHYA PRADESH,RAISEN,2021-03-31,37,240,2,279
MADHYA PRADESH,RAJGARH,2021-03-31,14,79,0,93
MADHYA PRADESH,RATLAM,2021-03-31,113,460,23,596
MADHYA PRADESH,REWA,2021-03-31,28,262,0,290
MADHYA PRADESH,SAGAR,2021-03-31,48,1238,2,1288
MADHYA PRADESH,SATNA,2021-03-31,32,196,0,228
MADHYA PRADESH,SEHORE,2021-03-31,49,257,1,307
MADHYA PRADESH,SEONI,2021-03-31,34,282,8,324
MADHYA PRADESH,SHAHDOL,2021-03-31,5,65,0,70
MADHYA PRADESH,SHAJAPUR,2021-03-31,12,104,0,116
MADHYA PRADESH,SHEOPUR,2021-03-31,1,60,1,62
MADHYA PRADESH,SHIVPURI,2021-03-31,15,290,12,317
MADHYA PRADESH,SIDHI,2021-03-31,10,16,0,26
MADHYA PRADESH,SINGRAULI,2021-03-31,2,216,0,218
MADHYA PRADESH,TIKAMGARH,2021-03-31,15,330,0,345
MADHYA PRADESH,UJJAIN,2021-03-31,154,324,0,478
MADHYA PRADESH,UMARIA,2021-03-31,13,40,0,53
MADHYA PRADESH,VIDISHA,2021-03-31,57,159,7,223
MAHARASHTRA,AHMEDNAGAR,2021-03-31,1452,2668,62,4182
MAHARASHTRA,AKOLA,2021-03-31,488,2018,7,2513
MAHARASHTRA,AMRAVATI,2021-03-31,319,3657,2,3978
MAHARASHTRA,AURANGABAD,2021-03-31,1519,6113,9,7641
MAHARASHTRA,BEED,2021-03-31,406,2546,0,2952
MAHARASHTRA,BHANDARA,2021-03-31,769,1597,0,2366
MAHARASHTRA,BULDHANA,2021-03-31,375,669,23,1067
MAHARASHTRA,CHANDRAPUR,2021-03-31,363,1473,5,1841
MAHARASHTRA,DHULE,2021-03-31,442,2389,8,2839
MAHARASHTRA,GADCHIROLI,2021-03-31,77,1264,3,1344
MAHARASHTRA,GONDIA,2021-03-31,168,2877,1,3046
MAHARASHTRA,HINGOLI,2021-03-31,105,540,0,645
MAHARASHTRA,JALGAON,2021-03-31,1226,8950,4,10180
MAHARASHTRA,JALNA,2021-03-31,340,11231,9,11580
MAHARASHTRA,KOLHAPUR,2021-03-31,93,1057,29,1179
MAHARASHTRA,LATUR,2021-03-31,704,4489,3,5196
MAHARASHTRA,MUMBAI,2021-03-31,6932,20330,65,27327
MAHARASHTRA,MUMBAI SUBURBAN,2021-03-31,2154,4539,10,6703
MAHARASHTRA,NAGPUR,2021-03-31,3991,8216,84,12291
MAHARASHTRA,NANDED,2021-03-31,1415,3429,35,4879
MAHARASHTRA,NANDURBAR,2021-03-31,481,1137,1,1619
MAHARASHTRA,NASHIK,2021-03-31,3038,3732,129,6899
MAHARASHTRA,OSMANABAD,2021-03-31,293,2050,3,2346
MAHARASHTRA,PALGHAR,2021-03-31,647,1267,10,1924
MAHARASHTRA,PARBHANI,2021-03-31,458,1929,0,2387
MAHARASHTRA,PUNE,2021-03-31,7683,12583,284,20550
MAHARASHTRA,RAIGAD,2021-03-31,865,2000,20,2885
MAHARASHTRA,RATNAGIRI,2021-03-31,72,320,0,392
MAHARASHTRA,SANGLI,2021-03-31,286,1769,9,2064
MAHARASHTRA,SATARA,2021-03-31,526,1513,29,2068
MAHARASHTRA,SINDHUDURG,2021-03-31,54,482,0,536
MAHARASHTRA,SOLAPUR,2021-03-31,708,2513,20,3241
MAHARASHTRA,THANE,2021-03-31,5159,8398,95,13652
MAHARASHTRA,WARDHA,2021-03-31,402,1937,1,2340
MAHARASHTRA,WASHIM,2021-03-31,303,1538,45,1886
MAHARASHTRA,YAVATMAL,2021-03-31,316,2636,5,2957
MANIPUR,BISHNUPUR,2021-03-31,0,35,0,35
MANIPUR,CHANDEL,2021-03-31,0,10,0,10
MANIPUR,CHURACHANDPUR,2021-03-31,0,69,0,69
MANIPUR,IMPHAL EAST,2021-03-31,1,113,0,114
MANIPUR,IMPHAL WEST,2021-03-31,1,407,0,408
MANIPUR,JIRIBAM,2021-03-31,0,2,0,2
MANIPUR,KAKCHING,2021-03-31,1,14,0,15
MANIPUR,KANGPOKPI,2021-03-31,1,34,0,35
MANIPUR,NONEY,2021-03-31,0,5,0,5
MANIPUR,PHERZAWL,2021-03-31,0,1,0,1
MANIPUR,SENAPATI,2021-03-31,0,23,0,23
MANIPUR,TAMENGLONG,2021-03-31,0,17,0,17
MANIPUR,TENGNOUPAL,2021-03-31,0,5,0,5
MANIPUR,THOUBAL,2021-03-31,0,47,0,47
MANIPUR,UKHRUL,2021-03-31,0,18,0,18
MEGHALAYA,EAST GARO HILLS,2021-03-31,0,15,0,15
MEGHALAYA,EAST JAINTIA HILLS,2021-03-31,0,35,0,35
MEGHALAYA,EAST KHASI HILLS,2021-03-31,0,469,1,470
MEGHALAYA,NORTH GARO HILLS,2021-03-31,0,16,0,16
MEGHALAYA,RI BHOI,2021-03-31,0,68,0,68
MEGHALAYA,SOUTH GARO HILLS,2021-03-31,0,7,0,7
MEGHALAYA,SOUTH WEST GARO HILLS,2021-03-31,0,44,0,44
MEGHALAYA,SOUTH WEST KHASI HILLS,2021-03-31,0,1,0,1
MEGHALAYA,WEST GARO HILLS,2021-03-31,0,31,0,31
MEGHALAYA,WEST JAINTIA HILLS,2021-03-31,0,41,0,41
MEGHALAYA,WEST KHASI HILLS,2021-03-31,0,72,0,72
MIZORAM,AIZAWL,2021-03-31,4,526,0,530
MIZORAM,CHAMPHAI,2021-03-31,1,1,0,2
MIZORAM,HNAHTHIAL,2021-03-31,1,7,0,8
MIZORAM,KOLASIB,2021-03-31,0,68,0,68
MIZORAM,LAWNGTLAI,2021-03-31,0,2,0,2
MIZORAM,LUNGLEI,2021-03-31,0,6,0,6
MIZORAM,MAMIT,2021-03-31,0,34,0,34
MIZORAM,SAIHA,2021-03-31,0,5,0,5
MIZORAM,SAITUAL,2021-03-31,0,56,0,56
MIZORAM,SERCHHIP,2021-03-31,0,5,0,5
NAGALAND,DIMAPUR,2021-03-31,45,86,0,131
NAGALAND,KIPHIRE,2021-03-31,0,12,0,12
NAGALAND,KOHIMA,2021-03-31,3,19,0,22
NAGALAND,MOKOKCHUNG,2021-03-31,0,8,0,8
NAGALAND,PEREN,2021-03-31,0,6,0,6
NAGALAND,PHEK,2021-03-31,0,6,0,6
NAGALAND,WOKHA,2021-03-31,0,1,0,1
ODISHA,ANUGUL,2021-03-31,24,719,0,743
ODISHA,BALANGIR,2021-03-31,4,1318,1,1323
ODISHA,BALESHWAR,2021-03-31,10,1754,1,1765
ODISHA,BARGARH,2021-03-31,18,465,0,483
ODISHA,BHADRAK,2021-03-31,8,497,0,505
ODISHA,BOUDH,2021-03-31,1,158,0,159
ODISHA,CUTTACK,2021-03-31,32,1449,3,1484
ODISHA,DEOGARH,2021-03-31,0,147,0,147
ODISHA,DHENKANAL,2021-03-31,4,513,0,517
ODISHA,GAJAPATI,2021-03-31,2,162,0,164
ODISHA,GANJAM,2021-03-31,5,1551,1,1557
ODISHA,JAGATSINGHAPUR,2021-03-31,5,480,0,485
ODISHA,JAJAPUR,2021-03-31,8,503,0,511
ODISHA,JHARSUGUDA,2021-03-31,3,436,41,480
ODISHA,KALAHANDI,2021-03-31,48,307,0,355
ODISHA,KANDHAMAL,2021-03-31,3,785,0,788
ODISHA,KENDRAPARA,2021-03-31,2,1029,0,1031
ODISHA,KENDUJHAR,2021-03-31,3,828,0,831
ODISHA,KHORDHA,2021-03-31,83,1931,3,2017
ODISHA,KORAPUT,2021-03-31,5,1740,0,1745
ODISHA,MALKANGIRI,2021-03-31,0,125,0,125
ODISHA,MAYURBHANJ,2021-03-31,19,1614,0,1633
ODISHA,NABARANGPUR,2021-03-31,7,747,0,754
ODISHA,NAYAGARH,2021-03-31,2,515,0,517
ODISHA,NUAPADA,2021-03-31,43,339,0,382
ODISHA,PURI,2021-03-31,9,509,0,518
ODISHA,RAYAGADA,2021-03-31,8,513,0,521
ODISHA,SAMBALPUR,2021-03-31,33,398,0,431
ODISHA,SONEPUR,2021-03-31,0,568,0,568
ODISHA,SUNDARGARH,2021-03-31,72,424,0,496
PUDUCHERRY,KARAIKAL,2021-03-31,49,303,0,352
PUDUCHERRY,MAHE,2021-03-31,3,84,1,88
PUDUCHERRY,PONDICHERRY,2021-03-31,170,1072,9,1251
PUDUCHERRY,YANAM,2021-03-31,0,83,0,83
PUNJAB,AMRITSAR,2021-03-31,492,3098,14,3604
PUNJAB,BARNALA,2021-03-31,39,184,1,224
PUNJAB,BATHINDA,2021-03-31,140,1881,48,2069
PUNJAB,FARIDKOT,2021-03-31,82,485,314,881
PUNJAB,FATEHGARH SAHIB,2021-03-31,36,418,7,461
PUNJAB,FAZILKA,2021-03-31,43,631,0,674
PUNJAB,FIROZEPUR,2021-03-31,59,510,4,573
PUNJAB,GURDASPUR,2021-03-31,70,1385,5,1460
PUNJAB,HOSHIARPUR,2021-03-31,281,2122,24,2427
PUNJAB,JALANDHAR,2021-03-31,469,4400,245,5114
PUNJAB,KAPURTHALA,2021-03-31,67,545,18,630
PUNJAB,LUDHIANA,2021-03-31,397,3394,20,3811
PUNJAB,MANSA,2021-03-31,44,794,1,839
PUNJAB,MOGA,2021-03-31,160,430,15,605
PUNJAB,PATHANKOT,2021-03-31,26,272,0,298
PUNJAB,PATIALA,2021-03-31,297,2517,2,2816
PUNJAB,RUPNAGAR,2021-03-31,136,795,5,936
PUNJAB,S.A.S NAGAR,2021-03-31,542,1957,12,2511
PUNJAB,SANGRUR,2021-03-31,82,1314,2,1398
PUNJAB,SHAHID BHAGAT SINGH NAGAR,2021-03-31,19,1533,0,1552
PUNJAB,SRI MUKTSAR SAHIB,2021-03-31,23,384,4,411
PUNJAB,TARN TARAN,2021-03-31,65,722,3,790
RAJASTHAN,AJMER,2021-03-31,2,46,1039,1087
RAJASTHAN,ALWAR,2021-03-31,16,883,21,920
RAJASTHAN,BANSWARA,2021-03-31,2,77,1,80
RAJASTHAN,BARAN,2021-03-31,1,12,0,13
RAJASTHAN,BARMER,2021-03-31,1,91,0,92
RAJASTHAN,BHARATPUR,2021-03-31,0,219,5,224
RAJASTHAN,BHILWARA,2021-03-31,2,616,6,624
RAJASTHAN,BIKANER,2021-03-31,81,657,1,739
RAJASTHAN,BUNDI,2021-03-31,1,28,0,29
RAJASTHAN,CHITTORGARH,2021-03-31,101,301,19,421
RAJASTHAN,CHURU,2021-03-31,1,72,5,78
RAJASTHAN,DAUSA,2021-03-31,1,291,22,314
RAJASTHAN,DHOLPUR,2021-03-31,10,104,0,114
RAJASTHAN,DUNGARPUR,2021-03-31,71,364,0,435
RAJASTHAN,GANGANAGAR,2021-03-31,40,58,0,98
RAJASTHAN,HANUMANGARH,2021-03-31,3,964,3,970
RAJASTHAN,JAIPUR,2021-03-31,196,2168,565,2929
RAJASTHAN,JAISALMER,2021-03-31,1,213,0,214
RAJASTHAN,JALORE,2021-03-31,14,451,0,465
RAJASTHAN,JHALAWAR,2021-03-31,2,70,0,72
RAJASTHAN,JHUNJHUNU,2021-03-31,1,120,8,129
RAJASTHAN,JODHPUR,2021-03-31,65,586,3,654
RAJASTHAN,KARAULI,2021-03-31,3,234,8,245
RAJASTHAN,KOTA,2021-03-31,169,1878,10,2057
RAJASTHAN,NAGAUR,2021-03-31,2,78,69,149
RAJASTHAN,PALI,2021-03-31,2,27,6,35
RAJASTHAN,PRATAPGARH,2021-03-31,33,15,0,48
RAJASTHAN,RAJSAMAND,2021-03-31,5,34,1,40
RAJASTHAN,SAWAI MADHOPUR,2021-03-31,4,393,4,401
RAJASTHAN,SIKAR,2021-03-31,6,153,9,168
RAJASTHAN,SIROHI,2021-03-31,1,19,0,20
RAJASTHAN,TONK,2021-03-31,1,239,28,268
RAJASTHAN,UDAIPUR,2021-03-31,488,1157,4,1649
SIKKIM,EAST DISTRICT,2021-03-31,0,115,0,115
SIKKIM,NORTH DISTRICT,2021-03-31,0,3,0,3
SIKKIM,SOUTH DISTRICT,2021-03-31,0,1,0,1
SIKKIM,WEST DISTRICT,2021-03-31,0,1,0,1
TAMIL NADU,ARIYALUR,2021-03-31,8,804,0,812
TAMIL NADU,CHENGALPATTU,2021-03-31,252,6675,4,6931
TAMIL NADU,CHENNAI,2021-03-31,1367,12631,26,14024
TAMIL NADU,COIMBATORE,2021-03-31,317,3303,3,3623
TAMIL NADU,CUDDALORE,2021-03-31,101,1865,0,1966
TAMIL NADU,DHARMAPURI,2021-03-31,3,714,0,717
TAMIL NADU,DINDIGUL,2021-03-31,29,3085,5,3119
TAMIL NADU,ERODE,2021-03-31,34,1852,1,1887
TAMIL NADU,KALLAKURICHI,2021-03-31,7,303,0,310
TAMIL NADU,KANCHIPURAM,2021-03-31,110,2288,4,2402
TAMIL NADU,KANNIYAKUMARI,2021-03-31,32,1703,2,1737
TAMIL NADU,KARUR,2021-03-31,15,1141,0,1156
TAMIL NADU,KRISHNAGIRI,2021-03-31,39,1604,4,1647
TAMIL NADU,MADURAI,2021-03-31,72,2962,0,3034
TAMIL NADU,NAGAPATTINAM,2021-03-31,92,1058,0,1150
TAMIL NADU,NAMAKKAL,2021-03-31,28,724,0,752
TAMIL NADU,PERAMBALUR,2021-03-31,3,555,0,558
TAMIL NADU,PUDUKKOTTAI,2021-03-31,17,1540,5,1562
TAMIL NADU,RAMANATHAPURAM,2021-03-31,11,1223,0,1234
TAMIL NADU,RANIPET,2021-03-31,20,157,1,178
TAMIL NADU,SALEM,2021-03-31,101,2356,4,2461
TAMIL NADU,SIVAGANGA,2021-03-31,33,723,0,756
TAMIL NADU,TENKASI,2021-03-31,16,667,2,685
TAMIL NADU,THANJAVUR,2021-03-31,79,2671,1,2751
TAMIL NADU,THE NILGIRIS,2021-03-31,30,1291,1,1322
TAMIL NADU,THENI,2021-03-31,16,508,0,524
TAMIL NADU,THIRUVALLUR,2021-03-31,192,2804,11,3007
TAMIL NADU,THIRUVARUR,2021-03-31,58,1422,1,1481
TAMIL NADU,TIRUCHIRAPPALLI,2021-03-31,125,3294,2,3421
TAMIL NADU,TIRUNELVELI,2021-03-31,65,1313,0,1378
TAMIL NADU,TIRUPATHUR,2021-03-31,26,3753,0,3779
TAMIL NADU,TIRUPPUR,2021-03-31,84,1886,1,1971
TAMIL NADU,TIRUVANNAMALAI,2021-03-31,12,897,0,909
TAMIL NADU,TUTICORIN,2021-03-31,22,969,6,997
TAMIL NADU,VELLORE,2021-03-31,44,1369,5,1418
TAMIL NADU,VILLUPURAM,2021-03-31,28,1065,1,1094
TAMIL NADU,VIRUDHUNAGAR,2021-03-31,8,222,0,230
TELANGANA,ADILABAD,2021-03-31,1,891,0,892
TELANGANA,BHADRADRI KOTHAGUDEM,2021-03-31,0,436,0,436
TELANGANA,HYDERABAD,2021-03-31,73,10374,26,10473
TELANGANA,JAGITIAL,2021-03-31,0,1176,0,1176
TELANGANA,JANGOAN,2021-03-31,0,982,0,982
TELANGANA,JAYASHANKAR BHUPALAPALLY,2021-03-31,0,563,0,563
TELANGANA,JOGULAMBA GADWAL,2021-03-31,0,807,0,807
TELANGANA,KAMAREDDY,2021-03-31,0,715,0,715
TELANGANA,KARIMNAGAR,2021-03-31,1,1659,0,1660
TELANGANA,KHAMMAM,2021-03-31,0,1064,0,1064
TELANGANA,KUMURAM BHEEM ASIFABAD,2021-03-31,0,360,0,360
TELANGANA,MAHABUBABAD,2021-03-31,0,295,0,295
TELANGANA,MAHABUBNAGAR,2021-03-31,1,1028,6,1035
TELANGANA,MANCHERIAL,2021-03-31,0,565,0,565
TELANGANA,MEDAK,2021-03-31,0,326,0,326
TELANGANA,MEDCHAL MALKAJGIRI,2021-03-31,6,2695,0,2701
TELANGANA,MULUGU,2021-03-31,0,407,0,407
TELANGANA,NAGARKURNOOL,2021-03-31,0,1516,0,1516
TELANGANA,NALGONDA,2021-03-31,1,1435,0,1436
TELANGANA,NARAYANPET,2021-03-31,0,278,0,278
TELANGANA,NIRMAL,2021-03-31,0,710,0,710
TELANGANA,NIZAMABAD,2021-03-31,0,1450,8,1458
TELANGANA,PEDDAPALLI,2021-03-31,0,1308,0,1308
TELANGANA,RAJANNA SIRCILLA,2021-03-31,0,258,0,258
TELANGANA,RANGA REDDY,2021-03-31,8,3598,1,3607
TELANGANA,SANGAREDDY,2021-03-31,2,792,0,794
TELANGANA,SIDDIPET,2021-03-31,2,1809,0,1811
TELANGANA,SURYAPET,2021-03-31,2,888,0,890
TELANGANA,VIKARABAD,2021-03-31,1,588,0,589
TELANGANA,WANAPARTHY,2021-03-31,0,448,0,448
TELANGANA,WARANGAL RURAL,2021-03-31,3,847,0,850
TELANGANA,WARANGAL URBAN,2021-03-31,2,2403,0,2405
TELANGANA,YADADRI BHUVANAGIRI,2021-03-31,0,386,0,386
TRIPURA,DHALAI,2021-03-31,0,18,0,18
TRIPURA,GOMATI,2021-03-31,2,56,0,58
TRIPURA,KHOWAI,2021-03-31,0,29,0,29
TRIPURA,NORTH TRIPURA,2021-03-31,1,116,0,117
TRIPURA,SEPAHIJALA,2021-03-31,1,85,0,86
TRIPURA,SOUTH TRIPURA,2021-03-31,0,50,0,50
TRIPURA,UNAKOTI,2021-03-31,0,11,0,11
TRIPURA,WEST TRIPURA,2021-03-31,15,245,0,260
UTTAR PRADESH,AGRA,2021-03-31,35,2075,19,2129
UTTAR PRADESH,ALIGARH,2021-03-31,22,3089,2,3113
UTTAR PRADESH,AMBEDKAR NAGAR,2021-03-31,4,834,1,839
UTTAR PRADESH,AMETHI,2021-03-31,4,1025,0,1029
UTTAR PRADESH,AMROHA,2021-03-31,3,53,0,56
UTTAR PRADESH,AURAIYA,2021-03-31,7,975,7,989
UTTAR PRADESH,AYODHYA,2021-03-31,11,1786,1,1798
UTTAR PRADESH,AZAMGARH,2021-03-31,35,854,6,895
UTTAR PRADESH,BAGHPAT,2021-03-31,6,966,2,974
UTTAR PRADESH,BAHRAICH,2021-03-31,11,1343,53,1407
UTTAR PRADESH,BALLIA,2021-03-31,33,697,29,759
UTTAR PRADESH,BALRAMPUR,2021-03-31,4,1663,0,1667
UTTAR PRADESH,BANDA,2021-03-31,14,1996,6,2016
UTTAR PRADESH,BARABANKI,2021-03-31,65,1915,47,2027
UTTAR PRADESH,BAREILLY,2021-03-31,37,2709,3,2749
UTTAR PRADESH,BASTI,2021-03-31,13,3256,3,3272
UTTAR PRADESH,BHADOHI,2021-03-31,21,1584,12,1617
UTTAR PRADESH,BIJNOR,2021-03-31,11,1488,3,1502
UTTAR PRADESH,BUDAUN,2021-03-31,13,2318,14,2345
UTTAR PRADESH,BULANDSHAHR,2021-03-31,6,2357,0,2363
UTTAR PRADESH,CHANDAULI,2021-03-31,15,393,11,419
UTTAR PRADESH,CHITRAKOOT,2021-03-31,3,286,28,317
UTTAR PRADESH,DEORIA,2021-03-31,19,934,758,1711
UTTAR PRADESH,ETAH,2021-03-31,9,430,3,442
UTTAR PRADESH,ETAWAH,2021-03-31,4,1399,96,1499
UTTAR PRADESH,FARRUKHABAD,2021-03-31,6,415,9,430
UTTAR PRADESH,FATEHPUR,2021-03-31,4,1603,39,1646
UTTAR PRADESH,FIROZABAD,2021-03-31,28,1656,6,1690
UTTAR PRADESH,GAUTAM BUDDHA NAGAR,2021-03-31,268,2679,68,3015
UTTAR PRADESH,GHAZIABAD,2021-03-31,238,4619,43,4900
UTTAR PRADESH,GHAZIPUR,2021-03-31,24,672,124,820
UTTAR PRADESH,GONDA,2021-03-31,11,1144,1,1156
UTTAR PRADESH,GORAKHPUR,2021-03-31,52,2343,71,2466
UTTAR PRADESH,HAMIRPUR,2021-03-31,1,421,0,422
UTTAR PRADESH,HAPUR,2021-03-31,4,1571,1,1576
UTTAR PRADESH,HARDOI,2021-03-31,9,1170,0,1179
UTTAR PRADESH,HATHRAS,2021-03-31,2,540,0,542
UTTAR PRADESH,JALAUN,2021-03-31,5,903,5,913
UTTAR PRADESH,JAUNPUR,2021-03-31,46,2035,0,2081
UTTAR PRADESH,JHANSI,2021-03-31,41,2055,1,2097
UTTAR PRADESH,KANNAUJ,2021-03-31,11,1416,11,1438
UTTAR PRADESH,KANPUR DEHAT,2021-03-31,1,865,0,866
UTTAR PRADESH,KANPUR NAGAR,2021-03-31,89,2586,13,2688
UTTAR PRADESH,KASGANJ,2021-03-31,4,2618,19,2641
UTTAR PRADESH,KAUSHAMBI,2021-03-31,4,1779,1,1784
UTTAR PRADESH,KHERI,2021-03-31,12,1001,1,1014
UTTAR PRADESH,KUSHI NAGAR,2021-03-31,7,730,24,761
UTTAR PRADESH,LALITPUR,2021-03-31,19,1190,2,1211
UTTAR PRADESH,LUCKNOW,2021-03-31,924,10600,199,11723
UTTAR PRADESH,MAHARAJGANJ,2021-03-31,6,648,100,754
UTTAR PRADESH,MAHOBA,2021-03-31,3,1651,5,1659
UTTAR PRADESH,MAINPURI,2021-03-31,1,1074,6,1081
UTTAR PRADESH,MATHURA,2021-03-31,29,997,41,1067
UTTAR PRADESH,MAU,2021-03-31,7,959,12,978
UTTAR PRADESH,MEERUT,2021-03-31,65,4463,30,4558
UTTAR PRADESH,MIRZAPUR,2021-03-31,19,1301,0,1320
UTTAR PRADESH,MORADABAD,2021-03-31,15,2342,104,2461
UTTAR PRADESH,MUZAFFARNAGAR,2021-03-31,23,2956,6,2985
UTTAR PRADESH,PILIBHIT,2021-03-31,4,1515,1,1520
UTTAR PRADESH,PRATAPGARH,2021-03-31,22,1431,33,1486
UTTAR PRADESH,PRAYAGRAJ,2021-03-31,259,1350,9,1618
UTTAR PRADESH,RAE BARELI,2021-03-31,50,1563,14,1627
UTTAR PRADESH,RAMPUR,2021-03-31,18,971,0,989
UTTAR PRADESH,SAHARANPUR,2021-03-31,46,2004,6,2056
UTTAR PRADESH,SAMBHAL,2021-03-31,5,330,23,358
UTTAR PRADESH,SANT KABEER NAGAR,2021-03-31,9,912,0,921
UTTAR PRADESH,SHAHJAHANPUR,2021-03-31,12,1397,1,1410
UTTAR PRADESH,SHAMLI,2021-03-31,13,753,3,769
UTTAR PRADESH,SHRAVASTI,2021-03-31,8,1058,0,1066
UTTAR PRADESH,SIDDHARTH NAGAR,2021-03-31,13,1458,162,1633
UTTAR PRADESH,SITAPUR,2021-03-31,11,1226,3,1240
UTTAR PRADESH,SONBHADRA,2021-03-31,14,855,0,869
UTTAR PRADESH,SULTANPUR,2021-03-31,7,1747,99,1853
UTTAR PRADESH,UNNAO,2021-03-31,12,1795,79,1886
UTTAR PRADESH,VARANASI,2021-03-31,338,3741,4,4083
UTTARAKHAND,ALMORA,2021-03-31,1,64,0,65
UTTARAKHAND,BAGESHWAR,2021-03-31,2,36,0,38
UTTARAKHAND,CHAMOLI,2021-03-31,2,85,0,87
UTTARAKHAND,CHAMPAWAT,2021-03-31,1,19,0,20
UTTARAKHAND,DEHRADUN,2021-03-31,219,3459,25,3703
UTTARAKHAND,HARIDWAR,2021-03-31,126,5922,4,6052
UTTARAKHAND,NAINITAL,2021-03-31,42,893,0,935
UTTARAKHAND,PAURI GARHWAL,2021-03-31,15,862,7,884
UTTARAKHAND,PITHORAGARH,2021-03-31,4,292,0,296
UTTARAKHAND,RUDRA PRAYAG,2021-03-31,2,23,0,25
UTTARAKHAND,TEHRI GARHWAL,2021-03-31,2,203,1,206
UTTARAKHAND,UDAM SINGH NAGAR,2021-03-31,19,1024,121,1164
UTTARAKHAND,UTTAR KASHI,2021-03-31,0,43,0,43
WEST BENGAL,24 PARAGANAS NORTH,2021-03-31,443,4096,24,4563
WEST BENGAL,24 PARAGANAS SOUTH,2021-03-31,102,3047,26,3175
WEST BENGAL,ALIPURDUAR,2021-03-31,0,174,0,174
WEST BENGAL,BANKURA,2021-03-31,9,1168,5,1182
WEST BENGAL,BIRBHUM,2021-03-31,86,622,5,713
WEST BENGAL,COOCHBEHAR,2021-03-31,2,1152,0,1154
WEST BENGAL,DARJEELING,2021-03-31,12,403,1,416
WEST BENGAL,DINAJPUR DAKSHIN,2021-03-31,1,534,2,537
WEST BENGAL,DINAJPUR UTTAR,2021-03-31,10,206,1,217
WEST BENGAL,HOOGHLY,2021-03-31,87,1034,5,1126
WEST BENGAL,HOWRAH,2021-03-31,137,1230,38,1405
WEST BENGAL,JALPAIGURI,2021-03-31,10,391,7,408
WEST BENGAL,JHARGRAM,2021-03-31,3,94,0,97
WEST BENGAL,KALIMPONG,2021-03-31,2,184,0,186
WEST BENGAL,KOLKATA,2021-03-31,694,3898,12,4604
WEST BENGAL,MALDAH,2021-03-31,18,1074,4,1096
WEST BENGAL,MEDINIPUR EAST,2021-03-31,35,775,1,811
WEST BENGAL,MEDINIPUR WEST,2021-03-31,11,449,11,471
WEST BENGAL,MURSHIDABAD,2021-03-31,17,1095,12,1124
WEST BENGAL,NADIA,2021-03-31,18,675,9,702
WEST BENGAL,PASCHIM BARDHAMAN,2021-03-31,80,450,19,549
WEST BENGAL,PURBA BARDHAMAN,2021-03-31,16,662,0,678
WEST BENGAL,PURULIA,2021-03-31,21,355,0,376
ANDAMAN AND NICOBAR ISLANDS,NICOBARS,2021-03-26,0,6,1,7
ANDAMAN AND NICOBAR ISLANDS,NICOBARS,2021-03-27,0,18,0,18
ANDAMAN AND NICOBAR ISLANDS,NICOBARS,2021-03-28,0,6,0,6
ANDAMAN AND NICOBAR ISLANDS,NICOBARS,2021-03-29,1,12,0,13
ANDAMAN AND NICOBAR ISLANDS,NICOBARS,2021-03-30,1,24,0,25
ANDAMAN AND NICOBAR ISLANDS,NORTH AND MIDDLE ANDAMAN,2021-03-26,0,7,0,7
ANDAMAN AND NICOBAR ISLANDS,NORTH AND MIDDLE ANDAMAN,2021-03-27,0,10,0,10
ANDAMAN AND NICOBAR ISLANDS,NORTH AND MIDDLE ANDAMAN,2021-03-28,0,13,0,13
ANDAMAN AND NICOBAR ISLANDS,NORTH AND MIDDLE ANDAMAN,2021-03-29,0,8,0,8
ANDAMAN AND NICOBAR ISLANDS,NORTH AND MIDDLE ANDAMAN,2021-03-30,2,26,0,28
ANDAMAN AND NICOBAR ISLANDS,SOUTH ANDAMANS,2021-03-26,2,351,0,353
ANDAMAN AND NICOBAR ISLANDS,SOUTH ANDAMANS,2021-03-27,5,298,0,303
ANDAMAN AND NICOBAR ISLANDS,SOUTH ANDAMANS,2021-03-28,0,222,0,222
ANDAMAN AND NICOBAR ISLANDS,SOUTH ANDAMANS,2021-03-29,2,46,0,48
ANDAMAN AND NICOBAR ISLANDS,SOUTH ANDAMANS,2021-03-30,3,593,0,596
ANDHRA PRADESH,ANANTAPUR,2021-03-26,41,6727,1,6769
ANDHRA PRADESH,ANANTAPUR,2021-03-27,68,2749,2,2819
ANDHRA PRADESH,ANANTAPUR,2021-03-28,42,9974,1,10017
ANDHRA PRADESH,ANANTAPUR,2021-03-29,50,6767,0,6817
ANDHRA PRADESH,ANANTAPUR,2021-03-30,47,2976,1,3024
ANDHRA PRADESH,CHITTOOR,2021-03-26,228,4769,0,4997
ANDHRA PRADESH,CHITTOOR,2021-03-27,209,2794,0,3003
ANDHRA PRADESH,CHITTOOR,2021-03-28,178,6603,1,6782
ANDHRA PRADESH,CHITTOOR,2021-03-29,238,5957,0,6195
ANDHRA PRADESH,CHITTOOR,2021-03-30,143,1601,0,1744
ANDHRA PRADESH,EAST GODAVARI,2021-03-26,190,6131,0,6321
ANDHRA PRADESH,EAST GODAVARI,2021-03-27,92,1005,2,1099
ANDHRA PRADESH,EAST GODAVARI,2021-03-28,252,6455,0,6707
ANDHRA PRADESH,EAST GODAVARI,2021-03-29,215,10593,0,10808
ANDHRA PRADESH,EAST GODAVARI,2021-03-30,171,4288,0,4459
ANDHRA PRADESH,GUNTUR,2021-03-26,145,3773,0,3918
ANDHRA PRADESH,GUNTUR,2021-03-27,226,2754,0,2980
ANDHRA PRADESH,GUNTUR,2021-03-28,214,5440,0,5654
ANDHRA PRADESH,GUNTUR,2021-03-29,231,4879,0,5110
ANDHRA PRADESH,GUNTUR,2021-03-30,355,3739,0,4094
ANDHRA PRADESH,KRISHNA,2021-03-26,145,3849,0,3994
ANDHRA PRADESH,KRISHNA,2021-03-27,147,4463,0,4610
ANDHRA PRADESH,KRISHNA,2021-03-28,158,3316,1,3475
ANDHRA PRADESH,KRISHNA,2021-03-29,149,6700,0,6849
ANDHRA PRADESH,KRISHNA,2021-03-30,206,5369,0,5575
ANDHRA PRADESH,KURNOOL,2021-03-26,80,4918,1,4999
ANDHRA PRADESH,KURNOOL,2021-03-27,63,3595,3,3661
ANDHRA PRADESH,KURNOOL,2021-03-28,26,7382,0,7408
ANDHRA PRADESH,KURNOOL,2021-03-29,57,6316,0,6373
ANDHRA PRADESH,KURNOOL,2021-03-30,64,3067,0,3131
ANDHRA PRADESH,PRAKASAM,2021-03-26,33,6576,0,6609
ANDHRA PRADESH,PRAKASAM,2021-03-27,40,4501,0,4541
ANDHRA PRADESH,PRAKASAM,2021-03-28,26,5827,0,5853
ANDHRA PRADESH,PRAKASAM,2021-03-29,40,8559,0,8599
ANDHRA PRADESH,PRAKASAM,2021-03-30,41,1851,0,1892
ANDHRA PRADESH,SPSR NELLORE,2021-03-26,66,4324,1,4391
ANDHRA PRADESH,SPSR NELLORE,2021-03-27,87,3072,0,3159
ANDHRA PRADESH,SPSR NELLORE,2021-03-28,84,5308,0,5392
ANDHRA PRADESH,SPSR NELLORE,2021-03-29,60,5673,0,5733
ANDHRA PRADESH,SPSR NELLORE,2021-03-30,35,1492,0,1527
ANDHRA PRADESH,SRIKAKULAM,2021-03-26,45,4134,0,4179
ANDHRA PRADESH,SRIKAKULAM,2021-03-27,44,1686,0,1730
ANDHRA PRADESH,SRIKAKULAM,2021-03-28,53,4278,0,4331
ANDHRA PRADESH,SRIKAKULAM,2021-03-29,26,3542,0,3568
ANDHRA PRADESH,SRIKAKULAM,2021-03-30,52,1195,0,1247
ANDHRA PRADESH,VISAKHAPATANAM,2021-03-26,180,9268,1,9449
ANDHRA PRADESH,VISAKHAPATANAM,2021-03-27,252,5350,0,5602
ANDHRA PRADESH,VISAKHAPATANAM,2021-03-28,90,6397,0,6487
ANDHRA PRADESH,VISAKHAPATANAM,2021-03-29,181,6605,0,6786
ANDHRA PRADESH,VISAKHAPATANAM,2021-03-30,269,3480,1,3750
ANDHRA PRADESH,VIZIANAGARAM,2021-03-26,20,6274,0,6294
ANDHRA PRADESH,VIZIANAGARAM,2021-03-27,13,3723,0,3736
ANDHRA PRADESH,VIZIANAGARAM,2021-03-28,12,2380,0,2392
ANDHRA PRADESH,VIZIANAGARAM,2021-03-29,12,4759,0,4771
ANDHRA PRADESH,VIZIANAGARAM,2021-03-30,19,3775,0,3794
ANDHRA PRADESH,WEST GODAVARI,2021-03-26,30,5114,0,5144
ANDHRA PRADESH,WEST GODAVARI,2021-03-27,21,2730,0,2751
ANDHRA PRADESH,WEST GODAVARI,2021-03-28,44,5135,0,5179
ANDHRA PRADESH,WEST GODAVARI,2021-03-29,36,5514,0,5550
ANDHRA PRADESH,WEST GODAVARI,2021-03-30,18,4886,0,4904
ANDHRA PRADESH,Y.S.R.,2021-03-26,49,7560,0,7609
ANDHRA PRADESH,Y.S.R.,2021-03-27,31,7599,0,7630
ANDHRA PRADESH,Y.S.R.,2021-03-28,44,8505,0,8549
ANDHRA PRADESH,Y.S.R.,2021-03-29,36,4800,0,4836
ANDHRA PRADESH,Y.S.R.,2021-03-30,73,2072,0,2145
ARUNACHAL PRADESH,ANJAW,2021-03-26,0,6,0,6
ARUNACHAL PRADESH,ANJAW,2021-03-28,0,1,0,1
ARUNACHAL PRADESH,ANJAW,2021-03-29,0,7,0,7
ARUNACHAL PRADESH,ANJAW,2021-03-30,0,1,0,1
ARUNACHAL PRADESH,CHANGLANG,2021-03-27,0,1,0,1
ARUNACHAL PRADESH,CHANGLANG,2021-03-28,0,3,0,3
ARUNACHAL PRADESH,CHANGLANG,2021-03-30,1,0,0,1
ARUNACHAL PRADESH,DIBANG VALLEY,2021-03-27,0,1,0,1
ARUNACHAL PRADESH,DIBANG VALLEY,2021-03-28,0,1,0,1
ARUNACHAL PRADESH,EAST KAMENG,2021-03-26,0,1,0,1
ARUNACHAL PRADESH,EAST SIANG,2021-03-26,0,15,0,15
ARUNACHAL PRADESH,EAST SIANG,2021-03-27,0,24,0,24
ARUNACHAL PRADESH,EAST SIANG,2021-03-28,0,3,0,3
ARUNACHAL PRADESH,EAST SIANG,2021-03-29,0,1,0,1
ARUNACHAL PRADESH,EAST SIANG,2021-03-30,0,16,0,16
ARUNACHAL PRADESH,KAMLE,2021-03-27,0,1,0,1
ARUNACHAL PRADESH,KURUNG KUMEY,2021-03-26,0,1,0,1
ARUNACHAL PRADESH,LEPARADA,2021-03-26,0,2,0,2
ARUNACHAL PRADESH,LEPARADA,2021-03-30,29,0,0,29
ARUNACHAL PRADESH,LOHIT,2021-03-26,0,3,0,3
ARUNACHAL PRADESH,LOWER DIBANG VALLEY,2021-03-26,1,0,0,1
ARUNACHAL PRADESH,LOWER DIBANG VALLEY,2021-03-27,4,0,0,4
ARUNACHAL PRADESH,LOWER SIANG,2021-03-26,0,11,0,11
ARUNACHAL PRADESH,LOWER SIANG,2021-03-28,0,14,1,15
ARUNACHAL PRADESH,LOWER SIANG,2021-03-29,0,15,0,15
ARUNACHAL PRADESH,LOWER SIANG,2021-03-30,0,3,0,3
ARUNACHAL PRADESH,LOWER SUBANSIRI,2021-03-26,0,1,0,1
ARUNACHAL PRADESH,LOWER SUBANSIRI,2021-03-28,0,40,0,40
ARUNACHAL PRADESH,LOWER SUBANSIRI,2021-03-29,0,1,0,1
ARUNACHAL PRADESH,LOWER SUBANSIRI,2021-03-30,0,10,0,10
ARUNACHAL PRADESH,NAMSAI,2021-03-26,0,1,0,1
ARUNACHAL PRADESH,NAMSAI,2021-03-29,0,2,0,2
ARUNACHAL PRADESH,NAMSAI,2021-03-30,0,1,0,1
ARUNACHAL PRADESH,PAKKE KESSANG,2021-03-28,0,1,0,1
ARUNACHAL PRADESH,PAPUM PARE,2021-03-26,0,8,0,8
ARUNACHAL PRADESH,PAPUM PARE,2021-03-27,0,8,0,8
ARUNACHAL PRADESH,PAPUM PARE,2021-03-28,0,2,0,2
ARUNACHAL PRADESH,PAPUM PARE,2021-03-29,0,7,1,8
ARUNACHAL PRADESH,PAPUM PARE,2021-03-30,0,13,0,13
ARUNACHAL PRADESH,SIANG,2021-03-26,0,1,0,1
ARUNACHAL PRADESH,TAWANG,2021-03-26,0,2,0,2
ARUNACHAL PRADESH,TAWANG,2021-03-27,0,1,0,1
ARUNACHAL PRADESH,TAWANG,2021-03-28,0,1,0,1
ARUNACHAL PRADESH,UPPER SIANG,2021-03-27,0,1,0,1
ARUNACHAL PRADESH,UPPER SUBANSIRI,2021-03-30,0,4,0,4
ARUNACHAL PRADESH,WEST KAMENG,2021-03-26,0,102,0,102
ARUNACHAL PRADESH,WEST KAMENG,2021-03-27,0,38,0,38
ARUNACHAL PRADESH,WEST KAMENG,2021-03-28,0,1,0,1
ARUNACHAL PRADESH,WEST KAMENG,2021-03-30,16,21,0,37
ARUNACHAL PRADESH,WEST SIANG,2021-03-27,0,2,0,2
ARUNACHAL PRADESH,WEST SIANG,2021-03-30,0,3,0,3
ASSAM,BAKSA,2021-03-26,0,40,0,40
ASSAM,BAKSA,2021-03-27,0,48,0,48
ASSAM,BAKSA,2021-03-28,0,3,0,3
ASSAM,BAKSA,2021-03-29,0,19,0,19
ASSAM,BAKSA,2021-03-30,0,32,0,32
ASSAM,BARPETA,2021-03-26,0,247,0,247
ASSAM,BARPETA,2021-03-27,0,253,0,253
ASSAM,BARPETA,2021-03-28,0,5,0,5
ASSAM,BARPETA,2021-03-29,0,23,0,23
ASSAM,BARPETA,2021-03-30,0,300,0,300
ASSAM,BISWANATH,2021-03-26,0,127,0,127
ASSAM,BISWANATH,2021-03-27,1,5,0,6
ASSAM,BISWANATH,2021-03-28,0,4,0,4
ASSAM,BISWANATH,2021-03-29,0,29,0,29
ASSAM,BISWANATH,2021-03-30,0,53,0,53
ASSAM,BONGAIGAON,2021-03-26,1,130,0,131
ASSAM,BONGAIGAON,2021-03-27,4,81,0,85
ASSAM,BONGAIGAON,2021-03-28,2,20,0,22
ASSAM,BONGAIGAON,2021-03-29,3,12,0,15
ASSAM,BONGAIGAON,2021-03-30,1,61,0,62
ASSAM,CACHAR,2021-03-26,0,4596,29,4625
ASSAM,CACHAR,2021-03-27,2,146,42,190
ASSAM,CACHAR,2021-03-28,2,93,0,95
ASSAM,CACHAR,2021-03-29,1,63,7,71
ASSAM,CACHAR,2021-03-30,0,3353,43,3396
ASSAM,CHARAIDEO,2021-03-26,0,104,0,104
ASSAM,CHARAIDEO,2021-03-27,0,7,0,7
ASSAM,CHARAIDEO,2021-03-28,0,12,0,12
ASSAM,CHARAIDEO,2021-03-29,0,13,0,13
ASSAM,CHARAIDEO,2021-03-30,0,48,0,48
ASSAM,CHIRANG,2021-03-26,0,29,0,29
ASSAM,CHIRANG,2021-03-27,0,35,0,35
ASSAM,CHIRANG,2021-03-28,0,7,0,7
ASSAM,CHIRANG,2021-03-29,0,8,0,8
ASSAM,CHIRANG,2021-03-30,1,71,0,72
ASSAM,DARRANG,2021-03-26,0,360,0,360
ASSAM,DARRANG,2021-03-27,0,306,0,306
ASSAM,DARRANG,2021-03-28,0,122,0,122
ASSAM,DARRANG,2021-03-29,0,302,0,302
ASSAM,DARRANG,2021-03-30,0,369,0,369
ASSAM,DHEMAJI,2021-03-26,0,37,0,37
ASSAM,DHEMAJI,2021-03-27,0,11,0,11
ASSAM,DHEMAJI,2021-03-28,0,28,0,28
ASSAM,DHEMAJI,2021-03-29,0,37,0,37
ASSAM,DHEMAJI,2021-03-30,0,22,0,22
ASSAM,DHUBRI,2021-03-26,0,170,6,176
ASSAM,DHUBRI,2021-03-27,0,228,0,228
ASSAM,DHUBRI,2021-03-28,3,77,0,80
ASSAM,DHUBRI,2021-03-29,3,110,0,113
ASSAM,DHUBRI,2021-03-30,0,180,0,180
ASSAM,DIBRUGARH,2021-03-26,14,174,3,191
ASSAM,DIBRUGARH,2021-03-27,2,52,0,54
ASSAM,DIBRUGARH,2021-03-28,2,106,1,109
ASSAM,DIBRUGARH,2021-03-29,2,122,1,125
ASSAM,DIBRUGARH,2021-03-30,9,178,0,187
ASSAM,DIMA HASAO,2021-03-26,0,19,0,19
ASSAM,DIMA HASAO,2021-03-27,0,25,0,25
ASSAM,DIMA HASAO,2021-03-28,0,7,0,7
ASSAM,DIMA HASAO,2021-03-29,0,33,0,33
ASSAM,DIMA HASAO,2021-03-30,0,13,0,13
ASSAM,GOALPARA,2021-03-26,0,213,0,213
ASSAM,GOALPARA,2021-03-27,0,229,0,229
ASSAM,GOALPARA,2021-03-28,0,47,0,47
ASSAM,GOALPARA,2021-03-29,0,112,0,112
ASSAM,GOALPARA,2021-03-30,0,220,0,220
ASSAM,GOLAGHAT,2021-03-26,1,113,0,114
ASSAM,GOLAGHAT,2021-03-27,0,37,0,37
ASSAM,GOLAGHAT,2021-03-28,0,27,0,27
ASSAM,GOLAGHAT,2021-03-29,0,150,0,150
ASSAM,GOLAGHAT,2021-03-30,1,83,0,84
ASSAM,HAILAKANDI,2021-03-26,1,357,0,358
ASSAM,HAILAKANDI,2021-03-27,0,276,0,276
ASSAM,HAILAKANDI,2021-03-28,0,56,0,56
ASSAM,HAILAKANDI,2021-03-29,0,158,0,158
ASSAM,HAILAKANDI,2021-03-30,1,279,3,283
ASSAM,HOJAI,2021-03-26,0,143,0,143
ASSAM,HOJAI,2021-03-27,1,102,0,103
ASSAM,HOJAI,2021-03-28,0,22,0,22
ASSAM,HOJAI,2021-03-29,0,42,0,42
ASSAM,HOJAI,2021-03-30,3,221,1,225
ASSAM,JORHAT,2021-03-26,8,422,1,431
ASSAM,JORHAT,2021-03-27,0,77,0,77
ASSAM,JORHAT,2021-03-28,0,64,0,64
ASSAM,JORHAT,2021-03-29,0,93,0,93
ASSAM,JORHAT,2021-03-30,0,216,0,216
ASSAM,KAMRUP,2021-03-26,4,478,1,483
ASSAM,KAMRUP,2021-03-27,1,532,0,533
ASSAM,KAMRUP,2021-03-28,3,415,0,418
ASSAM,KAMRUP,2021-03-29,1,193,0,194
ASSAM,KAMRUP,2021-03-30,11,524,0,535
ASSAM,KAMRUP METRO,2021-03-26,15,2025,1,2041
ASSAM,KAMRUP METRO,2021-03-27,22,1540,0,1562
ASSAM,KAMRUP METRO,2021-03-28,14,799,1,814
ASSAM,KAMRUP METRO,2021-03-29,22,724,0,746
ASSAM,KAMRUP METRO,2021-03-30,38,1600,1,1639
ASSAM,KARBI ANGLONG,2021-03-26,0,20,0,20
ASSAM,KARBI ANGLONG,2021-03-27,0,8,0,8
ASSAM,KARBI ANGLONG,2021-03-28,1,4,0,5
ASSAM,KARBI ANGLONG,2021-03-29,0,9,0,9
ASSAM,KARBI ANGLONG,2021-03-30,0,5,0,5
ASSAM,KARIMGANJ,2021-03-26,2,228,0,230
ASSAM,KARIMGANJ,2021-03-27,4,156,0,160
ASSAM,KARIMGANJ,2021-03-28,0,36,0,36
ASSAM,KARIMGANJ,2021-03-29,0,69,0,69
ASSAM,KARIMGANJ,2021-03-30,1,135,0,136
ASSAM,KOKRAJHAR,2021-03-26,0,22,0,22
ASSAM,KOKRAJHAR,2021-03-27,0,20,0,20
ASSAM,KOKRAJHAR,2021-03-28,0,5,0,5
ASSAM,KOKRAJHAR,2021-03-29,0,23,0,23
ASSAM,KOKRAJHAR,2021-03-30,0,88,0,88
ASSAM,LAKHIMPUR,2021-03-26,1,113,0,114
ASSAM,LAKHIMPUR,2021-03-27,0,50,0,50
ASSAM,LAKHIMPUR,2021-03-28,0,146,0,146
ASSAM,LAKHIMPUR,2021-03-29,0,187,0,187
ASSAM,LAKHIMPUR,2021-03-30,0,218,0,218
ASSAM,MAJULI,2021-03-26,0,12,0,12
ASSAM,MAJULI,2021-03-27,0,3,0,3
ASSAM,MAJULI,2021-03-28,0,4,0,4
ASSAM,MAJULI,2021-03-29,0,9,0,9
ASSAM,MAJULI,2021-03-30,0,9,0,9
ASSAM,MARIGAON,2021-03-26,1,59,0,60
ASSAM,MARIGAON,2021-03-27,1,42,0,43
ASSAM,MARIGAON,2021-03-28,0,4,0,4
ASSAM,MARIGAON,2021-03-29,0,40,0,40
ASSAM,MARIGAON,2021-03-30,0,106,0,106
ASSAM,NAGAON,2021-03-26,1,718,0,719
ASSAM,NAGAON,2021-03-27,4,132,0,136
ASSAM,NAGAON,2021-03-28,3,62,0,65
ASSAM,NAGAON,2021-03-29,0,77,0,77
ASSAM,NAGAON,2021-03-30,2,288,1,291
ASSAM,NALBARI,2021-03-26,0,116,0,116
ASSAM,NALBARI,2021-03-27,0,23,0,23
ASSAM,NALBARI,2021-03-28,0,3,0,3
ASSAM,NALBARI,2021-03-29,0,24,0,24
ASSAM,NALBARI,2021-03-30,0,62,0,62
ASSAM,SIVASAGAR,2021-03-26,1,174,0,175
ASSAM,SIVASAGAR,2021-03-27,1,11,0,12
ASSAM,SIVASAGAR,2021-03-28,0,10,0,10
ASSAM,SIVASAGAR,2021-03-29,1,20,0,21
ASSAM,SIVASAGAR,2021-03-30,1,105,0,106
ASSAM,SONITPUR,2021-03-26,3,333,0,336
ASSAM,SONITPUR,2021-03-27,1,32,0,33
ASSAM,SONITPUR,2021-03-28,0,79,0,79
ASSAM,SONITPUR,2021-03-29,0,38,0,38
ASSAM,SONITPUR,2021-03-30,1,187,0,188
ASSAM,SOUTH SALMARA MANCACHAR,2021-03-26,0,5,0,5
ASSAM,SOUTH SALMARA MANCACHAR,2021-03-27,0,14,0,14
ASSAM,SOUTH SALMARA MANCACHAR,2021-03-28,0,2,0,2
ASSAM,SOUTH SALMARA MANCACHAR,2021-03-29,0,10,0,10
ASSAM,SOUTH SALMARA MANCACHAR,2021-03-30,0,20,0,20
ASSAM,TINSUKIA,2021-03-26,0,78,1,79
ASSAM,TINSUKIA,2021-03-27,0,12,0,12
ASSAM,TINSUKIA,2021-03-28,1,44,0,45
ASSAM,TINSUKIA,2021-03-29,2,49,0,51
ASSAM,TINSUKIA,2021-03-30,1,151,0,152
ASSAM,UDALGURI,2021-03-26,0,10,0,10
ASSAM,UDALGURI,2021-03-27,0,5,0,5
ASSAM,UDALGURI,2021-03-28,0,5,0,5
ASSAM,UDALGURI,2021-03-29,1,6,0,7
ASSAM,UDALGURI,2021-03-30,0,12,0,12
ASSAM,WEST KARBI ANGLONG,2021-03-26,0,5,0,5
ASSAM,WEST KARBI ANGLONG,2021-03-27,0,12,0,12
ASSAM,WEST KARBI ANGLONG,2021-03-28,0,1,0,1
ASSAM,WEST KARBI ANGLONG,2021-03-30,0,7,0,7
BIHAR,ARARIA,2021-03-26,4,649,0,653
BIHAR,ARARIA,2021-03-27,20,1527,0,1547
BIHAR,ARARIA,2021-03-28,5,1157,0,1162
BIHAR,ARARIA,2021-03-29,2,428,0,430
BIHAR,ARARIA,2021-03-30,4,1732,0,1736
BIHAR,ARWAL,2021-03-26,1,1093,13,1107
BIHAR,ARWAL,2021-03-27,1,348,36,385
BIHAR,ARWAL,2021-03-28,3,317,0,320
BIHAR,ARWAL,2021-03-29,1,7,0,8
BIHAR,ARWAL,2021-03-30,2,520,0,522
BIHAR,AURANGABAD,2021-03-26,2,2904,2,2908
BIHAR,AURANGABAD,2021-03-27,0,341,3,344
BIHAR,AURANGABAD,2021-03-28,0,460,0,460
BIHAR,AURANGABAD,2021-03-29,0,97,0,97
BIHAR,AURANGABAD,2021-03-30,4,369,0,373
BIHAR,BANKA,2021-03-26,1,342,34,377
BIHAR,BANKA,2021-03-27,4,515,2,521
BIHAR,BANKA,2021-03-28,1,1950,37,1988
BIHAR,BANKA,2021-03-29,10,934,7,951
BIHAR,BANKA,2021-03-30,2,1990,81,2073
BIHAR,BEGUSARAI,2021-03-26,7,998,0,1005
BIHAR,BEGUSARAI,2021-03-27,2,2413,0,2415
BIHAR,BEGUSARAI,2021-03-28,3,356,0,359
BIHAR,BEGUSARAI,2021-03-29,3,457,0,460
BIHAR,BEGUSARAI,2021-03-30,3,1900,0,1903
BIHAR,BHAGALPUR,2021-03-26,6,474,90,570
BIHAR,BHAGALPUR,2021-03-27,33,1118,332,1483
BIHAR,BHAGALPUR,2021-03-28,24,1874,0,1898
BIHAR,BHAGALPUR,2021-03-29,19,592,55,666
BIHAR,BHAGALPUR,2021-03-30,8,3451,60,3519
BIHAR,BHOJPUR,2021-03-26,4,2173,56,2233
BIHAR,BHOJPUR,2021-03-27,2,1790,154,1946
BIHAR,BHOJPUR,2021-03-28,4,1355,218,1577
BIHAR,BHOJPUR,2021-03-29,1,1477,6,1484
BIHAR,BHOJPUR,2021-03-30,8,1030,12,1050
BIHAR,BUXAR,2021-03-26,3,2368,32,2403
BIHAR,BUXAR,2021-03-27,2,961,1,964
BIHAR,BUXAR,2021-03-28,5,346,10,361
BIHAR,BUXAR,2021-03-29,2,778,0,780
BIHAR,BUXAR,2021-03-30,10,1721,0,1731
BIHAR,DARBHANGA,2021-03-26,4,1047,199,1250
BIHAR,DARBHANGA,2021-03-27,9,1078,102,1189
BIHAR,DARBHANGA,2021-03-28,7,1249,125,1381
BIHAR,DARBHANGA,2021-03-29,2,66,0,68
BIHAR,DARBHANGA,2021-03-30,7,1383,1,1391
BIHAR,GAYA,2021-03-26,10,2786,14,2810
BIHAR,GAYA,2021-03-27,15,2441,13,2469
BIHAR,GAYA,2021-03-28,7,704,4,715
BIHAR,GAYA,2021-03-29,1,550,14,565
BIHAR,GAYA,2021-03-30,15,2163,3,2181
BIHAR,GOPALGANJ,2021-03-26,2,2181,10,2193
BIHAR,GOPALGANJ,2021-03-27,3,430,17,450
BIHAR,GOPALGANJ,2021-03-28,3,713,1,717
BIHAR,GOPALGANJ,2021-03-29,0,157,0,157
BIHAR,GOPALGANJ,2021-03-30,1,354,27,382
BIHAR,JAMUI,2021-03-26,0,110,0,110
BIHAR,JAMUI,2021-03-27,3,331,4,338
BIHAR,JAMUI,2021-03-28,1,615,1,617
BIHAR,JAMUI,2021-03-29,0,165,1,166
BIHAR,JAMUI,2021-03-30,0,117,0,117
BIHAR,JEHANABAD,2021-03-26,9,546,16,571
BIHAR,JEHANABAD,2021-03-27,13,1031,2,1046
BIHAR,JEHANABAD,2021-03-28,6,1173,2,1181
BIHAR,JEHANABAD,2021-03-29,11,933,0,944
BIHAR,JEHANABAD,2021-03-30,11,635,5,651
BIHAR,KAIMUR (BHABUA),2021-03-26,0,1323,0,1323
BIHAR,KAIMUR (BHABUA),2021-03-27,1,801,1,803
BIHAR,KAIMUR (BHABUA),2021-03-28,3,841,0,844
BIHAR,KAIMUR (BHABUA),2021-03-29,0,48,0,48
BIHAR,KAIMUR (BHABUA),2021-03-30,2,1884,0,1886
BIHAR,KATIHAR,2021-03-26,3,1163,0,1166
BIHAR,KATIHAR,2021-03-27,7,1476,0,1483
BIHAR,KATIHAR,2021-03-28,1,555,1,557
BIHAR,KATIHAR,2021-03-29,8,674,0,682
BIHAR,KATIHAR,2021-03-30,0,742,0,742
BIHAR,KHAGARIA,2021-03-26,0,942,0,942
BIHAR,KHAGARIA,2021-03-27,0,934,0,934
BIHAR,KHAGARIA,2021-03-28,3,916,1,920
BIHAR,KHAGARIA,2021-03-29,0,12,0,12
BIHAR,KHAGARIA,2021-03-30,1,989,0,990
BIHAR,KISHANGANJ,2021-03-26,4,968,0,972
BIHAR,KISHANGANJ,2021-03-27,1,780,0,781
BIHAR,KISHANGANJ,2021-03-28,4,870,220,1094
BIHAR,KISHANGANJ,2021-03-29,2,272,0,274
BIHAR,KISHANGANJ,2021-03-30,3,1616,0,1619
BIHAR,LAKHISARAI,2021-03-26,3,398,0,401
BIHAR,LAKHISARAI,2021-03-27,0,321,0,321
BIHAR,LAKHISARAI,2021-03-28,1,72,0,73
BIHAR,LAKHISARAI,2021-03-29,0,3,0,3
BIHAR,LAKHISARAI,2021-03-30,0,837,0,837
BIHAR,MADHEPURA,2021-03-26,0,445,0,445
BIHAR,MADHEPURA,2021-03-27,4,781,0,785
BIHAR,MADHEPURA,2021-03-28,2,472,9,483
BIHAR,MADHEPURA,2021-03-29,1,107,0,108
BIHAR,MADHEPURA,2021-03-30,2,749,0,751
BIHAR,MADHUBANI,2021-03-26,7,1959,4,1970
BIHAR,MADHUBANI,2021-03-27,10,1228,41,1279
BIHAR,MADHUBANI,2021-03-28,16,538,8,562
BIHAR,MADHUBANI,2021-03-29,1,170,0,171
BIHAR,MADHUBANI,2021-03-30,6,1637,5,1648
BIHAR,MUNGER,2021-03-26,3,1041,3,1047
BIHAR,MUNGER,2021-03-27,10,968,35,1013
BIHAR,MUNGER,2021-03-28,3,778,0,781
BIHAR,MUNGER,2021-03-29,4,632,0,636
BIHAR,MUNGER,2021-03-30,8,283,56,347
BIHAR,MUZAFFARPUR,2021-03-26,10,944,27,981
BIHAR,MUZAFFARPUR,2021-03-27,5,2068,0,2073
BIHAR,MUZAFFARPUR,2021-03-28,2,663,0,665
BIHAR,MUZAFFARPUR,2021-03-29,7,665,3,675
BIHAR,MUZAFFARPUR,2021-03-30,17,1394,0,1411
BIHAR,NALANDA,2021-03-26,5,2221,0,2226
BIHAR,NALANDA,2021-03-27,6,2532,1,2539
BIHAR,NALANDA,2021-03-28,4,2297,0,2301
BIHAR,NALANDA,2021-03-29,0,367,0,367
BIHAR,NALANDA,2021-03-30,11,1763,1,1775
BIHAR,NAWADA,2021-03-26,4,680,0,684
BIHAR,NAWADA,2021-03-27,6,1605,0,1611
BIHAR,NAWADA,2021-03-28,0,234,0,234
BIHAR,NAWADA,2021-03-29,0,34,1,35
BIHAR,NAWADA,2021-03-30,0,856,0,856
BIHAR,PASHCHIM CHAMPARAN,2021-03-26,3,1120,0,1123
BIHAR,PASHCHIM CHAMPARAN,2021-03-27,6,1469,69,1544
BIHAR,PASHCHIM CHAMPARAN,2021-03-28,2,492,0,494
BIHAR,PASHCHIM CHAMPARAN,2021-03-29,1,82,0,83
BIHAR,PASHCHIM CHAMPARAN,2021-03-30,18,686,0,704
BIHAR,PATNA,2021-03-26,96,2483,5,2584
BIHAR,PATNA,2021-03-27,172,2107,4,2283
BIHAR,PATNA,2021-03-28,151,2373,7,2531
BIHAR,PATNA,2021-03-29,18,746,0,764
BIHAR,PATNA,2021-03-30,108,1888,16,2012
BIHAR,PURBI CHAMPARAN,2021-03-26,5,1552,0,1557
BIHAR,PURBI CHAMPARAN,2021-03-27,4,709,3,716
BIHAR,PURBI CHAMPARAN,2021-03-28,0,1920,41,1961
BIHAR,PURBI CHAMPARAN,2021-03-29,0,1044,0,1044
BIHAR,PURBI CHAMPARAN,2021-03-30,5,2013,17,2035
BIHAR,PURNIA,2021-03-26,3,810,204,1017
BIHAR,PURNIA,2021-03-27,2,1449,336,1787
BIHAR,PURNIA,2021-03-28,4,1047,222,1273
BIHAR,PURNIA,2021-03-29,3,65,1,69
BIHAR,PURNIA,2021-03-30,8,586,0,594
BIHAR,ROHTAS,2021-03-26,8,1828,0,1836
BIHAR,ROHTAS,2021-03-27,7,2681,0,2688
BIHAR,ROHTAS,2021-03-28,0,819,0,819
BIHAR,ROHTAS,2021-03-29,0,37,0,37
BIHAR,ROHTAS,2021-03-30,2,1542,146,1690
BIHAR,SAHARSA,2021-03-26,4,294,1,299
BIHAR,SAHARSA,2021-03-27,5,325,0,330
BIHAR,SAHARSA,2021-03-28,1,503,0,504
BIHAR,SAHARSA,2021-03-29,1,639,0,640
BIHAR,SAHARSA,2021-03-30,1,848,0,849
BIHAR,SAMASTIPUR,2021-03-26,5,1968,20,1993
BIHAR,SAMASTIPUR,2021-03-27,8,1224,56,1288
BIHAR,SAMASTIPUR,2021-03-28,1,509,133,643
BIHAR,SAMASTIPUR,2021-03-29,2,164,0,166
BIHAR,SAMASTIPUR,2021-03-30,1,1771,30,1802
BIHAR,SARAN,2021-03-26,8,1003,0,1011
BIHAR,SARAN,2021-03-27,7,598,2,607
BIHAR,SARAN,2021-03-28,8,971,1,980
BIHAR,SARAN,2021-03-29,3,1049,5,1057
BIHAR,SARAN,2021-03-30,13,2014,1,2028
BIHAR,SHEIKHPURA,2021-03-26,0,300,4,304
BIHAR,SHEIKHPURA,2021-03-27,0,371,10,381
BIHAR,SHEIKHPURA,2021-03-28,0,3,0,3
BIHAR,SHEIKHPURA,2021-03-29,0,4,0,4
BIHAR,SHEIKHPURA,2021-03-30,1,62,0,63
BIHAR,SHEOHAR,2021-03-26,0,520,0,520
BIHAR,SHEOHAR,2021-03-27,0,691,0,691
BIHAR,SHEOHAR,2021-03-28,0,525,0,525
BIHAR,SHEOHAR,2021-03-29,0,1083,0,1083
BIHAR,SHEOHAR,2021-03-30,0,894,0,894
BIHAR,SITAMARHI,2021-03-26,2,1273,4,1279
BIHAR,SITAMARHI,2021-03-27,6,932,4,942
BIHAR,SITAMARHI,2021-03-28,7,765,1,773
BIHAR,SITAMARHI,2021-03-29,2,1043,0,1045
BIHAR,SITAMARHI,2021-03-30,0,512,0,512
BIHAR,SIWAN,2021-03-26,8,1111,0,1119
BIHAR,SIWAN,2021-03-27,13,1578,2,1593
BIHAR,SIWAN,2021-03-28,15,1222,0,1237
BIHAR,SIWAN,2021-03-29,11,258,0,269
BIHAR,SIWAN,2021-03-30,3,753,23,779
BIHAR,SUPAUL,2021-03-26,4,975,0,979
BIHAR,SUPAUL,2021-03-27,1,683,55,739
BIHAR,SUPAUL,2021-03-28,2,1251,51,1304
BIHAR,SUPAUL,2021-03-29,0,422,18,440
BIHAR,SUPAUL,2021-03-30,5,1017,19,1041
BIHAR,VAISHALI,2021-03-26,1,433,0,434
BIHAR,VAISHALI,2021-03-27,4,921,7,932
BIHAR,VAISHALI,2021-03-28,3,694,1,698
BIHAR,VAISHALI,2021-03-29,0,72,0,72
BIHAR,VAISHALI,2021-03-30,3,964,0,967
CHANDIGARH,CHANDIGARH,2021-03-26,402,1233,9,1644
CHANDIGARH,CHANDIGARH,2021-03-27,350,2482,23,2855
CHANDIGARH,CHANDIGARH,2021-03-28,309,1549,11,1869
CHANDIGARH,CHANDIGARH,2021-03-29,307,1438,9,1754
CHANDIGARH,CHANDIGARH,2021-03-30,309,1259,5,1573
CHHATTISGARH,BALOD,2021-03-26,56,1521,0,1577
CHHATTISGARH,BALOD,2021-03-27,74,1612,0,1686
CHHATTISGARH,BALOD,2021-03-28,45,1069,2,1116
CHHATTISGARH,BALOD,2021-03-29,30,626,0,656
CHHATTISGARH,BALOD,2021-03-30,130,1198,0,1328
CHHATTISGARH,BALODA BAZAR,2021-03-26,57,1042,10,1109
CHHATTISGARH,BALODA BAZAR,2021-03-27,47,648,3,698
CHHATTISGARH,BALODA BAZAR,2021-03-28,39,211,1,251
CHHATTISGARH,BALODA BAZAR,2021-03-29,7,18,1,26
CHHATTISGARH,BALODA BAZAR,2021-03-30,69,439,0,508
CHHATTISGARH,BALRAMPUR,2021-03-26,1,464,1,466
CHHATTISGARH,BALRAMPUR,2021-03-27,3,568,0,571
CHHATTISGARH,BALRAMPUR,2021-03-28,3,142,0,145
CHHATTISGARH,BALRAMPUR,2021-03-29,8,34,0,42
CHHATTISGARH,BALRAMPUR,2021-03-30,14,552,2,568
CHHATTISGARH,BASTAR,2021-03-26,23,1407,0,1430
CHHATTISGARH,BASTAR,2021-03-27,16,2017,0,2033
CHHATTISGARH,BASTAR,2021-03-28,50,1041,0,1091
CHHATTISGARH,BASTAR,2021-03-29,9,40,0,49
CHHATTISGARH,BASTAR,2021-03-30,43,1118,0,1161
CHHATTISGARH,BEMETARA,2021-03-26,95,680,0,775
CHHATTISGARH,BEMETARA,2021-03-27,139,460,2,601
CHHATTISGARH,BEMETARA,2021-03-28,65,230,4,299
CHHATTISGARH,BEMETARA,2021-03-29,28,70,0,98
CHHATTISGARH,BEMETARA,2021-03-30,201,267,1,469
CHHATTISGARH,BIJAPUR,2021-03-26,5,897,0,902
CHHATTISGARH,BIJAPUR,2021-03-27,1,495,2,498
CHHATTISGARH,BIJAPUR,2021-03-28,3,159,0,162
CHHATTISGARH,BIJAPUR,2021-03-29,0,97,0,97
CHHATTISGARH,BIJAPUR,2021-03-30,1,705,0,706
CHHATTISGARH,BILASPUR,2021-03-26,117,2413,7,2537
CHHATTISGARH,BILASPUR,2021-03-27,142,2859,13,3014
CHHATTISGARH,BILASPUR,2021-03-28,114,1448,22,1584
CHHATTISGARH,BILASPUR,2021-03-29,98,319,6,423
CHHATTISGARH,BILASPUR,2021-03-30,211,2327,5,2543
CHHATTISGARH,DANTEWADA,2021-03-26,2,217,0,219
CHHATTISGARH,DANTEWADA,2021-03-27,9,404,0,413
CHHATTISGARH,DANTEWADA,2021-03-28,5,209,0,214
CHHATTISGARH,DANTEWADA,2021-03-29,1,44,0,45
CHHATTISGARH,DANTEWADA,2021-03-30,7,331,0,338
CHHATTISGARH,DHAMTARI,2021-03-26,49,665,13,727
CHHATTISGARH,DHAMTARI,2021-03-27,48,1040,14,1102
CHHATTISGARH,DHAMTARI,2021-03-28,52,884,43,979
CHHATTISGARH,DHAMTARI,2021-03-29,5,135,2,142
CHHATTISGARH,DHAMTARI,2021-03-30,81,865,13,959
CHHATTISGARH,DURG,2021-03-26,1063,1598,8,2669
CHHATTISGARH,DURG,2021-03-27,1237,1798,66,3101
CHHATTISGARH,DURG,2021-03-28,760,793,16,1569
CHHATTISGARH,DURG,2021-03-29,432,289,0,721
CHHATTISGARH,DURG,2021-03-30,1004,1012,3,2019
CHHATTISGARH,GARIYABAND,2021-03-26,22,391,1,414
CHHATTISGARH,GARIYABAND,2021-03-27,19,293,7,319
CHHATTISGARH,GARIYABAND,2021-03-28,59,316,10,385
CHHATTISGARH,GARIYABAND,2021-03-29,0,8,0,8
CHHATTISGARH,GARIYABAND,2021-03-30,35,345,22,402
CHHATTISGARH,GAURELLA PENDRA MARWAHI,2021-03-26,9,761,0,770
CHHATTISGARH,GAURELLA PENDRA MARWAHI,2021-03-27,17,707,0,724
CHHATTISGARH,GAURELLA PENDRA MARWAHI,2021-03-28,5,436,0,441
CHHATTISGARH,GAURELLA PENDRA MARWAHI,2021-03-29,6,137,0,143
CHHATTISGARH,GAURELLA PENDRA MARWAHI,2021-03-30,13,151,0,164
CHHATTISGARH,JANJGIR CHAMPA,2021-03-26,17,1607,0,1624
CHHATTISGARH,JANJGIR CHAMPA,2021-03-27,32,1509,1,1542
CHHATTISGARH,JANJGIR CHAMPA,2021-03-28,25,1094,1,1120
CHHATTISGARH,JANJGIR CHAMPA,2021-03-29,2,189,0,191
CHHATTISGARH,JANJGIR CHAMPA,2021-03-30,66,1278,0,1344
CHHATTISGARH,JASHPUR,2021-03-26,46,665,1,712
CHHATTISGARH,JASHPUR,2021-03-27,58,432,0,490
CHHATTISGARH,JASHPUR,2021-03-28,43,280,1,324
CHHATTISGARH,JASHPUR,2021-03-29,34,246,4,284
CHHATTISGARH,JASHPUR,2021-03-30,29,128,1,158
CHHATTISGARH,KABIRDHAM,2021-03-26,15,336,0,351
CHHATTISGARH,KABIRDHAM,2021-03-27,31,381,3,415
CHHATTISGARH,KABIRDHAM,2021-03-28,21,57,0,78
CHHATTISGARH,KABIRDHAM,2021-03-29,12,4,0,16
CHHATTISGARH,KABIRDHAM,2021-03-30,56,327,0,383
CHHATTISGARH,KANKER,2021-03-26,25,1785,0,1810
CHHATTISGARH,KANKER,2021-03-27,21,1226,0,1247
CHHATTISGARH,KANKER,2021-03-28,20,1141,0,1161
CHHATTISGARH,KANKER,2021-03-29,18,189,0,207
CHHATTISGARH,KANKER,2021-03-30,47,622,0,669
CHHATTISGARH,KONDAGAON,2021-03-26,3,334,0,337
CHHATTISGARH,KONDAGAON,2021-03-27,22,283,0,305
CHHATTISGARH,KONDAGAON,2021-03-28,4,155,0,159
CHHATTISGARH,KONDAGAON,2021-03-29,0,210,0,210
CHHATTISGARH,KONDAGAON,2021-03-30,8,362,0,370
CHHATTISGARH,KORBA,2021-03-26,57,1862,0,1919
CHHATTISGARH,KORBA,2021-03-27,61,1806,11,1878
CHHATTISGARH,KORBA,2021-03-28,50,1429,6,1485
CHHATTISGARH,KORBA,2021-03-29,13,376,0,389
CHHATTISGARH,KORBA,2021-03-30,119,1983,0,2102
CHHATTISGARH,KOREA,2021-03-26,40,756,1,797
CHHATTISGARH,KOREA,2021-03-27,54,589,5,648
CHHATTISGARH,KOREA,2021-03-28,30,568,7,605
CHHATTISGARH,KOREA,2021-03-29,5,154,5,164
CHHATTISGARH,KOREA,2021-03-30,28,468,4,500
CHHATTISGARH,MAHASAMUND,2021-03-26,76,1078,12,1166
CHHATTISGARH,MAHASAMUND,2021-03-27,95,1785,6,1886
CHHATTISGARH,MAHASAMUND,2021-03-28,83,988,2,1073
CHHATTISGARH,MAHASAMUND,2021-03-29,27,463,3,493
CHHATTISGARH,MAHASAMUND,2021-03-30,151,1073,6,1230
CHHATTISGARH,MUNGELI,2021-03-26,6,474,1,481
CHHATTISGARH,MUNGELI,2021-03-27,11,506,1,518
CHHATTISGARH,MUNGELI,2021-03-28,20,335,2,357
CHHATTISGARH,MUNGELI,2021-03-29,0,1,0,1
CHHATTISGARH,MUNGELI,2021-03-30,29,234,0,263
CHHATTISGARH,NARAYANPUR,2021-03-26,2,180,0,182
CHHATTISGARH,NARAYANPUR,2021-03-27,4,270,0,274
CHHATTISGARH,NARAYANPUR,2021-03-28,2,269,0,271
CHHATTISGARH,NARAYANPUR,2021-03-29,0,7,0,7
CHHATTISGARH,NARAYANPUR,2021-03-30,1,111,0,112
CHHATTISGARH,RAIGARH,2021-03-26,24,1149,16,1189
CHHATTISGARH,RAIGARH,2021-03-27,36,852,8,896
CHHATTISGARH,RAIGARH,2021-03-28,34,522,1,557
CHHATTISGARH,RAIGARH,2021-03-29,7,45,0,52
CHHATTISGARH,RAIGARH,2021-03-30,74,959,18,1051
CHHATTISGARH,RAIPUR,2021-03-26,647,2233,49,2929
CHHATTISGARH,RAIPUR,2021-03-27,830,2110,63,3003
CHHATTISGARH,RAIPUR,2021-03-28,851,1288,58,2197
CHHATTISGARH,RAIPUR,2021-03-29,177,203,1,381
CHHATTISGARH,RAIPUR,2021-03-30,971,1600,55,2626
CHHATTISGARH,RAJNANDGAON,2021-03-26,211,2062,4,2277
CHHATTISGARH,RAJNANDGAON,2021-03-27,238,2299,4,2541
CHHATTISGARH,RAJNANDGAON,2021-03-28,209,1082,3,1294
CHHATTISGARH,RAJNANDGAON,2021-03-29,48,284,0,332
CHHATTISGARH,RAJNANDGAON,2021-03-30,320,935,95,1350
CHHATTISGARH,SUKMA,2021-03-26,4,199,0,203
CHHATTISGARH,SUKMA,2021-03-27,1,56,0,57
CHHATTISGARH,SUKMA,2021-03-28,0,289,0,289
CHHATTISGARH,SUKMA,2021-03-29,0,18,0,18
CHHATTISGARH,SUKMA,2021-03-30,2,48,0,50
CHHATTISGARH,SURAJPUR,2021-03-26,33,1093,10,1136
CHHATTISGARH,SURAJPUR,2021-03-27,54,678,9,741
CHHATTISGARH,SURAJPUR,2021-03-28,26,754,2,782
CHHATTISGARH,SURAJPUR,2021-03-29,7,119,0,126
CHHATTISGARH,SURAJPUR,2021-03-30,54,806,1,861
CHHATTISGARH,SURGUJA,2021-03-26,80,1701,5,1786
CHHATTISGARH,SURGUJA,2021-03-27,83,1663,3,1749
CHHATTISGARH,SURGUJA,2021-03-28,52,1076,4,1132
CHHATTISGARH,SURGUJA,2021-03-29,54,406,2,462
CHHATTISGARH,SURGUJA,2021-03-30,64,1035,2,1101
DADRA AND NAGAR HAVELI,DADRA AND NAGAR HAVELI,2021-03-26,23,351,1,375
DADRA AND NAGAR HAVELI,DADRA AND NAGAR HAVELI,2021-03-27,21,207,0,228
DADRA AND NAGAR HAVELI,DADRA AND NAGAR HAVELI,2021-03-28,12,129,1,142
DADRA AND NAGAR HAVELI,DADRA AND NAGAR HAVELI,2021-03-29,14,105,2,121
DADRA AND NAGAR HAVELI,DADRA AND NAGAR HAVELI,2021-03-30,12,250,0,262
DAMAN AND DIU,DAMAN,2021-03-26,7,212,0,219
DAMAN AND DIU,DAMAN,2021-03-27,8,233,0,241
DAMAN AND DIU,DAMAN,2021-03-28,8,225,0,233
DAMAN AND DIU,DAMAN,2021-03-29,8,219,0,227
DAMAN AND DIU,DAMAN,2021-03-30,0,77,0,77
DAMAN AND DIU,DIU,2021-03-26,0,3,0,3
DAMAN AND DIU,DIU,2021-03-27,1,60,0,61
DAMAN AND DIU,DIU,2021-03-28,0,14,0,14
DAMAN AND DIU,DIU,2021-03-29,0,38,0,38
DAMAN AND DIU,DIU,2021-03-30,0,27,0,27
DELHI,CENTRAL,2021-03-26,66,6964,14,7044
DELHI,CENTRAL,2021-03-27,76,6030,30,6136
DELHI,CENTRAL,2021-03-28,78,5175,6,5259
DELHI,CENTRAL,2021-03-29,49,4660,0,4709
DELHI,CENTRAL,2021-03-30,98,5570,13,5681
DELHI,EAST,2021-03-26,148,5547,30,5725
DELHI,EAST,2021-03-27,162,5041,5,5208
DELHI,EAST,2021-03-28,101,4511,14,4626
DELHI,EAST,2021-03-29,68,1684,1,1753
DELHI,EAST,2021-03-30,205,6670,23,6898
DELHI,NEW DELHI,2021-03-26,189,8901,15,9105
DELHI,NEW DELHI,2021-03-27,273,6065,11,6349
DELHI,NEW DELHI,2021-03-28,262,4733,14,5009
DELHI,NEW DELHI,2021-03-29,114,3125,1,3240
DELHI,NEW DELHI,2021-03-30,291,4409,11,4711
DELHI,NORTH,2021-03-26,111,8219,27,8357
DELHI,NORTH,2021-03-27,124,8075,19,8218
DELHI,NORTH,2021-03-28,184,5605,8,5797
DELHI,NORTH,2021-03-29,87,3198,8,3293
DELHI,NORTH,2021-03-30,137,5519,42,5698
DELHI,NORTH EAST,2021-03-26,46,6901,11,6958
DELHI,NORTH EAST,2021-03-27,41,3582,6,3629
DELHI,NORTH EAST,2021-03-28,45,6215,0,6260
DELHI,NORTH EAST,2021-03-29,33,1762,0,1795
DELHI,NORTH EAST,2021-03-30,54,3034,4,3092
DELHI,NORTH WEST,2021-03-26,252,8949,36,9237
DELHI,NORTH WEST,2021-03-27,293,10508,5,10806
DELHI,NORTH WEST,2021-03-28,404,6391,15,6810
DELHI,NORTH WEST,2021-03-29,107,1819,0,1926
DELHI,NORTH WEST,2021-03-30,296,9181,13,9490
DELHI,SHAHDARA,2021-03-26,60,7666,9,7735
DELHI,SHAHDARA,2021-03-27,68,5979,10,6057
DELHI,SHAHDARA,2021-03-28,75,4986,7,5068
DELHI,SHAHDARA,2021-03-29,48,2314,0,2362
DELHI,SHAHDARA,2021-03-30,70,6698,23,6791
DELHI,SOUTH,2021-03-26,332,10194,97,10623
DELHI,SOUTH,2021-03-27,359,7589,8,7956
DELHI,SOUTH,2021-03-28,131,6401,6,6538
DELHI,SOUTH,2021-03-29,83,4411,3,4497
DELHI,SOUTH,2021-03-30,222,5405,60,5687
DELHI,SOUTH EAST,2021-03-26,130,7041,8,7179
DELHI,SOUTH EAST,2021-03-27,108,5792,1,5901
DELHI,SOUTH EAST,2021-03-28,155,5623,2,5780
DELHI,SOUTH EAST,2021-03-29,130,3690,3,3823
DELHI,SOUTH EAST,2021-03-30,184,3855,7,4046
DELHI,SOUTH WEST,2021-03-26,150,8366,1,8517
DELHI,SOUTH WEST,2021-03-27,225,10083,1,10309
DELHI,SOUTH WEST,2021-03-28,278,7954,5,8237
DELHI,SOUTH WEST,2021-03-29,106,4985,0,5091
DELHI,SOUTH WEST,2021-03-30,199,7090,2,7291
DELHI,WEST,2021-03-26,187,10982,7,11176
DELHI,WEST,2021-03-27,286,9018,20,9324
DELHI,WEST,2021-03-28,308,9070,7,9385
DELHI,WEST,2021-03-29,197,4055,2,4254
DELHI,WEST,2021-03-30,276,7369,8,7653
GOA,NORTH GOA,2021-03-26,60,968,1,1029
GOA,NORTH GOA,2021-03-27,99,794,2,895
GOA,NORTH GOA,2021-03-28,71,775,6,852
GOA,NORTH GOA,2021-03-29,50,601,0,651
GOA,NORTH GOA,2021-03-30,95,748,0,843
GOA,SOUTH GOA,2021-03-26,69,1013,1,1083
GOA,SOUTH GOA,2021-03-27,111,1377,0,1488
GOA,SOUTH GOA,2021-03-28,60,714,0,774
GOA,SOUTH GOA,2021-03-29,49,667,0,716
GOA,SOUTH GOA,2021-03-30,104,740,2,846
GUJARAT,AHMADABAD,2021-03-26,639,8162,83,8884
GUJARAT,AHMADABAD,2021-03-27,778,10055,87,10920
GUJARAT,AHMADABAD,2021-03-28,662,11334,74,12070
GUJARAT,AHMADABAD,2021-03-29,426,12110,35,12571
GUJARAT,AHMADABAD,2021-03-30,784,13410,83,14277
GUJARAT,AMRELI,2021-03-26,17,1601,0,1618
GUJARAT,AMRELI,2021-03-27,18,1451,0,1469
GUJARAT,AMRELI,2021-03-28,49,1147,0,1196
GUJARAT,AMRELI,2021-03-29,11,496,0,507
GUJARAT,AMRELI,2021-03-30,35,1350,0,1385
GUJARAT,ANAND,2021-03-26,71,2086,14,2171
GUJARAT,ANAND,2021-03-27,59,2454,6,2519
GUJARAT,ANAND,2021-03-28,16,5956,0,5972
GUJARAT,ANAND,2021-03-29,54,3580,8,3642
GUJARAT,ANAND,2021-03-30,52,3704,2,3758
GUJARAT,ARVALLI,2021-03-26,47,4149,3,4199
GUJARAT,ARVALLI,2021-03-27,25,1330,0,1355
GUJARAT,ARVALLI,2021-03-28,11,509,0,520
GUJARAT,ARVALLI,2021-03-29,23,464,0,487
GUJARAT,ARVALLI,2021-03-30,23,653,0,676
GUJARAT,BANAS KANTHA,2021-03-26,19,642,1,662
GUJARAT,BANAS KANTHA,2021-03-27,14,573,0,587
GUJARAT,BANAS KANTHA,2021-03-28,13,167,0,180
GUJARAT,BANAS KANTHA,2021-03-29,6,74,0,80
GUJARAT,BANAS KANTHA,2021-03-30,24,761,0,785
GUJARAT,BHARUCH,2021-03-26,135,5485,7,5627
GUJARAT,BHARUCH,2021-03-27,131,5047,4,5182
GUJARAT,BHARUCH,2021-03-28,63,3131,3,3197
GUJARAT,BHARUCH,2021-03-29,22,685,0,707
GUJARAT,BHARUCH,2021-03-30,110,2568,44,2722
GUJARAT,BHAVNAGAR,2021-03-26,91,12814,0,12905
GUJARAT,BHAVNAGAR,2021-03-27,120,14726,0,14846
GUJARAT,BHAVNAGAR,2021-03-28,30,6146,1,6177
GUJARAT,BHAVNAGAR,2021-03-29,70,4627,0,4697
GUJARAT,BHAVNAGAR,2021-03-30,344,7254,2,7600
GUJARAT,BOTAD,2021-03-26,3,2314,0,2317
GUJARAT,BOTAD,2021-03-27,2,2354,0,2356
GUJARAT,BOTAD,2021-03-28,4,2222,0,2226
GUJARAT,BOTAD,2021-03-29,1,1870,0,1871
GUJARAT,BOTAD,2021-03-30,3,1325,0,1328
GUJARAT,CHHOTAUDEPUR,2021-03-26,16,555,1,572
GUJARAT,CHHOTAUDEPUR,2021-03-27,17,1137,3,1157
GUJARAT,CHHOTAUDEPUR,2021-03-28,2,532,0,534
GUJARAT,CHHOTAUDEPUR,2021-03-29,0,358,0,358
GUJARAT,CHHOTAUDEPUR,2021-03-30,9,422,0,431
GUJARAT,DANG,2021-03-26,2,1549,0,1551
GUJARAT,DANG,2021-03-27,2,1747,0,1749
GUJARAT,DANG,2021-03-28,1,242,0,243
GUJARAT,DANG,2021-03-29,0,400,0,400
GUJARAT,DANG,2021-03-30,0,348,0,348
GUJARAT,DEVBHUMI DWARKA,2021-03-26,9,2041,2,2052
GUJARAT,DEVBHUMI DWARKA,2021-03-27,14,1136,2,1152
GUJARAT,DEVBHUMI DWARKA,2021-03-28,26,312,2,340
GUJARAT,DEVBHUMI DWARKA,2021-03-29,16,173,0,189
GUJARAT,DEVBHUMI DWARKA,2021-03-30,48,682,0,730
GUJARAT,DOHAD,2021-03-26,45,11079,1,11125
GUJARAT,DOHAD,2021-03-27,30,9671,2,9703
GUJARAT,DOHAD,2021-03-28,26,4167,1,4194
GUJARAT,DOHAD,2021-03-29,11,2045,1,2057
GUJARAT,DOHAD,2021-03-30,98,2229,2,2329
GUJARAT,GANDHINAGAR,2021-03-26,51,7253,2,7306
GUJARAT,GANDHINAGAR,2021-03-27,80,5931,2,6013
GUJARAT,GANDHINAGAR,2021-03-28,53,2505,1,2559
GUJARAT,GANDHINAGAR,2021-03-29,74,3705,16,3795
GUJARAT,GANDHINAGAR,2021-03-30,140,5655,1,5796
GUJARAT,GIR SOMNATH,2021-03-26,56,6490,0,6546
GUJARAT,GIR SOMNATH,2021-03-27,23,4866,0,4889
GUJARAT,GIR SOMNATH,2021-03-28,6,995,0,1001
GUJARAT,GIR SOMNATH,2021-03-29,10,497,0,507
GUJARAT,GIR SOMNATH,2021-03-30,11,1430,0,1441
GUJARAT,JAMNAGAR,2021-03-26,47,1880,3,1930
GUJARAT,JAMNAGAR,2021-03-27,57,1908,6,1971
GUJARAT,JAMNAGAR,2021-03-28,46,602,3,651
GUJARAT,JAMNAGAR,2021-03-29,67,755,7,829
GUJARAT,JAMNAGAR,2021-03-30,111,1641,6,1758
GUJARAT,JUNAGADH,2021-03-26,42,13555,3,13600
GUJARAT,JUNAGADH,2021-03-27,19,8155,0,8174
GUJARAT,JUNAGADH,2021-03-28,14,1828,0,1842
GUJARAT,JUNAGADH,2021-03-29,5,790,0,795
GUJARAT,JUNAGADH,2021-03-30,11,3846,1,3858
GUJARAT,KACHCHH,2021-03-26,72,9195,3,9270
GUJARAT,KACHCHH,2021-03-27,53,12342,5,12400
GUJARAT,KACHCHH,2021-03-28,49,8658,5,8712
GUJARAT,KACHCHH,2021-03-29,13,6303,5,6321
GUJARAT,KACHCHH,2021-03-30,74,8927,1,9002
GUJARAT,KHEDA,2021-03-26,76,2075,12,2163
GUJARAT,KHEDA,2021-03-27,32,1737,7,1776
GUJARAT,KHEDA,2021-03-28,38,1149,6,1193
GUJARAT,KHEDA,2021-03-29,60,1137,17,1214
GUJARAT,KHEDA,2021-03-30,25,1698,3,1726
GUJARAT,MAHESANA,2021-03-26,57,2811,2,2870
GUJARAT,MAHESANA,2021-03-27,65,6536,4,6605
GUJARAT,MAHESANA,2021-03-28,48,6643,1,6692
GUJARAT,MAHESANA,2021-03-29,28,1476,2,1506
GUJARAT,MAHESANA,2021-03-30,38,2509,7,2554
GUJARAT,MAHISAGAR,2021-03-26,30,1855,42,1927
GUJARAT,MAHISAGAR,2021-03-27,50,2319,15,2384
GUJARAT,MAHISAGAR,2021-03-28,52,813,19,884
GUJARAT,MAHISAGAR,2021-03-29,23,297,0,320
GUJARAT,MAHISAGAR,2021-03-30,73,1136,0,1209
GUJARAT,MORBI,2021-03-26,47,6035,3,6085
GUJARAT,MORBI,2021-03-27,33,4028,0,4061
GUJARAT,MORBI,2021-03-28,37,2120,0,2157
GUJARAT,MORBI,2021-03-29,39,1386,9,1434
GUJARAT,MORBI,2021-03-30,50,1503,1,1554
GUJARAT,NARMADA,2021-03-26,56,1015,0,1071
GUJARAT,NARMADA,2021-03-27,48,534,0,582
GUJARAT,NARMADA,2021-03-28,28,141,2,171
GUJARAT,NARMADA,2021-03-29,42,131,0,173
GUJARAT,NARMADA,2021-03-30,45,273,0,318
GUJARAT,NAVSARI,2021-03-26,32,2617,9,2658
GUJARAT,NAVSARI,2021-03-27,30,3676,2,3708
GUJARAT,NAVSARI,2021-03-28,10,1069,2,1081
GUJARAT,NAVSARI,2021-03-29,11,567,0,578
GUJARAT,NAVSARI,2021-03-30,35,2053,2,2090
GUJARAT,PANCH MAHALS,2021-03-26,44,2471,29,2544
GUJARAT,PANCH MAHALS,2021-03-27,85,2831,2,2918
GUJARAT,PANCH MAHALS,2021-03-28,13,786,0,799
GUJARAT,PANCH MAHALS,2021-03-29,25,355,0,380
GUJARAT,PANCH MAHALS,2021-03-30,51,1097,2,1150
GUJARAT,PATAN,2021-03-26,51,867,3,921
GUJARAT,PATAN,2021-03-27,50,579,5,634
GUJARAT,PATAN,2021-03-28,20,205,1,226
GUJARAT,PATAN,2021-03-29,10,180,4,194
GUJARAT,PATAN,2021-03-30,53,648,5,706
GUJARAT,PORBANDAR,2021-03-26,3,2167,0,2170
GUJARAT,PORBANDAR,2021-03-27,2,3263,0,3265
GUJARAT,PORBANDAR,2021-03-28,1,2504,0,2505
GUJARAT,PORBANDAR,2021-03-29,3,1239,0,1242
GUJARAT,PORBANDAR,2021-03-30,3,1759,0,1762
GUJARAT,RAJKOT,2021-03-26,181,5874,0,6055
GUJARAT,RAJKOT,2021-03-27,208,5794,2,6004
GUJARAT,RAJKOT,2021-03-28,243,2933,3,3179
GUJARAT,RAJKOT,2021-03-29,183,1328,0,1511
GUJARAT,RAJKOT,2021-03-30,204,4568,0,4772
GUJARAT,SABAR KANTHA,2021-03-26,56,10841,6,10903
GUJARAT,SABAR KANTHA,2021-03-27,43,9262,7,9312
GUJARAT,SABAR KANTHA,2021-03-28,10,4507,0,4517
GUJARAT,SABAR KANTHA,2021-03-29,32,2510,14,2556
GUJARAT,SABAR KANTHA,2021-03-30,21,4197,2,4220
GUJARAT,SURAT,2021-03-26,687,14382,21,15090
GUJARAT,SURAT,2021-03-27,707,30123,3,30833
GUJARAT,SURAT,2021-03-28,468,20833,11,21312
GUJARAT,SURAT,2021-03-29,361,18222,4,18587
GUJARAT,SURAT,2021-03-30,881,45072,30,45983
GUJARAT,SURENDRANAGAR,2021-03-26,61,3754,0,3815
GUJARAT,SURENDRANAGAR,2021-03-27,50,4165,1,4216
GUJARAT,SURENDRANAGAR,2021-03-28,28,1633,1,1662
GUJARAT,SURENDRANAGAR,2021-03-29,46,1130,0,1176
GUJARAT,SURENDRANAGAR,2021-03-30,61,909,1,971
GUJARAT,TAPI,2021-03-26,50,363,5,418
GUJARAT,TAPI,2021-03-27,44,356,2,402
GUJARAT,TAPI,2021-03-28,37,127,13,177
GUJARAT,TAPI,2021-03-29,50,122,12,184
GUJARAT,TAPI,2021-03-30,50,251,20,321
GUJARAT,VADODARA,2021-03-26,239,8331,216,8786
GUJARAT,VADODARA,2021-03-27,304,7184,141,7629
GUJARAT,VADODARA,2021-03-28,208,2864,21,3093
GUJARAT,VADODARA,2021-03-29,261,1553,46,1860
GUJARAT,VADODARA,2021-03-30,357,3983,29,4369
GUJARAT,VALSAD,2021-03-26,61,2845,1,2907
GUJARAT,VALSAD,2021-03-27,50,1692,0,1742
GUJARAT,VALSAD,2021-03-28,34,1392,0,1426
GUJARAT,VALSAD,2021-03-29,27,1128,0,1155
GUJARAT,VALSAD,2021-03-30,49,1036,1,1086
HARYANA,AMBALA,2021-03-26,261,1084,66,1411
HARYANA,AMBALA,2021-03-27,133,983,62,1178
HARYANA,AMBALA,2021-03-28,244,1452,105,1801
HARYANA,AMBALA,2021-03-29,70,370,6,446
HARYANA,AMBALA,2021-03-30,104,493,30,627
HARYANA,BHIWANI,2021-03-26,2,231,0,233
HARYANA,BHIWANI,2021-03-27,11,122,0,133
HARYANA,BHIWANI,2021-03-28,2,61,0,63
HARYANA,BHIWANI,2021-03-29,0,23,0,23
HARYANA,BHIWANI,2021-03-30,6,388,0,394
HARYANA,CHARKI DADRI,2021-03-26,1,706,12,719
HARYANA,CHARKI DADRI,2021-03-27,5,501,0,506
HARYANA,CHARKI DADRI,2021-03-28,3,251,0,254
HARYANA,CHARKI DADRI,2021-03-29,0,1,0,1
HARYANA,CHARKI DADRI,2021-03-30,5,536,2,543
HARYANA,FARIDABAD,2021-03-26,112,1204,0,1316
HARYANA,FARIDABAD,2021-03-27,141,1614,1,1756
HARYANA,FARIDABAD,2021-03-28,138,1165,1,1304
HARYANA,FARIDABAD,2021-03-29,59,722,1,782
HARYANA,FARIDABAD,2021-03-30,91,1360,2,1453
HARYANA,FATEHABAD,2021-03-26,49,431,0,480
HARYANA,FATEHABAD,2021-03-27,10,348,0,358
HARYANA,FATEHABAD,2021-03-28,40,166,0,206
HARYANA,FATEHABAD,2021-03-29,9,36,0,45
HARYANA,FATEHABAD,2021-03-30,6,252,0,258
HARYANA,GURUGRAM,2021-03-26,336,5219,24,5579
HARYANA,GURUGRAM,2021-03-27,407,4870,23,5300
HARYANA,GURUGRAM,2021-03-28,375,4520,36,4931
HARYANA,GURUGRAM,2021-03-29,146,2068,28,2242
HARYANA,GURUGRAM,2021-03-30,335,3567,41,3943
HARYANA,HISAR,2021-03-26,38,1078,1,1117
HARYANA,HISAR,2021-03-27,30,729,0,759
HARYANA,HISAR,2021-03-28,31,668,0,699
HARYANA,HISAR,2021-03-29,8,79,0,87
HARYANA,HISAR,2021-03-30,25,995,1,1021
HARYANA,JHAJJAR,2021-03-26,14,579,1,594
HARYANA,JHAJJAR,2021-03-27,7,712,5,724
HARYANA,JHAJJAR,2021-03-28,17,754,0,771
HARYANA,JHAJJAR,2021-03-29,0,175,1,176
HARYANA,JHAJJAR,2021-03-30,19,902,0,921
HARYANA,JIND,2021-03-26,60,588,19,667
HARYANA,JIND,2021-03-27,54,919,1,974
HARYANA,JIND,2021-03-28,57,591,14,662
HARYANA,JIND,2021-03-29,5,25,0,30
HARYANA,JIND,2021-03-30,49,659,15,723
HARYANA,KAITHAL,2021-03-26,30,424,8,462
HARYANA,KAITHAL,2021-03-27,85,547,7,639
HARYANA,KAITHAL,2021-03-28,32,315,0,347
HARYANA,KAITHAL,2021-03-29,8,154,3,165
HARYANA,KAITHAL,2021-03-30,79,536,0,615
HARYANA,KARNAL,2021-03-26,217,609,2,828
HARYANA,KARNAL,2021-03-27,218,785,0,1003
HARYANA,KARNAL,2021-03-28,52,147,0,199
HARYANA,KARNAL,2021-03-29,19,173,0,192
HARYANA,KARNAL,2021-03-30,386,431,1,818
HARYANA,KURUKSHETRA,2021-03-26,90,862,17,969
HARYANA,KURUKSHETRA,2021-03-27,105,397,1,503
HARYANA,KURUKSHETRA,2021-03-28,143,397,9,549
HARYANA,KURUKSHETRA,2021-03-29,65,310,5,380
HARYANA,KURUKSHETRA,2021-03-30,89,877,24,990
HARYANA,MAHENDRAGARH,2021-03-26,7,367,1,375
HARYANA,MAHENDRAGARH,2021-03-27,8,194,0,202
HARYANA,MAHENDRAGARH,2021-03-28,1,332,0,333
HARYANA,MAHENDRAGARH,2021-03-29,0,12,0,12
HARYANA,MAHENDRAGARH,2021-03-30,1,385,1,387
HARYANA,NUH,2021-03-26,2,308,0,310
HARYANA,NUH,2021-03-27,2,247,0,249
HARYANA,NUH,2021-03-28,0,10,0,10
HARYANA,NUH,2021-03-29,0,1,0,1
HARYANA,NUH,2021-03-30,0,117,0,117
HARYANA,PALWAL,2021-03-26,0,64,0,64
HARYANA,PALWAL,2021-03-27,3,76,1,80
HARYANA,PALWAL,2021-03-28,2,92,0,94
HARYANA,PALWAL,2021-03-29,0,120,0,120
HARYANA,PALWAL,2021-03-30,0,318,0,318
HARYANA,PANCHKULA,2021-03-26,161,1820,5,1986
HARYANA,PANCHKULA,2021-03-27,361,2943,0,3304
HARYANA,PANCHKULA,2021-03-28,121,232,1,354
HARYANA,PANCHKULA,2021-03-29,251,1450,4,1705
HARYANA,PANCHKULA,2021-03-30,116,373,4,493
HARYANA,PANIPAT,2021-03-26,59,614,2,675
HARYANA,PANIPAT,2021-03-27,53,863,1,917
HARYANA,PANIPAT,2021-03-28,105,389,3,497
HARYANA,PANIPAT,2021-03-29,26,109,0,135
HARYANA,PANIPAT,2021-03-30,22,830,3,855
HARYANA,REWARI,2021-03-26,7,604,1,612
HARYANA,REWARI,2021-03-27,13,1344,2,1359
HARYANA,REWARI,2021-03-28,8,601,0,609
HARYANA,REWARI,2021-03-29,1,271,0,272
HARYANA,REWARI,2021-03-30,5,848,5,858
HARYANA,ROHTAK,2021-03-26,34,494,0,528
HARYANA,ROHTAK,2021-03-27,57,674,1,732
HARYANA,ROHTAK,2021-03-28,27,325,0,352
HARYANA,ROHTAK,2021-03-29,3,451,1,455
HARYANA,ROHTAK,2021-03-30,56,587,0,643
HARYANA,SIRSA,2021-03-26,21,641,20,682
HARYANA,SIRSA,2021-03-27,11,506,0,517
HARYANA,SIRSA,2021-03-28,4,210,0,214
HARYANA,SIRSA,2021-03-29,8,55,0,63
HARYANA,SIRSA,2021-03-30,23,886,0,909
HARYANA,SONIPAT,2021-03-26,53,770,2,825
HARYANA,SONIPAT,2021-03-27,62,654,4,720
HARYANA,SONIPAT,2021-03-28,40,124,0,164
HARYANA,SONIPAT,2021-03-29,45,127,2,174
HARYANA,SONIPAT,2021-03-30,23,1233,0,1256
HARYANA,YAMUNANAGAR,2021-03-26,72,552,2,626
HARYANA,YAMUNANAGAR,2021-03-27,176,577,2,755
HARYANA,YAMUNANAGAR,2021-03-28,188,153,0,341
HARYANA,YAMUNANAGAR,2021-03-29,103,140,1,244
HARYANA,YAMUNANAGAR,2021-03-30,54,661,0,715
HIMACHAL PRADESH,BILASPUR,2021-03-26,29,429,3,461
HIMACHAL PRADESH,BILASPUR,2021-03-27,40,339,4,383
HIMACHAL PRADESH,BILASPUR,2021-03-28,39,147,1,187
HIMACHAL PRADESH,BILASPUR,2021-03-29,2,70,0,72
HIMACHAL PRADESH,BILASPUR,2021-03-30,34,252,0,286
HIMACHAL PRADESH,CHAMBA,2021-03-26,5,683,20,708
HIMACHAL PRADESH,CHAMBA,2021-03-27,5,794,10,809
HIMACHAL PRADESH,CHAMBA,2021-03-28,1,303,2,306
HIMACHAL PRADESH,CHAMBA,2021-03-29,2,342,4,348
HIMACHAL PRADESH,CHAMBA,2021-03-30,5,401,0,406
HIMACHAL PRADESH,HAMIRPUR,2021-03-26,40,441,1,482
HIMACHAL PRADESH,HAMIRPUR,2021-03-27,26,430,0,456
HIMACHAL PRADESH,HAMIRPUR,2021-03-28,33,379,8,420
HIMACHAL PRADESH,HAMIRPUR,2021-03-29,21,197,1,219
HIMACHAL PRADESH,HAMIRPUR,2021-03-30,41,374,6,421
HIMACHAL PRADESH,KANGRA,2021-03-26,47,971,1,1019
HIMACHAL PRADESH,KANGRA,2021-03-27,44,1256,3,1303
HIMACHAL PRADESH,KANGRA,2021-03-28,54,814,0,868
HIMACHAL PRADESH,KANGRA,2021-03-29,40,359,1,400
HIMACHAL PRADESH,KANGRA,2021-03-30,96,1724,13,1833
HIMACHAL PRADESH,KINNAUR,2021-03-26,0,4,0,4
HIMACHAL PRADESH,KINNAUR,2021-03-27,2,115,1,118
HIMACHAL PRADESH,KINNAUR,2021-03-28,0,3,0,3
HIMACHAL PRADESH,KINNAUR,2021-03-29,0,3,0,3
HIMACHAL PRADESH,KINNAUR,2021-03-30,0,49,0,49
HIMACHAL PRADESH,KULLU,2021-03-26,1,107,2,110
HIMACHAL PRADESH,KULLU,2021-03-27,11,131,2,144
HIMACHAL PRADESH,KULLU,2021-03-28,2,27,7,36
HIMACHAL PRADESH,KULLU,2021-03-29,6,103,0,109
HIMACHAL PRADESH,KULLU,2021-03-30,10,127,2,139
HIMACHAL PRADESH,LAHUL AND SPITI,2021-03-26,0,1,0,1
HIMACHAL PRADESH,LAHUL AND SPITI,2021-03-27,0,1,0,1
HIMACHAL PRADESH,LAHUL AND SPITI,2021-03-28,0,1,0,1
HIMACHAL PRADESH,LAHUL AND SPITI,2021-03-29,0,2,0,2
HIMACHAL PRADESH,MANDI,2021-03-26,14,336,9,359
HIMACHAL PRADESH,MANDI,2021-03-27,36,366,5,407
HIMACHAL PRADESH,MANDI,2021-03-28,8,193,8,209
HIMACHAL PRADESH,MANDI,2021-03-29,10,139,2,151
HIMACHAL PRADESH,MANDI,2021-03-30,27,378,3,408
HIMACHAL PRADESH,SHIMLA,2021-03-26,24,517,9,550
HIMACHAL PRADESH,SHIMLA,2021-03-27,40,706,7,753
HIMACHAL PRADESH,SHIMLA,2021-03-28,28,392,7,427
HIMACHAL PRADESH,SHIMLA,2021-03-29,19,330,10,359
HIMACHAL PRADESH,SHIMLA,2021-03-30,28,675,48,751
HIMACHAL PRADESH,SIRMAUR,2021-03-26,29,617,1,647
HIMACHAL PRADESH,SIRMAUR,2021-03-27,28,366,2,396
HIMACHAL PRADESH,SIRMAUR,2021-03-28,35,841,4,880
HIMACHAL PRADESH,SIRMAUR,2021-03-29,7,384,2,393
HIMACHAL PRADESH,SIRMAUR,2021-03-30,11,237,3,251
HIMACHAL PRADESH,SOLAN,2021-03-26,100,1777,0,1877
HIMACHAL PRADESH,SOLAN,2021-03-27,60,1173,0,1233
HIMACHAL PRADESH,SOLAN,2021-03-28,53,722,0,775
HIMACHAL PRADESH,SOLAN,2021-03-29,48,485,0,533
HIMACHAL PRADESH,SOLAN,2021-03-30,29,652,1,682
HIMACHAL PRADESH,UNA,2021-03-26,23,363,0,386
HIMACHAL PRADESH,UNA,2021-03-27,100,836,7,943
HIMACHAL PRADESH,UNA,2021-03-28,9,163,0,172
HIMACHAL PRADESH,UNA,2021-03-29,40,131,0,171
HIMACHAL PRADESH,UNA,2021-03-30,49,544,1,594
INDIA,INDIA,2021-03-26,27,4,0,31
INDIA,INDIA,2021-03-27,25,5,0,30
INDIA,INDIA,2021-03-28,15,2,0,17
INDIA,INDIA,2021-03-29,9,1,0,10
INDIA,INDIA,2021-03-30,23,4,0,27
JAMMU AND KASHMIR,ANANTNAG,2021-03-26,8,417,0,425
JAMMU AND KASHMIR,ANANTNAG,2021-03-27,7,473,0,480
JAMMU AND KASHMIR,ANANTNAG,2021-03-28,2,243,0,245
JAMMU AND KASHMIR,ANANTNAG,2021-03-29,22,409,0,431
JAMMU AND KASHMIR,ANANTNAG,2021-03-30,7,366,0,373
JAMMU AND KASHMIR,BANDIPORA,2021-03-26,0,155,3,158
JAMMU AND KASHMIR,BANDIPORA,2021-03-27,1,214,0,215
JAMMU AND KASHMIR,BANDIPORA,2021-03-28,1,9,0,10
JAMMU AND KASHMIR,BANDIPORA,2021-03-29,1,50,0,51
JAMMU AND KASHMIR,BANDIPORA,2021-03-30,1,21,0,22
JAMMU AND KASHMIR,BARAMULLA,2021-03-26,16,230,0,246
JAMMU AND KASHMIR,BARAMULLA,2021-03-27,23,310,0,333
JAMMU AND KASHMIR,BARAMULLA,2021-03-28,5,395,0,400
JAMMU AND KASHMIR,BARAMULLA,2021-03-29,21,386,0,407
JAMMU AND KASHMIR,BARAMULLA,2021-03-30,14,388,0,402
JAMMU AND KASHMIR,BUDGAM,2021-03-26,8,883,0,891
JAMMU AND KASHMIR,BUDGAM,2021-03-27,36,1403,0,1439
JAMMU AND KASHMIR,BUDGAM,2021-03-28,1,289,0,290
JAMMU AND KASHMIR,BUDGAM,2021-03-29,16,858,0,874
JAMMU AND KASHMIR,BUDGAM,2021-03-30,31,937,0,968
JAMMU AND KASHMIR,DODA,2021-03-26,0,3,0,3
JAMMU AND KASHMIR,DODA,2021-03-27,0,11,0,11
JAMMU AND KASHMIR,DODA,2021-03-28,0,8,0,8
JAMMU AND KASHMIR,DODA,2021-03-29,0,21,0,21
JAMMU AND KASHMIR,DODA,2021-03-30,0,22,0,22
JAMMU AND KASHMIR,GANDERBAL,2021-03-26,1,282,0,283
JAMMU AND KASHMIR,GANDERBAL,2021-03-27,7,132,0,139
JAMMU AND KASHMIR,GANDERBAL,2021-03-28,0,74,0,74
JAMMU AND KASHMIR,GANDERBAL,2021-03-29,2,138,0,140
JAMMU AND KASHMIR,GANDERBAL,2021-03-30,6,102,0,108
JAMMU AND KASHMIR,JAMMU,2021-03-26,32,902,1,935
JAMMU AND KASHMIR,JAMMU,2021-03-27,27,578,0,605
JAMMU AND KASHMIR,JAMMU,2021-03-28,12,381,2,395
JAMMU AND KASHMIR,JAMMU,2021-03-29,45,831,0,876
JAMMU AND KASHMIR,JAMMU,2021-03-30,28,670,1,699
JAMMU AND KASHMIR,KATHUA,2021-03-26,4,250,0,254
JAMMU AND KASHMIR,KATHUA,2021-03-27,8,602,1,611
JAMMU AND KASHMIR,KATHUA,2021-03-28,1,135,0,136
JAMMU AND KASHMIR,KATHUA,2021-03-29,3,379,0,382
JAMMU AND KASHMIR,KATHUA,2021-03-30,5,795,0,800
JAMMU AND KASHMIR,KISHTWAR,2021-03-26,0,16,0,16
JAMMU AND KASHMIR,KISHTWAR,2021-03-27,0,6,0,6
JAMMU AND KASHMIR,KISHTWAR,2021-03-28,0,3,0,3
JAMMU AND KASHMIR,KISHTWAR,2021-03-29,1,41,0,42
JAMMU AND KASHMIR,KISHTWAR,2021-03-30,0,19,0,19
JAMMU AND KASHMIR,KULGAM,2021-03-26,2,362,0,364
JAMMU AND KASHMIR,KULGAM,2021-03-27,1,400,0,401
JAMMU AND KASHMIR,KULGAM,2021-03-28,1,136,0,137
JAMMU AND KASHMIR,KULGAM,2021-03-29,11,274,0,285
JAMMU AND KASHMIR,KULGAM,2021-03-30,10,786,0,796
JAMMU AND KASHMIR,KUPWARA,2021-03-26,3,55,0,58
JAMMU AND KASHMIR,KUPWARA,2021-03-27,0,63,0,63
JAMMU AND KASHMIR,KUPWARA,2021-03-28,0,39,0,39
JAMMU AND KASHMIR,KUPWARA,2021-03-29,9,321,0,330
JAMMU AND KASHMIR,KUPWARA,2021-03-30,6,172,0,178
JAMMU AND KASHMIR,POONCH,2021-03-26,1,234,0,235
JAMMU AND KASHMIR,POONCH,2021-03-27,4,413,0,417
JAMMU AND KASHMIR,POONCH,2021-03-28,0,78,0,78
JAMMU AND KASHMIR,POONCH,2021-03-29,2,364,0,366
JAMMU AND KASHMIR,POONCH,2021-03-30,2,141,0,143
JAMMU AND KASHMIR,PULWAMA,2021-03-26,5,669,0,674
JAMMU AND KASHMIR,PULWAMA,2021-03-27,13,754,0,767
JAMMU AND KASHMIR,PULWAMA,2021-03-28,3,252,0,255
JAMMU AND KASHMIR,PULWAMA,2021-03-29,21,758,0,779
JAMMU AND KASHMIR,PULWAMA,2021-03-30,25,1013,1,1039
JAMMU AND KASHMIR,RAJOURI,2021-03-26,1,217,0,218
JAMMU AND KASHMIR,RAJOURI,2021-03-27,0,239,0,239
JAMMU AND KASHMIR,RAJOURI,2021-03-28,0,132,0,132
JAMMU AND KASHMIR,RAJOURI,2021-03-29,3,438,0,441
JAMMU AND KASHMIR,RAJOURI,2021-03-30,4,491,0,495
JAMMU AND KASHMIR,RAMBAN,2021-03-26,1,147,0,148
JAMMU AND KASHMIR,RAMBAN,2021-03-27,2,198,0,200
JAMMU AND KASHMIR,RAMBAN,2021-03-28,0,130,0,130
JAMMU AND KASHMIR,RAMBAN,2021-03-29,0,97,0,97
JAMMU AND KASHMIR,RAMBAN,2021-03-30,0,124,0,124
JAMMU AND KASHMIR,REASI,2021-03-26,5,61,0,66
JAMMU AND KASHMIR,REASI,2021-03-27,3,84,0,87
JAMMU AND KASHMIR,REASI,2021-03-28,0,30,0,30
JAMMU AND KASHMIR,REASI,2021-03-29,2,35,0,37
JAMMU AND KASHMIR,REASI,2021-03-30,2,60,0,62
JAMMU AND KASHMIR,SAMBA,2021-03-26,3,240,0,243
JAMMU AND KASHMIR,SAMBA,2021-03-27,0,68,0,68
JAMMU AND KASHMIR,SAMBA,2021-03-28,1,136,0,137
JAMMU AND KASHMIR,SAMBA,2021-03-29,3,82,0,85
JAMMU AND KASHMIR,SAMBA,2021-03-30,1,56,0,57
JAMMU AND KASHMIR,SHOPIAN,2021-03-26,0,413,0,413
JAMMU AND KASHMIR,SHOPIAN,2021-03-27,0,398,0,398
JAMMU AND KASHMIR,SHOPIAN,2021-03-28,0,228,0,228
JAMMU AND KASHMIR,SHOPIAN,2021-03-29,2,462,0,464
JAMMU AND KASHMIR,SHOPIAN,2021-03-30,4,423,0,427
JAMMU AND KASHMIR,SRINAGAR,2021-03-26,78,4251,2,4331
JAMMU AND KASHMIR,SRINAGAR,2021-03-27,104,4930,1,5035
JAMMU AND KASHMIR,SRINAGAR,2021-03-28,43,4126,0,4169
JAMMU AND KASHMIR,SRINAGAR,2021-03-29,73,5411,1,5485
JAMMU AND KASHMIR,SRINAGAR,2021-03-30,154,4297,1,4452
JAMMU AND KASHMIR,UDHAMPUR,2021-03-26,2,627,1,630
JAMMU AND KASHMIR,UDHAMPUR,2021-03-27,11,490,0,501
JAMMU AND KASHMIR,UDHAMPUR,2021-03-28,1,167,0,168
JAMMU AND KASHMIR,UDHAMPUR,2021-03-29,1,204,0,205
JAMMU AND KASHMIR,UDHAMPUR,2021-03-30,4,840,1,845
JHARKHAND,BOKARO,2021-03-26,13,571,5,589
JHARKHAND,BOKARO,2021-03-27,19,967,10,996
JHARKHAND,BOKARO,2021-03-28,15,214,0,229
JHARKHAND,BOKARO,2021-03-29,4,39,0,43
JHARKHAND,BOKARO,2021-03-30,14,432,6,452
JHARKHAND,CHATRA,2021-03-26,1,85,0,86
JHARKHAND,CHATRA,2021-03-27,1,38,56,95
JHARKHAND,CHATRA,2021-03-28,0,185,0,185
JHARKHAND,CHATRA,2021-03-29,0,235,4,239
JHARKHAND,CHATRA,2021-03-30,2,156,0,158
JHARKHAND,DEOGHAR,2021-03-26,15,235,0,250
JHARKHAND,DEOGHAR,2021-03-27,10,319,0,329
JHARKHAND,DEOGHAR,2021-03-28,11,548,1,560
JHARKHAND,DEOGHAR,2021-03-29,0,229,0,229
JHARKHAND,DEOGHAR,2021-03-30,7,481,0,488
JHARKHAND,DHANBAD,2021-03-26,5,825,1,831
JHARKHAND,DHANBAD,2021-03-27,11,209,1,221
JHARKHAND,DHANBAD,2021-03-28,14,173,0,187
JHARKHAND,DHANBAD,2021-03-29,0,53,0,53
JHARKHAND,DHANBAD,2021-03-30,8,345,0,353
JHARKHAND,DUMKA,2021-03-26,7,566,1,574
JHARKHAND,DUMKA,2021-03-27,5,247,8,260
JHARKHAND,DUMKA,2021-03-28,7,166,7,180
JHARKHAND,DUMKA,2021-03-29,3,307,2,312
JHARKHAND,DUMKA,2021-03-30,6,291,7,304
JHARKHAND,EAST SINGHBUM,2021-03-26,30,2650,2,2682
JHARKHAND,EAST SINGHBUM,2021-03-27,23,1614,3,1640
JHARKHAND,EAST SINGHBUM,2021-03-28,24,466,1,491
JHARKHAND,EAST SINGHBUM,2021-03-29,37,374,0,411
JHARKHAND,EAST SINGHBUM,2021-03-30,45,1469,0,1514
JHARKHAND,GARHWA,2021-03-26,1,134,1,136
JHARKHAND,GARHWA,2021-03-27,0,135,0,135
JHARKHAND,GARHWA,2021-03-28,1,280,0,281
JHARKHAND,GARHWA,2021-03-29,0,273,0,273
JHARKHAND,GARHWA,2021-03-30,2,216,2,220
JHARKHAND,GIRIDIH,2021-03-26,3,650,0,653
JHARKHAND,GIRIDIH,2021-03-27,3,913,0,916
JHARKHAND,GIRIDIH,2021-03-28,2,34,0,36
JHARKHAND,GIRIDIH,2021-03-29,1,112,0,113
JHARKHAND,GIRIDIH,2021-03-30,3,719,0,722
JHARKHAND,GODDA,2021-03-26,1,137,0,138
JHARKHAND,GODDA,2021-03-27,9,70,0,79
JHARKHAND,GODDA,2021-03-28,1,15,0,16
JHARKHAND,GODDA,2021-03-29,1,139,0,140
JHARKHAND,GODDA,2021-03-30,4,389,0,393
JHARKHAND,GUMLA,2021-03-26,6,328,0,334
JHARKHAND,GUMLA,2021-03-27,12,173,0,185
JHARKHAND,GUMLA,2021-03-28,8,8,0,16
JHARKHAND,GUMLA,2021-03-29,1,71,0,72
JHARKHAND,GUMLA,2021-03-30,13,303,0,316
JHARKHAND,HAZARIBAGH,2021-03-26,2,586,0,588
JHARKHAND,HAZARIBAGH,2021-03-27,10,268,77,355
JHARKHAND,HAZARIBAGH,2021-03-28,5,58,17,80
JHARKHAND,HAZARIBAGH,2021-03-29,2,374,0,376
JHARKHAND,HAZARIBAGH,2021-03-30,2,691,0,693
JHARKHAND,JAMTARA,2021-03-26,2,170,0,172
JHARKHAND,JAMTARA,2021-03-27,4,220,0,224
JHARKHAND,JAMTARA,2021-03-28,0,83,0,83
JHARKHAND,JAMTARA,2021-03-29,1,21,0,22
JHARKHAND,JAMTARA,2021-03-30,3,161,0,164
JHARKHAND,KHUNTI,2021-03-26,0,65,0,65
JHARKHAND,KHUNTI,2021-03-27,0,16,0,16
JHARKHAND,KHUNTI,2021-03-28,0,4,0,4
JHARKHAND,KHUNTI,2021-03-29,0,5,0,5
JHARKHAND,KHUNTI,2021-03-30,2,16,0,18
JHARKHAND,KODERMA,2021-03-26,5,727,1,733
JHARKHAND,KODERMA,2021-03-27,1,89,0,90
JHARKHAND,KODERMA,2021-03-28,2,19,5,26
JHARKHAND,KODERMA,2021-03-29,2,203,0,205
JHARKHAND,KODERMA,2021-03-30,0,61,0,61
JHARKHAND,LATEHAR,2021-03-26,9,604,0,613
JHARKHAND,LATEHAR,2021-03-27,5,557,0,562
JHARKHAND,LATEHAR,2021-03-28,0,144,0,144
JHARKHAND,LATEHAR,2021-03-29,0,7,0,7
JHARKHAND,LATEHAR,2021-03-30,2,190,1,193
JHARKHAND,LOHARDAGA,2021-03-26,2,353,0,355
JHARKHAND,LOHARDAGA,2021-03-27,6,164,0,170
JHARKHAND,LOHARDAGA,2021-03-28,4,20,0,24
JHARKHAND,LOHARDAGA,2021-03-29,0,57,0,57
JHARKHAND,LOHARDAGA,2021-03-30,7,14,0,21
JHARKHAND,PAKUR,2021-03-26,0,1391,99,1490
JHARKHAND,PAKUR,2021-03-27,5,631,26,662
JHARKHAND,PAKUR,2021-03-28,11,537,0,548
JHARKHAND,PAKUR,2021-03-29,3,259,0,262
JHARKHAND,PAKUR,2021-03-30,8,567,0,575
JHARKHAND,PALAMU,2021-03-26,1,40,0,41
JHARKHAND,PALAMU,2021-03-27,2,106,0,108
JHARKHAND,PALAMU,2021-03-28,0,276,1,277
JHARKHAND,PALAMU,2021-03-29,0,235,0,235
JHARKHAND,PALAMU,2021-03-30,0,1131,1,1132
JHARKHAND,RAMGARH,2021-03-26,3,141,1,145
JHARKHAND,RAMGARH,2021-03-27,1,168,0,169
JHARKHAND,RAMGARH,2021-03-28,8,19,0,27
JHARKHAND,RAMGARH,2021-03-29,0,13,0,13
JHARKHAND,RAMGARH,2021-03-30,7,306,0,313
JHARKHAND,RANCHI,2021-03-26,181,1687,0,1868
JHARKHAND,RANCHI,2021-03-27,358,842,1,1201
JHARKHAND,RANCHI,2021-03-28,235,513,0,748
JHARKHAND,RANCHI,2021-03-29,182,263,0,445
JHARKHAND,RANCHI,2021-03-30,273,778,1,1052
JHARKHAND,SAHEBGANJ,2021-03-26,0,246,1,247
JHARKHAND,SAHEBGANJ,2021-03-27,10,168,0,178
JHARKHAND,SAHEBGANJ,2021-03-28,0,61,0,61
JHARKHAND,SAHEBGANJ,2021-03-29,0,86,0,86
JHARKHAND,SAHEBGANJ,2021-03-30,4,228,0,232
JHARKHAND,SARAIKELA KHARSAWAN,2021-03-26,2,147,0,149
JHARKHAND,SARAIKELA KHARSAWAN,2021-03-27,7,96,0,103
JHARKHAND,SARAIKELA KHARSAWAN,2021-03-28,3,91,0,94
JHARKHAND,SARAIKELA KHARSAWAN,2021-03-29,1,25,0,26
JHARKHAND,SARAIKELA KHARSAWAN,2021-03-30,0,128,0,128
JHARKHAND,SIMDEGA,2021-03-26,3,313,0,316
JHARKHAND,SIMDEGA,2021-03-27,1,230,0,231
JHARKHAND,SIMDEGA,2021-03-28,6,151,0,157
JHARKHAND,SIMDEGA,2021-03-29,1,108,0,109
JHARKHAND,SIMDEGA,2021-03-30,6,113,0,119
JHARKHAND,WEST SINGHBHUM,2021-03-26,1,430,0,431
JHARKHAND,WEST SINGHBHUM,2021-03-27,15,476,0,491
JHARKHAND,WEST SINGHBHUM,2021-03-28,0,272,0,272
JHARKHAND,WEST SINGHBHUM,2021-03-29,0,124,0,124
JHARKHAND,WEST SINGHBHUM,2021-03-30,4,421,0,425
KARNATAKA,BAGALKOTE,2021-03-26,14,3086,12,3112
KARNATAKA,BAGALKOTE,2021-03-27,1,3386,5,3392
KARNATAKA,BAGALKOTE,2021-03-28,16,3169,0,3185
KARNATAKA,BAGALKOTE,2021-03-29,0,914,4,918
KARNATAKA,BAGALKOTE,2021-03-30,14,2332,16,2362
KARNATAKA,BALLARI,2021-03-26,25,3036,3,3064
KARNATAKA,BALLARI,2021-03-27,67,2857,65,2989
KARNATAKA,BALLARI,2021-03-28,29,2480,39,2548
KARNATAKA,BALLARI,2021-03-29,50,2663,10,2723
KARNATAKA,BALLARI,2021-03-30,67,3035,25,3127
KARNATAKA,BELAGAVI,2021-03-26,16,3497,4,3517
KARNATAKA,BELAGAVI,2021-03-27,39,3002,12,3053
KARNATAKA,BELAGAVI,2021-03-28,13,1639,1,1653
KARNATAKA,BELAGAVI,2021-03-29,10,1717,5,1732
KARNATAKA,BELAGAVI,2021-03-30,52,3406,21,3479
KARNATAKA,BENGALURU RURAL,2021-03-26,76,877,3,956
KARNATAKA,BENGALURU RURAL,2021-03-27,58,539,4,601
KARNATAKA,BENGALURU RURAL,2021-03-28,42,1795,1,1838
KARNATAKA,BENGALURU RURAL,2021-03-29,65,1479,0,1544
KARNATAKA,BENGALURU RURAL,2021-03-30,105,2744,6,2855
KARNATAKA,BENGALURU URBAN,2021-03-26,1962,42588,161,44711
KARNATAKA,BENGALURU URBAN,2021-03-27,2106,41684,69,43859
KARNATAKA,BENGALURU URBAN,2021-03-28,1815,31222,78,33115
KARNATAKA,BENGALURU URBAN,2021-03-29,2179,48273,84,50536
KARNATAKA,BENGALURU URBAN,2021-03-30,2972,45041,225,48238
KARNATAKA,BIDAR,2021-03-26,88,2661,0,2749
KARNATAKA,BIDAR,2021-03-27,69,3418,0,3487
KARNATAKA,BIDAR,2021-03-28,264,3752,1,4017
KARNATAKA,BIDAR,2021-03-29,112,3187,1,3300
KARNATAKA,BIDAR,2021-03-30,259,2683,0,2942
KARNATAKA,CHAMARAJANAGARA,2021-03-26,10,1167,3,1180
KARNATAKA,CHAMARAJANAGARA,2021-03-27,9,29,0,38
KARNATAKA,CHAMARAJANAGARA,2021-03-28,3,1821,1,1825
KARNATAKA,CHAMARAJANAGARA,2021-03-29,2,373,0,375
KARNATAKA,CHAMARAJANAGARA,2021-03-30,5,1128,0,1133
KARNATAKA,CHIKKABALLAPURA,2021-03-26,8,2263,4,2275
KARNATAKA,CHIKKABALLAPURA,2021-03-27,11,1562,3,1576
KARNATAKA,CHIKKABALLAPURA,2021-03-28,5,960,2,967
KARNATAKA,CHIKKABALLAPURA,2021-03-29,11,3671,13,3695
KARNATAKA,CHIKKABALLAPURA,2021-03-30,13,3325,12,3350
KARNATAKA,CHIKKAMAGALURU,2021-03-26,43,1263,1,1307
KARNATAKA,CHIKKAMAGALURU,2021-03-27,18,1207,0,1225
KARNATAKA,CHIKKAMAGALURU,2021-03-28,26,1106,0,1132
KARNATAKA,CHIKKAMAGALURU,2021-03-29,15,1159,1,1175
KARNATAKA,CHIKKAMAGALURU,2021-03-30,27,1201,1,1229
KARNATAKA,CHITRADURGA,2021-03-26,9,1656,2,1667
KARNATAKA,CHITRADURGA,2021-03-27,11,1016,1,1028
KARNATAKA,CHITRADURGA,2021-03-28,3,775,1,779
KARNATAKA,CHITRADURGA,2021-03-29,17,1397,0,1414
KARNATAKA,CHITRADURGA,2021-03-30,11,886,0,897
KARNATAKA,DAKSHINA KANNADA,2021-03-26,47,3247,0,3294
KARNATAKA,DAKSHINA KANNADA,2021-03-27,79,2278,8,2365
KARNATAKA,DAKSHINA KANNADA,2021-03-28,48,1606,2,1656
KARNATAKA,DAKSHINA KANNADA,2021-03-29,51,1899,3,1953
KARNATAKA,DAKSHINA KANNADA,2021-03-30,64,2537,4,2605
KARNATAKA,DAVANGERE,2021-03-26,5,1419,30,1454
KARNATAKA,DAVANGERE,2021-03-27,13,1774,5,1792
KARNATAKA,DAVANGERE,2021-03-28,3,1675,7,1685
KARNATAKA,DAVANGERE,2021-03-29,16,1894,71,1981
KARNATAKA,DAVANGERE,2021-03-30,21,1742,23,1786
KARNATAKA,DHARWAD,2021-03-26,45,2424,16,2485
KARNATAKA,DHARWAD,2021-03-27,63,1952,18,2033
KARNATAKA,DHARWAD,2021-03-28,57,1174,32,1263
KARNATAKA,DHARWAD,2021-03-29,27,3008,3,3038
KARNATAKA,DHARWAD,2021-03-30,75,3873,28,3976
KARNATAKA,GADAG,2021-03-26,7,977,151,1135
KARNATAKA,GADAG,2021-03-27,18,1015,403,1436
KARNATAKA,GADAG,2021-03-28,20,1141,72,1233
KARNATAKA,GADAG,2021-03-29,12,1172,214,1398
KARNATAKA,GADAG,2021-03-30,21,898,508,1427
KARNATAKA,HASSAN,2021-03-26,52,3268,36,3356
KARNATAKA,HASSAN,2021-03-27,67,2727,13,2807
KARNATAKA,HASSAN,2021-03-28,33,3084,27,3144
KARNATAKA,HASSAN,2021-03-29,61,1136,230,1427
KARNATAKA,HASSAN,2021-03-30,75,1679,111,1865
KARNATAKA,HAVERI,2021-03-26,0,819,1,820
KARNATAKA,HAVERI,2021-03-27,1,265,0,266
KARNATAKA,HAVERI,2021-03-28,0,600,0,600
KARNATAKA,HAVERI,2021-03-29,1,680,0,681
KARNATAKA,HAVERI,2021-03-30,4,1395,2,1401
KARNATAKA,KALABURAGI,2021-03-26,168,4894,15,5077
KARNATAKA,KALABURAGI,2021-03-27,177,5299,41,5517
KARNATAKA,KALABURAGI,2021-03-28,158,3359,2,3519
KARNATAKA,KALABURAGI,2021-03-29,191,4896,315,5402
KARNATAKA,KALABURAGI,2021-03-30,144,2510,103,2757
KARNATAKA,KODAGU,2021-03-26,9,975,24,1008
KARNATAKA,KODAGU,2021-03-27,11,1991,57,2059
KARNATAKA,KODAGU,2021-03-28,2,42,0,44
KARNATAKA,KODAGU,2021-03-29,15,688,21,724
KARNATAKA,KODAGU,2021-03-30,7,979,42,1028
KARNATAKA,KOLAR,2021-03-26,34,1764,0,1798
KARNATAKA,KOLAR,2021-03-27,24,3188,0,3212
KARNATAKA,KOLAR,2021-03-28,21,1999,2,2022
KARNATAKA,KOLAR,2021-03-29,23,1925,3,1951
KARNATAKA,KOLAR,2021-03-30,17,1869,5,1891
KARNATAKA,KOPPAL,2021-03-26,5,1249,5,1259
KARNATAKA,KOPPAL,2021-03-27,19,1061,16,1096
KARNATAKA,KOPPAL,2021-03-28,21,638,1,660
KARNATAKA,KOPPAL,2021-03-29,8,839,3,850
KARNATAKA,KOPPAL,2021-03-30,11,572,7,590
KARNATAKA,MANDYA,2021-03-26,12,2204,14,2230
KARNATAKA,MANDYA,2021-03-27,43,2016,7,2066
KARNATAKA,MANDYA,2021-03-28,53,1851,6,1910
KARNATAKA,MANDYA,2021-03-29,37,1928,16,1981
KARNATAKA,MANDYA,2021-03-30,41,2180,15,2236
KARNATAKA,MYSURU,2021-03-26,119,3341,7,3467
KARNATAKA,MYSURU,2021-03-27,123,5796,15,5934
KARNATAKA,MYSURU,2021-03-28,123,5266,6,5395
KARNATAKA,MYSURU,2021-03-29,96,3845,7,3948
KARNATAKA,MYSURU,2021-03-30,184,6642,61,6887
KARNATAKA,RAICHUR,2021-03-26,14,1098,24,1136
KARNATAKA,RAICHUR,2021-03-27,20,1497,26,1543
KARNATAKA,RAICHUR,2021-03-28,7,988,7,1002
KARNATAKA,RAICHUR,2021-03-29,14,1412,6,1432
KARNATAKA,RAICHUR,2021-03-30,31,828,1,860
KARNATAKA,RAMANAGARA,2021-03-26,5,1414,2,1421
KARNATAKA,RAMANAGARA,2021-03-27,9,869,0,878
KARNATAKA,RAMANAGARA,2021-03-28,3,239,0,242
KARNATAKA,RAMANAGARA,2021-03-29,13,722,0,735
KARNATAKA,RAMANAGARA,2021-03-30,10,540,0,550
KARNATAKA,SHIVAMOGGA,2021-03-26,15,1770,15,1800
KARNATAKA,SHIVAMOGGA,2021-03-27,36,2062,10,2108
KARNATAKA,SHIVAMOGGA,2021-03-28,7,1439,5,1451
KARNATAKA,SHIVAMOGGA,2021-03-29,32,2479,3,2514
KARNATAKA,SHIVAMOGGA,2021-03-30,32,2079,18,2129
KARNATAKA,TUMAKURU,2021-03-26,83,2763,11,2857
KARNATAKA,TUMAKURU,2021-03-27,69,1817,71,1957
KARNATAKA,TUMAKURU,2021-03-28,65,1472,2,1539
KARNATAKA,TUMAKURU,2021-03-29,45,2740,1,2786
KARNATAKA,TUMAKURU,2021-03-30,184,1231,18,1433
KARNATAKA,UDUPI,2021-03-26,170,2510,2,2682
KARNATAKA,UDUPI,2021-03-27,117,2312,1,2430
KARNATAKA,UDUPI,2021-03-28,72,1956,3,2031
KARNATAKA,UDUPI,2021-03-29,53,2244,0,2297
KARNATAKA,UDUPI,2021-03-30,60,1452,0,1512
KARNATAKA,UTTARA KANNADA,2021-03-26,9,1432,101,1542
KARNATAKA,UTTARA KANNADA,2021-03-27,24,1925,438,2387
KARNATAKA,UTTARA KANNADA,2021-03-28,32,1897,120,2049
KARNATAKA,UTTARA KANNADA,2021-03-29,23,2014,203,2240
KARNATAKA,UTTARA KANNADA,2021-03-30,52,1704,92,1848
KARNATAKA,VIJAYAPURA,2021-03-26,47,2988,0,3035
KARNATAKA,VIJAYAPURA,2021-03-27,24,2011,0,2035
KARNATAKA,VIJAYAPURA,2021-03-28,33,3523,0,3556
KARNATAKA,VIJAYAPURA,2021-03-29,16,1516,0,1532
KARNATAKA,VIJAYAPURA,2021-03-30,19,1396,0,1415
KARNATAKA,YADGIR,2021-03-26,12,1157,0,1169
KARNATAKA,YADGIR,2021-03-27,10,1201,0,1211
KARNATAKA,YADGIR,2021-03-28,10,1143,0,1153
KARNATAKA,YADGIR,2021-03-29,17,697,0,714
KARNATAKA,YADGIR,2021-03-30,12,864,0,876
KERALA,ALAPPUZHA,2021-03-26,102,3010,35,3147
KERALA,ALAPPUZHA,2021-03-27,100,2958,5,3063
KERALA,ALAPPUZHA,2021-03-28,60,1769,7,1836
KERALA,ALAPPUZHA,2021-03-29,57,2480,10,2547
KERALA,ALAPPUZHA,2021-03-30,98,3163,10,3271
KERALA,ERNAKULAM,2021-03-26,235,5927,78,6240
KERALA,ERNAKULAM,2021-03-27,313,8088,31,8432
KERALA,ERNAKULAM,2021-03-28,165,6461,21,6647
KERALA,ERNAKULAM,2021-03-29,287,7878,39,8204
KERALA,ERNAKULAM,2021-03-30,332,9269,23,9624
KERALA,IDUKKI,2021-03-26,116,1361,8,1485
KERALA,IDUKKI,2021-03-27,45,1151,1,1197
KERALA,IDUKKI,2021-03-28,39,686,5,730
KERALA,IDUKKI,2021-03-29,91,1318,3,1412
KERALA,IDUKKI,2021-03-30,143,1403,9,1555
KERALA,KANNUR,2021-03-26,282,4016,15,4313
KERALA,KANNUR,2021-03-27,261,3882,9,4152
KERALA,KANNUR,2021-03-28,318,2734,9,3061
KERALA,KANNUR,2021-03-29,258,3509,10,3777
KERALA,KANNUR,2021-03-30,395,4712,9,5116
KERALA,KASARAGOD,2021-03-26,116,2407,17,2540
KERALA,KASARAGOD,2021-03-27,110,2242,51,2403
KERALA,KASARAGOD,2021-03-28,165,1476,6,1647
KERALA,KASARAGOD,2021-03-29,120,1957,31,2108
KERALA,KASARAGOD,2021-03-30,104,2412,87,2603
KERALA,KOLLAM,2021-03-26,225,3881,32,4138
KERALA,KOLLAM,2021-03-27,175,3733,14,3922
KERALA,KOLLAM,2021-03-28,115,2124,9,2248
KERALA,KOLLAM,2021-03-29,133,2910,25,3068
KERALA,KOLLAM,2021-03-30,193,4297,24,4514
KERALA,KOTTAYAM,2021-03-26,147,2887,19,3053
KERALA,KOTTAYAM,2021-03-27,225,2699,18,2942
KERALA,KOTTAYAM,2021-03-28,124,1747,21,1892
KERALA,KOTTAYAM,2021-03-29,113,3215,14,3342
KERALA,KOTTAYAM,2021-03-30,244,3654,17,3915
KERALA,KOZHIKODE,2021-03-26,312,4647,36,4995
KERALA,KOZHIKODE,2021-03-27,414,5974,56,6444
KERALA,KOZHIKODE,2021-03-28,308,3069,54,3431
KERALA,KOZHIKODE,2021-03-29,248,4561,17,4826
KERALA,KOZHIKODE,2021-03-30,406,5853,32,6291
KERALA,MALAPPURAM,2021-03-26,112,4312,7,4431
KERALA,MALAPPURAM,2021-03-27,215,4401,8,4624
KERALA,MALAPPURAM,2021-03-28,125,2535,6,2666
KERALA,MALAPPURAM,2021-03-29,211,4093,2,4306
KERALA,MALAPPURAM,2021-03-30,248,5056,7,5311
KERALA,PALAKKAD,2021-03-26,138,2579,1,2718
KERALA,PALAKKAD,2021-03-27,81,2612,3,2696
KERALA,PALAKKAD,2021-03-28,72,1554,0,1626
KERALA,PALAKKAD,2021-03-29,110,2711,6,2827
KERALA,PALAKKAD,2021-03-30,96,2914,4,3014
KERALA,PATHANAMTHITTA,2021-03-26,108,2370,5,2483
KERALA,PATHANAMTHITTA,2021-03-27,61,1965,1,2027
KERALA,PATHANAMTHITTA,2021-03-28,79,1720,6,1805
KERALA,PATHANAMTHITTA,2021-03-29,88,2169,3,2260
KERALA,PATHANAMTHITTA,2021-03-30,106,2263,11,2380
KERALA,THIRUVANANTHAPURAM,2021-03-26,163,5511,26,5700
KERALA,THIRUVANANTHAPURAM,2021-03-27,204,6065,26,6295
KERALA,THIRUVANANTHAPURAM,2021-03-28,181,4820,22,5023
KERALA,THIRUVANANTHAPURAM,2021-03-29,194,5094,14,5302
KERALA,THIRUVANANTHAPURAM,2021-03-30,317,6482,30,6829
KERALA,THRISSUR,2021-03-26,172,4588,2,4762
KERALA,THRISSUR,2021-03-27,223,4888,2,5113
KERALA,THRISSUR,2021-03-28,155,2521,4,2680
KERALA,THRISSUR,2021-03-29,133,5205,3,5341
KERALA,THRISSUR,2021-03-30,220,6291,4,6515
KERALA,WAYANAD,2021-03-26,59,953,6,1018
KERALA,WAYANAD,2021-03-27,68,1203,4,1275
KERALA,WAYANAD,2021-03-28,53,1018,6,1077
KERALA,WAYANAD,2021-03-29,50,791,1,842
KERALA,WAYANAD,2021-03-30,100,1219,6,1325
LADAKH,KARGIL,2021-03-26,3,210,0,213
LADAKH,KARGIL,2021-03-27,0,116,0,116
LADAKH,KARGIL,2021-03-28,0,2,0,2
LADAKH,KARGIL,2021-03-29,1,292,0,293
LADAKH,KARGIL,2021-03-30,2,194,0,196
LADAKH,LEH LADAKH,2021-03-26,14,504,4,522
LADAKH,LEH LADAKH,2021-03-27,9,570,1,580
LADAKH,LEH LADAKH,2021-03-28,1,90,0,91
LADAKH,LEH LADAKH,2021-03-29,31,611,0,642
LADAKH,LEH LADAKH,2021-03-30,116,874,7,997
LAKSHADWEEP,LAKSHADWEEP DISTRICT,2021-03-26,0,382,0,382
LAKSHADWEEP,LAKSHADWEEP DISTRICT,2021-03-27,0,307,0,307
LAKSHADWEEP,LAKSHADWEEP DISTRICT,2021-03-28,2,162,0,164
LAKSHADWEEP,LAKSHADWEEP DISTRICT,2021-03-29,0,351,0,351
LAKSHADWEEP,LAKSHADWEEP DISTRICT,2021-03-30,1,146,0,147
MADHYA PRADESH,AGAR MALWA,2021-03-26,2,207,38,247
MADHYA PRADESH,AGAR MALWA,2021-03-27,5,342,0,347
MADHYA PRADESH,AGAR MALWA,2021-03-28,2,71,0,73
MADHYA PRADESH,AGAR MALWA,2021-03-29,10,175,1,186
MADHYA PRADESH,AGAR MALWA,2021-03-30,19,108,0,127
MADHYA PRADESH,ALIRAJPUR,2021-03-26,10,461,0,471
MADHYA PRADESH,ALIRAJPUR,2021-03-27,27,397,2,426
MADHYA PRADESH,ALIRAJPUR,2021-03-28,18,195,0,213
MADHYA PRADESH,ALIRAJPUR,2021-03-29,5,157,0,162
MADHYA PRADESH,ALIRAJPUR,2021-03-30,8,194,2,204
MADHYA PRADESH,ANUPPUR,2021-03-26,17,19,0,36
MADHYA PRADESH,ANUPPUR,2021-03-27,7,40,0,47
MADHYA PRADESH,ANUPPUR,2021-03-28,23,29,1,53
MADHYA PRADESH,ANUPPUR,2021-03-29,1,2,0,3
MADHYA PRADESH,ANUPPUR,2021-03-30,19,42,0,61
MADHYA PRADESH,ASHOKNAGAR,2021-03-26,8,157,1,166
MADHYA PRADESH,ASHOKNAGAR,2021-03-27,4,99,0,103
MADHYA PRADESH,ASHOKNAGAR,2021-03-28,6,215,0,221
MADHYA PRADESH,ASHOKNAGAR,2021-03-29,1,47,0,48
MADHYA PRADESH,ASHOKNAGAR,2021-03-30,1,56,0,57
MADHYA PRADESH,BALAGHAT,2021-03-26,29,117,0,146
MADHYA PRADESH,BALAGHAT,2021-03-27,37,728,18,783
MADHYA PRADESH,BALAGHAT,2021-03-28,29,314,0,343
MADHYA PRADESH,BALAGHAT,2021-03-29,7,41,0,48
MADHYA PRADESH,BALAGHAT,2021-03-30,58,218,0,276
MADHYA PRADESH,BARWANI,2021-03-26,39,336,0,375
MADHYA PRADESH,BARWANI,2021-03-27,55,445,33,533
MADHYA PRADESH,BARWANI,2021-03-28,69,172,0,241
MADHYA PRADESH,BARWANI,2021-03-29,19,149,0,168
MADHYA PRADESH,BARWANI,2021-03-30,89,184,1,274
MADHYA PRADESH,BETUL,2021-03-26,41,325,1,367
MADHYA PRADESH,BETUL,2021-03-27,115,532,1,648
MADHYA PRADESH,BETUL,2021-03-28,64,207,0,271
MADHYA PRADESH,BETUL,2021-03-29,30,233,0,263
MADHYA PRADESH,BETUL,2021-03-30,112,388,3,503
MADHYA PRADESH,BHIND,2021-03-26,3,233,0,236
MADHYA PRADESH,BHIND,2021-03-27,1,241,0,242
MADHYA PRADESH,BHIND,2021-03-28,7,316,0,323
MADHYA PRADESH,BHIND,2021-03-29,4,248,0,252
MADHYA PRADESH,BHIND,2021-03-30,7,121,0,128
MADHYA PRADESH,BHOPAL,2021-03-26,685,1956,161,2802
MADHYA PRADESH,BHOPAL,2021-03-27,853,2472,82,3407
MADHYA PRADESH,BHOPAL,2021-03-28,936,2757,77,3770
MADHYA PRADESH,BHOPAL,2021-03-29,671,2671,40,3382
MADHYA PRADESH,BHOPAL,2021-03-30,789,1978,143,2910
MADHYA PRADESH,BURHANPUR,2021-03-26,22,646,1,669
MADHYA PRADESH,BURHANPUR,2021-03-27,18,458,9,485
MADHYA PRADESH,BURHANPUR,2021-03-28,20,368,3,391
MADHYA PRADESH,BURHANPUR,2021-03-29,2,13,1,16
MADHYA PRADESH,BURHANPUR,2021-03-30,33,471,3,507
MADHYA PRADESH,CHHATARPUR,2021-03-26,5,81,0,86
MADHYA PRADESH,CHHATARPUR,2021-03-27,10,272,1,283
MADHYA PRADESH,CHHATARPUR,2021-03-28,6,41,0,47
MADHYA PRADESH,CHHATARPUR,2021-03-29,11,74,0,85
MADHYA PRADESH,CHHATARPUR,2021-03-30,22,201,2,225
MADHYA PRADESH,CHHINDWARA,2021-03-26,95,607,135,837
MADHYA PRADESH,CHHINDWARA,2021-03-27,85,434,48,567
MADHYA PRADESH,CHHINDWARA,2021-03-28,146,869,93,1108
MADHYA PRADESH,CHHINDWARA,2021-03-29,51,113,5,169
MADHYA PRADESH,CHHINDWARA,2021-03-30,117,596,159,872
MADHYA PRADESH,DAMOH,2021-03-26,23,170,0,193
MADHYA PRADESH,DAMOH,2021-03-27,12,227,0,239
MADHYA PRADESH,DAMOH,2021-03-28,14,65,0,79
MADHYA PRADESH,DAMOH,2021-03-29,21,11,0,32
MADHYA PRADESH,DAMOH,2021-03-30,3,159,0,162
MADHYA PRADESH,DATIA,2021-03-26,12,560,1,573
MADHYA PRADESH,DATIA,2021-03-27,15,206,15,236
MADHYA PRADESH,DATIA,2021-03-28,11,45,0,56
MADHYA PRADESH,DATIA,2021-03-29,4,210,40,254
MADHYA PRADESH,DATIA,2021-03-30,4,79,0,83
MADHYA PRADESH,DEWAS,2021-03-26,60,605,1,666
MADHYA PRADESH,DEWAS,2021-03-27,16,249,0,265
MADHYA PRADESH,DEWAS,2021-03-28,10,31,0,41
MADHYA PRADESH,DEWAS,2021-03-29,11,33,0,44
MADHYA PRADESH,DEWAS,2021-03-30,256,229,0,485
MADHYA PRADESH,DHAR,2021-03-26,130,393,0,523
MADHYA PRADESH,DHAR,2021-03-27,66,353,3,422
MADHYA PRADESH,DHAR,2021-03-28,41,63,0,104
MADHYA PRADESH,DHAR,2021-03-29,132,319,0,451
MADHYA PRADESH,DHAR,2021-03-30,128,431,4,563
MADHYA PRADESH,DINDORI,2021-03-26,3,486,0,489
MADHYA PRADESH,DINDORI,2021-03-27,9,309,0,318
MADHYA PRADESH,DINDORI,2021-03-28,1,231,1,233
MADHYA PRADESH,DINDORI,2021-03-29,5,38,0,43
MADHYA PRADESH,DINDORI,2021-03-30,4,305,0,309
MADHYA PRADESH,EAST NIMAR,2021-03-26,21,545,1,567
MADHYA PRADESH,EAST NIMAR,2021-03-27,15,412,11,438
MADHYA PRADESH,EAST NIMAR,2021-03-28,61,529,5,595
MADHYA PRADESH,EAST NIMAR,2021-03-29,34,395,2,431
MADHYA PRADESH,EAST NIMAR,2021-03-30,27,255,5,287
MADHYA PRADESH,GUNA,2021-03-26,17,528,0,545
MADHYA PRADESH,GUNA,2021-03-27,21,106,0,127
MADHYA PRADESH,GUNA,2021-03-28,17,353,0,370
MADHYA PRADESH,GUNA,2021-03-29,14,237,0,251
MADHYA PRADESH,GUNA,2021-03-30,17,231,0,248
MADHYA PRADESH,GWALIOR,2021-03-26,75,1021,1,1097
MADHYA PRADESH,GWALIOR,2021-03-27,61,1099,1,1161
MADHYA PRADESH,GWALIOR,2021-03-28,113,817,3,933
MADHYA PRADESH,GWALIOR,2021-03-29,48,713,1,762
MADHYA PRADESH,GWALIOR,2021-03-30,62,405,0,467
MADHYA PRADESH,HARDA,2021-03-26,1,222,0,223
MADHYA PRADESH,HARDA,2021-03-27,7,65,0,72
MADHYA PRADESH,HARDA,2021-03-28,8,59,0,67
MADHYA PRADESH,HARDA,2021-03-29,7,57,0,64
MADHYA PRADESH,HARDA,2021-03-30,10,192,0,202
MADHYA PRADESH,HOSHANGABAD,2021-03-26,70,275,5,350
MADHYA PRADESH,HOSHANGABAD,2021-03-27,45,480,7,532
MADHYA PRADESH,HOSHANGABAD,2021-03-28,61,370,2,433
MADHYA PRADESH,HOSHANGABAD,2021-03-29,48,242,0,290
MADHYA PRADESH,HOSHANGABAD,2021-03-30,42,74,7,123
MADHYA PRADESH,INDORE,2021-03-26,2185,5099,9,7293
MADHYA PRADESH,INDORE,2021-03-27,1823,4703,151,6677
MADHYA PRADESH,INDORE,2021-03-28,1628,3299,12,4939
MADHYA PRADESH,INDORE,2021-03-29,1346,2240,6,3592
MADHYA PRADESH,INDORE,2021-03-30,1280,2778,23,4081
MADHYA PRADESH,JABALPUR,2021-03-26,225,2166,3,2394
MADHYA PRADESH,JABALPUR,2021-03-27,232,850,204,1286
MADHYA PRADESH,JABALPUR,2021-03-28,119,602,33,754
MADHYA PRADESH,JABALPUR,2021-03-29,134,641,7,782
MADHYA PRADESH,JABALPUR,2021-03-30,176,782,2,960
MADHYA PRADESH,JHABUA,2021-03-26,31,176,0,207
MADHYA PRADESH,JHABUA,2021-03-27,42,191,2,235
MADHYA PRADESH,JHABUA,2021-03-28,33,162,0,195
MADHYA PRADESH,JHABUA,2021-03-29,29,142,0,171
MADHYA PRADESH,JHABUA,2021-03-30,60,159,3,222
MADHYA PRADESH,KATNI,2021-03-26,4,305,1,310
MADHYA PRADESH,KATNI,2021-03-27,29,183,0,212
MADHYA PRADESH,KATNI,2021-03-28,19,51,0,70
MADHYA PRADESH,KATNI,2021-03-29,8,13,0,21
MADHYA PRADESH,KATNI,2021-03-30,24,300,0,324
MADHYA PRADESH,KHARGONE,2021-03-26,100,720,0,820
MADHYA PRADESH,KHARGONE,2021-03-27,119,721,1,841
MADHYA PRADESH,KHARGONE,2021-03-28,77,368,0,445
MADHYA PRADESH,KHARGONE,2021-03-29,90,374,0,464
MADHYA PRADESH,KHARGONE,2021-03-30,53,259,11,323
MADHYA PRADESH,MANDLA,2021-03-26,4,140,0,144
MADHYA PRADESH,MANDLA,2021-03-27,4,111,2,117
MADHYA PRADESH,MANDLA,2021-03-28,1,101,0,102
MADHYA PRADESH,MANDLA,2021-03-29,3,6,0,9
MADHYA PRADESH,MANDLA,2021-03-30,4,250,81,335
MADHYA PRADESH,MANDSAUR,2021-03-26,37,486,7,530
MADHYA PRADESH,MANDSAUR,2021-03-27,34,452,6,492
MADHYA PRADESH,MANDSAUR,2021-03-28,45,336,14,395
MADHYA PRADESH,MANDSAUR,2021-03-29,17,62,0,79
MADHYA PRADESH,MANDSAUR,2021-03-30,34,183,0,217
MADHYA PRADESH,MORENA,2021-03-26,9,240,0,249
MADHYA PRADESH,MORENA,2021-03-27,5,315,1,321
MADHYA PRADESH,MORENA,2021-03-28,12,336,0,348
MADHYA PRADESH,MORENA,2021-03-29,5,181,0,186
MADHYA PRADESH,MORENA,2021-03-30,6,268,0,274
MADHYA PRADESH,NARSINGHPUR,2021-03-26,36,407,4,447
MADHYA PRADESH,NARSINGHPUR,2021-03-27,23,319,2,344
MADHYA PRADESH,NARSINGHPUR,2021-03-28,13,150,0,163
MADHYA PRADESH,NARSINGHPUR,2021-03-29,8,56,0,64
MADHYA PRADESH,NARSINGHPUR,2021-03-30,42,251,25,318
MADHYA PRADESH,NEEMUCH,2021-03-26,15,419,5,439
MADHYA PRADESH,NEEMUCH,2021-03-27,10,286,7,303
MADHYA PRADESH,NEEMUCH,2021-03-28,14,121,2,137
MADHYA PRADESH,NEEMUCH,2021-03-29,16,92,3,111
MADHYA PRADESH,NEEMUCH,2021-03-30,15,151,1,167
MADHYA PRADESH,NIWARI,2021-03-26,4,64,0,68
MADHYA PRADESH,NIWARI,2021-03-27,1,81,0,82
MADHYA PRADESH,NIWARI,2021-03-28,2,291,0,293
MADHYA PRADESH,NIWARI,2021-03-29,0,6,0,6
MADHYA PRADESH,NIWARI,2021-03-30,4,158,0,162
MADHYA PRADESH,PANNA,2021-03-26,13,195,1,209
MADHYA PRADESH,PANNA,2021-03-27,8,117,0,125
MADHYA PRADESH,PANNA,2021-03-28,6,72,0,78
MADHYA PRADESH,PANNA,2021-03-29,1,42,0,43
MADHYA PRADESH,PANNA,2021-03-30,17,258,0,275
MADHYA PRADESH,RAISEN,2021-03-26,22,225,0,247
MADHYA PRADESH,RAISEN,2021-03-27,34,159,0,193
MADHYA PRADESH,RAISEN,2021-03-28,17,30,0,47
MADHYA PRADESH,RAISEN,2021-03-29,27,35,1,63
MADHYA PRADESH,RAISEN,2021-03-30,26,146,0,172
MADHYA PRADESH,RAJGARH,2021-03-26,3,217,1,221
MADHYA PRADESH,RAJGARH,2021-03-27,22,299,0,321
MADHYA PRADESH,RAJGARH,2021-03-28,3,94,0,97
MADHYA PRADESH,RAJGARH,2021-03-29,28,146,1,175
MADHYA PRADESH,RAJGARH,2021-03-30,19,150,17,186
MADHYA PRADESH,RATLAM,2021-03-26,119,528,12,659
MADHYA PRADESH,RATLAM,2021-03-27,105,574,20,699
MADHYA PRADESH,RATLAM,2021-03-28,89,324,23,436
MADHYA PRADESH,RATLAM,2021-03-29,91,274,9,374
MADHYA PRADESH,RATLAM,2021-03-30,75,277,7,359
MADHYA PRADESH,REWA,2021-03-26,17,368,4,389
MADHYA PRADESH,REWA,2021-03-27,31,580,5,616
MADHYA PRADESH,REWA,2021-03-28,40,426,2,468
MADHYA PRADESH,REWA,2021-03-29,8,56,0,64
MADHYA PRADESH,REWA,2021-03-30,36,131,1,168
MADHYA PRADESH,SAGAR,2021-03-26,37,625,5,667
MADHYA PRADESH,SAGAR,2021-03-27,41,463,2,506
MADHYA PRADESH,SAGAR,2021-03-28,35,477,0,512
MADHYA PRADESH,SAGAR,2021-03-29,40,236,0,276
MADHYA PRADESH,SAGAR,2021-03-30,43,1008,1,1052
MADHYA PRADESH,SATNA,2021-03-26,19,350,0,369
MADHYA PRADESH,SATNA,2021-03-27,28,322,0,350
MADHYA PRADESH,SATNA,2021-03-28,16,229,0,245
MADHYA PRADESH,SATNA,2021-03-29,14,69,0,83
MADHYA PRADESH,SATNA,2021-03-30,29,185,0,214
MADHYA PRADESH,SEHORE,2021-03-26,18,287,1,306
MADHYA PRADESH,SEHORE,2021-03-27,17,383,0,400
MADHYA PRADESH,SEHORE,2021-03-28,34,463,0,497
MADHYA PRADESH,SEHORE,2021-03-29,18,337,0,355
MADHYA PRADESH,SEHORE,2021-03-30,30,638,1,669
MADHYA PRADESH,SEONI,2021-03-26,17,229,146,392
MADHYA PRADESH,SEONI,2021-03-27,19,281,3,303
MADHYA PRADESH,SEONI,2021-03-28,22,246,4,272
MADHYA PRADESH,SEONI,2021-03-29,17,91,4,112
MADHYA PRADESH,SEONI,2021-03-30,12,57,0,69
MADHYA PRADESH,SHAHDOL,2021-03-26,1,75,0,76
MADHYA PRADESH,SHAHDOL,2021-03-27,62,29,1,92
MADHYA PRADESH,SHAHDOL,2021-03-28,24,64,1,89
MADHYA PRADESH,SHAHDOL,2021-03-29,1,16,1,18
MADHYA PRADESH,SHAHDOL,2021-03-30,6,2,0,8
MADHYA PRADESH,SHAJAPUR,2021-03-26,43,1159,8,1210
MADHYA PRADESH,SHAJAPUR,2021-03-27,26,404,4,434
MADHYA PRADESH,SHAJAPUR,2021-03-28,25,364,0,389
MADHYA PRADESH,SHAJAPUR,2021-03-29,33,188,0,221
MADHYA PRADESH,SHAJAPUR,2021-03-30,47,121,3,171
MADHYA PRADESH,SHEOPUR,2021-03-26,3,155,5,163
MADHYA PRADESH,SHEOPUR,2021-03-27,2,274,1,277
MADHYA PRADESH,SHEOPUR,2021-03-28,0,38,0,38
MADHYA PRADESH,SHEOPUR,2021-03-29,4,132,0,136
MADHYA PRADESH,SHEOPUR,2021-03-30,2,165,0,167
MADHYA PRADESH,SHIVPURI,2021-03-26,8,148,10,166
MADHYA PRADESH,SHIVPURI,2021-03-27,24,152,0,176
MADHYA PRADESH,SHIVPURI,2021-03-28,31,285,2,318
MADHYA PRADESH,SHIVPURI,2021-03-29,4,192,3,199
MADHYA PRADESH,SHIVPURI,2021-03-30,22,198,1,221
MADHYA PRADESH,SIDHI,2021-03-26,4,167,0,171
MADHYA PRADESH,SIDHI,2021-03-27,6,162,0,168
MADHYA PRADESH,SIDHI,2021-03-28,3,155,0,158
MADHYA PRADESH,SIDHI,2021-03-29,0,1,0,1
MADHYA PRADESH,SIDHI,2021-03-30,5,307,0,312
MADHYA PRADESH,SINGRAULI,2021-03-26,11,400,0,411
MADHYA PRADESH,SINGRAULI,2021-03-27,5,140,0,145
MADHYA PRADESH,SINGRAULI,2021-03-28,3,151,0,154
MADHYA PRADESH,SINGRAULI,2021-03-29,4,133,0,137
MADHYA PRADESH,SINGRAULI,2021-03-30,0,15,0,15
MADHYA PRADESH,TIKAMGARH,2021-03-26,10,119,0,129
MADHYA PRADESH,TIKAMGARH,2021-03-27,8,187,0,195
MADHYA PRADESH,TIKAMGARH,2021-03-28,11,287,1,299
MADHYA PRADESH,TIKAMGARH,2021-03-29,4,45,0,49
MADHYA PRADESH,TIKAMGARH,2021-03-30,18,68,0,86
MADHYA PRADESH,UJJAIN,2021-03-26,95,300,0,395
MADHYA PRADESH,UJJAIN,2021-03-27,79,419,4,502
MADHYA PRADESH,UJJAIN,2021-03-28,35,842,7,884
MADHYA PRADESH,UJJAIN,2021-03-29,61,45,0,106
MADHYA PRADESH,UJJAIN,2021-03-30,43,522,0,565
MADHYA PRADESH,UMARIA,2021-03-26,8,49,0,57
MADHYA PRADESH,UMARIA,2021-03-27,7,27,0,34
MADHYA PRADESH,UMARIA,2021-03-28,6,12,0,18
MADHYA PRADESH,UMARIA,2021-03-29,0,1,0,1
MADHYA PRADESH,UMARIA,2021-03-30,24,16,0,40
MADHYA PRADESH,VIDISHA,2021-03-26,65,276,35,376
MADHYA PRADESH,VIDISHA,2021-03-27,25,180,7,212
MADHYA PRADESH,VIDISHA,2021-03-28,44,194,0,238
MADHYA PRADESH,VIDISHA,2021-03-29,9,29,19,57
MADHYA PRADESH,VIDISHA,2021-03-30,58,121,1,180
MAHARASHTRA,AHMEDNAGAR,2021-03-26,662,1360,23,2045
MAHARASHTRA,AHMEDNAGAR,2021-03-27,1274,2148,6,3428
MAHARASHTRA,AHMEDNAGAR,2021-03-28,1445,3060,97,4602
MAHARASHTRA,AHMEDNAGAR,2021-03-29,1241,2404,2,3647
MAHARASHTRA,AHMEDNAGAR,2021-03-30,1797,2746,57,4600
MAHARASHTRA,AKOLA,2021-03-26,334,2135,9,2478
MAHARASHTRA,AKOLA,2021-03-27,497,1774,2,2273
MAHARASHTRA,AKOLA,2021-03-28,173,1091,1,1265
MAHARASHTRA,AKOLA,2021-03-29,159,191,1,351
MAHARASHTRA,AKOLA,2021-03-30,458,2015,1,2474
MAHARASHTRA,AMRAVATI,2021-03-26,430,2386,3,2819
MAHARASHTRA,AMRAVATI,2021-03-27,607,3364,5,3976
MAHARASHTRA,AMRAVATI,2021-03-28,448,2248,2,2698
MAHARASHTRA,AMRAVATI,2021-03-29,86,404,0,490
MAHARASHTRA,AMRAVATI,2021-03-30,340,2817,0,3157
MAHARASHTRA,AURANGABAD,2021-03-26,1549,2644,29,4222
MAHARASHTRA,AURANGABAD,2021-03-27,1287,3632,13,4932
MAHARASHTRA,AURANGABAD,2021-03-28,982,3532,5,4519
MAHARASHTRA,AURANGABAD,2021-03-29,1397,3723,3,5123
MAHARASHTRA,AURANGABAD,2021-03-30,1438,3965,26,5429
MAHARASHTRA,BEED,2021-03-26,388,2322,3,2713
MAHARASHTRA,BEED,2021-03-27,346,2637,0,2983
MAHARASHTRA,BEED,2021-03-28,359,1849,1,2209
MAHARASHTRA,BEED,2021-03-29,329,1705,1,2035
MAHARASHTRA,BEED,2021-03-30,336,1873,4,2213
MAHARASHTRA,BHANDARA,2021-03-26,210,1813,4,2027
MAHARASHTRA,BHANDARA,2021-03-27,446,1304,2,1752
MAHARASHTRA,BHANDARA,2021-03-28,263,1326,0,1589
MAHARASHTRA,BHANDARA,2021-03-29,40,618,1,659
MAHARASHTRA,BHANDARA,2021-03-30,589,1424,1,2014
MAHARASHTRA,BULDHANA,2021-03-26,447,650,14,1111
MAHARASHTRA,BULDHANA,2021-03-27,306,487,8,801
MAHARASHTRA,BULDHANA,2021-03-28,441,562,20,1023
MAHARASHTRA,BULDHANA,2021-03-29,145,504,4,653
MAHARASHTRA,BULDHANA,2021-03-30,382,533,7,922
MAHARASHTRA,CHANDRAPUR,2021-03-26,306,2349,14,2669
MAHARASHTRA,CHANDRAPUR,2021-03-27,362,1927,26,2315
MAHARASHTRA,CHANDRAPUR,2021-03-28,204,1090,1,1295
MAHARASHTRA,CHANDRAPUR,2021-03-29,38,225,0,263
MAHARASHTRA,CHANDRAPUR,2021-03-30,310,2032,14,2356
MAHARASHTRA,DHULE,2021-03-26,529,2030,7,2566
MAHARASHTRA,DHULE,2021-03-27,814,2918,45,3777
MAHARASHTRA,DHULE,2021-03-28,384,1996,0,2380
MAHARASHTRA,DHULE,2021-03-29,476,2357,2,2835
MAHARASHTRA,DHULE,2021-03-30,606,2829,10,3445
MAHARASHTRA,GADCHIROLI,2021-03-26,44,1471,1,1516
MAHARASHTRA,GADCHIROLI,2021-03-27,48,870,1,919
MAHARASHTRA,GADCHIROLI,2021-03-28,22,792,0,814
MAHARASHTRA,GADCHIROLI,2021-03-29,16,336,1,353
MAHARASHTRA,GADCHIROLI,2021-03-30,96,743,0,839
MAHARASHTRA,GONDIA,2021-03-26,100,2966,0,3066
MAHARASHTRA,GONDIA,2021-03-27,105,2191,4,2300
MAHARASHTRA,GONDIA,2021-03-28,125,1170,0,1295
MAHARASHTRA,GONDIA,2021-03-29,27,309,0,336
MAHARASHTRA,GONDIA,2021-03-30,116,1672,0,1788
MAHARASHTRA,HINGOLI,2021-03-26,134,433,0,567
MAHARASHTRA,HINGOLI,2021-03-27,80,259,0,339
MAHARASHTRA,HINGOLI,2021-03-28,43,55,0,98
MAHARASHTRA,HINGOLI,2021-03-29,166,218,0,384
MAHARASHTRA,HINGOLI,2021-03-30,216,469,0,685
MAHARASHTRA,JALGAON,2021-03-26,894,5446,5,6345
MAHARASHTRA,JALGAON,2021-03-27,1164,8498,3,9665
MAHARASHTRA,JALGAON,2021-03-28,1027,6967,3,7997
MAHARASHTRA,JALGAON,2021-03-29,934,8550,5,9489
MAHARASHTRA,JALGAON,2021-03-30,1193,8759,7,9959
MAHARASHTRA,JALNA,2021-03-26,545,699,2,1246
MAHARASHTRA,JALNA,2021-03-27,357,808,0,1165
MAHARASHTRA,JALNA,2021-03-28,261,656,0,917
MAHARASHTRA,JALNA,2021-03-29,120,1270,0,1390
MAHARASHTRA,JALNA,2021-03-30,316,4890,4,5210
MAHARASHTRA,KOLHAPUR,2021-03-26,53,969,4,1026
MAHARASHTRA,KOLHAPUR,2021-03-27,77,1521,15,1613
MAHARASHTRA,KOLHAPUR,2021-03-28,109,1446,10,1565
MAHARASHTRA,KOLHAPUR,2021-03-29,93,1172,65,1330
MAHARASHTRA,KOLHAPUR,2021-03-30,109,1288,41,1438
MAHARASHTRA,LATUR,2021-03-26,517,1736,11,2264
MAHARASHTRA,LATUR,2021-03-27,465,1801,1,2267
MAHARASHTRA,LATUR,2021-03-28,382,1657,13,2052
MAHARASHTRA,LATUR,2021-03-29,554,1882,1,2437
MAHARASHTRA,LATUR,2021-03-30,617,3976,0,4593
MAHARASHTRA,MUMBAI,2021-03-26,4780,23903,40,28723
MAHARASHTRA,MUMBAI,2021-03-27,5635,22893,44,28572
MAHARASHTRA,MUMBAI,2021-03-28,4925,21506,33,26464
MAHARASHTRA,MUMBAI,2021-03-29,4035,21116,89,25240
MAHARASHTRA,MUMBAI,2021-03-30,4693,18429,107,23229
MAHARASHTRA,MUMBAI SUBURBAN,2021-03-26,1509,3219,14,4742
MAHARASHTRA,MUMBAI SUBURBAN,2021-03-27,1434,3267,7,4708
MAHARASHTRA,MUMBAI SUBURBAN,2021-03-28,1236,1429,5,2670
MAHARASHTRA,MUMBAI SUBURBAN,2021-03-29,1050,2430,3,3483
MAHARASHTRA,MUMBAI SUBURBAN,2021-03-30,1069,3118,11,4198
MAHARASHTRA,NAGPUR,2021-03-26,4255,7701,99,12055
MAHARASHTRA,NAGPUR,2021-03-27,4020,6872,94,10986
MAHARASHTRA,NAGPUR,2021-03-28,3469,6057,175,9701
MAHARASHTRA,NAGPUR,2021-03-29,1311,1565,19,2895
MAHARASHTRA,NAGPUR,2021-03-30,3426,7139,91,10656
MAHARASHTRA,NANDED,2021-03-26,1162,2792,39,3993
MAHARASHTRA,NANDED,2021-03-27,1233,2466,146,3845
MAHARASHTRA,NANDED,2021-03-28,1070,1920,55,3045
MAHARASHTRA,NANDED,2021-03-29,1060,2560,88,3708
MAHARASHTRA,NANDED,2021-03-30,1367,3957,39,5363
MAHARASHTRA,NANDURBAR,2021-03-26,412,263,0,675
MAHARASHTRA,NANDURBAR,2021-03-27,195,484,0,679
MAHARASHTRA,NANDURBAR,2021-03-28,401,215,0,616
MAHARASHTRA,NANDURBAR,2021-03-29,360,626,0,986
MAHARASHTRA,NANDURBAR,2021-03-30,593,1128,4,1725
MAHARASHTRA,NASHIK,2021-03-26,3742,4858,81,8681
MAHARASHTRA,NASHIK,2021-03-27,3693,4187,97,7977
MAHARASHTRA,NASHIK,2021-03-28,2934,3367,10,6311
MAHARASHTRA,NASHIK,2021-03-29,2530,3473,33,6036
MAHARASHTRA,NASHIK,2021-03-30,4662,5576,234,10472
MAHARASHTRA,OSMANABAD,2021-03-26,193,1698,2,1893
MAHARASHTRA,OSMANABAD,2021-03-27,247,2987,0,3234
MAHARASHTRA,OSMANABAD,2021-03-28,341,4002,3,4346
MAHARASHTRA,OSMANABAD,2021-03-29,289,3500,5,3794
MAHARASHTRA,OSMANABAD,2021-03-30,331,2284,3,2618
MAHARASHTRA,PALGHAR,2021-03-26,476,1210,2,1688
MAHARASHTRA,PALGHAR,2021-03-27,545,1202,12,1759
MAHARASHTRA,PALGHAR,2021-03-28,350,916,1,1267
MAHARASHTRA,PALGHAR,2021-03-29,240,600,1,841
MAHARASHTRA,PALGHAR,2021-03-30,461,1162,7,1630
MAHARASHTRA,PARBHANI,2021-03-26,215,2377,3,2595
MAHARASHTRA,PARBHANI,2021-03-27,355,1520,1,1876
MAHARASHTRA,PARBHANI,2021-03-28,435,2023,3,2461
MAHARASHTRA,PARBHANI,2021-03-29,494,2532,1,3027
MAHARASHTRA,PARBHANI,2021-03-30,424,2096,1,2521
MAHARASHTRA,PUNE,2021-03-26,7519,11343,502,19364
MAHARASHTRA,PUNE,2021-03-27,8905,11932,268,21105
MAHARASHTRA,PUNE,2021-03-28,4877,8056,275,13208
MAHARASHTRA,PUNE,2021-03-29,8029,10104,568,18701
MAHARASHTRA,PUNE,2021-03-30,9485,11392,396,21273
MAHARASHTRA,RAIGAD,2021-03-26,680,1681,2,2363
MAHARASHTRA,RAIGAD,2021-03-27,675,1477,1,2153
MAHARASHTRA,RAIGAD,2021-03-28,543,1046,5,1594
MAHARASHTRA,RAIGAD,2021-03-29,461,1181,6,1648
MAHARASHTRA,RAIGAD,2021-03-30,631,1816,18,2465
MAHARASHTRA,RATNAGIRI,2021-03-26,54,217,1,272
MAHARASHTRA,RATNAGIRI,2021-03-27,26,204,0,230
MAHARASHTRA,RATNAGIRI,2021-03-28,63,412,0,475
MAHARASHTRA,RATNAGIRI,2021-03-29,75,359,4,438
MAHARASHTRA,RATNAGIRI,2021-03-30,97,417,1,515
MAHARASHTRA,SANGLI,2021-03-26,183,1571,41,1795
MAHARASHTRA,SANGLI,2021-03-27,247,981,13,1241
MAHARASHTRA,SANGLI,2021-03-28,270,1532,39,1841
MAHARASHTRA,SANGLI,2021-03-29,235,1607,26,1868
MAHARASHTRA,SANGLI,2021-03-30,305,1690,38,2033
MAHARASHTRA,SATARA,2021-03-26,361,1803,54,2218
MAHARASHTRA,SATARA,2021-03-27,409,1811,30,2250
MAHARASHTRA,SATARA,2021-03-28,475,1858,79,2412
MAHARASHTRA,SATARA,2021-03-29,195,473,8,676
MAHARASHTRA,SATARA,2021-03-30,389,1002,47,1438
MAHARASHTRA,SINDHUDURG,2021-03-26,60,290,0,350
MAHARASHTRA,SINDHUDURG,2021-03-27,74,647,0,721
MAHARASHTRA,SINDHUDURG,2021-03-28,27,425,0,452
MAHARASHTRA,SINDHUDURG,2021-03-29,38,477,0,515
MAHARASHTRA,SINDHUDURG,2021-03-30,87,369,0,456
MAHARASHTRA,SOLAPUR,2021-03-26,566,2894,41,3501
MAHARASHTRA,SOLAPUR,2021-03-27,633,3510,6,4149
MAHARASHTRA,SOLAPUR,2021-03-28,463,3463,110,4036
MAHARASHTRA,SOLAPUR,2021-03-29,665,4141,126,4932
MAHARASHTRA,SOLAPUR,2021-03-30,735,3008,90,3833
MAHARASHTRA,THANE,2021-03-26,3732,8477,30,12239
MAHARASHTRA,THANE,2021-03-27,4691,9975,39,14705
MAHARASHTRA,THANE,2021-03-28,3906,6915,44,10865
MAHARASHTRA,THANE,2021-03-29,3746,6458,60,10264
MAHARASHTRA,THANE,2021-03-30,3753,8427,64,12244
MAHARASHTRA,WARDHA,2021-03-26,268,2166,1,2435
MAHARASHTRA,WARDHA,2021-03-27,378,1495,11,1884
MAHARASHTRA,WARDHA,2021-03-28,196,1042,5,1243
MAHARASHTRA,WARDHA,2021-03-29,54,320,0,374
MAHARASHTRA,WARDHA,2021-03-30,420,1808,16,2244
MAHARASHTRA,WASHIM,2021-03-26,534,2227,14,2775
MAHARASHTRA,WASHIM,2021-03-27,433,1762,21,2216
MAHARASHTRA,WASHIM,2021-03-28,437,2186,19,2642
MAHARASHTRA,WASHIM,2021-03-29,264,2429,28,2721
MAHARASHTRA,WASHIM,2021-03-30,169,1389,38,1596
MAHARASHTRA,YAVATMAL,2021-03-26,417,3642,5,4064
MAHARASHTRA,YAVATMAL,2021-03-27,355,2480,1,2836
MAHARASHTRA,YAVATMAL,2021-03-28,311,1726,1,2038
MAHARASHTRA,YAVATMAL,2021-03-29,267,2219,2,2488
MAHARASHTRA,YAVATMAL,2021-03-30,406,2931,3,3340
MANIPUR,BISHNUPUR,2021-03-26,0,101,0,101
MANIPUR,BISHNUPUR,2021-03-27,0,52,0,52
MANIPUR,BISHNUPUR,2021-03-28,0,30,0,30
MANIPUR,BISHNUPUR,2021-03-29,0,13,0,13
MANIPUR,BISHNUPUR,2021-03-30,1,35,0,36
MANIPUR,CHANDEL,2021-03-26,1,47,0,48
MANIPUR,CHANDEL,2021-03-27,0,19,0,19
MANIPUR,CHANDEL,2021-03-28,0,5,0,5
MANIPUR,CHANDEL,2021-03-29,0,18,0,18
MANIPUR,CHANDEL,2021-03-30,1,19,0,20
MANIPUR,CHURACHANDPUR,2021-03-26,0,52,0,52
MANIPUR,CHURACHANDPUR,2021-03-27,0,81,0,81
MANIPUR,CHURACHANDPUR,2021-03-28,1,80,0,81
MANIPUR,CHURACHANDPUR,2021-03-29,0,13,0,13
MANIPUR,CHURACHANDPUR,2021-03-30,0,149,0,149
MANIPUR,IMPHAL EAST,2021-03-26,1,134,0,135
MANIPUR,IMPHAL EAST,2021-03-27,3,196,0,199
MANIPUR,IMPHAL EAST,2021-03-28,1,88,0,89
MANIPUR,IMPHAL EAST,2021-03-29,0,97,0,97
MANIPUR,IMPHAL EAST,2021-03-30,1,95,0,96
MANIPUR,IMPHAL WEST,2021-03-26,2,479,0,481
MANIPUR,IMPHAL WEST,2021-03-27,3,484,0,487
MANIPUR,IMPHAL WEST,2021-03-28,1,181,0,182
MANIPUR,IMPHAL WEST,2021-03-29,0,174,0,174
MANIPUR,IMPHAL WEST,2021-03-30,2,216,2,220
MANIPUR,JIRIBAM,2021-03-26,0,1,0,1
MANIPUR,JIRIBAM,2021-03-27,0,1,0,1
MANIPUR,JIRIBAM,2021-03-29,0,2,0,2
MANIPUR,KAKCHING,2021-03-26,0,13,0,13
MANIPUR,KAKCHING,2021-03-27,0,34,0,34
MANIPUR,KAKCHING,2021-03-28,1,58,0,59
MANIPUR,KAKCHING,2021-03-29,1,8,0,9
MANIPUR,KAKCHING,2021-03-30,1,18,0,19
MANIPUR,KAMJONG,2021-03-26,0,10,0,10
MANIPUR,KAMJONG,2021-03-27,0,15,0,15
MANIPUR,KAMJONG,2021-03-30,0,1,0,1
MANIPUR,KANGPOKPI,2021-03-26,0,22,0,22
MANIPUR,KANGPOKPI,2021-03-27,0,22,0,22
MANIPUR,KANGPOKPI,2021-03-28,0,12,0,12
MANIPUR,KANGPOKPI,2021-03-29,0,44,0,44
MANIPUR,KANGPOKPI,2021-03-30,1,17,0,18
MANIPUR,NONEY,2021-03-26,0,7,0,7
MANIPUR,NONEY,2021-03-27,1,4,0,5
MANIPUR,NONEY,2021-03-28,0,1,0,1
MANIPUR,NONEY,2021-03-29,0,1,0,1
MANIPUR,PHERZAWL,2021-03-29,0,1,0,1
MANIPUR,PHERZAWL,2021-03-30,0,6,0,6
MANIPUR,SENAPATI,2021-03-26,0,14,0,14
MANIPUR,SENAPATI,2021-03-27,0,19,0,19
MANIPUR,SENAPATI,2021-03-28,0,13,0,13
MANIPUR,SENAPATI,2021-03-29,0,12,0,12
MANIPUR,SENAPATI,2021-03-30,0,22,0,22
MANIPUR,TAMENGLONG,2021-03-26,0,39,0,39
MANIPUR,TAMENGLONG,2021-03-27,1,31,0,32
MANIPUR,TAMENGLONG,2021-03-28,0,1,0,1
MANIPUR,TAMENGLONG,2021-03-29,1,115,0,116
MANIPUR,TAMENGLONG,2021-03-30,0,82,0,82
MANIPUR,TENGNOUPAL,2021-03-26,0,4,0,4
MANIPUR,TENGNOUPAL,2021-03-27,0,6,0,6
MANIPUR,TENGNOUPAL,2021-03-28,0,29,0,29
MANIPUR,TENGNOUPAL,2021-03-29,0,3,0,3
MANIPUR,TENGNOUPAL,2021-03-30,0,8,0,8
MANIPUR,THOUBAL,2021-03-26,0,48,0,48
MANIPUR,THOUBAL,2021-03-27,0,58,0,58
MANIPUR,THOUBAL,2021-03-28,2,35,0,37
MANIPUR,THOUBAL,2021-03-29,0,32,0,32
MANIPUR,THOUBAL,2021-03-30,0,36,0,36
MANIPUR,UKHRUL,2021-03-26,0,20,0,20
MANIPUR,UKHRUL,2021-03-27,2,24,0,26
MANIPUR,UKHRUL,2021-03-28,1,4,0,5
MANIPUR,UKHRUL,2021-03-29,0,53,0,53
MANIPUR,UKHRUL,2021-03-30,0,46,0,46
MEGHALAYA,EAST GARO HILLS,2021-03-26,0,22,0,22
MEGHALAYA,EAST GARO HILLS,2021-03-27,0,24,0,24
MEGHALAYA,EAST GARO HILLS,2021-03-29,0,38,0,38
MEGHALAYA,EAST GARO HILLS,2021-03-30,0,23,0,23
MEGHALAYA,EAST JAINTIA HILLS,2021-03-26,0,68,0,68
MEGHALAYA,EAST JAINTIA HILLS,2021-03-27,0,29,0,29
MEGHALAYA,EAST JAINTIA HILLS,2021-03-28,0,7,0,7
MEGHALAYA,EAST JAINTIA HILLS,2021-03-29,0,117,0,117
MEGHALAYA,EAST JAINTIA HILLS,2021-03-30,0,104,0,104
MEGHALAYA,EAST KHASI HILLS,2021-03-26,1,537,1,539
MEGHALAYA,EAST KHASI HILLS,2021-03-27,1,592,0,593
MEGHALAYA,EAST KHASI HILLS,2021-03-28,6,96,0,102
MEGHALAYA,EAST KHASI HILLS,2021-03-29,3,564,0,567
MEGHALAYA,EAST KHASI HILLS,2021-03-30,7,1128,2,1137
MEGHALAYA,NORTH GARO HILLS,2021-03-26,0,1,0,1
MEGHALAYA,NORTH GARO HILLS,2021-03-27,0,1,0,1
MEGHALAYA,NORTH GARO HILLS,2021-03-28,0,2,0,2
MEGHALAYA,NORTH GARO HILLS,2021-03-30,0,8,0,8
MEGHALAYA,RI BHOI,2021-03-26,0,121,0,121
MEGHALAYA,RI BHOI,2021-03-27,0,70,0,70
MEGHALAYA,RI BHOI,2021-03-28,0,15,0,15
MEGHALAYA,RI BHOI,2021-03-29,0,89,0,89
MEGHALAYA,RI BHOI,2021-03-30,2,187,0,189
MEGHALAYA,SOUTH GARO HILLS,2021-03-26,0,6,0,6
MEGHALAYA,SOUTH GARO HILLS,2021-03-27,0,3,0,3
MEGHALAYA,SOUTH GARO HILLS,2021-03-29,0,7,0,7
MEGHALAYA,SOUTH GARO HILLS,2021-03-30,0,9,0,9
MEGHALAYA,SOUTH WEST GARO HILLS,2021-03-26,0,22,0,22
MEGHALAYA,SOUTH WEST GARO HILLS,2021-03-27,0,14,0,14
MEGHALAYA,SOUTH WEST GARO HILLS,2021-03-28,0,1,0,1
MEGHALAYA,SOUTH WEST GARO HILLS,2021-03-29,0,36,0,36
MEGHALAYA,SOUTH WEST GARO HILLS,2021-03-30,1,78,0,79
MEGHALAYA,SOUTH WEST KHASI HILLS,2021-03-26,0,3,0,3
MEGHALAYA,SOUTH WEST KHASI HILLS,2021-03-27,0,54,0,54
MEGHALAYA,SOUTH WEST KHASI HILLS,2021-03-28,0,107,0,107
MEGHALAYA,SOUTH WEST KHASI HILLS,2021-03-29,0,92,0,92
MEGHALAYA,SOUTH WEST KHASI HILLS,2021-03-30,0,64,0,64
MEGHALAYA,WEST GARO HILLS,2021-03-26,0,25,0,25
MEGHALAYA,WEST GARO HILLS,2021-03-27,1,82,0,83
MEGHALAYA,WEST GARO HILLS,2021-03-28,0,6,0,6
MEGHALAYA,WEST GARO HILLS,2021-03-29,1,16,0,17
MEGHALAYA,WEST GARO HILLS,2021-03-30,21,120,0,141
MEGHALAYA,WEST JAINTIA HILLS,2021-03-26,0,70,0,70
MEGHALAYA,WEST JAINTIA HILLS,2021-03-27,0,81,0,81
MEGHALAYA,WEST JAINTIA HILLS,2021-03-28,0,32,0,32
MEGHALAYA,WEST JAINTIA HILLS,2021-03-29,0,64,0,64
MEGHALAYA,WEST JAINTIA HILLS,2021-03-30,0,106,0,106
MEGHALAYA,WEST KHASI HILLS,2021-03-26,1,32,0,33
MEGHALAYA,WEST KHASI HILLS,2021-03-27,0,27,0,27
MEGHALAYA,WEST KHASI HILLS,2021-03-28,0,3,0,3
MEGHALAYA,WEST KHASI HILLS,2021-03-29,0,33,0,33
MEGHALAYA,WEST KHASI HILLS,2021-03-30,0,46,0,46
MIZORAM,AIZAWL,2021-03-26,3,520,0,523
MIZORAM,AIZAWL,2021-03-27,3,483,0,486
MIZORAM,AIZAWL,2021-03-28,1,158,0,159
MIZORAM,AIZAWL,2021-03-29,3,411,0,414
MIZORAM,AIZAWL,2021-03-30,4,613,0,617
MIZORAM,CHAMPHAI,2021-03-26,0,9,0,9
MIZORAM,CHAMPHAI,2021-03-27,0,7,0,7
MIZORAM,CHAMPHAI,2021-03-30,0,5,0,5
MIZORAM,HNAHTHIAL,2021-03-26,0,1,0,1
MIZORAM,HNAHTHIAL,2021-03-27,0,1,0,1
MIZORAM,HNAHTHIAL,2021-03-30,1,5,0,6
MIZORAM,KHAWZAWL,2021-03-26,0,7,0,7
MIZORAM,KOLASIB,2021-03-26,0,175,0,175
MIZORAM,KOLASIB,2021-03-27,0,170,0,170
MIZORAM,KOLASIB,2021-03-28,0,16,0,16
MIZORAM,KOLASIB,2021-03-29,0,58,0,58
MIZORAM,KOLASIB,2021-03-30,0,75,0,75
MIZORAM,LAWNGTLAI,2021-03-26,0,4,0,4
MIZORAM,LAWNGTLAI,2021-03-29,0,1,0,1
MIZORAM,LUNGLEI,2021-03-26,0,10,0,10
MIZORAM,LUNGLEI,2021-03-27,0,7,0,7
MIZORAM,LUNGLEI,2021-03-29,0,1,0,1
MIZORAM,LUNGLEI,2021-03-30,0,8,0,8
MIZORAM,MAMIT,2021-03-26,0,1,0,1
MIZORAM,MAMIT,2021-03-27,0,62,0,62
MIZORAM,MAMIT,2021-03-29,0,61,0,61
MIZORAM,MAMIT,2021-03-30,0,43,0,43
MIZORAM,SAIHA,2021-03-26,0,7,0,7
MIZORAM,SAIHA,2021-03-27,0,26,0,26
MIZORAM,SAIHA,2021-03-28,0,10,0,10
MIZORAM,SAIHA,2021-03-30,0,6,0,6
MIZORAM,SAITUAL,2021-03-26,0,3,0,3
MIZORAM,SAITUAL,2021-03-27,0,73,0,73
MIZORAM,SAITUAL,2021-03-29,0,7,0,7
MIZORAM,SAITUAL,2021-03-30,0,37,0,37
MIZORAM,SERCHHIP,2021-03-26,0,27,0,27
MIZORAM,SERCHHIP,2021-03-30,0,1,0,1
NAGALAND,DIMAPUR,2021-03-26,1,62,0,63
NAGALAND,DIMAPUR,2021-03-27,0,60,0,60
NAGALAND,DIMAPUR,2021-03-28,0,42,1,43
NAGALAND,DIMAPUR,2021-03-29,0,105,0,105
NAGALAND,DIMAPUR,2021-03-30,0,57,0,57
NAGALAND,KIPHIRE,2021-03-26,0,3,0,3
NAGALAND,KIPHIRE,2021-03-28,0,1,0,1
NAGALAND,KIPHIRE,2021-03-29,0,14,0,14
NAGALAND,KIPHIRE,2021-03-30,0,1,0,1
NAGALAND,KOHIMA,2021-03-26,37,85,0,122
NAGALAND,KOHIMA,2021-03-27,22,60,0,82
NAGALAND,KOHIMA,2021-03-28,3,8,0,11
NAGALAND,KOHIMA,2021-03-29,0,68,0,68
NAGALAND,KOHIMA,2021-03-30,0,112,0,112
NAGALAND,MOKOKCHUNG,2021-03-26,1,45,0,46
NAGALAND,MOKOKCHUNG,2021-03-27,0,8,0,8
NAGALAND,MOKOKCHUNG,2021-03-28,0,5,0,5
NAGALAND,MOKOKCHUNG,2021-03-29,0,6,0,6
NAGALAND,MOKOKCHUNG,2021-03-30,0,14,0,14
NAGALAND,MON,2021-03-28,0,1,0,1
NAGALAND,MON,2021-03-29,0,2,0,2
NAGALAND,PEREN,2021-03-26,0,2,0,2
NAGALAND,PEREN,2021-03-28,0,4,0,4
NAGALAND,PEREN,2021-03-29,0,4,0,4
NAGALAND,PEREN,2021-03-30,0,1,0,1
NAGALAND,PHEK,2021-03-26,0,1,0,1
NAGALAND,PHEK,2021-03-28,0,2,0,2
NAGALAND,PHEK,2021-03-30,0,4,0,4
NAGALAND,TUENSANG,2021-03-26,0,2,0,2
NAGALAND,TUENSANG,2021-03-28,0,3,0,3
NAGALAND,TUENSANG,2021-03-29,0,2,0,2
NAGALAND,WOKHA,2021-03-26,0,3,0,3
NAGALAND,WOKHA,2021-03-27,0,1,0,1
NAGALAND,WOKHA,2021-03-28,0,3,0,3
NAGALAND,WOKHA,2021-03-29,0,1,0,1
NAGALAND,ZUNHEBOTO,2021-03-26,0,1,0,1
NAGALAND,ZUNHEBOTO,2021-03-27,0,3,0,3
NAGALAND,ZUNHEBOTO,2021-03-28,0,2,0,2
ODISHA,ANUGUL,2021-03-26,6,581,0,587
ODISHA,ANUGUL,2021-03-27,21,749,0,770
ODISHA,ANUGUL,2021-03-28,11,475,0,486
ODISHA,ANUGUL,2021-03-29,6,439,0,445
ODISHA,ANUGUL,2021-03-30,14,726,1,741
ODISHA,BALANGIR,2021-03-26,8,1457,2,1467
ODISHA,BALANGIR,2021-03-27,3,1252,26,1281
ODISHA,BALANGIR,2021-03-28,16,1332,12,1360
ODISHA,BALANGIR,2021-03-29,6,901,0,907
ODISHA,BALANGIR,2021-03-30,8,1207,2,1217
ODISHA,BALESHWAR,2021-03-26,14,2199,0,2213
ODISHA,BALESHWAR,2021-03-27,7,2057,0,2064
ODISHA,BALESHWAR,2021-03-28,15,1592,0,1607
ODISHA,BALESHWAR,2021-03-29,4,1399,2,1405
ODISHA,BALESHWAR,2021-03-30,20,2003,0,2023
ODISHA,BARGARH,2021-03-26,18,510,0,528
ODISHA,BARGARH,2021-03-27,20,513,0,533
ODISHA,BARGARH,2021-03-28,25,427,0,452
ODISHA,BARGARH,2021-03-29,19,180,0,199
ODISHA,BARGARH,2021-03-30,52,519,0,571
ODISHA,BHADRAK,2021-03-26,2,787,0,789
ODISHA,BHADRAK,2021-03-27,5,526,0,531
ODISHA,BHADRAK,2021-03-28,3,344,0,347
ODISHA,BHADRAK,2021-03-29,0,544,0,544
ODISHA,BHADRAK,2021-03-30,3,555,0,558
ODISHA,BOUDH,2021-03-26,0,100,0,100
ODISHA,BOUDH,2021-03-27,0,154,0,154
ODISHA,BOUDH,2021-03-28,0,113,0,113
ODISHA,BOUDH,2021-03-29,0,195,0,195
ODISHA,BOUDH,2021-03-30,0,166,0,166
ODISHA,CUTTACK,2021-03-26,25,2023,0,2048
ODISHA,CUTTACK,2021-03-27,20,1451,0,1471
ODISHA,CUTTACK,2021-03-28,14,927,1,942
ODISHA,CUTTACK,2021-03-29,10,588,0,598
ODISHA,CUTTACK,2021-03-30,29,1877,2,1908
ODISHA,DEOGARH,2021-03-26,0,313,0,313
ODISHA,DEOGARH,2021-03-27,0,121,0,121
ODISHA,DEOGARH,2021-03-28,0,184,0,184
ODISHA,DEOGARH,2021-03-29,0,63,0,63
ODISHA,DEOGARH,2021-03-30,1,68,0,69
ODISHA,DHENKANAL,2021-03-26,0,313,0,313
ODISHA,DHENKANAL,2021-03-27,1,396,0,397
ODISHA,DHENKANAL,2021-03-28,0,171,1,172
ODISHA,DHENKANAL,2021-03-29,0,165,0,165
ODISHA,DHENKANAL,2021-03-30,2,427,0,429
ODISHA,GAJAPATI,2021-03-26,1,366,1,368
ODISHA,GAJAPATI,2021-03-27,1,551,1,553
ODISHA,GAJAPATI,2021-03-28,0,114,0,114
ODISHA,GAJAPATI,2021-03-29,0,152,0,152
ODISHA,GAJAPATI,2021-03-30,6,367,2,375
ODISHA,GANJAM,2021-03-26,0,1368,0,1368
ODISHA,GANJAM,2021-03-27,5,963,0,968
ODISHA,GANJAM,2021-03-28,2,888,43,933
ODISHA,GANJAM,2021-03-29,6,1075,40,1121
ODISHA,GANJAM,2021-03-30,4,1676,0,1680
ODISHA,JAGATSINGHAPUR,2021-03-26,0,409,0,409
ODISHA,JAGATSINGHAPUR,2021-03-27,4,444,0,448
ODISHA,JAGATSINGHAPUR,2021-03-28,0,422,0,422
ODISHA,JAGATSINGHAPUR,2021-03-29,0,89,1,90
ODISHA,JAGATSINGHAPUR,2021-03-30,1,700,0,701
ODISHA,JAJAPUR,2021-03-26,11,591,0,602
ODISHA,JAJAPUR,2021-03-27,8,281,0,289
ODISHA,JAJAPUR,2021-03-28,3,121,0,124
ODISHA,JAJAPUR,2021-03-29,4,144,0,148
ODISHA,JAJAPUR,2021-03-30,3,962,0,965
ODISHA,JHARSUGUDA,2021-03-26,3,542,4,549
ODISHA,JHARSUGUDA,2021-03-27,5,414,0,419
ODISHA,JHARSUGUDA,2021-03-28,21,497,0,518
ODISHA,JHARSUGUDA,2021-03-29,12,480,0,492
ODISHA,JHARSUGUDA,2021-03-30,6,518,0,524
ODISHA,KALAHANDI,2021-03-26,13,580,0,593
ODISHA,KALAHANDI,2021-03-27,6,515,0,521
ODISHA,KALAHANDI,2021-03-28,24,512,0,536
ODISHA,KALAHANDI,2021-03-29,12,177,0,189
ODISHA,KALAHANDI,2021-03-30,68,366,0,434
ODISHA,KANDHAMAL,2021-03-26,0,487,0,487
ODISHA,KANDHAMAL,2021-03-27,0,615,0,615
ODISHA,KANDHAMAL,2021-03-28,1,959,0,960
ODISHA,KANDHAMAL,2021-03-29,0,501,0,501
ODISHA,KANDHAMAL,2021-03-30,0,665,0,665
ODISHA,KENDRAPARA,2021-03-26,2,1172,2,1176
ODISHA,KENDRAPARA,2021-03-27,0,1087,1,1088
ODISHA,KENDRAPARA,2021-03-28,1,913,0,914
ODISHA,KENDRAPARA,2021-03-29,1,807,0,808
ODISHA,KENDRAPARA,2021-03-30,1,1344,0,1345
ODISHA,KENDUJHAR,2021-03-26,1,695,1,697
ODISHA,KENDUJHAR,2021-03-27,0,731,0,731
ODISHA,KENDUJHAR,2021-03-28,0,533,0,533
ODISHA,KENDUJHAR,2021-03-29,2,338,0,340
ODISHA,KENDUJHAR,2021-03-30,5,696,0,701
ODISHA,KHORDHA,2021-03-26,53,1710,3,1766
ODISHA,KHORDHA,2021-03-27,99,1272,0,1371
ODISHA,KHORDHA,2021-03-28,51,943,2,996
ODISHA,KHORDHA,2021-03-29,29,648,3,680
ODISHA,KHORDHA,2021-03-30,48,2006,5,2059
ODISHA,KORAPUT,2021-03-26,0,1657,0,1657
ODISHA,KORAPUT,2021-03-27,1,1360,0,1361
ODISHA,KORAPUT,2021-03-28,1,1616,0,1617
ODISHA,KORAPUT,2021-03-29,0,1117,0,1117
ODISHA,KORAPUT,2021-03-30,5,1564,0,1569
ODISHA,MALKANGIRI,2021-03-26,0,314,0,314
ODISHA,MALKANGIRI,2021-03-27,0,158,0,158
ODISHA,MALKANGIRI,2021-03-28,0,200,0,200
ODISHA,MALKANGIRI,2021-03-29,0,287,0,287
ODISHA,MALKANGIRI,2021-03-30,0,132,0,132
ODISHA,MAYURBHANJ,2021-03-26,8,1301,0,1309
ODISHA,MAYURBHANJ,2021-03-27,10,1404,0,1414
ODISHA,MAYURBHANJ,2021-03-28,9,1271,0,1280
ODISHA,MAYURBHANJ,2021-03-29,8,1028,0,1036
ODISHA,MAYURBHANJ,2021-03-30,10,1246,0,1256
ODISHA,NABARANGPUR,2021-03-26,0,757,0,757
ODISHA,NABARANGPUR,2021-03-27,1,763,0,764
ODISHA,NABARANGPUR,2021-03-28,6,501,0,507
ODISHA,NABARANGPUR,2021-03-29,3,373,0,376
ODISHA,NABARANGPUR,2021-03-30,4,748,0,752
ODISHA,NAYAGARH,2021-03-26,0,514,0,514
ODISHA,NAYAGARH,2021-03-27,0,663,10,673
ODISHA,NAYAGARH,2021-03-28,0,252,0,252
ODISHA,NAYAGARH,2021-03-29,1,250,1,252
ODISHA,NAYAGARH,2021-03-30,2,511,0,513
ODISHA,NUAPADA,2021-03-26,29,468,0,497
ODISHA,NUAPADA,2021-03-27,41,268,0,309
ODISHA,NUAPADA,2021-03-28,17,456,0,473
ODISHA,NUAPADA,2021-03-29,42,365,0,407
ODISHA,NUAPADA,2021-03-30,43,214,1,258
ODISHA,PURI,2021-03-26,5,559,0,564
ODISHA,PURI,2021-03-27,9,848,1,858
ODISHA,PURI,2021-03-28,2,507,0,509
ODISHA,PURI,2021-03-29,6,352,0,358
ODISHA,PURI,2021-03-30,9,574,0,583
ODISHA,RAYAGADA,2021-03-26,1,315,0,316
ODISHA,RAYAGADA,2021-03-27,8,375,1,384
ODISHA,RAYAGADA,2021-03-28,3,137,0,140
ODISHA,RAYAGADA,2021-03-29,1,70,1,72
ODISHA,RAYAGADA,2021-03-30,3,325,0,328
ODISHA,SAMBALPUR,2021-03-26,22,576,0,598
ODISHA,SAMBALPUR,2021-03-27,10,540,0,550
ODISHA,SAMBALPUR,2021-03-28,16,430,1,447
ODISHA,SAMBALPUR,2021-03-29,6,89,0,95
ODISHA,SAMBALPUR,2021-03-30,28,423,0,451
ODISHA,SONEPUR,2021-03-26,0,257,0,257
ODISHA,SONEPUR,2021-03-27,1,293,0,294
ODISHA,SONEPUR,2021-03-28,0,231,0,231
ODISHA,SONEPUR,2021-03-29,1,138,0,139
ODISHA,SONEPUR,2021-03-30,2,422,0,424
ODISHA,SUNDARGARH,2021-03-26,23,594,0,617
ODISHA,SUNDARGARH,2021-03-27,21,533,0,554
ODISHA,SUNDARGARH,2021-03-28,22,188,0,210
ODISHA,SUNDARGARH,2021-03-29,21,269,0,290
ODISHA,SUNDARGARH,2021-03-30,34,600,0,634
PUDUCHERRY,KARAIKAL,2021-03-26,36,469,0,505
PUDUCHERRY,KARAIKAL,2021-03-27,41,435,0,476
PUDUCHERRY,KARAIKAL,2021-03-28,27,291,1,319
PUDUCHERRY,KARAIKAL,2021-03-29,44,413,0,457
PUDUCHERRY,KARAIKAL,2021-03-30,64,574,0,638
PUDUCHERRY,MAHE,2021-03-26,6,95,0,101
PUDUCHERRY,MAHE,2021-03-27,13,3,0,16
PUDUCHERRY,MAHE,2021-03-28,1,43,1,45
PUDUCHERRY,MAHE,2021-03-29,8,36,0,44
PUDUCHERRY,MAHE,2021-03-30,18,56,0,74
PUDUCHERRY,PONDICHERRY,2021-03-26,105,1161,9,1275
PUDUCHERRY,PONDICHERRY,2021-03-27,129,951,11,1091
PUDUCHERRY,PONDICHERRY,2021-03-28,115,812,15,942
PUDUCHERRY,PONDICHERRY,2021-03-29,78,909,1,988
PUDUCHERRY,PONDICHERRY,2021-03-30,50,626,2,678
PUDUCHERRY,YANAM,2021-03-26,1,130,1,132
PUDUCHERRY,YANAM,2021-03-27,0,105,0,105
PUDUCHERRY,YANAM,2021-03-29,2,73,0,75
PUDUCHERRY,YANAM,2021-03-30,1,80,0,81
PUNJAB,AMRITSAR,2021-03-26,520,2574,20,3114
PUNJAB,AMRITSAR,2021-03-27,344,2867,5,3216
PUNJAB,AMRITSAR,2021-03-28,437,1988,17,2442
PUNJAB,AMRITSAR,2021-03-29,503,2883,18,3404
PUNJAB,AMRITSAR,2021-03-30,390,2587,5,2982
PUNJAB,BARNALA,2021-03-26,3,28,2,33
PUNJAB,BARNALA,2021-03-27,35,969,20,1024
PUNJAB,BARNALA,2021-03-28,27,697,11,735
PUNJAB,BARNALA,2021-03-29,5,255,2,262
PUNJAB,BARNALA,2021-03-30,4,51,0,55
PUNJAB,BATHINDA,2021-03-26,87,685,28,800
PUNJAB,BATHINDA,2021-03-27,81,1549,133,1763
PUNJAB,BATHINDA,2021-03-28,91,730,24,845
PUNJAB,BATHINDA,2021-03-29,63,1276,25,1364
PUNJAB,BATHINDA,2021-03-30,75,1007,14,1096
PUNJAB,FARIDKOT,2021-03-26,26,70,21,117
PUNJAB,FARIDKOT,2021-03-27,54,464,24,542
PUNJAB,FARIDKOT,2021-03-28,41,110,8,159
PUNJAB,FARIDKOT,2021-03-29,13,127,5,145
PUNJAB,FARIDKOT,2021-03-30,14,948,3,965
PUNJAB,FATEHGARH SAHIB,2021-03-26,32,420,0,452
PUNJAB,FATEHGARH SAHIB,2021-03-27,31,510,9,550
PUNJAB,FATEHGARH SAHIB,2021-03-28,83,353,1,437
PUNJAB,FATEHGARH SAHIB,2021-03-29,16,183,1,200
PUNJAB,FATEHGARH SAHIB,2021-03-30,31,356,1,388
PUNJAB,FAZILKA,2021-03-26,7,803,7,817
PUNJAB,FAZILKA,2021-03-27,22,605,5,632
PUNJAB,FAZILKA,2021-03-28,40,190,2,232
PUNJAB,FAZILKA,2021-03-29,23,55,1,79
PUNJAB,FAZILKA,2021-03-30,21,189,0,210
PUNJAB,FIROZEPUR,2021-03-26,37,978,9,1024
PUNJAB,FIROZEPUR,2021-03-27,5,540,15,560
PUNJAB,FIROZEPUR,2021-03-28,41,119,6,166
PUNJAB,FIROZEPUR,2021-03-29,38,191,2,231
PUNJAB,FIROZEPUR,2021-03-30,9,463,0,472
PUNJAB,GURDASPUR,2021-03-26,113,707,0,820
PUNJAB,GURDASPUR,2021-03-27,89,865,1,955
PUNJAB,GURDASPUR,2021-03-28,93,619,2,714
PUNJAB,GURDASPUR,2021-03-29,218,1055,2,1275
PUNJAB,GURDASPUR,2021-03-30,180,1349,2,1531
PUNJAB,HOSHIARPUR,2021-03-26,374,2392,14,2780
PUNJAB,HOSHIARPUR,2021-03-27,416,2704,26,3146
PUNJAB,HOSHIARPUR,2021-03-28,226,2232,21,2479
PUNJAB,HOSHIARPUR,2021-03-29,233,2145,20,2398
PUNJAB,HOSHIARPUR,2021-03-30,227,1471,9,1707
PUNJAB,JALANDHAR,2021-03-26,630,4149,109,4888
PUNJAB,JALANDHAR,2021-03-27,704,4034,114,4852
PUNJAB,JALANDHAR,2021-03-28,484,3920,274,4678
PUNJAB,JALANDHAR,2021-03-29,462,3486,34,3982
PUNJAB,JALANDHAR,2021-03-30,315,4445,0,4760
PUNJAB,KAPURTHALA,2021-03-26,234,820,1,1055
PUNJAB,KAPURTHALA,2021-03-27,109,461,2,572
PUNJAB,KAPURTHALA,2021-03-28,60,219,84,363
PUNJAB,KAPURTHALA,2021-03-29,123,334,35,492
PUNJAB,KAPURTHALA,2021-03-30,87,876,1,964
PUNJAB,LUDHIANA,2021-03-26,477,3446,10,3933
PUNJAB,LUDHIANA,2021-03-27,443,5354,21,5818
PUNJAB,LUDHIANA,2021-03-28,551,3727,22,4300
PUNJAB,LUDHIANA,2021-03-29,363,3320,4,3687
PUNJAB,LUDHIANA,2021-03-30,421,4104,71,4596
PUNJAB,MANSA,2021-03-26,2,900,1,903
PUNJAB,MANSA,2021-03-27,47,39,0,86
PUNJAB,MANSA,2021-03-28,26,718,1,745
PUNJAB,MANSA,2021-03-29,52,823,0,875
PUNJAB,MANSA,2021-03-30,18,538,1,557
PUNJAB,MOGA,2021-03-26,51,711,109,871
PUNJAB,MOGA,2021-03-27,9,908,18,935
PUNJAB,MOGA,2021-03-28,107,132,58,297
PUNJAB,MOGA,2021-03-29,23,625,2,650
PUNJAB,MOGA,2021-03-30,13,661,0,674
PUNJAB,PATHANKOT,2021-03-26,70,311,1,382
PUNJAB,PATHANKOT,2021-03-27,47,1163,13,1223
PUNJAB,PATHANKOT,2021-03-28,2,332,1,335
PUNJAB,PATHANKOT,2021-03-29,51,220,1,272
PUNJAB,PATHANKOT,2021-03-30,47,1171,7,1225
PUNJAB,PATIALA,2021-03-26,325,2106,0,2431
PUNJAB,PATIALA,2021-03-27,316,1592,1,1909
PUNJAB,PATIALA,2021-03-28,272,1731,3,2006
PUNJAB,PATIALA,2021-03-29,296,2480,0,2776
PUNJAB,PATIALA,2021-03-30,213,1522,0,1735
PUNJAB,RUPNAGAR,2021-03-26,102,677,1,780
PUNJAB,RUPNAGAR,2021-03-27,134,780,1,915
PUNJAB,RUPNAGAR,2021-03-28,84,516,0,600
PUNJAB,RUPNAGAR,2021-03-29,98,577,1,676
PUNJAB,RUPNAGAR,2021-03-30,111,544,3,658
PUNJAB,S.A.S NAGAR,2021-03-26,364,1375,9,1748
PUNJAB,S.A.S NAGAR,2021-03-27,391,1617,8,2016
PUNJAB,S.A.S NAGAR,2021-03-28,292,1176,4,1472
PUNJAB,S.A.S NAGAR,2021-03-29,322,1395,12,1729
PUNJAB,S.A.S NAGAR,2021-03-30,242,1317,12,1571
PUNJAB,SANGRUR,2021-03-26,32,1476,0,1508
PUNJAB,SANGRUR,2021-03-27,86,1253,0,1339
PUNJAB,SANGRUR,2021-03-28,55,307,0,362
PUNJAB,SANGRUR,2021-03-29,82,2126,0,2208
PUNJAB,SANGRUR,2021-03-30,45,1350,31,1426
PUNJAB,SHAHID BHAGAT SINGH NAGAR,2021-03-26,32,1432,0,1464
PUNJAB,SHAHID BHAGAT SINGH NAGAR,2021-03-27,98,916,2,1016
PUNJAB,SHAHID BHAGAT SINGH NAGAR,2021-03-28,181,398,1,580
PUNJAB,SHAHID BHAGAT SINGH NAGAR,2021-03-29,154,1167,0,1321
PUNJAB,SHAHID BHAGAT SINGH NAGAR,2021-03-30,72,265,0,337
PUNJAB,SRI MUKTSAR SAHIB,2021-03-26,13,138,1,152
PUNJAB,SRI MUKTSAR SAHIB,2021-03-27,19,1295,36,1350
PUNJAB,SRI MUKTSAR SAHIB,2021-03-28,100,658,58,816
PUNJAB,SRI MUKTSAR SAHIB,2021-03-29,47,1138,62,1247
PUNJAB,SRI MUKTSAR SAHIB,2021-03-30,25,558,0,583
PUNJAB,TARN TARAN,2021-03-26,36,404,0,440
PUNJAB,TARN TARAN,2021-03-27,15,528,0,543
PUNJAB,TARN TARAN,2021-03-28,37,468,5,510
PUNJAB,TARN TARAN,2021-03-29,16,432,0,448
PUNJAB,TARN TARAN,2021-03-30,24,263,2,289
RAJASTHAN,AJMER,2021-03-26,4,84,1079,1167
RAJASTHAN,AJMER,2021-03-27,2,60,852,914
RAJASTHAN,AJMER,2021-03-28,4,62,545,611
RAJASTHAN,AJMER,2021-03-29,2,36,233,271
RAJASTHAN,AJMER,2021-03-30,1,65,886,952
RAJASTHAN,ALWAR,2021-03-26,6,984,13,1003
RAJASTHAN,ALWAR,2021-03-27,3,637,7,647
RAJASTHAN,ALWAR,2021-03-28,13,966,7,986
RAJASTHAN,ALWAR,2021-03-29,1,174,0,175
RAJASTHAN,ALWAR,2021-03-30,20,1258,23,1301
RAJASTHAN,BANSWARA,2021-03-26,1,90,2,93
RAJASTHAN,BANSWARA,2021-03-27,0,142,0,142
RAJASTHAN,BANSWARA,2021-03-28,0,42,0,42
RAJASTHAN,BANSWARA,2021-03-29,1,12,0,13
RAJASTHAN,BANSWARA,2021-03-30,0,21,0,21
RAJASTHAN,BARAN,2021-03-26,3,32,0,35
RAJASTHAN,BARAN,2021-03-27,1,31,0,32
RAJASTHAN,BARAN,2021-03-28,0,26,1,27
RAJASTHAN,BARAN,2021-03-29,0,3,0,3
RAJASTHAN,BARAN,2021-03-30,27,152,0,179
RAJASTHAN,BARMER,2021-03-26,0,41,0,41
RAJASTHAN,BARMER,2021-03-27,1,38,1,40
RAJASTHAN,BARMER,2021-03-28,0,19,0,19
RAJASTHAN,BARMER,2021-03-29,1,23,0,24
RAJASTHAN,BARMER,2021-03-30,0,89,0,89
RAJASTHAN,BHARATPUR,2021-03-26,3,286,1,290
RAJASTHAN,BHARATPUR,2021-03-27,6,740,8,754
RAJASTHAN,BHARATPUR,2021-03-28,2,441,3,446
RAJASTHAN,BHARATPUR,2021-03-29,13,335,0,348
RAJASTHAN,BHARATPUR,2021-03-30,1,202,0,203
RAJASTHAN,BHILWARA,2021-03-26,73,717,4,794
RAJASTHAN,BHILWARA,2021-03-27,41,832,1,874
RAJASTHAN,BHILWARA,2021-03-28,41,912,2,955
RAJASTHAN,BHILWARA,2021-03-29,35,382,0,417
RAJASTHAN,BHILWARA,2021-03-30,14,283,2,299
RAJASTHAN,BIKANER,2021-03-26,2,817,5,824
RAJASTHAN,BIKANER,2021-03-27,6,827,3,836
RAJASTHAN,BIKANER,2021-03-28,3,258,0,261
RAJASTHAN,BIKANER,2021-03-29,1,28,2,31
RAJASTHAN,BIKANER,2021-03-30,35,373,2,410
RAJASTHAN,BUNDI,2021-03-26,0,57,1,58
RAJASTHAN,BUNDI,2021-03-27,1,137,1,139
RAJASTHAN,BUNDI,2021-03-28,0,86,0,86
RAJASTHAN,BUNDI,2021-03-29,0,7,0,7
RAJASTHAN,BUNDI,2021-03-30,0,46,2,48
RAJASTHAN,CHITTORGARH,2021-03-26,23,302,0,325
RAJASTHAN,CHITTORGARH,2021-03-27,5,342,13,360
RAJASTHAN,CHITTORGARH,2021-03-28,29,346,0,375
RAJASTHAN,CHITTORGARH,2021-03-29,0,65,0,65
RAJASTHAN,CHITTORGARH,2021-03-30,3,470,3,476
RAJASTHAN,CHURU,2021-03-26,1,636,4,641
RAJASTHAN,CHURU,2021-03-27,4,546,4,554
RAJASTHAN,CHURU,2021-03-28,2,570,0,572
RAJASTHAN,CHURU,2021-03-29,1,52,0,53
RAJASTHAN,CHURU,2021-03-30,0,221,5,226
RAJASTHAN,DAUSA,2021-03-26,0,242,12,254
RAJASTHAN,DAUSA,2021-03-27,2,432,5,439
RAJASTHAN,DAUSA,2021-03-28,3,663,27,693
RAJASTHAN,DAUSA,2021-03-29,1,101,0,102
RAJASTHAN,DAUSA,2021-03-30,0,294,7,301
RAJASTHAN,DHOLPUR,2021-03-26,0,10,0,10
RAJASTHAN,DHOLPUR,2021-03-27,7,16,0,23
RAJASTHAN,DHOLPUR,2021-03-28,4,13,0,17
RAJASTHAN,DHOLPUR,2021-03-29,0,1,0,1
RAJASTHAN,DHOLPUR,2021-03-30,4,21,1,26
RAJASTHAN,DUNGARPUR,2021-03-26,27,481,0,508
RAJASTHAN,DUNGARPUR,2021-03-27,4,457,0,461
RAJASTHAN,DUNGARPUR,2021-03-28,0,286,0,286
RAJASTHAN,DUNGARPUR,2021-03-29,3,261,0,264
RAJASTHAN,DUNGARPUR,2021-03-30,1,290,0,291
RAJASTHAN,GANGANAGAR,2021-03-26,18,58,6,82
RAJASTHAN,GANGANAGAR,2021-03-27,36,119,7,162
RAJASTHAN,GANGANAGAR,2021-03-28,29,82,2,113
RAJASTHAN,GANGANAGAR,2021-03-29,1,13,0,14
RAJASTHAN,GANGANAGAR,2021-03-30,58,132,2,192
RAJASTHAN,HANUMANGARH,2021-03-26,1,630,0,631
RAJASTHAN,HANUMANGARH,2021-03-27,4,749,1,754
RAJASTHAN,HANUMANGARH,2021-03-28,1,374,0,375
RAJASTHAN,HANUMANGARH,2021-03-29,0,380,0,380
RAJASTHAN,HANUMANGARH,2021-03-30,4,616,2,622
RAJASTHAN,JAIPUR,2021-03-26,199,3721,490,4410
RAJASTHAN,JAIPUR,2021-03-27,209,3801,468,4478
RAJASTHAN,JAIPUR,2021-03-28,162,2902,500,3564
RAJASTHAN,JAIPUR,2021-03-29,57,1553,4,1614
RAJASTHAN,JAIPUR,2021-03-30,150,2003,635,2788
RAJASTHAN,JAISALMER,2021-03-26,1,16,0,17
RAJASTHAN,JAISALMER,2021-03-27,3,48,0,51
RAJASTHAN,JAISALMER,2021-03-28,0,112,0,112
RAJASTHAN,JAISALMER,2021-03-29,0,5,0,5
RAJASTHAN,JAISALMER,2021-03-30,15,41,0,56
RAJASTHAN,JALORE,2021-03-26,9,647,1,657
RAJASTHAN,JALORE,2021-03-27,10,623,3,636
RAJASTHAN,JALORE,2021-03-28,3,722,0,725
RAJASTHAN,JALORE,2021-03-29,0,241,0,241
RAJASTHAN,JALORE,2021-03-30,12,515,1,528
RAJASTHAN,JHALAWAR,2021-03-26,3,411,0,414
RAJASTHAN,JHALAWAR,2021-03-27,35,345,0,380
RAJASTHAN,JHALAWAR,2021-03-28,24,881,5,910
RAJASTHAN,JHALAWAR,2021-03-29,0,157,0,157
RAJASTHAN,JHALAWAR,2021-03-30,4,344,0,348
RAJASTHAN,JHUNJHUNU,2021-03-26,5,133,1,139
RAJASTHAN,JHUNJHUNU,2021-03-27,2,62,3,67
RAJASTHAN,JHUNJHUNU,2021-03-28,4,67,4,75
RAJASTHAN,JHUNJHUNU,2021-03-29,1,56,0,57
RAJASTHAN,JHUNJHUNU,2021-03-30,2,90,3,95
RAJASTHAN,JODHPUR,2021-03-26,109,980,11,1100
RAJASTHAN,JODHPUR,2021-03-27,68,706,4,778
RAJASTHAN,JODHPUR,2021-03-28,27,165,5,197
RAJASTHAN,JODHPUR,2021-03-29,8,83,1,92
RAJASTHAN,JODHPUR,2021-03-30,81,618,2,701
RAJASTHAN,KARAULI,2021-03-26,5,207,2,214
RAJASTHAN,KARAULI,2021-03-27,0,93,3,96
RAJASTHAN,KARAULI,2021-03-28,1,29,1,31
RAJASTHAN,KARAULI,2021-03-29,0,306,7,313
RAJASTHAN,KARAULI,2021-03-30,16,273,6,295
RAJASTHAN,KOTA,2021-03-26,149,1719,4,1872
RAJASTHAN,KOTA,2021-03-27,178,1928,7,2113
RAJASTHAN,KOTA,2021-03-28,4,1428,10,1442
RAJASTHAN,KOTA,2021-03-29,2,114,1,117
RAJASTHAN,KOTA,2021-03-30,84,1760,17,1861
RAJASTHAN,NAGAUR,2021-03-26,2,65,129,196
RAJASTHAN,NAGAUR,2021-03-27,6,53,27,86
RAJASTHAN,NAGAUR,2021-03-28,2,29,23,54
RAJASTHAN,NAGAUR,2021-03-29,2,46,23,71
RAJASTHAN,NAGAUR,2021-03-30,0,60,21,81
RAJASTHAN,PALI,2021-03-26,7,278,7,292
RAJASTHAN,PALI,2021-03-27,3,617,14,634
RAJASTHAN,PALI,2021-03-28,4,460,3,467
RAJASTHAN,PALI,2021-03-29,0,278,5,283
RAJASTHAN,PALI,2021-03-30,7,689,51,747
RAJASTHAN,PRATAPGARH,2021-03-26,0,11,1,12
RAJASTHAN,PRATAPGARH,2021-03-27,12,22,0,34
RAJASTHAN,PRATAPGARH,2021-03-28,22,9,0,31
RAJASTHAN,PRATAPGARH,2021-03-29,0,3,0,3
RAJASTHAN,PRATAPGARH,2021-03-30,28,3,0,31
RAJASTHAN,RAJSAMAND,2021-03-26,3,32,0,35
RAJASTHAN,RAJSAMAND,2021-03-27,5,20,1,26
RAJASTHAN,RAJSAMAND,2021-03-28,2,9,0,11
RAJASTHAN,RAJSAMAND,2021-03-29,0,9,0,9
RAJASTHAN,RAJSAMAND,2021-03-30,14,178,0,192
RAJASTHAN,SAWAI MADHOPUR,2021-03-26,0,265,2,267
RAJASTHAN,SAWAI MADHOPUR,2021-03-27,1,98,4,103
RAJASTHAN,SAWAI MADHOPUR,2021-03-28,0,213,1,214
RAJASTHAN,SAWAI MADHOPUR,2021-03-29,1,9,0,10
RAJASTHAN,SAWAI MADHOPUR,2021-03-30,0,24,8,32
RAJASTHAN,SIKAR,2021-03-26,3,213,11,227
RAJASTHAN,SIKAR,2021-03-27,4,73,12,89
RAJASTHAN,SIKAR,2021-03-28,4,73,5,82
RAJASTHAN,SIKAR,2021-03-29,2,95,0,97
RAJASTHAN,SIKAR,2021-03-30,2,100,13,115
RAJASTHAN,SIROHI,2021-03-26,0,22,0,22
RAJASTHAN,SIROHI,2021-03-27,1,15,0,16
RAJASTHAN,SIROHI,2021-03-28,1,2,0,3
RAJASTHAN,SIROHI,2021-03-29,0,3,0,3
RAJASTHAN,SIROHI,2021-03-30,2,10,0,12
RAJASTHAN,TONK,2021-03-26,0,169,6,175
RAJASTHAN,TONK,2021-03-27,1,28,5,34
RAJASTHAN,TONK,2021-03-28,0,186,3,189
RAJASTHAN,TONK,2021-03-29,0,18,0,18
RAJASTHAN,TONK,2021-03-30,1,219,5,225
RAJASTHAN,UDAIPUR,2021-03-26,501,1121,2,1624
RAJASTHAN,UDAIPUR,2021-03-27,438,2243,4,2685
RAJASTHAN,UDAIPUR,2021-03-28,351,524,2,877
RAJASTHAN,UDAIPUR,2021-03-29,243,1238,0,1481
RAJASTHAN,UDAIPUR,2021-03-30,157,485,4,646
SIKKIM,EAST DISTRICT,2021-03-26,9,64,0,73
SIKKIM,EAST DISTRICT,2021-03-27,0,93,0,93
SIKKIM,EAST DISTRICT,2021-03-28,1,4,0,5
SIKKIM,EAST DISTRICT,2021-03-29,5,53,0,58
SIKKIM,EAST DISTRICT,2021-03-30,0,84,0,84
SIKKIM,NORTH DISTRICT,2021-03-26,0,3,0,3
SIKKIM,NORTH DISTRICT,2021-03-27,0,6,0,6
SIKKIM,NORTH DISTRICT,2021-03-28,0,3,0,3
SIKKIM,NORTH DISTRICT,2021-03-29,0,7,0,7
SIKKIM,NORTH DISTRICT,2021-03-30,0,2,0,2
SIKKIM,SOUTH DISTRICT,2021-03-26,2,27,0,29
SIKKIM,SOUTH DISTRICT,2021-03-27,0,3,0,3
SIKKIM,SOUTH DISTRICT,2021-03-28,0,3,0,3
SIKKIM,SOUTH DISTRICT,2021-03-29,0,4,0,4
SIKKIM,SOUTH DISTRICT,2021-03-30,1,19,0,20
SIKKIM,WEST DISTRICT,2021-03-26,0,6,0,6
SIKKIM,WEST DISTRICT,2021-03-27,0,9,0,9
SIKKIM,WEST DISTRICT,2021-03-29,1,3,0,4
SIKKIM,WEST DISTRICT,2021-03-30,0,5,0,5
TAMIL NADU,ARIYALUR,2021-03-26,5,654,0,659
TAMIL NADU,ARIYALUR,2021-03-27,8,309,0,317
TAMIL NADU,ARIYALUR,2021-03-28,1,185,0,186
TAMIL NADU,ARIYALUR,2021-03-29,3,627,0,630
TAMIL NADU,ARIYALUR,2021-03-30,8,650,0,658
TAMIL NADU,CHENGALPATTU,2021-03-26,197,6341,2,6540
TAMIL NADU,CHENGALPATTU,2021-03-27,156,5789,0,5945
TAMIL NADU,CHENGALPATTU,2021-03-28,168,5242,0,5410
TAMIL NADU,CHENGALPATTU,2021-03-29,216,6638,2,6856
TAMIL NADU,CHENGALPATTU,2021-03-30,240,4289,3,4532
TAMIL NADU,CHENNAI,2021-03-26,1101,13000,52,14153
TAMIL NADU,CHENNAI,2021-03-27,1152,13215,18,14385
TAMIL NADU,CHENNAI,2021-03-28,927,11341,14,12282
TAMIL NADU,CHENNAI,2021-03-29,1140,11121,11,12272
TAMIL NADU,CHENNAI,2021-03-30,1363,12705,33,14101
TAMIL NADU,COIMBATORE,2021-03-26,218,3710,0,3928
TAMIL NADU,COIMBATORE,2021-03-27,291,4215,0,4506
TAMIL NADU,COIMBATORE,2021-03-28,271,2322,1,2594
TAMIL NADU,COIMBATORE,2021-03-29,211,3431,0,3642
TAMIL NADU,COIMBATORE,2021-03-30,327,3858,0,4185
TAMIL NADU,CUDDALORE,2021-03-26,64,3221,0,3285
TAMIL NADU,CUDDALORE,2021-03-27,33,3987,0,4020
TAMIL NADU,CUDDALORE,2021-03-28,20,933,0,953
TAMIL NADU,CUDDALORE,2021-03-29,89,2515,1,2605
TAMIL NADU,CUDDALORE,2021-03-30,56,2538,0,2594
TAMIL NADU,DHARMAPURI,2021-03-26,8,955,0,963
TAMIL NADU,DHARMAPURI,2021-03-27,10,813,3,826
TAMIL NADU,DHARMAPURI,2021-03-28,10,803,0,813
TAMIL NADU,DHARMAPURI,2021-03-29,7,1117,3,1127
TAMIL NADU,DHARMAPURI,2021-03-30,16,873,4,893
TAMIL NADU,DINDIGUL,2021-03-26,26,2434,0,2460
TAMIL NADU,DINDIGUL,2021-03-27,27,2756,2,2785
TAMIL NADU,DINDIGUL,2021-03-28,30,2925,0,2955
TAMIL NADU,DINDIGUL,2021-03-29,10,3391,0,3401
TAMIL NADU,DINDIGUL,2021-03-30,48,4190,12,4250
TAMIL NADU,ERODE,2021-03-26,31,2759,0,2790
TAMIL NADU,ERODE,2021-03-27,38,2379,0,2417
TAMIL NADU,ERODE,2021-03-28,44,2230,0,2274
TAMIL NADU,ERODE,2021-03-29,38,828,0,866
TAMIL NADU,ERODE,2021-03-30,47,2156,0,2203
TAMIL NADU,KALLAKURICHI,2021-03-26,4,409,0,413
TAMIL NADU,KALLAKURICHI,2021-03-27,1,584,0,585
TAMIL NADU,KALLAKURICHI,2021-03-28,6,606,1,613
TAMIL NADU,KALLAKURICHI,2021-03-29,1,341,0,342
TAMIL NADU,KALLAKURICHI,2021-03-30,14,360,0,374
TAMIL NADU,KANCHIPURAM,2021-03-26,80,3657,8,3745
TAMIL NADU,KANCHIPURAM,2021-03-27,82,3011,1,3094
TAMIL NADU,KANCHIPURAM,2021-03-28,86,1972,1,2059
TAMIL NADU,KANCHIPURAM,2021-03-29,70,2310,2,2382
TAMIL NADU,KANCHIPURAM,2021-03-30,106,1944,4,2054
TAMIL NADU,KANNIYAKUMARI,2021-03-26,17,1803,7,1827
TAMIL NADU,KANNIYAKUMARI,2021-03-27,18,1971,4,1993
TAMIL NADU,KANNIYAKUMARI,2021-03-28,20,1373,4,1397
TAMIL NADU,KANNIYAKUMARI,2021-03-29,60,2097,4,2161
TAMIL NADU,KANNIYAKUMARI,2021-03-30,29,2033,2,2064
TAMIL NADU,KARUR,2021-03-26,12,1016,0,1028
TAMIL NADU,KARUR,2021-03-27,6,1088,1,1095
TAMIL NADU,KARUR,2021-03-28,10,852,1,863
TAMIL NADU,KARUR,2021-03-29,12,811,1,824
TAMIL NADU,KARUR,2021-03-30,11,1110,0,1121
TAMIL NADU,KRISHNAGIRI,2021-03-26,30,1044,1,1075
TAMIL NADU,KRISHNAGIRI,2021-03-27,28,1907,3,1938
TAMIL NADU,KRISHNAGIRI,2021-03-28,31,1160,3,1194
TAMIL NADU,KRISHNAGIRI,2021-03-29,15,3090,1,3106
TAMIL NADU,KRISHNAGIRI,2021-03-30,53,1449,5,1507
TAMIL NADU,MADURAI,2021-03-26,41,2641,1,2683
TAMIL NADU,MADURAI,2021-03-27,31,3099,0,3130
TAMIL NADU,MADURAI,2021-03-28,40,2032,0,2072
TAMIL NADU,MADURAI,2021-03-29,74,3438,1,3513
TAMIL NADU,MADURAI,2021-03-30,70,3509,0,3579
TAMIL NADU,NAGAPATTINAM,2021-03-26,66,1216,0,1282
TAMIL NADU,NAGAPATTINAM,2021-03-27,36,954,0,990
TAMIL NADU,NAGAPATTINAM,2021-03-28,53,799,0,852
TAMIL NADU,NAGAPATTINAM,2021-03-29,79,708,0,787
TAMIL NADU,NAGAPATTINAM,2021-03-30,38,1067,0,1105
TAMIL NADU,NAMAKKAL,2021-03-26,29,1167,0,1196
TAMIL NADU,NAMAKKAL,2021-03-27,14,1146,2,1162
TAMIL NADU,NAMAKKAL,2021-03-28,9,631,0,640
TAMIL NADU,NAMAKKAL,2021-03-29,37,960,3,1000
TAMIL NADU,NAMAKKAL,2021-03-30,13,1509,2,1524
TAMIL NADU,PERAMBALUR,2021-03-26,1,546,0,547
TAMIL NADU,PERAMBALUR,2021-03-27,0,673,1,674
TAMIL NADU,PERAMBALUR,2021-03-28,2,573,0,575
TAMIL NADU,PERAMBALUR,2021-03-29,0,263,0,263
TAMIL NADU,PERAMBALUR,2021-03-30,1,521,0,522
TAMIL NADU,PUDUKKOTTAI,2021-03-26,15,1353,0,1368
TAMIL NADU,PUDUKKOTTAI,2021-03-27,13,1261,1,1275
TAMIL NADU,PUDUKKOTTAI,2021-03-28,23,1013,1,1037
TAMIL NADU,PUDUKKOTTAI,2021-03-29,15,388,1,404
TAMIL NADU,PUDUKKOTTAI,2021-03-30,34,1478,0,1512
TAMIL NADU,RAMANATHAPURAM,2021-03-26,5,1062,0,1067
TAMIL NADU,RAMANATHAPURAM,2021-03-27,7,609,0,616
TAMIL NADU,RAMANATHAPURAM,2021-03-28,4,1370,0,1374
TAMIL NADU,RAMANATHAPURAM,2021-03-29,10,963,0,973
TAMIL NADU,RAMANATHAPURAM,2021-03-30,8,966,0,974
TAMIL NADU,RANIPET,2021-03-26,27,311,0,338
TAMIL NADU,RANIPET,2021-03-27,24,642,0,666
TAMIL NADU,RANIPET,2021-03-28,33,47,0,80
TAMIL NADU,RANIPET,2021-03-29,3,381,0,384
TAMIL NADU,RANIPET,2021-03-30,35,510,0,545
TAMIL NADU,SALEM,2021-03-26,34,3730,5,3769
TAMIL NADU,SALEM,2021-03-27,69,3025,7,3101
TAMIL NADU,SALEM,2021-03-28,73,1769,0,1842
TAMIL NADU,SALEM,2021-03-29,20,2451,8,2479
TAMIL NADU,SALEM,2021-03-30,27,2941,4,2972
TAMIL NADU,SIVAGANGA,2021-03-26,24,967,0,991
TAMIL NADU,SIVAGANGA,2021-03-27,14,784,1,799
TAMIL NADU,SIVAGANGA,2021-03-28,12,440,0,452
TAMIL NADU,SIVAGANGA,2021-03-29,22,986,0,1008
TAMIL NADU,SIVAGANGA,2021-03-30,24,819,0,843
TAMIL NADU,TENKASI,2021-03-26,5,738,1,744
TAMIL NADU,TENKASI,2021-03-27,14,778,3,795
TAMIL NADU,TENKASI,2021-03-28,6,558,3,567
TAMIL NADU,TENKASI,2021-03-29,7,370,0,377
TAMIL NADU,TENKASI,2021-03-30,29,663,5,697
TAMIL NADU,THANJAVUR,2021-03-26,71,4698,0,4769
TAMIL NADU,THANJAVUR,2021-03-27,78,3547,1,3626
TAMIL NADU,THANJAVUR,2021-03-28,189,3461,3,3653
TAMIL NADU,THANJAVUR,2021-03-29,108,2184,3,2295
TAMIL NADU,THANJAVUR,2021-03-30,130,1774,0,1904
TAMIL NADU,THE NILGIRIS,2021-03-26,24,1058,1,1083
TAMIL NADU,THE NILGIRIS,2021-03-27,30,1194,7,1231
TAMIL NADU,THE NILGIRIS,2021-03-28,17,1441,2,1460
TAMIL NADU,THE NILGIRIS,2021-03-29,14,1236,0,1250
TAMIL NADU,THE NILGIRIS,2021-03-30,34,1327,3,1364
TAMIL NADU,THENI,2021-03-26,7,592,0,599
TAMIL NADU,THENI,2021-03-27,13,509,0,522
TAMIL NADU,THENI,2021-03-28,7,317,0,324
TAMIL NADU,THENI,2021-03-29,9,137,0,146
TAMIL NADU,THENI,2021-03-30,18,590,0,608
TAMIL NADU,THIRUVALLUR,2021-03-26,111,2564,6,2681
TAMIL NADU,THIRUVALLUR,2021-03-27,121,3218,6,3345
TAMIL NADU,THIRUVALLUR,2021-03-28,125,2521,3,2649
TAMIL NADU,THIRUVALLUR,2021-03-29,78,2132,2,2212
TAMIL NADU,THIRUVALLUR,2021-03-30,167,3688,9,3864
TAMIL NADU,THIRUVARUR,2021-03-26,42,1645,1,1688
TAMIL NADU,THIRUVARUR,2021-03-27,69,1184,0,1253
TAMIL NADU,THIRUVARUR,2021-03-28,66,399,0,465
TAMIL NADU,THIRUVARUR,2021-03-29,52,1470,0,1522
TAMIL NADU,THIRUVARUR,2021-03-30,42,979,0,1021
TAMIL NADU,TIRUCHIRAPPALLI,2021-03-26,55,2814,0,2869
TAMIL NADU,TIRUCHIRAPPALLI,2021-03-27,65,2627,0,2692
TAMIL NADU,TIRUCHIRAPPALLI,2021-03-28,64,2451,12,2527
TAMIL NADU,TIRUCHIRAPPALLI,2021-03-29,59,2533,1,2593
TAMIL NADU,TIRUCHIRAPPALLI,2021-03-30,132,2957,1,3090
TAMIL NADU,TIRUNELVELI,2021-03-26,37,1123,2,1162
TAMIL NADU,TIRUNELVELI,2021-03-27,25,1466,3,1494
TAMIL NADU,TIRUNELVELI,2021-03-28,10,357,1,368
TAMIL NADU,TIRUNELVELI,2021-03-29,46,1146,1,1193
TAMIL NADU,TIRUNELVELI,2021-03-30,59,1235,1,1295
TAMIL NADU,TIRUPATHUR,2021-03-26,14,2693,10,2717
TAMIL NADU,TIRUPATHUR,2021-03-27,25,1706,0,1731
TAMIL NADU,TIRUPATHUR,2021-03-28,11,2303,0,2314
TAMIL NADU,TIRUPATHUR,2021-03-29,7,2815,0,2822
TAMIL NADU,TIRUPATHUR,2021-03-30,4,2014,0,2018
TAMIL NADU,TIRUPPUR,2021-03-26,57,1745,0,1802
TAMIL NADU,TIRUPPUR,2021-03-27,81,2470,3,2554
TAMIL NADU,TIRUPPUR,2021-03-28,79,1671,0,1750
TAMIL NADU,TIRUPPUR,2021-03-29,33,714,3,750
TAMIL NADU,TIRUPPUR,2021-03-30,74,1586,2,1662
TAMIL NADU,TIRUVANNAMALAI,2021-03-26,18,931,0,949
TAMIL NADU,TIRUVANNAMALAI,2021-03-27,8,744,0,752
TAMIL NADU,TIRUVANNAMALAI,2021-03-28,11,315,0,326
TAMIL NADU,TIRUVANNAMALAI,2021-03-29,11,867,1,879
TAMIL NADU,TIRUVANNAMALAI,2021-03-30,38,1130,3,1171
TAMIL NADU,TUTICORIN,2021-03-26,18,954,4,976
TAMIL NADU,TUTICORIN,2021-03-27,22,936,4,962
TAMIL NADU,TUTICORIN,2021-03-28,16,819,7,842
TAMIL NADU,TUTICORIN,2021-03-29,9,349,0,358
TAMIL NADU,TUTICORIN,2021-03-30,18,1020,7,1045
TAMIL NADU,VELLORE,2021-03-26,25,1602,0,1627
TAMIL NADU,VELLORE,2021-03-27,41,1582,0,1623
TAMIL NADU,VELLORE,2021-03-28,28,609,0,637
TAMIL NADU,VELLORE,2021-03-29,45,1484,1,1530
TAMIL NADU,VELLORE,2021-03-30,59,1852,4,1915
TAMIL NADU,VILLUPURAM,2021-03-26,21,1191,0,1212
TAMIL NADU,VILLUPURAM,2021-03-27,21,1393,0,1414
TAMIL NADU,VILLUPURAM,2021-03-28,34,1139,1,1174
TAMIL NADU,VILLUPURAM,2021-03-29,8,393,0,401
TAMIL NADU,VILLUPURAM,2021-03-30,40,1105,0,1145
TAMIL NADU,VIRUDHUNAGAR,2021-03-26,18,1148,1,1167
TAMIL NADU,VIRUDHUNAGAR,2021-03-27,11,1010,0,1021
TAMIL NADU,VIRUDHUNAGAR,2021-03-28,13,606,0,619
TAMIL NADU,VIRUDHUNAGAR,2021-03-29,14,505,0,519
TAMIL NADU,VIRUDHUNAGAR,2021-03-30,19,724,1,744
TELANGANA,ADILABAD,2021-03-26,0,755,0,755
TELANGANA,ADILABAD,2021-03-27,0,846,0,846
TELANGANA,ADILABAD,2021-03-28,0,637,0,637
TELANGANA,ADILABAD,2021-03-29,0,741,0,741
TELANGANA,ADILABAD,2021-03-30,1,790,0,791
TELANGANA,BHADRADRI KOTHAGUDEM,2021-03-26,0,604,0,604
TELANGANA,BHADRADRI KOTHAGUDEM,2021-03-27,0,489,0,489
TELANGANA,BHADRADRI KOTHAGUDEM,2021-03-28,0,274,0,274
TELANGANA,BHADRADRI KOTHAGUDEM,2021-03-29,0,283,0,283
TELANGANA,BHADRADRI KOTHAGUDEM,2021-03-30,0,594,0,594
TELANGANA,HYDERABAD,2021-03-26,43,9189,25,9257
TELANGANA,HYDERABAD,2021-03-27,88,9429,9,9526
TELANGANA,HYDERABAD,2021-03-28,72,5120,52,5244
TELANGANA,HYDERABAD,2021-03-29,144,7842,20,8006
TELANGANA,HYDERABAD,2021-03-30,129,9135,25,9289
TELANGANA,JAGITIAL,2021-03-26,0,1004,0,1004
TELANGANA,JAGITIAL,2021-03-27,0,1245,0,1245
TELANGANA,JAGITIAL,2021-03-28,0,659,0,659
TELANGANA,JAGITIAL,2021-03-29,0,890,0,890
TELANGANA,JAGITIAL,2021-03-30,0,1074,0,1074
TELANGANA,JANGOAN,2021-03-26,0,710,0,710
TELANGANA,JANGOAN,2021-03-27,0,718,0,718
TELANGANA,JANGOAN,2021-03-28,0,465,0,465
TELANGANA,JANGOAN,2021-03-29,0,496,0,496
TELANGANA,JANGOAN,2021-03-30,0,735,0,735
TELANGANA,JAYASHANKAR BHUPALAPALLY,2021-03-26,0,564,0,564
TELANGANA,JAYASHANKAR BHUPALAPALLY,2021-03-27,0,608,0,608
TELANGANA,JAYASHANKAR BHUPALAPALLY,2021-03-28,0,406,0,406
TELANGANA,JAYASHANKAR BHUPALAPALLY,2021-03-29,0,476,0,476
TELANGANA,JAYASHANKAR BHUPALAPALLY,2021-03-30,0,593,0,593
TELANGANA,JOGULAMBA GADWAL,2021-03-26,0,783,0,783
TELANGANA,JOGULAMBA GADWAL,2021-03-27,0,590,0,590
TELANGANA,JOGULAMBA GADWAL,2021-03-28,0,767,0,767
TELANGANA,JOGULAMBA GADWAL,2021-03-29,0,739,0,739
TELANGANA,JOGULAMBA GADWAL,2021-03-30,0,1032,0,1032
TELANGANA,KAMAREDDY,2021-03-26,0,665,0,665
TELANGANA,KAMAREDDY,2021-03-27,1,699,0,700
TELANGANA,KAMAREDDY,2021-03-28,0,278,0,278
TELANGANA,KAMAREDDY,2021-03-29,0,314,0,314
TELANGANA,KAMAREDDY,2021-03-30,0,745,0,745
TELANGANA,KARIMNAGAR,2021-03-26,0,1853,0,1853
TELANGANA,KARIMNAGAR,2021-03-27,4,1663,0,1667
TELANGANA,KARIMNAGAR,2021-03-28,1,1214,0,1215
TELANGANA,KARIMNAGAR,2021-03-29,0,1005,0,1005
TELANGANA,KARIMNAGAR,2021-03-30,0,2056,0,2056
TELANGANA,KHAMMAM,2021-03-26,12,902,0,914
TELANGANA,KHAMMAM,2021-03-27,2,957,0,959
TELANGANA,KHAMMAM,2021-03-28,2,306,0,308
TELANGANA,KHAMMAM,2021-03-29,0,570,0,570
TELANGANA,KHAMMAM,2021-03-30,3,1078,0,1081
TELANGANA,KUMURAM BHEEM ASIFABAD,2021-03-26,0,354,0,354
TELANGANA,KUMURAM BHEEM ASIFABAD,2021-03-27,0,388,0,388
TELANGANA,KUMURAM BHEEM ASIFABAD,2021-03-28,0,259,0,259
TELANGANA,KUMURAM BHEEM ASIFABAD,2021-03-29,0,196,0,196
TELANGANA,KUMURAM BHEEM ASIFABAD,2021-03-30,0,321,0,321
TELANGANA,MAHABUBABAD,2021-03-26,1,372,0,373
TELANGANA,MAHABUBABAD,2021-03-27,0,356,0,356
TELANGANA,MAHABUBABAD,2021-03-28,1,83,0,84
TELANGANA,MAHABUBABAD,2021-03-29,0,208,0,208
TELANGANA,MAHABUBABAD,2021-03-30,0,291,0,291
TELANGANA,MAHABUBNAGAR,2021-03-26,0,1696,0,1696
TELANGANA,MAHABUBNAGAR,2021-03-27,0,1533,1,1534
TELANGANA,MAHABUBNAGAR,2021-03-28,0,544,0,544
TELANGANA,MAHABUBNAGAR,2021-03-29,0,685,0,685
TELANGANA,MAHABUBNAGAR,2021-03-30,0,992,0,992
TELANGANA,MANCHERIAL,2021-03-26,0,578,0,578
TELANGANA,MANCHERIAL,2021-03-27,1,1102,0,1103
TELANGANA,MANCHERIAL,2021-03-28,0,550,0,550
TELANGANA,MANCHERIAL,2021-03-29,0,487,0,487
TELANGANA,MANCHERIAL,2021-03-30,0,621,0,621
TELANGANA,MEDAK,2021-03-26,0,352,2,354
TELANGANA,MEDAK,2021-03-27,0,403,0,403
TELANGANA,MEDAK,2021-03-28,2,93,0,95
TELANGANA,MEDAK,2021-03-29,1,319,0,320
TELANGANA,MEDAK,2021-03-30,8,279,0,287
TELANGANA,MEDCHAL MALKAJGIRI,2021-03-26,4,3271,0,3275
TELANGANA,MEDCHAL MALKAJGIRI,2021-03-27,2,2716,0,2718
TELANGANA,MEDCHAL MALKAJGIRI,2021-03-28,4,1713,0,1717
TELANGANA,MEDCHAL MALKAJGIRI,2021-03-29,6,2216,0,2222
TELANGANA,MEDCHAL MALKAJGIRI,2021-03-30,6,2927,2,2935
TELANGANA,MULUGU,2021-03-26,0,509,0,509
TELANGANA,MULUGU,2021-03-27,0,564,0,564
TELANGANA,MULUGU,2021-03-28,0,190,0,190
TELANGANA,MULUGU,2021-03-29,0,242,0,242
TELANGANA,MULUGU,2021-03-30,0,449,0,449
TELANGANA,NAGARKURNOOL,2021-03-26,0,1672,0,1672
TELANGANA,NAGARKURNOOL,2021-03-27,0,1477,0,1477
TELANGANA,NAGARKURNOOL,2021-03-28,0,1447,0,1447
TELANGANA,NAGARKURNOOL,2021-03-29,0,1349,0,1349
TELANGANA,NAGARKURNOOL,2021-03-30,0,1012,0,1012
TELANGANA,NALGONDA,2021-03-26,0,2121,0,2121
TELANGANA,NALGONDA,2021-03-27,2,1942,0,1944
TELANGANA,NALGONDA,2021-03-28,0,1019,0,1019
TELANGANA,NALGONDA,2021-03-29,0,1524,0,1524
TELANGANA,NALGONDA,2021-03-30,2,1598,0,1600
TELANGANA,NARAYANPET,2021-03-26,0,280,0,280
TELANGANA,NARAYANPET,2021-03-27,0,191,0,191
TELANGANA,NARAYANPET,2021-03-28,0,125,0,125
TELANGANA,NARAYANPET,2021-03-29,0,51,0,51
TELANGANA,NARAYANPET,2021-03-30,0,157,0,157
TELANGANA,NIRMAL,2021-03-26,0,1215,0,1215
TELANGANA,NIRMAL,2021-03-27,0,1116,0,1116
TELANGANA,NIRMAL,2021-03-28,0,732,0,732
TELANGANA,NIRMAL,2021-03-29,0,623,0,623
TELANGANA,NIRMAL,2021-03-30,1,1070,0,1071
TELANGANA,NIZAMABAD,2021-03-26,2,1301,0,1303
TELANGANA,NIZAMABAD,2021-03-27,1,1490,0,1491
TELANGANA,NIZAMABAD,2021-03-28,0,474,0,474
TELANGANA,NIZAMABAD,2021-03-29,0,682,1,683
TELANGANA,NIZAMABAD,2021-03-30,0,1239,0,1239
TELANGANA,PEDDAPALLI,2021-03-26,0,1321,0,1321
TELANGANA,PEDDAPALLI,2021-03-27,0,1398,0,1398
TELANGANA,PEDDAPALLI,2021-03-28,0,951,0,951
TELANGANA,PEDDAPALLI,2021-03-29,0,1267,0,1267
TELANGANA,PEDDAPALLI,2021-03-30,0,1410,0,1410
TELANGANA,RAJANNA SIRCILLA,2021-03-26,0,249,0,249
TELANGANA,RAJANNA SIRCILLA,2021-03-27,0,285,0,285
TELANGANA,RAJANNA SIRCILLA,2021-03-28,0,153,0,153
TELANGANA,RAJANNA SIRCILLA,2021-03-29,0,314,0,314
TELANGANA,RAJANNA SIRCILLA,2021-03-30,0,158,0,158
TELANGANA,RANGA REDDY,2021-03-26,7,3140,1,3148
TELANGANA,RANGA REDDY,2021-03-27,16,3640,0,3656
TELANGANA,RANGA REDDY,2021-03-28,18,1430,2,1450
TELANGANA,RANGA REDDY,2021-03-29,23,1969,7,1999
TELANGANA,RANGA REDDY,2021-03-30,22,2859,11,2892
TELANGANA,SANGAREDDY,2021-03-26,5,1007,0,1012
TELANGANA,SANGAREDDY,2021-03-27,2,1040,0,1042
TELANGANA,SANGAREDDY,2021-03-28,4,463,0,467
TELANGANA,SANGAREDDY,2021-03-29,4,710,1,715
TELANGANA,SANGAREDDY,2021-03-30,4,1072,0,1076
TELANGANA,SIDDIPET,2021-03-26,0,1778,0,1778
TELANGANA,SIDDIPET,2021-03-27,0,2697,0,2697
TELANGANA,SIDDIPET,2021-03-28,0,1054,0,1054
TELANGANA,SIDDIPET,2021-03-29,2,1252,0,1254
TELANGANA,SIDDIPET,2021-03-30,0,1566,0,1566
TELANGANA,SURYAPET,2021-03-26,0,783,0,783
TELANGANA,SURYAPET,2021-03-27,2,675,0,677
TELANGANA,SURYAPET,2021-03-28,3,620,0,623
TELANGANA,SURYAPET,2021-03-29,0,573,0,573
TELANGANA,SURYAPET,2021-03-30,1,964,0,965
TELANGANA,VIKARABAD,2021-03-26,0,625,0,625
TELANGANA,VIKARABAD,2021-03-27,0,714,0,714
TELANGANA,VIKARABAD,2021-03-28,0,487,0,487
TELANGANA,VIKARABAD,2021-03-29,0,586,0,586
TELANGANA,VIKARABAD,2021-03-30,0,546,0,546
TELANGANA,WANAPARTHY,2021-03-26,0,471,0,471
TELANGANA,WANAPARTHY,2021-03-27,0,347,0,347
TELANGANA,WANAPARTHY,2021-03-28,0,133,0,133
TELANGANA,WANAPARTHY,2021-03-29,0,192,0,192
TELANGANA,WANAPARTHY,2021-03-30,0,550,0,550
TELANGANA,WARANGAL RURAL,2021-03-26,2,846,0,848
TELANGANA,WARANGAL RURAL,2021-03-27,0,952,0,952
TELANGANA,WARANGAL RURAL,2021-03-28,0,829,0,829
TELANGANA,WARANGAL RURAL,2021-03-29,0,923,0,923
TELANGANA,WARANGAL RURAL,2021-03-30,0,881,0,881
TELANGANA,WARANGAL URBAN,2021-03-26,0,2952,0,2952
TELANGANA,WARANGAL URBAN,2021-03-27,1,2646,0,2647
TELANGANA,WARANGAL URBAN,2021-03-28,1,1549,0,1550
TELANGANA,WARANGAL URBAN,2021-03-29,0,2464,0,2464
TELANGANA,WARANGAL URBAN,2021-03-30,2,2038,0,2040
TELANGANA,YADADRI BHUVANAGIRI,2021-03-26,1,282,0,283
TELANGANA,YADADRI BHUVANAGIRI,2021-03-27,0,329,0,329
TELANGANA,YADADRI BHUVANAGIRI,2021-03-28,0,23,0,23
TELANGANA,YADADRI BHUVANAGIRI,2021-03-29,0,309,0,309
TELANGANA,YADADRI BHUVANAGIRI,2021-03-30,0,389,0,389
TRIPURA,DHALAI,2021-03-26,3,50,0,53
TRIPURA,DHALAI,2021-03-27,0,18,0,18
TRIPURA,DHALAI,2021-03-28,0,5,0,5
TRIPURA,DHALAI,2021-03-29,0,43,0,43
TRIPURA,DHALAI,2021-03-30,0,12,0,12
TRIPURA,GOMATI,2021-03-26,0,34,0,34
TRIPURA,GOMATI,2021-03-27,0,65,0,65
TRIPURA,GOMATI,2021-03-28,0,3,0,3
TRIPURA,GOMATI,2021-03-29,0,21,0,21
TRIPURA,GOMATI,2021-03-30,1,55,0,56
TRIPURA,KHOWAI,2021-03-26,0,20,0,20
TRIPURA,KHOWAI,2021-03-27,0,31,0,31
TRIPURA,KHOWAI,2021-03-28,0,4,0,4
TRIPURA,KHOWAI,2021-03-29,0,12,0,12
TRIPURA,KHOWAI,2021-03-30,1,24,0,25
TRIPURA,NORTH TRIPURA,2021-03-26,0,80,0,80
TRIPURA,NORTH TRIPURA,2021-03-27,1,89,0,90
TRIPURA,NORTH TRIPURA,2021-03-28,0,49,0,49
TRIPURA,NORTH TRIPURA,2021-03-29,0,48,0,48
TRIPURA,NORTH TRIPURA,2021-03-30,0,107,0,107
TRIPURA,SEPAHIJALA,2021-03-26,0,59,0,59
TRIPURA,SEPAHIJALA,2021-03-27,0,62,0,62
TRIPURA,SEPAHIJALA,2021-03-28,0,25,0,25
TRIPURA,SEPAHIJALA,2021-03-29,0,42,0,42
TRIPURA,SEPAHIJALA,2021-03-30,1,111,0,112
TRIPURA,SOUTH TRIPURA,2021-03-26,1,54,0,55
TRIPURA,SOUTH TRIPURA,2021-03-27,0,56,0,56
TRIPURA,SOUTH TRIPURA,2021-03-28,0,15,0,15
TRIPURA,SOUTH TRIPURA,2021-03-29,1,29,0,30
TRIPURA,SOUTH TRIPURA,2021-03-30,4,100,0,104
TRIPURA,UNAKOTI,2021-03-26,0,10,0,10
TRIPURA,UNAKOTI,2021-03-27,0,1,0,1
TRIPURA,UNAKOTI,2021-03-28,0,1,0,1
TRIPURA,UNAKOTI,2021-03-29,0,1,0,1
TRIPURA,UNAKOTI,2021-03-30,0,10,0,10
TRIPURA,WEST TRIPURA,2021-03-26,3,184,0,187
TRIPURA,WEST TRIPURA,2021-03-27,1,264,0,265
TRIPURA,WEST TRIPURA,2021-03-28,2,69,0,71
TRIPURA,WEST TRIPURA,2021-03-29,2,170,0,172
TRIPURA,WEST TRIPURA,2021-03-30,6,223,1,230
UTTAR PRADESH,AGRA,2021-03-26,11,1724,5,1740
UTTAR PRADESH,AGRA,2021-03-27,22,3914,33,3969
UTTAR PRADESH,AGRA,2021-03-28,19,2873,22,2914
UTTAR PRADESH,AGRA,2021-03-29,9,1271,10,1290
UTTAR PRADESH,AGRA,2021-03-30,22,819,7,848
UTTAR PRADESH,ALIGARH,2021-03-26,7,2722,5,2734
UTTAR PRADESH,ALIGARH,2021-03-27,10,3412,0,3422
UTTAR PRADESH,ALIGARH,2021-03-28,15,3234,6,3255
UTTAR PRADESH,ALIGARH,2021-03-29,6,1424,34,1464
UTTAR PRADESH,ALIGARH,2021-03-30,20,1417,14,1451
UTTAR PRADESH,AMBEDKAR NAGAR,2021-03-26,2,1121,0,1123
UTTAR PRADESH,AMBEDKAR NAGAR,2021-03-27,8,1138,1,1147
UTTAR PRADESH,AMBEDKAR NAGAR,2021-03-28,1,1362,0,1363
UTTAR PRADESH,AMBEDKAR NAGAR,2021-03-29,3,1544,0,1547
UTTAR PRADESH,AMBEDKAR NAGAR,2021-03-30,3,1232,0,1235
UTTAR PRADESH,AMETHI,2021-03-26,3,2423,0,2426
UTTAR PRADESH,AMETHI,2021-03-27,3,818,1,822
UTTAR PRADESH,AMETHI,2021-03-28,0,1101,0,1101
UTTAR PRADESH,AMETHI,2021-03-29,1,329,0,330
UTTAR PRADESH,AMETHI,2021-03-30,1,1280,0,1281
UTTAR PRADESH,AMROHA,2021-03-26,4,879,0,883
UTTAR PRADESH,AMROHA,2021-03-27,5,1708,0,1713
UTTAR PRADESH,AMROHA,2021-03-28,4,256,1,261
UTTAR PRADESH,AMROHA,2021-03-29,6,550,23,579
UTTAR PRADESH,AMROHA,2021-03-30,1,931,0,932
UTTAR PRADESH,AURAIYA,2021-03-26,3,962,18,983
UTTAR PRADESH,AURAIYA,2021-03-27,7,997,90,1094
UTTAR PRADESH,AURAIYA,2021-03-28,14,238,12,264
UTTAR PRADESH,AURAIYA,2021-03-29,5,1091,12,1108
UTTAR PRADESH,AURAIYA,2021-03-30,5,95,0,100
UTTAR PRADESH,AYODHYA,2021-03-26,2,1856,2,1860
UTTAR PRADESH,AYODHYA,2021-03-27,5,1886,0,1891
UTTAR PRADESH,AYODHYA,2021-03-28,6,1262,1,1269
UTTAR PRADESH,AYODHYA,2021-03-29,5,332,0,337
UTTAR PRADESH,AYODHYA,2021-03-30,9,586,0,595
UTTAR PRADESH,AZAMGARH,2021-03-26,14,941,4,959
UTTAR PRADESH,AZAMGARH,2021-03-27,33,1258,4,1295
UTTAR PRADESH,AZAMGARH,2021-03-28,15,966,17,998
UTTAR PRADESH,AZAMGARH,2021-03-29,7,1354,2,1363
UTTAR PRADESH,AZAMGARH,2021-03-30,17,640,3,660
UTTAR PRADESH,BAGHPAT,2021-03-26,1,1353,30,1384
UTTAR PRADESH,BAGHPAT,2021-03-27,2,1326,20,1348
UTTAR PRADESH,BAGHPAT,2021-03-28,7,1496,89,1592
UTTAR PRADESH,BAGHPAT,2021-03-29,0,1153,31,1184
UTTAR PRADESH,BAGHPAT,2021-03-30,2,803,0,805
UTTAR PRADESH,BAHRAICH,2021-03-26,2,1114,19,1135
UTTAR PRADESH,BAHRAICH,2021-03-27,6,1320,47,1373
UTTAR PRADESH,BAHRAICH,2021-03-28,4,1103,21,1128
UTTAR PRADESH,BAHRAICH,2021-03-29,3,779,41,823
UTTAR PRADESH,BAHRAICH,2021-03-30,10,964,4,978
UTTAR PRADESH,BALLIA,2021-03-26,8,1528,8,1544
UTTAR PRADESH,BALLIA,2021-03-27,17,1373,4,1394
UTTAR PRADESH,BALLIA,2021-03-28,9,936,2,947
UTTAR PRADESH,BALLIA,2021-03-29,9,486,0,495
UTTAR PRADESH,BALLIA,2021-03-30,4,1043,0,1047
UTTAR PRADESH,BALRAMPUR,2021-03-26,24,1718,1,1743
UTTAR PRADESH,BALRAMPUR,2021-03-27,26,1555,1,1582
UTTAR PRADESH,BALRAMPUR,2021-03-28,6,1097,0,1103
UTTAR PRADESH,BALRAMPUR,2021-03-29,4,1009,0,1013
UTTAR PRADESH,BALRAMPUR,2021-03-30,10,973,0,983
UTTAR PRADESH,BANDA,2021-03-26,8,1796,29,1833
UTTAR PRADESH,BANDA,2021-03-27,1,1959,7,1967
UTTAR PRADESH,BANDA,2021-03-28,15,2312,10,2337
UTTAR PRADESH,BANDA,2021-03-29,1,1733,6,1740
UTTAR PRADESH,BANDA,2021-03-30,3,1515,6,1524
UTTAR PRADESH,BARABANKI,2021-03-26,17,1457,2,1476
UTTAR PRADESH,BARABANKI,2021-03-27,16,1757,4,1777
UTTAR PRADESH,BARABANKI,2021-03-28,14,1132,52,1198
UTTAR PRADESH,BARABANKI,2021-03-29,26,642,51,719
UTTAR PRADESH,BARABANKI,2021-03-30,31,266,2,299
UTTAR PRADESH,BAREILLY,2021-03-26,33,1422,8,1463
UTTAR PRADESH,BAREILLY,2021-03-27,31,1600,9,1640
UTTAR PRADESH,BAREILLY,2021-03-28,28,2115,0,2143
UTTAR PRADESH,BAREILLY,2021-03-29,12,1168,1,1181
UTTAR PRADESH,BAREILLY,2021-03-30,14,331,2,347
UTTAR PRADESH,BASTI,2021-03-26,13,2629,2,2644
UTTAR PRADESH,BASTI,2021-03-27,14,2502,0,2516
UTTAR PRADESH,BASTI,2021-03-28,3,3280,34,3317
UTTAR PRADESH,BASTI,2021-03-29,4,170,32,206
UTTAR PRADESH,BASTI,2021-03-30,6,1615,2,1623
UTTAR PRADESH,BHADOHI,2021-03-26,2,1544,1,1547
UTTAR PRADESH,BHADOHI,2021-03-27,5,1574,2,1581
UTTAR PRADESH,BHADOHI,2021-03-28,2,1364,4,1370
UTTAR PRADESH,BHADOHI,2021-03-29,4,1457,1,1462
UTTAR PRADESH,BHADOHI,2021-03-30,2,1351,0,1353
UTTAR PRADESH,BIJNOR,2021-03-26,7,961,6,974
UTTAR PRADESH,BIJNOR,2021-03-27,4,2099,1,2104
UTTAR PRADESH,BIJNOR,2021-03-28,10,1390,2,1402
UTTAR PRADESH,BIJNOR,2021-03-29,3,73,0,76
UTTAR PRADESH,BIJNOR,2021-03-30,8,103,6,117
UTTAR PRADESH,BUDAUN,2021-03-26,19,1812,28,1859
UTTAR PRADESH,BUDAUN,2021-03-27,9,1745,0,1754
UTTAR PRADESH,BUDAUN,2021-03-28,5,3337,0,3342
UTTAR PRADESH,BUDAUN,2021-03-29,2,590,0,592
UTTAR PRADESH,BUDAUN,2021-03-30,1,987,0,988
UTTAR PRADESH,BULANDSHAHR,2021-03-26,5,3365,6,3376
UTTAR PRADESH,BULANDSHAHR,2021-03-27,7,566,60,633
UTTAR PRADESH,BULANDSHAHR,2021-03-28,3,1165,72,1240
UTTAR PRADESH,BULANDSHAHR,2021-03-29,5,503,94,602
UTTAR PRADESH,BULANDSHAHR,2021-03-30,3,165,0,168
UTTAR PRADESH,CHANDAULI,2021-03-26,8,827,20,855
UTTAR PRADESH,CHANDAULI,2021-03-27,4,726,3,733
UTTAR PRADESH,CHANDAULI,2021-03-28,6,523,35,564
UTTAR PRADESH,CHANDAULI,2021-03-29,8,152,0,160
UTTAR PRADESH,CHANDAULI,2021-03-30,5,71,0,76
UTTAR PRADESH,CHITRAKOOT,2021-03-26,1,867,55,923
UTTAR PRADESH,CHITRAKOOT,2021-03-27,0,608,0,608
UTTAR PRADESH,CHITRAKOOT,2021-03-28,1,500,8,509
UTTAR PRADESH,CHITRAKOOT,2021-03-29,2,613,0,615
UTTAR PRADESH,CHITRAKOOT,2021-03-30,4,126,45,175
UTTAR PRADESH,DEORIA,2021-03-26,3,2652,110,2765
UTTAR PRADESH,DEORIA,2021-03-27,7,2876,216,3099
UTTAR PRADESH,DEORIA,2021-03-28,3,1059,158,1220
UTTAR PRADESH,DEORIA,2021-03-29,1,117,0,118
UTTAR PRADESH,DEORIA,2021-03-30,8,1156,100,1264
UTTAR PRADESH,ETAH,2021-03-26,0,672,28,700
UTTAR PRADESH,ETAH,2021-03-27,1,2018,7,2026
UTTAR PRADESH,ETAH,2021-03-28,4,859,78,941
UTTAR PRADESH,ETAH,2021-03-29,3,23,1,27
UTTAR PRADESH,ETAH,2021-03-30,10,639,0,649
UTTAR PRADESH,ETAWAH,2021-03-26,7,1265,129,1401
UTTAR PRADESH,ETAWAH,2021-03-27,18,1366,99,1483
UTTAR PRADESH,ETAWAH,2021-03-28,4,823,90,917
UTTAR PRADESH,ETAWAH,2021-03-29,6,665,12,683
UTTAR PRADESH,ETAWAH,2021-03-30,14,245,19,278
UTTAR PRADESH,FARRUKHABAD,2021-03-26,3,827,25,855
UTTAR PRADESH,FARRUKHABAD,2021-03-27,3,765,32,800
UTTAR PRADESH,FARRUKHABAD,2021-03-28,2,338,6,346
UTTAR PRADESH,FARRUKHABAD,2021-03-29,3,418,14,435
UTTAR PRADESH,FARRUKHABAD,2021-03-30,0,50,1,51
UTTAR PRADESH,FATEHPUR,2021-03-26,11,1348,168,1527
UTTAR PRADESH,FATEHPUR,2021-03-27,61,1661,87,1809
UTTAR PRADESH,FATEHPUR,2021-03-28,5,1257,20,1282
UTTAR PRADESH,FATEHPUR,2021-03-29,6,749,18,773
UTTAR PRADESH,FATEHPUR,2021-03-30,2,496,0,498
UTTAR PRADESH,FIROZABAD,2021-03-26,12,2050,17,2079
UTTAR PRADESH,FIROZABAD,2021-03-27,22,1982,0,2004
UTTAR PRADESH,FIROZABAD,2021-03-28,13,899,0,912
UTTAR PRADESH,FIROZABAD,2021-03-29,14,472,0,486
UTTAR PRADESH,FIROZABAD,2021-03-30,14,722,0,736
UTTAR PRADESH,GAUTAM BUDDHA NAGAR,2021-03-26,245,4189,90,4524
UTTAR PRADESH,GAUTAM BUDDHA NAGAR,2021-03-27,281,4121,79,4481
UTTAR PRADESH,GAUTAM BUDDHA NAGAR,2021-03-28,240,2847,75,3162
UTTAR PRADESH,GAUTAM BUDDHA NAGAR,2021-03-29,101,2059,11,2171
UTTAR PRADESH,GAUTAM BUDDHA NAGAR,2021-03-30,222,1738,61,2021
UTTAR PRADESH,GHAZIABAD,2021-03-26,214,4069,83,4366
UTTAR PRADESH,GHAZIABAD,2021-03-27,271,4599,101,4971
UTTAR PRADESH,GHAZIABAD,2021-03-28,216,2645,67,2928
UTTAR PRADESH,GHAZIABAD,2021-03-29,115,2778,11,2904
UTTAR PRADESH,GHAZIABAD,2021-03-30,159,3742,89,3990
UTTAR PRADESH,GHAZIPUR,2021-03-26,3,754,24,781
UTTAR PRADESH,GHAZIPUR,2021-03-27,14,1371,35,1420
UTTAR PRADESH,GHAZIPUR,2021-03-28,9,484,5,498
UTTAR PRADESH,GHAZIPUR,2021-03-29,3,47,0,50
UTTAR PRADESH,GHAZIPUR,2021-03-30,7,402,0,409
UTTAR PRADESH,GONDA,2021-03-26,10,1278,22,1310
UTTAR PRADESH,GONDA,2021-03-27,7,940,2,949
UTTAR PRADESH,GONDA,2021-03-28,3,930,0,933
UTTAR PRADESH,GONDA,2021-03-29,3,613,0,616
UTTAR PRADESH,GONDA,2021-03-30,15,961,0,976
UTTAR PRADESH,GORAKHPUR,2021-03-26,38,1330,53,1421
UTTAR PRADESH,GORAKHPUR,2021-03-27,30,3546,58,3634
UTTAR PRADESH,GORAKHPUR,2021-03-28,13,3188,54,3255
UTTAR PRADESH,GORAKHPUR,2021-03-29,25,279,1,305
UTTAR PRADESH,GORAKHPUR,2021-03-30,15,662,0,677
UTTAR PRADESH,HAMIRPUR,2021-03-26,0,1061,11,1072
UTTAR PRADESH,HAMIRPUR,2021-03-27,0,655,5,660
UTTAR PRADESH,HAMIRPUR,2021-03-28,2,1051,0,1053
UTTAR PRADESH,HAMIRPUR,2021-03-29,0,607,0,607
UTTAR PRADESH,HAMIRPUR,2021-03-30,0,575,8,583
UTTAR PRADESH,HAPUR,2021-03-26,5,1554,95,1654
UTTAR PRADESH,HAPUR,2021-03-27,1,755,42,798
UTTAR PRADESH,HAPUR,2021-03-28,4,984,22,1010
UTTAR PRADESH,HAPUR,2021-03-29,2,367,14,383
UTTAR PRADESH,HAPUR,2021-03-30,7,726,31,764
UTTAR PRADESH,HARDOI,2021-03-26,14,1501,36,1551
UTTAR PRADESH,HARDOI,2021-03-27,3,1496,48,1547
UTTAR PRADESH,HARDOI,2021-03-28,11,1052,51,1114
UTTAR PRADESH,HARDOI,2021-03-29,1,798,16,815
UTTAR PRADESH,HARDOI,2021-03-30,1,455,2,458
UTTAR PRADESH,HATHRAS,2021-03-26,0,883,0,883
UTTAR PRADESH,HATHRAS,2021-03-27,2,1192,0,1194
UTTAR PRADESH,HATHRAS,2021-03-28,2,1759,0,1761
UTTAR PRADESH,HATHRAS,2021-03-29,0,415,0,415
UTTAR PRADESH,HATHRAS,2021-03-30,384,426,0,810
UTTAR PRADESH,JALAUN,2021-03-26,0,1251,3,1254
UTTAR PRADESH,JALAUN,2021-03-27,1,1075,3,1079
UTTAR PRADESH,JALAUN,2021-03-28,1,734,6,741
UTTAR PRADESH,JALAUN,2021-03-29,3,340,0,343
UTTAR PRADESH,JALAUN,2021-03-30,5,434,1,440
UTTAR PRADESH,JAUNPUR,2021-03-26,6,2259,4,2269
UTTAR PRADESH,JAUNPUR,2021-03-27,7,599,13,619
UTTAR PRADESH,JAUNPUR,2021-03-28,9,1771,1,1781
UTTAR PRADESH,JAUNPUR,2021-03-29,4,218,0,222
UTTAR PRADESH,JAUNPUR,2021-03-30,7,51,1,59
UTTAR PRADESH,JHANSI,2021-03-26,34,2625,1,2660
UTTAR PRADESH,JHANSI,2021-03-27,37,3396,4,3437
UTTAR PRADESH,JHANSI,2021-03-28,11,2385,1,2397
UTTAR PRADESH,JHANSI,2021-03-29,17,1004,0,1021
UTTAR PRADESH,JHANSI,2021-03-30,5,2132,4,2141
UTTAR PRADESH,KANNAUJ,2021-03-26,4,1355,1,1360
UTTAR PRADESH,KANNAUJ,2021-03-27,2,1915,1,1918
UTTAR PRADESH,KANNAUJ,2021-03-28,6,1004,2,1012
UTTAR PRADESH,KANNAUJ,2021-03-29,2,615,0,617
UTTAR PRADESH,KANNAUJ,2021-03-30,2,865,10,877
UTTAR PRADESH,KANPUR DEHAT,2021-03-26,1,1076,5,1082
UTTAR PRADESH,KANPUR DEHAT,2021-03-27,0,832,0,832
UTTAR PRADESH,KANPUR DEHAT,2021-03-28,0,798,0,798
UTTAR PRADESH,KANPUR DEHAT,2021-03-29,1,1148,1,1150
UTTAR PRADESH,KANPUR DEHAT,2021-03-30,1,554,1,556
UTTAR PRADESH,KANPUR NAGAR,2021-03-26,34,4430,15,4479
UTTAR PRADESH,KANPUR NAGAR,2021-03-27,54,4786,13,4853
UTTAR PRADESH,KANPUR NAGAR,2021-03-28,47,3829,8,3884
UTTAR PRADESH,KANPUR NAGAR,2021-03-29,54,1532,3,1589
UTTAR PRADESH,KANPUR NAGAR,2021-03-30,86,1713,0,1799
UTTAR PRADESH,KASGANJ,2021-03-26,1,3042,0,3043
UTTAR PRADESH,KASGANJ,2021-03-27,2,2744,0,2746
UTTAR PRADESH,KASGANJ,2021-03-28,5,1214,9,1228
UTTAR PRADESH,KASGANJ,2021-03-29,1,4,1,6
UTTAR PRADESH,KASGANJ,2021-03-30,0,516,7,523
UTTAR PRADESH,KAUSHAMBI,2021-03-26,0,1285,0,1285
UTTAR PRADESH,KAUSHAMBI,2021-03-27,3,860,0,863
UTTAR PRADESH,KAUSHAMBI,2021-03-28,2,1351,0,1353
UTTAR PRADESH,KAUSHAMBI,2021-03-29,0,649,0,649
UTTAR PRADESH,KAUSHAMBI,2021-03-30,0,254,0,254
UTTAR PRADESH,KHERI,2021-03-26,2,999,1,1002
UTTAR PRADESH,KHERI,2021-03-27,13,1475,13,1501
UTTAR PRADESH,KHERI,2021-03-28,5,1113,9,1127
UTTAR PRADESH,KHERI,2021-03-29,3,723,5,731
UTTAR PRADESH,KHERI,2021-03-30,7,1436,11,1454
UTTAR PRADESH,KUSHI NAGAR,2021-03-26,3,1447,35,1485
UTTAR PRADESH,KUSHI NAGAR,2021-03-27,5,1073,37,1115
UTTAR PRADESH,KUSHI NAGAR,2021-03-28,3,1325,82,1410
UTTAR PRADESH,KUSHI NAGAR,2021-03-29,5,362,20,387
UTTAR PRADESH,KUSHI NAGAR,2021-03-30,2,1100,0,1102
UTTAR PRADESH,LALITPUR,2021-03-26,21,1794,2,1817
UTTAR PRADESH,LALITPUR,2021-03-27,15,1852,3,1870
UTTAR PRADESH,LALITPUR,2021-03-28,16,1546,0,1562
UTTAR PRADESH,LALITPUR,2021-03-29,21,1177,6,1204
UTTAR PRADESH,LALITPUR,2021-03-30,11,614,0,625
UTTAR PRADESH,LUCKNOW,2021-03-26,271,9193,72,9536
UTTAR PRADESH,LUCKNOW,2021-03-27,436,15192,82,15710
UTTAR PRADESH,LUCKNOW,2021-03-28,455,11072,61,11588
UTTAR PRADESH,LUCKNOW,2021-03-29,405,5601,176,6182
UTTAR PRADESH,LUCKNOW,2021-03-30,461,5832,172,6465
UTTAR PRADESH,MAHARAJGANJ,2021-03-26,17,2170,114,2301
UTTAR PRADESH,MAHARAJGANJ,2021-03-27,3,2329,133,2465
UTTAR PRADESH,MAHARAJGANJ,2021-03-28,11,1138,126,1275
UTTAR PRADESH,MAHARAJGANJ,2021-03-29,1,1083,159,1243
UTTAR PRADESH,MAHARAJGANJ,2021-03-30,3,124,5,132
UTTAR PRADESH,MAHOBA,2021-03-26,1,1146,122,1269
UTTAR PRADESH,MAHOBA,2021-03-27,0,730,1,731
UTTAR PRADESH,MAHOBA,2021-03-28,7,1209,15,1231
UTTAR PRADESH,MAHOBA,2021-03-29,3,791,0,794
UTTAR PRADESH,MAHOBA,2021-03-30,5,498,8,511
UTTAR PRADESH,MAINPURI,2021-03-26,1,1517,0,1518
UTTAR PRADESH,MAINPURI,2021-03-27,1,1694,0,1695
UTTAR PRADESH,MAINPURI,2021-03-28,0,1365,4,1369
UTTAR PRADESH,MAINPURI,2021-03-29,0,446,0,446
UTTAR PRADESH,MAINPURI,2021-03-30,2,1207,1,1210
UTTAR PRADESH,MATHURA,2021-03-26,29,1542,21,1592
UTTAR PRADESH,MATHURA,2021-03-27,17,1866,12,1895
UTTAR PRADESH,MATHURA,2021-03-28,63,2064,78,2205
UTTAR PRADESH,MATHURA,2021-03-29,7,794,6,807
UTTAR PRADESH,MATHURA,2021-03-30,5,632,0,637
UTTAR PRADESH,MAU,2021-03-26,5,1324,13,1342
UTTAR PRADESH,MAU,2021-03-27,5,991,4,1000
UTTAR PRADESH,MAU,2021-03-28,4,626,4,634
UTTAR PRADESH,MAU,2021-03-29,0,34,0,34
UTTAR PRADESH,MAU,2021-03-30,2,283,0,285
UTTAR PRADESH,MEERUT,2021-03-26,56,3634,9,3699
UTTAR PRADESH,MEERUT,2021-03-27,72,5378,18,5468
UTTAR PRADESH,MEERUT,2021-03-28,24,3456,6,3486
UTTAR PRADESH,MEERUT,2021-03-29,34,697,8,739
UTTAR PRADESH,MEERUT,2021-03-30,49,1903,6,1958
UTTAR PRADESH,MIRZAPUR,2021-03-26,3,1009,0,1012
UTTAR PRADESH,MIRZAPUR,2021-03-27,5,1983,0,1988
UTTAR PRADESH,MIRZAPUR,2021-03-28,1,1216,0,1217
UTTAR PRADESH,MIRZAPUR,2021-03-29,0,1004,0,1004
UTTAR PRADESH,MIRZAPUR,2021-03-30,1,912,0,913
UTTAR PRADESH,MORADABAD,2021-03-26,13,2954,2,2969
UTTAR PRADESH,MORADABAD,2021-03-27,22,2555,6,2583
UTTAR PRADESH,MORADABAD,2021-03-28,9,2544,1,2554
UTTAR PRADESH,MORADABAD,2021-03-29,16,154,77,247
UTTAR PRADESH,MORADABAD,2021-03-30,8,992,12,1012
UTTAR PRADESH,MUZAFFARNAGAR,2021-03-26,18,1222,12,1252
UTTAR PRADESH,MUZAFFARNAGAR,2021-03-27,27,2365,11,2403
UTTAR PRADESH,MUZAFFARNAGAR,2021-03-28,26,1338,9,1373
UTTAR PRADESH,MUZAFFARNAGAR,2021-03-29,3,919,0,922
UTTAR PRADESH,MUZAFFARNAGAR,2021-03-30,28,1416,18,1462
UTTAR PRADESH,PILIBHIT,2021-03-26,3,1226,0,1229
UTTAR PRADESH,PILIBHIT,2021-03-27,1,1220,0,1221
UTTAR PRADESH,PILIBHIT,2021-03-28,0,1176,0,1176
UTTAR PRADESH,PILIBHIT,2021-03-29,0,84,0,84
UTTAR PRADESH,PILIBHIT,2021-03-30,2,1806,0,1808
UTTAR PRADESH,PRATAPGARH,2021-03-26,12,1477,3,1492
UTTAR PRADESH,PRATAPGARH,2021-03-27,13,2747,8,2768
UTTAR PRADESH,PRATAPGARH,2021-03-28,11,1078,144,1233
UTTAR PRADESH,PRATAPGARH,2021-03-29,26,956,15,997
UTTAR PRADESH,PRATAPGARH,2021-03-30,10,532,0,542
UTTAR PRADESH,PRAYAGRAJ,2021-03-26,43,5195,1,5239
UTTAR PRADESH,PRAYAGRAJ,2021-03-27,102,2331,5,2438
UTTAR PRADESH,PRAYAGRAJ,2021-03-28,51,1457,6,1514
UTTAR PRADESH,PRAYAGRAJ,2021-03-29,45,4544,8,4597
UTTAR PRADESH,PRAYAGRAJ,2021-03-30,54,382,1,437
UTTAR PRADESH,RAE BARELI,2021-03-26,26,1984,3,2013
UTTAR PRADESH,RAE BARELI,2021-03-27,9,1472,1,1482
UTTAR PRADESH,RAE BARELI,2021-03-28,17,1406,23,1446
UTTAR PRADESH,RAE BARELI,2021-03-29,41,1117,27,1185
UTTAR PRADESH,RAE BARELI,2021-03-30,26,489,9,524
UTTAR PRADESH,RAMPUR,2021-03-26,10,1647,8,1665
UTTAR PRADESH,RAMPUR,2021-03-27,1,989,0,990
UTTAR PRADESH,RAMPUR,2021-03-28,14,2204,112,2330
UTTAR PRADESH,RAMPUR,2021-03-29,7,843,57,907
UTTAR PRADESH,RAMPUR,2021-03-30,6,822,1,829
UTTAR PRADESH,SAHARANPUR,2021-03-26,42,2761,89,2892
UTTAR PRADESH,SAHARANPUR,2021-03-27,84,2910,7,3001
UTTAR PRADESH,SAHARANPUR,2021-03-28,24,2179,6,2209
UTTAR PRADESH,SAHARANPUR,2021-03-29,3,457,2,462
UTTAR PRADESH,SAHARANPUR,2021-03-30,48,1568,72,1688
UTTAR PRADESH,SAMBHAL,2021-03-26,6,1773,4,1783
UTTAR PRADESH,SAMBHAL,2021-03-27,3,949,13,965
UTTAR PRADESH,SAMBHAL,2021-03-28,1,1510,113,1624
UTTAR PRADESH,SAMBHAL,2021-03-29,4,1195,63,1262
UTTAR PRADESH,SAMBHAL,2021-03-30,14,676,32,722
UTTAR PRADESH,SANT KABEER NAGAR,2021-03-26,16,1431,0,1447
UTTAR PRADESH,SANT KABEER NAGAR,2021-03-27,11,1602,3,1616
UTTAR PRADESH,SANT KABEER NAGAR,2021-03-28,2,784,1,787
UTTAR PRADESH,SANT KABEER NAGAR,2021-03-29,9,1351,0,1360
UTTAR PRADESH,SANT KABEER NAGAR,2021-03-30,2,1072,0,1074
UTTAR PRADESH,SHAHJAHANPUR,2021-03-26,12,1950,120,2082
UTTAR PRADESH,SHAHJAHANPUR,2021-03-27,7,1625,2,1634
UTTAR PRADESH,SHAHJAHANPUR,2021-03-28,6,1407,105,1518
UTTAR PRADESH,SHAHJAHANPUR,2021-03-29,1,732,5,738
UTTAR PRADESH,SHAHJAHANPUR,2021-03-30,9,375,1,385
UTTAR PRADESH,SHAMLI,2021-03-26,5,2382,3,2390
UTTAR PRADESH,SHAMLI,2021-03-27,5,1853,2,1860
UTTAR PRADESH,SHAMLI,2021-03-28,12,1546,9,1567
UTTAR PRADESH,SHAMLI,2021-03-29,0,1061,0,1061
UTTAR PRADESH,SHAMLI,2021-03-30,14,752,9,775
UTTAR PRADESH,SHRAVASTI,2021-03-26,4,991,0,995
UTTAR PRADESH,SHRAVASTI,2021-03-27,2,881,0,883
UTTAR PRADESH,SHRAVASTI,2021-03-28,0,720,0,720
UTTAR PRADESH,SHRAVASTI,2021-03-29,0,311,0,311
UTTAR PRADESH,SHRAVASTI,2021-03-30,0,490,1,491
UTTAR PRADESH,SIDDHARTH NAGAR,2021-03-26,6,980,0,986
UTTAR PRADESH,SIDDHARTH NAGAR,2021-03-27,9,1278,73,1360
UTTAR PRADESH,SIDDHARTH NAGAR,2021-03-28,1,714,10,725
UTTAR PRADESH,SIDDHARTH NAGAR,2021-03-29,5,170,0,175
UTTAR PRADESH,SIDDHARTH NAGAR,2021-03-30,6,207,342,555
UTTAR PRADESH,SITAPUR,2021-03-26,3,1709,13,1725
UTTAR PRADESH,SITAPUR,2021-03-27,6,1602,9,1617
UTTAR PRADESH,SITAPUR,2021-03-28,4,1395,3,1402
UTTAR PRADESH,SITAPUR,2021-03-29,4,705,5,714
UTTAR PRADESH,SITAPUR,2021-03-30,5,1057,0,1062
UTTAR PRADESH,SONBHADRA,2021-03-26,6,1601,1,1608
UTTAR PRADESH,SONBHADRA,2021-03-27,4,1342,43,1389
UTTAR PRADESH,SONBHADRA,2021-03-28,0,2352,49,2401
UTTAR PRADESH,SONBHADRA,2021-03-29,0,745,0,745
UTTAR PRADESH,SONBHADRA,2021-03-30,3,348,3,354
UTTAR PRADESH,SULTANPUR,2021-03-26,7,1800,54,1861
UTTAR PRADESH,SULTANPUR,2021-03-27,13,2164,110,2287
UTTAR PRADESH,SULTANPUR,2021-03-28,9,663,79,751
UTTAR PRADESH,SULTANPUR,2021-03-29,8,891,24,923
UTTAR PRADESH,SULTANPUR,2021-03-30,3,786,4,793
UTTAR PRADESH,UNNAO,2021-03-26,23,2320,17,2360
UTTAR PRADESH,UNNAO,2021-03-27,31,2292,13,2336
UTTAR PRADESH,UNNAO,2021-03-28,51,1892,12,1955
UTTAR PRADESH,UNNAO,2021-03-29,9,1441,0,1450
UTTAR PRADESH,UNNAO,2021-03-30,25,1575,17,1617
UTTAR PRADESH,VARANASI,2021-03-26,53,3493,4,3550
UTTAR PRADESH,VARANASI,2021-03-27,95,3791,13,3899
UTTAR PRADESH,VARANASI,2021-03-28,76,2454,1,2531
UTTAR PRADESH,VARANASI,2021-03-29,40,1570,4,1614
UTTAR PRADESH,VARANASI,2021-03-30,30,2429,2,2461
UTTARAKHAND,ALMORA,2021-03-26,2,133,0,135
UTTARAKHAND,ALMORA,2021-03-27,1,59,0,60
UTTARAKHAND,ALMORA,2021-03-28,3,21,0,24
UTTARAKHAND,ALMORA,2021-03-29,0,7,0,7
UTTARAKHAND,ALMORA,2021-03-30,3,50,0,53
UTTARAKHAND,BAGESHWAR,2021-03-26,0,152,0,152
UTTARAKHAND,BAGESHWAR,2021-03-27,2,340,0,342
UTTARAKHAND,BAGESHWAR,2021-03-28,0,5,0,5
UTTARAKHAND,BAGESHWAR,2021-03-29,0,19,0,19
UTTARAKHAND,BAGESHWAR,2021-03-30,3,289,0,292
UTTARAKHAND,CHAMOLI,2021-03-26,3,216,10,229
UTTARAKHAND,CHAMOLI,2021-03-27,1,47,0,48
UTTARAKHAND,CHAMOLI,2021-03-28,0,6,0,6
UTTARAKHAND,CHAMOLI,2021-03-29,0,20,0,20
UTTARAKHAND,CHAMOLI,2021-03-30,6,66,0,72
UTTARAKHAND,CHAMPAWAT,2021-03-26,2,83,3,88
UTTARAKHAND,CHAMPAWAT,2021-03-27,1,28,0,29
UTTARAKHAND,CHAMPAWAT,2021-03-28,0,6,0,6
UTTARAKHAND,CHAMPAWAT,2021-03-29,0,1,0,1
UTTARAKHAND,CHAMPAWAT,2021-03-30,0,41,1,42
UTTARAKHAND,DEHRADUN,2021-03-26,99,2695,61,2855
UTTARAKHAND,DEHRADUN,2021-03-27,167,3323,15,3505
UTTARAKHAND,DEHRADUN,2021-03-28,109,2410,1,2520
UTTARAKHAND,DEHRADUN,2021-03-29,36,1495,10,1541
UTTARAKHAND,DEHRADUN,2021-03-30,167,2818,6,2991
UTTARAKHAND,HARIDWAR,2021-03-26,68,4913,4,4985
UTTARAKHAND,HARIDWAR,2021-03-27,62,5497,18,5577
UTTARAKHAND,HARIDWAR,2021-03-28,66,3732,10,3808
UTTARAKHAND,HARIDWAR,2021-03-29,19,1675,1,1695
UTTARAKHAND,HARIDWAR,2021-03-30,68,2659,5,2732
UTTARAKHAND,NAINITAL,2021-03-26,18,690,1,709
UTTARAKHAND,NAINITAL,2021-03-27,29,1115,3,1147
UTTARAKHAND,NAINITAL,2021-03-28,8,46,0,54
UTTARAKHAND,NAINITAL,2021-03-29,3,10,1,14
UTTARAKHAND,NAINITAL,2021-03-30,25,708,3,736
UTTARAKHAND,PAURI GARHWAL,2021-03-26,5,768,2,775
UTTARAKHAND,PAURI GARHWAL,2021-03-27,14,174,0,188
UTTARAKHAND,PAURI GARHWAL,2021-03-28,7,758,2,767
UTTARAKHAND,PAURI GARHWAL,2021-03-29,1,28,0,29
UTTARAKHAND,PAURI GARHWAL,2021-03-30,13,456,1,470
UTTARAKHAND,PITHORAGARH,2021-03-26,3,494,0,497
UTTARAKHAND,PITHORAGARH,2021-03-27,0,27,0,27
UTTARAKHAND,PITHORAGARH,2021-03-28,3,21,0,24
UTTARAKHAND,PITHORAGARH,2021-03-29,1,2,0,3
UTTARAKHAND,PITHORAGARH,2021-03-30,1,74,0,75
UTTARAKHAND,RUDRA PRAYAG,2021-03-26,3,145,2,150
UTTARAKHAND,RUDRA PRAYAG,2021-03-27,3,112,0,115
UTTARAKHAND,RUDRA PRAYAG,2021-03-28,2,73,0,75
UTTARAKHAND,RUDRA PRAYAG,2021-03-29,0,5,0,5
UTTARAKHAND,RUDRA PRAYAG,2021-03-30,0,58,0,58
UTTARAKHAND,TEHRI GARHWAL,2021-03-26,36,200,0,236
UTTARAKHAND,TEHRI GARHWAL,2021-03-27,33,259,2,294
UTTARAKHAND,TEHRI GARHWAL,2021-03-28,0,52,0,52
UTTARAKHAND,TEHRI GARHWAL,2021-03-29,1,108,0,109
UTTARAKHAND,TEHRI GARHWAL,2021-03-30,10,157,0,167
UTTARAKHAND,UDAM SINGH NAGAR,2021-03-26,10,1187,6,1203
UTTARAKHAND,UDAM SINGH NAGAR,2021-03-27,22,1009,167,1198
UTTARAKHAND,UDAM SINGH NAGAR,2021-03-28,5,834,4,843
UTTARAKHAND,UDAM SINGH NAGAR,2021-03-29,1,18,0,19
UTTARAKHAND,UDAM SINGH NAGAR,2021-03-30,28,2353,64,2445
UTTARAKHAND,UTTAR KASHI,2021-03-26,3,437,2,442
UTTARAKHAND,UTTAR KASHI,2021-03-27,1,149,11,161
UTTARAKHAND,UTTAR KASHI,2021-03-28,8,319,1,328
UTTARAKHAND,UTTAR KASHI,2021-03-29,1,283,22,306
UTTARAKHAND,UTTAR KASHI,2021-03-30,8,300,2,310
WEST BENGAL,24 PARAGANAS NORTH,2021-03-26,169,3707,36,3912
WEST BENGAL,24 PARAGANAS NORTH,2021-03-27,185,4221,22,4428
WEST BENGAL,24 PARAGANAS NORTH,2021-03-28,73,1279,2,1354
WEST BENGAL,24 PARAGANAS NORTH,2021-03-29,112,1818,13,1943
WEST BENGAL,24 PARAGANAS NORTH,2021-03-30,257,3682,34,3973
WEST BENGAL,24 PARAGANAS SOUTH,2021-03-26,28,2683,169,2880
WEST BENGAL,24 PARAGANAS SOUTH,2021-03-27,50,2976,18,3044
WEST BENGAL,24 PARAGANAS SOUTH,2021-03-28,36,2512,27,2575
WEST BENGAL,24 PARAGANAS SOUTH,2021-03-29,21,1742,21,1784
WEST BENGAL,24 PARAGANAS SOUTH,2021-03-30,50,2336,3,2389
WEST BENGAL,ALIPURDUAR,2021-03-26,0,187,0,187
WEST BENGAL,ALIPURDUAR,2021-03-27,3,536,0,539
WEST BENGAL,ALIPURDUAR,2021-03-28,0,429,0,429
WEST BENGAL,ALIPURDUAR,2021-03-29,1,263,0,264
WEST BENGAL,ALIPURDUAR,2021-03-30,1,351,12,364
WEST BENGAL,BANKURA,2021-03-26,7,706,1,714
WEST BENGAL,BANKURA,2021-03-27,9,1186,11,1206
WEST BENGAL,BANKURA,2021-03-28,12,976,15,1003
WEST BENGAL,BANKURA,2021-03-29,11,804,12,827
WEST BENGAL,BANKURA,2021-03-30,4,722,14,740
WEST BENGAL,BIRBHUM,2021-03-26,39,851,3,893
WEST BENGAL,BIRBHUM,2021-03-27,49,719,16,784
WEST BENGAL,BIRBHUM,2021-03-28,26,454,8,488
WEST BENGAL,BIRBHUM,2021-03-29,13,142,3,158
WEST BENGAL,BIRBHUM,2021-03-30,61,528,11,600
WEST BENGAL,COOCHBEHAR,2021-03-26,0,1631,2,1633
WEST BENGAL,COOCHBEHAR,2021-03-27,4,2000,21,2025
WEST BENGAL,COOCHBEHAR,2021-03-28,1,1948,22,1971
WEST BENGAL,COOCHBEHAR,2021-03-29,3,1106,0,1109
WEST BENGAL,COOCHBEHAR,2021-03-30,2,818,4,824
WEST BENGAL,DARJEELING,2021-03-26,16,558,7,581
WEST BENGAL,DARJEELING,2021-03-27,27,556,7,590
WEST BENGAL,DARJEELING,2021-03-28,15,298,1,314
WEST BENGAL,DARJEELING,2021-03-29,6,344,2,352
WEST BENGAL,DARJEELING,2021-03-30,4,808,25,837
WEST BENGAL,DINAJPUR DAKSHIN,2021-03-26,4,340,51,395
WEST BENGAL,DINAJPUR DAKSHIN,2021-03-27,1,411,10,422
WEST BENGAL,DINAJPUR DAKSHIN,2021-03-28,1,393,14,408
WEST BENGAL,DINAJPUR DAKSHIN,2021-03-29,1,194,0,195
WEST BENGAL,DINAJPUR DAKSHIN,2021-03-30,1,367,12,380
WEST BENGAL,DINAJPUR UTTAR,2021-03-26,5,178,0,183
WEST BENGAL,DINAJPUR UTTAR,2021-03-27,8,315,0,323
WEST BENGAL,DINAJPUR UTTAR,2021-03-28,7,152,0,159
WEST BENGAL,DINAJPUR UTTAR,2021-03-29,8,101,0,109
WEST BENGAL,DINAJPUR UTTAR,2021-03-30,5,216,1,222
WEST BENGAL,HOOGHLY,2021-03-26,36,1039,2,1077
WEST BENGAL,HOOGHLY,2021-03-27,29,994,4,1027
WEST BENGAL,HOOGHLY,2021-03-28,15,184,0,199
WEST BENGAL,HOOGHLY,2021-03-29,12,491,2,505
WEST BENGAL,HOOGHLY,2021-03-30,51,1143,2,1196
WEST BENGAL,HOWRAH,2021-03-26,69,882,4,955
WEST BENGAL,HOWRAH,2021-03-27,67,810,12,889
WEST BENGAL,HOWRAH,2021-03-28,28,448,23,499
WEST BENGAL,HOWRAH,2021-03-29,47,472,8,527
WEST BENGAL,HOWRAH,2021-03-30,96,1092,44,1232
WEST BENGAL,JALPAIGURI,2021-03-26,11,520,1,532
WEST BENGAL,JALPAIGURI,2021-03-27,1,412,1,414
WEST BENGAL,JALPAIGURI,2021-03-28,6,477,0,483
WEST BENGAL,JALPAIGURI,2021-03-29,0,241,0,241
WEST BENGAL,JALPAIGURI,2021-03-30,6,479,0,485
WEST BENGAL,JHARGRAM,2021-03-26,2,78,0,80
WEST BENGAL,JHARGRAM,2021-03-27,0,33,0,33
WEST BENGAL,JHARGRAM,2021-03-28,0,59,0,59
WEST BENGAL,JHARGRAM,2021-03-29,0,35,0,35
WEST BENGAL,JHARGRAM,2021-03-30,0,23,0,23
WEST BENGAL,KALIMPONG,2021-03-26,0,111,0,111
WEST BENGAL,KALIMPONG,2021-03-27,6,64,0,70
WEST BENGAL,KALIMPONG,2021-03-28,1,65,0,66
WEST BENGAL,KALIMPONG,2021-03-29,1,89,8,98
WEST BENGAL,KALIMPONG,2021-03-30,0,164,15,179
WEST BENGAL,KOLKATA,2021-03-26,444,3707,14,4165
WEST BENGAL,KOLKATA,2021-03-27,365,3970,9,4344
WEST BENGAL,KOLKATA,2021-03-28,210,1682,0,1892
WEST BENGAL,KOLKATA,2021-03-29,392,2985,24,3401
WEST BENGAL,KOLKATA,2021-03-30,576,4489,19,5084
WEST BENGAL,MALDAH,2021-03-26,14,1048,5,1067
WEST BENGAL,MALDAH,2021-03-27,16,806,15,837
WEST BENGAL,MALDAH,2021-03-28,1,179,5,185
WEST BENGAL,MALDAH,2021-03-29,3,104,0,107
WEST BENGAL,MALDAH,2021-03-30,24,706,10,740
WEST BENGAL,MEDINIPUR EAST,2021-03-26,12,981,1,994
WEST BENGAL,MEDINIPUR EAST,2021-03-27,8,1066,0,1074
WEST BENGAL,MEDINIPUR EAST,2021-03-28,8,202,0,210
WEST BENGAL,MEDINIPUR EAST,2021-03-29,5,171,0,176
WEST BENGAL,MEDINIPUR EAST,2021-03-30,17,793,0,810
WEST BENGAL,MEDINIPUR WEST,2021-03-26,6,627,10,643
WEST BENGAL,MEDINIPUR WEST,2021-03-27,6,481,27,514
WEST BENGAL,MEDINIPUR WEST,2021-03-28,13,234,9,256
WEST BENGAL,MEDINIPUR WEST,2021-03-29,6,250,3,259
WEST BENGAL,MEDINIPUR WEST,2021-03-30,10,229,0,239
WEST BENGAL,MURSHIDABAD,2021-03-26,6,966,7,979
WEST BENGAL,MURSHIDABAD,2021-03-27,20,1150,3,1173
WEST BENGAL,MURSHIDABAD,2021-03-28,7,470,8,485
WEST BENGAL,MURSHIDABAD,2021-03-29,12,818,12,842
WEST BENGAL,MURSHIDABAD,2021-03-30,28,1181,3,1212
WEST BENGAL,NADIA,2021-03-26,12,775,6,793
WEST BENGAL,NADIA,2021-03-27,13,787,0,800
WEST BENGAL,NADIA,2021-03-28,5,445,10,460
WEST BENGAL,NADIA,2021-03-29,12,573,12,597
WEST BENGAL,NADIA,2021-03-30,24,547,11,582
WEST BENGAL,PASCHIM BARDHAMAN,2021-03-26,64,331,16,411
WEST BENGAL,PASCHIM BARDHAMAN,2021-03-27,37,683,4,724
WEST BENGAL,PASCHIM BARDHAMAN,2021-03-28,10,201,3,214
WEST BENGAL,PASCHIM BARDHAMAN,2021-03-29,30,420,10,460
WEST BENGAL,PASCHIM BARDHAMAN,2021-03-30,83,561,16,660
WEST BENGAL,PURBA BARDHAMAN,2021-03-26,4,654,0,658
WEST BENGAL,PURBA BARDHAMAN,2021-03-27,7,803,0,810
WEST BENGAL,PURBA BARDHAMAN,2021-03-28,1,600,0,601
WEST BENGAL,PURBA BARDHAMAN,2021-03-29,4,529,0,533
WEST BENGAL,PURBA BARDHAMAN,2021-03-30,10,521,3,534
WEST BENGAL,PURULIA,2021-03-26,8,563,0,571
WEST BENGAL,PURULIA,2021-03-27,13,459,1,473
WEST BENGAL,PURULIA,2021-03-28,7,289,0,296
WEST BENGAL,PURULIA,2021-03-29,1,210,0,211
WEST BENGAL,PURULIA,2021-03-30,4,227,0,231
