state_residence,district_residence,Date,new_case,negative_case,Failed_test,Total_test,Invalid
ANDAMAN AND NICOBAR ISLANDS,NICOBARS,2021-02-01,0,17,0,17,
ANDAMAN AND NICOBAR ISLANDS,NICOBARS,2021-02-02,0,4,0,4,
ANDAMAN AND NICOBAR ISLANDS,NICOBARS,2021-02-03,0,11,0,11,
ANDAMAN AND NICOBAR ISLANDS,NICOBARS,2021-02-04,0,9,0,9,
ANDAMAN AND NICOBAR ISLANDS,NICOBARS,2021-02-05,0,11,0,11,
ANDAMAN AND NICOBAR ISLANDS,NORTH AND MIDDLE ANDAMAN,2021-02-01,0,19,0,19,
ANDAMAN AND NICOBAR ISLANDS,NORTH AND MIDDLE ANDAMAN,2021-02-02,0,17,0,17,
ANDAMAN AND NICOBAR ISLANDS,NORTH AND MIDDLE ANDAMAN,2021-02-03,0,13,0,13,
ANDAMAN AND NICOBAR ISLANDS,NORTH AND MIDDLE ANDAMAN,2021-02-04,0,9,0,9,
ANDAMAN AND NICOBAR ISLANDS,NORTH AND MIDDLE ANDAMAN,2021-02-05,0,6,0,6,
ANDAMAN AND NICOBAR ISLANDS,SOUTH ANDAMANS,2021-02-01,1,494,2,497,
ANDAMAN AND NICOBAR ISLANDS,SOUTH ANDAMANS,2021-02-02,0,1073,1,1074,
ANDAMAN AND NICOBAR ISLANDS,SOUTH ANDAMANS,2021-02-03,1,544,0,545,
ANDAMAN AND NICOBAR ISLANDS,SOUTH ANDAMANS,2021-02-04,1,834,0,835,
ANDAMAN AND NICOBAR ISLANDS,SOUTH ANDAMANS,2021-02-05,25,816,0,841,
ANDHRA PRADESH,ANANTAPUR,2021-02-01,6,1404,0,1410,
ANDHRA PRADESH,ANANTAPUR,2021-02-02,7,1124,0,1131,
ANDHRA PRADESH,ANANTAPUR,2021-02-03,8,1202,0,1210,
ANDHRA PRADESH,ANANTAPUR,2021-02-04,7,2674,0,2681,
ANDHRA PRADESH,ANANTAPUR,2021-02-05,4,4662,0,4666,
ANDHRA PRADESH,CHITTOOR,2021-02-01,22,2848,0,2870,
ANDHRA PRADESH,CHITTOOR,2021-02-02,12,1726,0,1738,
ANDHRA PRADESH,CHITTOOR,2021-02-03,23,1655,0,1678,
ANDHRA PRADESH,CHITTOOR,2021-02-04,29,2040,0,2069,
ANDHRA PRADESH,CHITTOOR,2021-02-05,31,2800,0,2831,
ANDHRA PRADESH,EAST GODAVARI,2021-02-01,6,1750,0,1756,
ANDHRA PRADESH,EAST GODAVARI,2021-02-02,12,707,0,719,
ANDHRA PRADESH,EAST GODAVARI,2021-02-03,4,786,0,790,
ANDHRA PRADESH,EAST GODAVARI,2021-02-04,11,1934,0,1945,
ANDHRA PRADESH,EAST GODAVARI,2021-02-05,13,1482,0,1495,
ANDHRA PRADESH,GUNTUR,2021-02-01,8,3090,0,3098,
ANDHRA PRADESH,GUNTUR,2021-02-02,16,4049,0,4065,
ANDHRA PRADESH,GUNTUR,2021-02-03,13,4186,0,4199,
ANDHRA PRADESH,GUNTUR,2021-02-04,8,4632,0,4640,
ANDHRA PRADESH,GUNTUR,2021-02-05,3,3390,0,3393,
ANDHRA PRADESH,KRISHNA,2021-02-01,23,1106,0,1129,
ANDHRA PRADESH,KRISHNA,2021-02-02,20,1327,0,1347,
ANDHRA PRADESH,KRISHNA,2021-02-03,32,1809,0,1841,
ANDHRA PRADESH,KRISHNA,2021-02-04,10,902,0,912,
ANDHRA PRADESH,KRISHNA,2021-02-05,14,3085,0,3099,
ANDHRA PRADESH,KURNOOL,2021-02-01,8,1453,0,1461,
ANDHRA PRADESH,KURNOOL,2021-02-02,4,3921,0,3925,
ANDHRA PRADESH,KURNOOL,2021-02-03,2,1587,0,1589,
ANDHRA PRADESH,KURNOOL,2021-02-04,1,2356,0,2357,
ANDHRA PRADESH,KURNOOL,2021-02-05,6,1604,0,1610,
ANDHRA PRADESH,PRAKASAM,2021-02-01,3,1494,0,1497,
ANDHRA PRADESH,PRAKASAM,2021-02-02,3,1719,0,1722,
ANDHRA PRADESH,PRAKASAM,2021-02-03,4,1340,0,1344,
ANDHRA PRADESH,PRAKASAM,2021-02-04,7,2990,0,2997,
ANDHRA PRADESH,PRAKASAM,2021-02-05,4,3217,0,3221,
ANDHRA PRADESH,SPSR NELLORE,2021-02-01,14,2184,0,2198,
ANDHRA PRADESH,SPSR NELLORE,2021-02-02,11,759,0,770,
ANDHRA PRADESH,SPSR NELLORE,2021-02-03,7,872,0,879,
ANDHRA PRADESH,SPSR NELLORE,2021-02-04,4,1864,0,1868,
ANDHRA PRADESH,SPSR NELLORE,2021-02-05,5,2353,0,2358,
ANDHRA PRADESH,SRIKAKULAM,2021-02-01,2,724,0,726,
ANDHRA PRADESH,SRIKAKULAM,2021-02-02,4,1966,1,1971,
ANDHRA PRADESH,SRIKAKULAM,2021-02-03,6,1575,0,1581,
ANDHRA PRADESH,SRIKAKULAM,2021-02-04,4,2391,0,2395,
ANDHRA PRADESH,SRIKAKULAM,2021-02-05,5,1685,0,1690,
ANDHRA PRADESH,VISAKHAPATANAM,2021-02-01,22,1287,0,1309,
ANDHRA PRADESH,VISAKHAPATANAM,2021-02-02,24,1497,0,1521,
ANDHRA PRADESH,VISAKHAPATANAM,2021-02-03,24,1746,1,1771,
ANDHRA PRADESH,VISAKHAPATANAM,2021-02-04,23,1507,0,1530,
ANDHRA PRADESH,VISAKHAPATANAM,2021-02-05,20,1358,1,1379,
ANDHRA PRADESH,VIZIANAGARAM,2021-02-01,2,1234,0,1236,
ANDHRA PRADESH,VIZIANAGARAM,2021-02-02,3,1231,0,1234,
ANDHRA PRADESH,VIZIANAGARAM,2021-02-03,1,1479,1,1481,
ANDHRA PRADESH,VIZIANAGARAM,2021-02-04,3,1680,0,1683,
ANDHRA PRADESH,VIZIANAGARAM,2021-02-05,2,1257,0,1259,
ANDHRA PRADESH,WEST GODAVARI,2021-02-01,5,548,0,553,
ANDHRA PRADESH,WEST GODAVARI,2021-02-02,12,2539,0,2551,
ANDHRA PRADESH,WEST GODAVARI,2021-02-03,7,2491,0,2498,
ANDHRA PRADESH,WEST GODAVARI,2021-02-04,9,1176,0,1185,
ANDHRA PRADESH,WEST GODAVARI,2021-02-05,7,973,0,980,
ANDHRA PRADESH,Y.S.R.,2021-02-01,4,413,1,418,
ANDHRA PRADESH,Y.S.R.,2021-02-02,2,2122,1,2125,
ANDHRA PRADESH,Y.S.R.,2021-02-03,4,1654,0,1658,
ANDHRA PRADESH,Y.S.R.,2021-02-04,8,2918,0,2926,
ANDHRA PRADESH,Y.S.R.,2021-02-05,4,3546,0,3550,
ARUNACHAL PRADESH,ANJAW,2021-02-01,0,9,0,9,
ARUNACHAL PRADESH,ANJAW,2021-02-03,0,6,0,6,
ARUNACHAL PRADESH,ANJAW,2021-02-04,0,3,0,3,
ARUNACHAL PRADESH,ANJAW,2021-02-05,0,3,0,3,
ARUNACHAL PRADESH,CHANGLANG,2021-02-01,1,2,0,3,
ARUNACHAL PRADESH,CHANGLANG,2021-02-02,0,1,0,1,
ARUNACHAL PRADESH,CHANGLANG,2021-02-03,0,3,0,3,
ARUNACHAL PRADESH,CHANGLANG,2021-02-04,0,1,0,1,
ARUNACHAL PRADESH,CHANGLANG,2021-02-05,0,2,0,2,
ARUNACHAL PRADESH,DIBANG VALLEY,2021-02-01,0,2,0,2,
ARUNACHAL PRADESH,DIBANG VALLEY,2021-02-02,0,2,0,2,
ARUNACHAL PRADESH,DIBANG VALLEY,2021-02-05,0,1,0,1,
ARUNACHAL PRADESH,EAST KAMENG,2021-02-01,0,1,0,1,
ARUNACHAL PRADESH,EAST KAMENG,2021-02-02,0,1,0,1,
ARUNACHAL PRADESH,EAST KAMENG,2021-02-03,0,2,0,2,
ARUNACHAL PRADESH,EAST KAMENG,2021-02-05,0,1,0,1,
ARUNACHAL PRADESH,EAST SIANG,2021-02-01,0,45,0,45,
ARUNACHAL PRADESH,EAST SIANG,2021-02-02,0,53,0,53,
ARUNACHAL PRADESH,EAST SIANG,2021-02-03,0,46,0,46,
ARUNACHAL PRADESH,EAST SIANG,2021-02-04,0,47,0,47,
ARUNACHAL PRADESH,EAST SIANG,2021-02-05,0,56,0,56,
ARUNACHAL PRADESH,KAMLE,2021-02-01,0,1,0,1,
ARUNACHAL PRADESH,KAMLE,2021-02-04,0,1,0,1,
ARUNACHAL PRADESH,LEPARADA,2021-02-03,7,2,0,9,
ARUNACHAL PRADESH,LEPARADA,2021-02-04,0,7,0,7,
ARUNACHAL PRADESH,LOHIT,2021-02-02,0,2,0,2,
ARUNACHAL PRADESH,LOHIT,2021-02-05,1,1,0,2,
ARUNACHAL PRADESH,LONGDING,2021-02-01,0,1,0,1,
ARUNACHAL PRADESH,LONGDING,2021-02-04,0,2,0,2,
ARUNACHAL PRADESH,LONGDING,2021-02-05,0,1,0,1,
ARUNACHAL PRADESH,LOWER DIBANG VALLEY,2021-02-03,1,34,0,35,
ARUNACHAL PRADESH,LOWER SIANG,2021-02-01,0,16,0,16,
ARUNACHAL PRADESH,LOWER SIANG,2021-02-02,0,11,0,11,
ARUNACHAL PRADESH,LOWER SIANG,2021-02-03,0,15,0,15,
ARUNACHAL PRADESH,LOWER SIANG,2021-02-04,0,34,0,34,
ARUNACHAL PRADESH,LOWER SIANG,2021-02-05,0,1,0,1,
ARUNACHAL PRADESH,LOWER SUBANSIRI,2021-02-01,0,10,0,10,
ARUNACHAL PRADESH,LOWER SUBANSIRI,2021-02-02,0,1,0,1,
ARUNACHAL PRADESH,LOWER SUBANSIRI,2021-02-03,0,5,0,5,
ARUNACHAL PRADESH,LOWER SUBANSIRI,2021-02-04,0,27,0,27,
ARUNACHAL PRADESH,LOWER SUBANSIRI,2021-02-05,0,11,0,11,
ARUNACHAL PRADESH,NAMSAI,2021-02-02,0,4,0,4,
ARUNACHAL PRADESH,NAMSAI,2021-02-03,0,4,0,4,
ARUNACHAL PRADESH,NAMSAI,2021-02-04,0,3,0,3,
ARUNACHAL PRADESH,NAMSAI,2021-02-05,0,1,0,1,
ARUNACHAL PRADESH,PAKKE KESSANG,2021-02-02,0,1,0,1,
ARUNACHAL PRADESH,PAKKE KESSANG,2021-02-05,0,1,0,1,
ARUNACHAL PRADESH,PAPUM PARE,2021-02-01,0,20,0,20,
ARUNACHAL PRADESH,PAPUM PARE,2021-02-02,0,36,0,36,
ARUNACHAL PRADESH,PAPUM PARE,2021-02-03,0,42,0,42,
ARUNACHAL PRADESH,PAPUM PARE,2021-02-04,0,56,0,56,
ARUNACHAL PRADESH,PAPUM PARE,2021-02-05,0,93,0,93,
ARUNACHAL PRADESH,SIANG,2021-02-05,0,1,0,1,
ARUNACHAL PRADESH,TAWANG,2021-02-03,0,1,0,1,
ARUNACHAL PRADESH,TAWANG,2021-02-05,0,3,0,3,
ARUNACHAL PRADESH,TIRAP,2021-02-03,0,2,0,2,
ARUNACHAL PRADESH,TIRAP,2021-02-04,0,2,0,2,
ARUNACHAL PRADESH,TIRAP,2021-02-05,0,3,0,3,
ARUNACHAL PRADESH,UPPER SIANG,2021-02-05,0,2,0,2,
ARUNACHAL PRADESH,UPPER SUBANSIRI,2021-02-02,0,1,0,1,
ARUNACHAL PRADESH,UPPER SUBANSIRI,2021-02-05,0,1,0,1,
ARUNACHAL PRADESH,WEST KAMENG,2021-02-01,1,24,0,25,
ARUNACHAL PRADESH,WEST KAMENG,2021-02-02,0,79,0,79,
ARUNACHAL PRADESH,WEST KAMENG,2021-02-03,0,49,1,50,
ARUNACHAL PRADESH,WEST KAMENG,2021-02-04,0,14,0,14,
ARUNACHAL PRADESH,WEST KAMENG,2021-02-05,0,74,0,74,
ARUNACHAL PRADESH,WEST SIANG,2021-02-02,0,7,0,7,
ARUNACHAL PRADESH,WEST SIANG,2021-02-03,0,39,0,39,
ARUNACHAL PRADESH,WEST SIANG,2021-02-04,0,36,0,36,
ARUNACHAL PRADESH,WEST SIANG,2021-02-05,0,2,0,2,
ASSAM,BAKSA,2021-02-01,0,59,0,59,
ASSAM,BAKSA,2021-02-02,0,87,0,87,
ASSAM,BAKSA,2021-02-03,0,117,0,117,
ASSAM,BAKSA,2021-02-04,0,35,0,35,
ASSAM,BAKSA,2021-02-05,0,23,0,23,
ASSAM,BARPETA,2021-02-01,0,116,0,116,
ASSAM,BARPETA,2021-02-02,0,194,0,194,
ASSAM,BARPETA,2021-02-03,0,294,0,294,
ASSAM,BARPETA,2021-02-04,1,211,0,212,
ASSAM,BARPETA,2021-02-05,0,154,0,154,
ASSAM,BISWANATH,2021-02-01,0,32,0,32,
ASSAM,BISWANATH,2021-02-02,0,17,0,17,
ASSAM,BISWANATH,2021-02-03,0,41,0,41,
ASSAM,BISWANATH,2021-02-04,0,21,0,21,
ASSAM,BISWANATH,2021-02-05,0,19,0,19,
ASSAM,BONGAIGAON,2021-02-01,0,279,0,279,
ASSAM,BONGAIGAON,2021-02-02,0,271,0,271,
ASSAM,BONGAIGAON,2021-02-03,0,303,0,303,
ASSAM,BONGAIGAON,2021-02-04,0,221,0,221,
ASSAM,BONGAIGAON,2021-02-05,0,250,0,250,
ASSAM,CACHAR,2021-02-01,8,4217,23,4248,
ASSAM,CACHAR,2021-02-02,2,196,32,230,
ASSAM,CACHAR,2021-02-03,0,93,16,109,
ASSAM,CACHAR,2021-02-04,0,149,45,194,
ASSAM,CACHAR,2021-02-05,20,1675,66,1761,
ASSAM,CHARAIDEO,2021-02-01,0,161,0,161,
ASSAM,CHARAIDEO,2021-02-02,0,163,0,163,
ASSAM,CHARAIDEO,2021-02-03,0,74,0,74,
ASSAM,CHARAIDEO,2021-02-04,0,153,0,153,
ASSAM,CHARAIDEO,2021-02-05,0,88,0,88,
ASSAM,CHIRANG,2021-02-01,0,107,0,107,
ASSAM,CHIRANG,2021-02-02,0,55,0,55,
ASSAM,CHIRANG,2021-02-03,0,65,0,65,
ASSAM,CHIRANG,2021-02-04,0,114,0,114,
ASSAM,CHIRANG,2021-02-05,0,32,0,32,
ASSAM,DARRANG,2021-02-01,1,371,0,372,
ASSAM,DARRANG,2021-02-02,0,459,0,459,
ASSAM,DARRANG,2021-02-03,0,433,0,433,
ASSAM,DARRANG,2021-02-04,0,323,0,323,
ASSAM,DARRANG,2021-02-05,1,366,0,367,
ASSAM,DHEMAJI,2021-02-01,0,119,0,119,
ASSAM,DHEMAJI,2021-02-02,0,101,0,101,
ASSAM,DHEMAJI,2021-02-03,0,121,0,121,
ASSAM,DHEMAJI,2021-02-04,0,77,0,77,
ASSAM,DHEMAJI,2021-02-05,1,121,0,122,
ASSAM,DHUBRI,2021-02-01,0,236,0,236,
ASSAM,DHUBRI,2021-02-02,0,176,0,176,
ASSAM,DHUBRI,2021-02-03,0,216,0,216,
ASSAM,DHUBRI,2021-02-04,0,240,0,240,
ASSAM,DHUBRI,2021-02-05,0,210,0,210,
ASSAM,DIBRUGARH,2021-02-01,5,371,0,376,
ASSAM,DIBRUGARH,2021-02-02,1,338,0,339,
ASSAM,DIBRUGARH,2021-02-03,2,287,0,289,
ASSAM,DIBRUGARH,2021-02-04,2,237,0,239,
ASSAM,DIBRUGARH,2021-02-05,0,173,0,173,
ASSAM,DIMA HASAO,2021-02-01,1,80,0,81,
ASSAM,DIMA HASAO,2021-02-02,0,43,0,43,
ASSAM,DIMA HASAO,2021-02-03,0,71,0,71,
ASSAM,DIMA HASAO,2021-02-04,2,48,0,50,
ASSAM,DIMA HASAO,2021-02-05,0,66,0,66,
ASSAM,GOALPARA,2021-02-01,1,464,0,465,
ASSAM,GOALPARA,2021-02-02,0,529,0,529,
ASSAM,GOALPARA,2021-02-03,0,401,0,401,
ASSAM,GOALPARA,2021-02-04,0,416,0,416,
ASSAM,GOALPARA,2021-02-05,0,447,0,447,
ASSAM,GOLAGHAT,2021-02-01,22,513,2,537,
ASSAM,GOLAGHAT,2021-02-02,31,366,1,398,
ASSAM,GOLAGHAT,2021-02-03,10,236,0,246,
ASSAM,GOLAGHAT,2021-02-04,0,164,0,164,
ASSAM,GOLAGHAT,2021-02-05,0,251,0,251,
ASSAM,HAILAKANDI,2021-02-01,1,432,3,436,
ASSAM,HAILAKANDI,2021-02-02,1,212,0,213,
ASSAM,HAILAKANDI,2021-02-03,0,195,1,196,
ASSAM,HAILAKANDI,2021-02-04,0,142,0,142,
ASSAM,HAILAKANDI,2021-02-05,1,338,72,411,
ASSAM,HOJAI,2021-02-01,0,159,0,159,
ASSAM,HOJAI,2021-02-02,0,114,0,114,
ASSAM,HOJAI,2021-02-03,0,186,0,186,
ASSAM,HOJAI,2021-02-04,0,150,0,150,
ASSAM,HOJAI,2021-02-05,0,174,0,174,
ASSAM,JORHAT,2021-02-01,0,372,17,389,
ASSAM,JORHAT,2021-02-02,1,369,85,455,
ASSAM,JORHAT,2021-02-03,0,298,0,298,
ASSAM,JORHAT,2021-02-04,1,313,0,314,
ASSAM,JORHAT,2021-02-05,0,367,0,367,
ASSAM,KAMRUP,2021-02-01,1,719,0,720,
ASSAM,KAMRUP,2021-02-02,1,531,0,532,
ASSAM,KAMRUP,2021-02-03,1,735,1,737,
ASSAM,KAMRUP,2021-02-04,0,596,0,596,
ASSAM,KAMRUP,2021-02-05,1,681,0,682,
ASSAM,KAMRUP METRO,2021-02-01,8,2113,1,2122,
ASSAM,KAMRUP METRO,2021-02-02,7,1974,0,1981,
ASSAM,KAMRUP METRO,2021-02-03,5,2061,0,2066,
ASSAM,KAMRUP METRO,2021-02-04,6,1799,0,1805,
ASSAM,KAMRUP METRO,2021-02-05,5,1620,1,1626,
ASSAM,KARBI ANGLONG,2021-02-01,0,27,0,27,
ASSAM,KARBI ANGLONG,2021-02-02,0,33,0,33,
ASSAM,KARBI ANGLONG,2021-02-03,0,28,0,28,
ASSAM,KARBI ANGLONG,2021-02-04,0,33,0,33,
ASSAM,KARBI ANGLONG,2021-02-05,0,94,0,94,
ASSAM,KARIMGANJ,2021-02-01,1,503,23,527,
ASSAM,KARIMGANJ,2021-02-02,0,371,1,372,
ASSAM,KARIMGANJ,2021-02-03,0,473,12,485,
ASSAM,KARIMGANJ,2021-02-04,0,303,0,303,
ASSAM,KARIMGANJ,2021-02-05,3,513,0,516,
ASSAM,KOKRAJHAR,2021-02-01,0,45,0,45,
ASSAM,KOKRAJHAR,2021-02-02,0,76,0,76,
ASSAM,KOKRAJHAR,2021-02-03,0,23,0,23,
ASSAM,KOKRAJHAR,2021-02-04,0,42,0,42,
ASSAM,KOKRAJHAR,2021-02-05,0,71,0,71,
ASSAM,LAKHIMPUR,2021-02-01,0,243,0,243,
ASSAM,LAKHIMPUR,2021-02-02,0,183,0,183,
ASSAM,LAKHIMPUR,2021-02-03,0,321,0,321,
ASSAM,LAKHIMPUR,2021-02-04,0,436,0,436,
ASSAM,LAKHIMPUR,2021-02-05,0,297,0,297,
ASSAM,MAJULI,2021-02-01,0,11,2,13,
ASSAM,MAJULI,2021-02-02,0,9,0,9,
ASSAM,MAJULI,2021-02-03,0,15,0,15,
ASSAM,MAJULI,2021-02-04,0,5,0,5,
ASSAM,MAJULI,2021-02-05,0,8,0,8,
ASSAM,MARIGAON,2021-02-01,0,241,0,241,
ASSAM,MARIGAON,2021-02-02,0,298,0,298,
ASSAM,MARIGAON,2021-02-03,1,102,0,103,
ASSAM,MARIGAON,2021-02-04,0,94,0,94,
ASSAM,MARIGAON,2021-02-05,0,143,0,143,
ASSAM,NAGAON,2021-02-01,1,572,10,583,
ASSAM,NAGAON,2021-02-02,0,416,0,416,
ASSAM,NAGAON,2021-02-03,2,422,0,424,
ASSAM,NAGAON,2021-02-04,1,298,0,299,
ASSAM,NAGAON,2021-02-05,1,346,0,347,
ASSAM,NALBARI,2021-02-01,0,82,0,82,
ASSAM,NALBARI,2021-02-02,0,48,0,48,
ASSAM,NALBARI,2021-02-03,1,55,0,56,
ASSAM,NALBARI,2021-02-04,0,42,0,42,
ASSAM,NALBARI,2021-02-05,0,35,0,35,
ASSAM,SIVASAGAR,2021-02-01,0,265,2,267,
ASSAM,SIVASAGAR,2021-02-02,1,252,0,253,
ASSAM,SIVASAGAR,2021-02-03,0,237,0,237,
ASSAM,SIVASAGAR,2021-02-04,0,188,0,188,
ASSAM,SIVASAGAR,2021-02-05,0,123,0,123,
ASSAM,SONITPUR,2021-02-01,1,261,0,262,
ASSAM,SONITPUR,2021-02-02,0,223,0,223,
ASSAM,SONITPUR,2021-02-03,1,239,0,240,
ASSAM,SONITPUR,2021-02-04,0,426,0,426,
ASSAM,SONITPUR,2021-02-05,7,296,0,303,
ASSAM,SOUTH SALMARA MANCACHAR,2021-02-01,0,34,0,34,
ASSAM,SOUTH SALMARA MANCACHAR,2021-02-02,0,44,0,44,
ASSAM,SOUTH SALMARA MANCACHAR,2021-02-03,0,26,0,26,
ASSAM,SOUTH SALMARA MANCACHAR,2021-02-04,0,41,0,41,
ASSAM,SOUTH SALMARA MANCACHAR,2021-02-05,0,16,0,16,
ASSAM,TINSUKIA,2021-02-01,2,304,0,306,
ASSAM,TINSUKIA,2021-02-02,0,234,0,234,
ASSAM,TINSUKIA,2021-02-03,1,435,0,436,
ASSAM,TINSUKIA,2021-02-04,1,231,0,232,
ASSAM,TINSUKIA,2021-02-05,1,247,0,248,
ASSAM,UDALGURI,2021-02-01,0,4,0,4,
ASSAM,UDALGURI,2021-02-02,0,4,0,4,
ASSAM,UDALGURI,2021-02-03,0,5,0,5,
ASSAM,UDALGURI,2021-02-04,0,9,0,9,
ASSAM,UDALGURI,2021-02-05,0,10,0,10,
ASSAM,WEST KARBI ANGLONG,2021-02-01,0,8,0,8,
ASSAM,WEST KARBI ANGLONG,2021-02-02,0,3,0,3,
ASSAM,WEST KARBI ANGLONG,2021-02-03,0,7,0,7,
ASSAM,WEST KARBI ANGLONG,2021-02-04,0,8,0,8,
ASSAM,WEST KARBI ANGLONG,2021-02-05,0,23,0,23,
BIHAR,ARARIA,2021-02-01,1,395,2,398,
BIHAR,ARARIA,2021-02-02,3,276,0,279,
BIHAR,ARARIA,2021-02-03,0,684,6,690,
BIHAR,ARARIA,2021-02-04,0,583,0,583,
BIHAR,ARARIA,2021-02-05,0,638,4,642,
BIHAR,ARWAL,2021-02-01,0,1162,0,1162,
BIHAR,ARWAL,2021-02-02,0,1576,17,1593,
BIHAR,ARWAL,2021-02-03,0,882,0,882,
BIHAR,ARWAL,2021-02-04,0,896,2,898,
BIHAR,ARWAL,2021-02-05,3,748,0,751,
BIHAR,AURANGABAD,2021-02-01,7,1620,0,1627,
BIHAR,AURANGABAD,2021-02-02,7,1744,0,1751,
BIHAR,AURANGABAD,2021-02-03,5,1165,0,1170,
BIHAR,AURANGABAD,2021-02-04,3,872,0,875,
BIHAR,AURANGABAD,2021-02-05,4,1138,0,1142,
BIHAR,BANKA,2021-02-01,2,1688,22,1712,
BIHAR,BANKA,2021-02-02,0,1740,104,1844,
BIHAR,BANKA,2021-02-03,4,1840,17,1861,
BIHAR,BANKA,2021-02-04,0,1497,0,1497,
BIHAR,BANKA,2021-02-05,0,1928,135,2063,
BIHAR,BEGUSARAI,2021-02-01,3,1677,0,1680,
BIHAR,BEGUSARAI,2021-02-02,10,3771,1,3782,
BIHAR,BEGUSARAI,2021-02-03,2,2195,1,2198,
BIHAR,BEGUSARAI,2021-02-04,4,2175,1,2180,
BIHAR,BEGUSARAI,2021-02-05,1,3532,1,3534,
BIHAR,BHAGALPUR,2021-02-01,4,1867,134,2005,
BIHAR,BHAGALPUR,2021-02-02,0,1445,109,1554,
BIHAR,BHAGALPUR,2021-02-03,4,2895,378,3277,
BIHAR,BHAGALPUR,2021-02-04,9,907,89,1005,
BIHAR,BHAGALPUR,2021-02-05,3,1964,51,2018,
BIHAR,BHOJPUR,2021-02-01,0,1281,5,1286,
BIHAR,BHOJPUR,2021-02-02,1,547,354,902,
BIHAR,BHOJPUR,2021-02-03,0,830,16,846,
BIHAR,BHOJPUR,2021-02-04,2,770,1,773,
BIHAR,BHOJPUR,2021-02-05,0,752,31,783,
BIHAR,BUXAR,2021-02-01,0,753,86,839,
BIHAR,BUXAR,2021-02-02,1,680,48,729,
BIHAR,BUXAR,2021-02-03,0,747,109,856,
BIHAR,BUXAR,2021-02-04,1,668,46,715,
BIHAR,BUXAR,2021-02-05,0,502,0,502,
BIHAR,DARBHANGA,2021-02-01,3,2271,21,2295,
BIHAR,DARBHANGA,2021-02-02,3,1801,24,1828,
BIHAR,DARBHANGA,2021-02-03,1,1779,6,1786,
BIHAR,DARBHANGA,2021-02-04,0,1841,1,1842,
BIHAR,DARBHANGA,2021-02-05,1,2717,0,2718,
BIHAR,GAYA,2021-02-01,6,3735,16,3757,
BIHAR,GAYA,2021-02-02,8,3406,9,3423,
BIHAR,GAYA,2021-02-03,9,2150,0,2159,
BIHAR,GAYA,2021-02-04,10,3586,95,3691,
BIHAR,GAYA,2021-02-05,2,3840,145,3987,
BIHAR,GOPALGANJ,2021-02-01,6,1028,96,1130,
BIHAR,GOPALGANJ,2021-02-02,3,564,1,568,
BIHAR,GOPALGANJ,2021-02-03,1,640,1,642,
BIHAR,GOPALGANJ,2021-02-04,1,350,1,352,
BIHAR,GOPALGANJ,2021-02-05,0,418,0,418,
BIHAR,JAMUI,2021-02-01,0,1211,1,1212,
BIHAR,JAMUI,2021-02-02,2,854,98,954,
BIHAR,JAMUI,2021-02-03,0,933,2,935,
BIHAR,JAMUI,2021-02-04,0,687,0,687,
BIHAR,JAMUI,2021-02-05,0,836,0,836,
BIHAR,JEHANABAD,2021-02-01,0,952,47,999,
BIHAR,JEHANABAD,2021-02-02,1,1022,0,1023,
BIHAR,JEHANABAD,2021-02-03,0,1095,20,1115,
BIHAR,JEHANABAD,2021-02-04,0,1056,1,1057,
BIHAR,JEHANABAD,2021-02-05,0,671,42,713,
BIHAR,KAIMUR (BHABUA),2021-02-01,0,2141,0,2141,
BIHAR,KAIMUR (BHABUA),2021-02-02,5,1825,0,1830,
BIHAR,KAIMUR (BHABUA),2021-02-03,2,1470,0,1472,
BIHAR,KAIMUR (BHABUA),2021-02-04,5,1557,0,1562,
BIHAR,KAIMUR (BHABUA),2021-02-05,7,1435,0,1442,
BIHAR,KATIHAR,2021-02-01,1,903,1,905,
BIHAR,KATIHAR,2021-02-02,0,1249,0,1249,
BIHAR,KATIHAR,2021-02-03,1,1386,25,1412,
BIHAR,KATIHAR,2021-02-04,0,1501,0,1501,
BIHAR,KATIHAR,2021-02-05,1,1576,0,1577,
BIHAR,KHAGARIA,2021-02-01,1,1333,0,1334,
BIHAR,KHAGARIA,2021-02-02,0,803,0,803,
BIHAR,KHAGARIA,2021-02-03,1,977,1,979,
BIHAR,KHAGARIA,2021-02-04,0,1003,0,1003,
BIHAR,KHAGARIA,2021-02-05,0,1701,1,1702,
BIHAR,KISHANGANJ,2021-02-01,2,786,0,788,
BIHAR,KISHANGANJ,2021-02-02,0,557,0,557,
BIHAR,KISHANGANJ,2021-02-03,0,816,15,831,
BIHAR,KISHANGANJ,2021-02-04,0,779,2,781,
BIHAR,KISHANGANJ,2021-02-05,0,591,0,591,
BIHAR,LAKHISARAI,2021-02-01,13,272,0,285,
BIHAR,LAKHISARAI,2021-02-02,0,687,0,687,
BIHAR,LAKHISARAI,2021-02-03,3,552,0,555,
BIHAR,LAKHISARAI,2021-02-04,1,800,0,801,
BIHAR,LAKHISARAI,2021-02-05,0,624,0,624,
BIHAR,MADHEPURA,2021-02-01,1,816,0,817,
BIHAR,MADHEPURA,2021-02-02,2,1393,0,1395,
BIHAR,MADHEPURA,2021-02-03,1,1145,0,1146,
BIHAR,MADHEPURA,2021-02-04,0,1290,0,1290,
BIHAR,MADHEPURA,2021-02-05,0,1081,0,1081,
BIHAR,MADHUBANI,2021-02-01,0,1433,10,1443,
BIHAR,MADHUBANI,2021-02-02,3,1352,10,1365,
BIHAR,MADHUBANI,2021-02-03,1,1082,10,1093,
BIHAR,MADHUBANI,2021-02-04,0,1179,15,1194,
BIHAR,MADHUBANI,2021-02-05,1,1346,5,1352,
BIHAR,MUNGER,2021-02-01,0,1354,20,1374,
BIHAR,MUNGER,2021-02-02,3,1068,12,1083,
BIHAR,MUNGER,2021-02-03,2,1557,0,1559,
BIHAR,MUNGER,2021-02-04,2,938,5,945,
BIHAR,MUNGER,2021-02-05,1,716,2,719,
BIHAR,MUZAFFARPUR,2021-02-01,7,1979,0,1986,
BIHAR,MUZAFFARPUR,2021-02-02,1,755,0,756,
BIHAR,MUZAFFARPUR,2021-02-03,2,1493,3,1498,
BIHAR,MUZAFFARPUR,2021-02-04,3,3346,0,3349,
BIHAR,MUZAFFARPUR,2021-02-05,1,2570,0,2571,
BIHAR,NALANDA,2021-02-01,1,2549,95,2645,
BIHAR,NALANDA,2021-02-02,2,3146,1,3149,
BIHAR,NALANDA,2021-02-03,1,2679,1,2681,
BIHAR,NALANDA,2021-02-04,1,2916,0,2917,
BIHAR,NALANDA,2021-02-05,0,2142,0,2142,
BIHAR,NAWADA,2021-02-01,7,1429,0,1436,
BIHAR,NAWADA,2021-02-02,0,737,1,738,
BIHAR,NAWADA,2021-02-03,0,943,1,944,
BIHAR,NAWADA,2021-02-04,0,1101,0,1101,
BIHAR,NAWADA,2021-02-05,1,1026,0,1027,
BIHAR,PASHCHIM CHAMPARAN,2021-02-01,0,1698,0,1698,
BIHAR,PASHCHIM CHAMPARAN,2021-02-02,1,1743,1,1745,
BIHAR,PASHCHIM CHAMPARAN,2021-02-03,0,1643,0,1643,
BIHAR,PASHCHIM CHAMPARAN,2021-02-04,0,1932,1,1933,
BIHAR,PASHCHIM CHAMPARAN,2021-02-05,0,2152,1,2153,
BIHAR,PATNA,2021-02-01,47,3361,5,3413,
BIHAR,PATNA,2021-02-02,44,3361,7,3412,
BIHAR,PATNA,2021-02-03,26,2906,8,2940,
BIHAR,PATNA,2021-02-04,38,3237,2,3277,
BIHAR,PATNA,2021-02-05,43,3347,12,3402,
BIHAR,PURBI CHAMPARAN,2021-02-01,1,1961,13,1975,
BIHAR,PURBI CHAMPARAN,2021-02-02,0,2524,0,2524,
BIHAR,PURBI CHAMPARAN,2021-02-03,0,3445,3,3448,
BIHAR,PURBI CHAMPARAN,2021-02-04,1,3431,0,3432,
BIHAR,PURBI CHAMPARAN,2021-02-05,4,3143,0,3147,
BIHAR,PURNIA,2021-02-01,6,994,284,1284,
BIHAR,PURNIA,2021-02-02,0,736,358,1094,
BIHAR,PURNIA,2021-02-03,2,1288,12,1302,
BIHAR,PURNIA,2021-02-04,2,1732,0,1734,
BIHAR,PURNIA,2021-02-05,3,926,0,929,
BIHAR,ROHTAS,2021-02-01,0,2131,27,2158,
BIHAR,ROHTAS,2021-02-02,2,2643,12,2657,
BIHAR,ROHTAS,2021-02-03,2,1768,48,1818,
BIHAR,ROHTAS,2021-02-04,3,1037,17,1057,
BIHAR,ROHTAS,2021-02-05,0,1060,24,1084,
BIHAR,SAHARSA,2021-02-01,1,616,0,617,
BIHAR,SAHARSA,2021-02-02,0,415,3,418,
BIHAR,SAHARSA,2021-02-03,0,527,0,527,
BIHAR,SAHARSA,2021-02-04,4,447,0,451,
BIHAR,SAHARSA,2021-02-05,0,656,0,656,
BIHAR,SAMASTIPUR,2021-02-01,0,2637,95,2732,
BIHAR,SAMASTIPUR,2021-02-02,1,2145,38,2184,
BIHAR,SAMASTIPUR,2021-02-03,0,2488,23,2511,
BIHAR,SAMASTIPUR,2021-02-04,0,3302,76,3378,
BIHAR,SAMASTIPUR,2021-02-05,6,3157,16,3179,
BIHAR,SARAN,2021-02-01,6,1528,3,1537,
BIHAR,SARAN,2021-02-02,3,1957,1,1961,
BIHAR,SARAN,2021-02-03,3,1792,6,1801,
BIHAR,SARAN,2021-02-04,1,1090,0,1091,
BIHAR,SARAN,2021-02-05,1,1475,6,1482,
BIHAR,SHEIKHPURA,2021-02-01,0,157,20,177,
BIHAR,SHEIKHPURA,2021-02-02,1,264,9,274,
BIHAR,SHEIKHPURA,2021-02-03,0,291,6,297,
BIHAR,SHEIKHPURA,2021-02-04,1,217,5,223,
BIHAR,SHEIKHPURA,2021-02-05,0,498,26,524,
BIHAR,SHEOHAR,2021-02-01,0,622,0,622,
BIHAR,SHEOHAR,2021-02-02,0,88,0,88,
BIHAR,SHEOHAR,2021-02-03,0,690,0,690,
BIHAR,SHEOHAR,2021-02-04,3,899,0,902,
BIHAR,SHEOHAR,2021-02-05,3,361,0,364,
BIHAR,SITAMARHI,2021-02-01,1,1800,0,1801,
BIHAR,SITAMARHI,2021-02-02,1,836,0,837,
BIHAR,SITAMARHI,2021-02-03,0,704,0,704,
BIHAR,SITAMARHI,2021-02-04,1,1591,0,1592,
BIHAR,SITAMARHI,2021-02-05,0,1300,0,1300,
BIHAR,SIWAN,2021-02-01,2,1351,0,1353,
BIHAR,SIWAN,2021-02-02,0,1440,2,1442,
BIHAR,SIWAN,2021-02-03,5,1483,0,1488,
BIHAR,SIWAN,2021-02-04,0,1388,1,1389,
BIHAR,SIWAN,2021-02-05,2,1971,0,1973,
BIHAR,SUPAUL,2021-02-01,1,1131,43,1175,
BIHAR,SUPAUL,2021-02-02,0,1257,0,1257,
BIHAR,SUPAUL,2021-02-03,0,1079,0,1079,
BIHAR,SUPAUL,2021-02-04,0,1512,45,1557,
BIHAR,SUPAUL,2021-02-05,0,1268,42,1310,
BIHAR,VAISHALI,2021-02-01,4,3330,4,3338,
BIHAR,VAISHALI,2021-02-02,3,2829,1,2833,
BIHAR,VAISHALI,2021-02-03,0,2865,0,2865,
BIHAR,VAISHALI,2021-02-04,0,3118,0,3118,
BIHAR,VAISHALI,2021-02-05,8,3499,1,3508,
CHANDIGARH,CHANDIGARH,2021-02-01,35,1443,49,1527,
CHANDIGARH,CHANDIGARH,2021-02-02,20,1444,32,1496,
CHANDIGARH,CHANDIGARH,2021-02-03,38,1493,12,1543,
CHANDIGARH,CHANDIGARH,2021-02-04,27,1274,1,1302,
CHANDIGARH,CHANDIGARH,2021-02-05,33,1212,0,1245,
CHHATTISGARH,BALOD,2021-02-01,3,573,1,577,
CHHATTISGARH,BALOD,2021-02-02,4,707,0,711,
CHHATTISGARH,BALOD,2021-02-03,7,1124,1,1132,
CHHATTISGARH,BALOD,2021-02-04,6,1178,1,1185,
CHHATTISGARH,BALOD,2021-02-05,5,808,1,814,
CHHATTISGARH,BALODA BAZAR,2021-02-01,7,411,4,422,
CHHATTISGARH,BALODA BAZAR,2021-02-02,17,741,38,796,
CHHATTISGARH,BALODA BAZAR,2021-02-03,19,699,2,720,
CHHATTISGARH,BALODA BAZAR,2021-02-04,14,444,7,465,
CHHATTISGARH,BALODA BAZAR,2021-02-05,10,267,4,281,
CHHATTISGARH,BALRAMPUR,2021-02-01,4,135,3,142,
CHHATTISGARH,BALRAMPUR,2021-02-02,2,335,2,339,
CHHATTISGARH,BALRAMPUR,2021-02-03,2,340,0,342,
CHHATTISGARH,BALRAMPUR,2021-02-04,12,281,1,294,
CHHATTISGARH,BALRAMPUR,2021-02-05,0,321,1,322,
CHHATTISGARH,BASTAR,2021-02-01,4,844,0,848,
CHHATTISGARH,BASTAR,2021-02-02,3,1394,1,1398,
CHHATTISGARH,BASTAR,2021-02-03,3,1063,0,1066,
CHHATTISGARH,BASTAR,2021-02-04,4,1649,0,1653,
CHHATTISGARH,BASTAR,2021-02-05,7,891,0,898,
CHHATTISGARH,BEMETARA,2021-02-01,2,272,0,274,
CHHATTISGARH,BEMETARA,2021-02-02,2,317,2,321,
CHHATTISGARH,BEMETARA,2021-02-03,2,1109,0,1111,
CHHATTISGARH,BEMETARA,2021-02-04,2,883,1,886,
CHHATTISGARH,BEMETARA,2021-02-05,4,485,1,490,
CHHATTISGARH,BIJAPUR,2021-02-01,0,82,0,82,
CHHATTISGARH,BIJAPUR,2021-02-02,1,135,0,136,
CHHATTISGARH,BIJAPUR,2021-02-03,0,356,0,356,
CHHATTISGARH,BIJAPUR,2021-02-04,1,46,0,47,
CHHATTISGARH,BIJAPUR,2021-02-05,0,112,0,112,
CHHATTISGARH,BILASPUR,2021-02-01,18,1246,17,1281,
CHHATTISGARH,BILASPUR,2021-02-02,20,804,8,832,
CHHATTISGARH,BILASPUR,2021-02-03,29,695,57,781,
CHHATTISGARH,BILASPUR,2021-02-04,22,785,8,815,
CHHATTISGARH,BILASPUR,2021-02-05,19,615,21,655,
CHHATTISGARH,DANTEWADA,2021-02-01,2,422,0,424,
CHHATTISGARH,DANTEWADA,2021-02-02,2,290,0,292,
CHHATTISGARH,DANTEWADA,2021-02-03,1,403,0,404,
CHHATTISGARH,DANTEWADA,2021-02-04,4,337,0,341,
CHHATTISGARH,DANTEWADA,2021-02-05,2,232,0,234,
CHHATTISGARH,DHAMTARI,2021-02-01,24,476,14,514,
CHHATTISGARH,DHAMTARI,2021-02-02,10,639,16,665,
CHHATTISGARH,DHAMTARI,2021-02-03,5,531,14,550,
CHHATTISGARH,DHAMTARI,2021-02-04,14,572,6,592,
CHHATTISGARH,DHAMTARI,2021-02-05,15,770,13,798,
CHHATTISGARH,DURG,2021-02-01,49,912,4,965,
CHHATTISGARH,DURG,2021-02-02,50,707,4,761,
CHHATTISGARH,DURG,2021-02-03,60,957,0,1017,
CHHATTISGARH,DURG,2021-02-04,54,1038,4,1096,
CHHATTISGARH,DURG,2021-02-05,39,1072,0,1111,
CHHATTISGARH,GARIYABAND,2021-02-01,5,199,10,214,
CHHATTISGARH,GARIYABAND,2021-02-02,10,249,13,272,
CHHATTISGARH,GARIYABAND,2021-02-03,6,274,13,293,
CHHATTISGARH,GARIYABAND,2021-02-04,8,176,3,187,
CHHATTISGARH,GARIYABAND,2021-02-05,7,206,13,226,
CHHATTISGARH,GAURELLA PENDRA MARWAHI,2021-02-01,2,219,0,221,
CHHATTISGARH,GAURELLA PENDRA MARWAHI,2021-02-02,1,423,35,459,
CHHATTISGARH,GAURELLA PENDRA MARWAHI,2021-02-03,0,180,7,187,
CHHATTISGARH,GAURELLA PENDRA MARWAHI,2021-02-04,1,83,0,84,
CHHATTISGARH,GAURELLA PENDRA MARWAHI,2021-02-05,0,199,0,199,
CHHATTISGARH,JANJGIR CHAMPA,2021-02-01,6,1956,0,1962,
CHHATTISGARH,JANJGIR CHAMPA,2021-02-02,18,1783,1,1802,
CHHATTISGARH,JANJGIR CHAMPA,2021-02-03,14,1733,0,1747,
CHHATTISGARH,JANJGIR CHAMPA,2021-02-04,7,1538,0,1545,
CHHATTISGARH,JANJGIR CHAMPA,2021-02-05,4,1282,0,1286,
CHHATTISGARH,JASHPUR,2021-02-01,9,329,0,338,
CHHATTISGARH,JASHPUR,2021-02-02,1,354,0,355,
CHHATTISGARH,JASHPUR,2021-02-03,7,447,0,454,
CHHATTISGARH,JASHPUR,2021-02-04,10,516,0,526,
CHHATTISGARH,JASHPUR,2021-02-05,5,448,0,453,
CHHATTISGARH,KABIRDHAM,2021-02-01,2,206,0,208,
CHHATTISGARH,KABIRDHAM,2021-02-02,1,100,0,101,
CHHATTISGARH,KABIRDHAM,2021-02-03,0,270,8,278,
CHHATTISGARH,KABIRDHAM,2021-02-04,4,665,3,672,
CHHATTISGARH,KABIRDHAM,2021-02-05,0,371,0,371,
CHHATTISGARH,KANKER,2021-02-01,5,330,0,335,
CHHATTISGARH,KANKER,2021-02-02,3,270,0,273,
CHHATTISGARH,KANKER,2021-02-03,5,521,0,526,
CHHATTISGARH,KANKER,2021-02-04,3,159,0,162,
CHHATTISGARH,KANKER,2021-02-05,4,235,1,240,
CHHATTISGARH,KONDAGAON,2021-02-01,2,1338,0,1340,
CHHATTISGARH,KONDAGAON,2021-02-02,1,958,0,959,
CHHATTISGARH,KONDAGAON,2021-02-03,1,811,0,812,
CHHATTISGARH,KONDAGAON,2021-02-04,1,1108,0,1109,
CHHATTISGARH,KONDAGAON,2021-02-05,1,444,0,445,
CHHATTISGARH,KORBA,2021-02-01,14,1785,0,1799,
CHHATTISGARH,KORBA,2021-02-02,9,1050,0,1059,
CHHATTISGARH,KORBA,2021-02-03,15,1059,0,1074,
CHHATTISGARH,KORBA,2021-02-04,15,1481,0,1496,
CHHATTISGARH,KORBA,2021-02-05,15,1042,1,1058,
CHHATTISGARH,KOREA,2021-02-01,7,764,2,773,
CHHATTISGARH,KOREA,2021-02-02,16,636,0,652,
CHHATTISGARH,KOREA,2021-02-03,11,1073,3,1087,
CHHATTISGARH,KOREA,2021-02-04,3,622,0,625,
CHHATTISGARH,KOREA,2021-02-05,3,711,1,715,
CHHATTISGARH,MAHASAMUND,2021-02-01,13,688,1,702,
CHHATTISGARH,MAHASAMUND,2021-02-02,11,1006,0,1017,
CHHATTISGARH,MAHASAMUND,2021-02-03,5,982,0,987,
CHHATTISGARH,MAHASAMUND,2021-02-04,8,1034,0,1042,
CHHATTISGARH,MAHASAMUND,2021-02-05,18,1399,0,1417,
CHHATTISGARH,MUNGELI,2021-02-01,4,294,0,298,
CHHATTISGARH,MUNGELI,2021-02-02,0,452,0,452,
CHHATTISGARH,MUNGELI,2021-02-03,5,667,13,685,
CHHATTISGARH,MUNGELI,2021-02-04,4,780,0,784,
CHHATTISGARH,MUNGELI,2021-02-05,0,796,2,798,
CHHATTISGARH,NARAYANPUR,2021-02-01,0,249,0,249,
CHHATTISGARH,NARAYANPUR,2021-02-02,0,112,0,112,
CHHATTISGARH,NARAYANPUR,2021-02-03,0,205,0,205,
CHHATTISGARH,NARAYANPUR,2021-02-04,0,116,0,116,
CHHATTISGARH,NARAYANPUR,2021-02-05,0,116,0,116,
CHHATTISGARH,RAIGARH,2021-02-01,10,1054,1,1065,
CHHATTISGARH,RAIGARH,2021-02-02,18,1278,5,1301,
CHHATTISGARH,RAIGARH,2021-02-03,16,1048,6,1070,
CHHATTISGARH,RAIGARH,2021-02-04,30,1251,1,1282,
CHHATTISGARH,RAIGARH,2021-02-05,16,967,2,985,
CHHATTISGARH,RAIPUR,2021-02-01,117,1923,29,2069,
CHHATTISGARH,RAIPUR,2021-02-02,165,1830,11,2006,
CHHATTISGARH,RAIPUR,2021-02-03,171,2174,32,2377,
CHHATTISGARH,RAIPUR,2021-02-04,136,1919,17,2072,
CHHATTISGARH,RAIPUR,2021-02-05,174,1881,33,2088,
CHHATTISGARH,RAJNANDGAON,2021-02-01,14,485,2,501,
CHHATTISGARH,RAJNANDGAON,2021-02-02,2,420,15,437,
CHHATTISGARH,RAJNANDGAON,2021-02-03,7,1346,9,1362,
CHHATTISGARH,RAJNANDGAON,2021-02-04,12,1041,0,1053,
CHHATTISGARH,RAJNANDGAON,2021-02-05,9,775,0,784,
CHHATTISGARH,SUKMA,2021-02-01,0,71,0,71,
CHHATTISGARH,SUKMA,2021-02-02,0,96,0,96,
CHHATTISGARH,SUKMA,2021-02-03,0,94,0,94,
CHHATTISGARH,SUKMA,2021-02-04,0,177,0,177,
CHHATTISGARH,SUKMA,2021-02-05,0,73,0,73,
CHHATTISGARH,SURAJPUR,2021-02-01,19,903,3,925,
CHHATTISGARH,SURAJPUR,2021-02-02,15,853,15,883,
CHHATTISGARH,SURAJPUR,2021-02-03,6,915,1,922,
CHHATTISGARH,SURAJPUR,2021-02-04,8,899,1,908,
CHHATTISGARH,SURAJPUR,2021-02-05,14,874,0,888,
CHHATTISGARH,SURGUJA,2021-02-01,3,641,3,647,
CHHATTISGARH,SURGUJA,2021-02-02,9,578,0,587,
CHHATTISGARH,SURGUJA,2021-02-03,8,679,0,687,
CHHATTISGARH,SURGUJA,2021-02-04,8,383,0,391,
CHHATTISGARH,SURGUJA,2021-02-05,4,525,2,531,
DADRA AND NAGAR HAVELI,DADRA AND NAGAR HAVELI,2021-02-01,0,232,0,232,
DADRA AND NAGAR HAVELI,DADRA AND NAGAR HAVELI,2021-02-02,0,234,1,235,
DADRA AND NAGAR HAVELI,DADRA AND NAGAR HAVELI,2021-02-03,1,224,0,225,
DADRA AND NAGAR HAVELI,DADRA AND NAGAR HAVELI,2021-02-04,0,182,0,182,
DADRA AND NAGAR HAVELI,DADRA AND NAGAR HAVELI,2021-02-05,0,211,0,211,
DAMAN AND DIU,DAMAN,2021-02-01,0,68,0,68,
DAMAN AND DIU,DAMAN,2021-02-02,2,172,0,174,
DAMAN AND DIU,DAMAN,2021-02-03,0,8,0,8,
DAMAN AND DIU,DAMAN,2021-02-04,0,67,0,67,
DAMAN AND DIU,DAMAN,2021-02-05,0,105,0,105,
DAMAN AND DIU,DIU,2021-02-01,0,13,0,13,
DAMAN AND DIU,DIU,2021-02-02,1,27,0,28,
DAMAN AND DIU,DIU,2021-02-03,1,41,0,42,
DAMAN AND DIU,DIU,2021-02-04,0,35,0,35,
DAMAN AND DIU,DIU,2021-02-05,0,16,0,16,
DELHI,CENTRAL,2021-02-01,8,4536,13,4557,
DELHI,CENTRAL,2021-02-02,14,3774,9,3797,
DELHI,CENTRAL,2021-02-03,10,5144,22,5176,
DELHI,CENTRAL,2021-02-04,20,4203,15,4238,
DELHI,CENTRAL,2021-02-05,10,4914,5,4929,
DELHI,EAST,2021-02-01,3,2844,3,2850,
DELHI,EAST,2021-02-02,11,3025,5,3041,
DELHI,EAST,2021-02-03,16,4958,0,4974,
DELHI,EAST,2021-02-04,7,4662,3,4672,
DELHI,EAST,2021-02-05,11,5465,0,5476,
DELHI,NEW DELHI,2021-02-01,19,5160,30,5209,
DELHI,NEW DELHI,2021-02-02,23,5657,9,5689,
DELHI,NEW DELHI,2021-02-03,27,6408,16,6451,
DELHI,NEW DELHI,2021-02-04,18,4673,18,4709,
DELHI,NEW DELHI,2021-02-05,37,6348,8,6393,
DELHI,NORTH,2021-02-01,1,6742,10,6753,
DELHI,NORTH,2021-02-02,4,5799,10,5813,
DELHI,NORTH,2021-02-03,1,7304,7,7312,
DELHI,NORTH,2021-02-04,8,6535,13,6556,
DELHI,NORTH,2021-02-05,2,6885,1,6888,
DELHI,NORTH EAST,2021-02-01,5,4001,44,4050,
DELHI,NORTH EAST,2021-02-02,1,4094,26,4121,
DELHI,NORTH EAST,2021-02-03,6,5654,13,5673,
DELHI,NORTH EAST,2021-02-04,4,5946,10,5960,
DELHI,NORTH EAST,2021-02-05,2,5160,27,5189,
DELHI,NORTH WEST,2021-02-01,19,4798,4,4821,
DELHI,NORTH WEST,2021-02-02,30,4323,2,4355,
DELHI,NORTH WEST,2021-02-03,28,5346,35,5409,
DELHI,NORTH WEST,2021-02-04,19,5213,15,5247,
DELHI,NORTH WEST,2021-02-05,16,5372,6,5394,
DELHI,SHAHDARA,2021-02-01,10,6228,0,6238,
DELHI,SHAHDARA,2021-02-02,3,5124,0,5127,
DELHI,SHAHDARA,2021-02-03,13,6354,7,6374,
DELHI,SHAHDARA,2021-02-04,4,6669,7,6680,
DELHI,SHAHDARA,2021-02-05,0,6331,1,6332,
DELHI,SOUTH,2021-02-01,34,5676,37,5747,
DELHI,SOUTH,2021-02-02,31,4976,31,5038,
DELHI,SOUTH,2021-02-03,33,5087,44,5164,
DELHI,SOUTH,2021-02-04,35,6030,19,6084,
DELHI,SOUTH,2021-02-05,31,5286,9,5326,
DELHI,SOUTH EAST,2021-02-01,5,4851,9,4865,
DELHI,SOUTH EAST,2021-02-02,14,4794,3,4811,
DELHI,SOUTH EAST,2021-02-03,5,5756,0,5761,
DELHI,SOUTH EAST,2021-02-04,1,4841,1,4843,
DELHI,SOUTH EAST,2021-02-05,5,5353,0,5358,
DELHI,SOUTH WEST,2021-02-01,13,5241,1,5255,
DELHI,SOUTH WEST,2021-02-02,26,5990,2,6018,
DELHI,SOUTH WEST,2021-02-03,20,4947,0,4967,
DELHI,SOUTH WEST,2021-02-04,26,2779,2,2807,
DELHI,SOUTH WEST,2021-02-05,18,3658,5,3681,
DELHI,WEST,2021-02-01,22,8318,5,8345,
DELHI,WEST,2021-02-02,20,8952,2,8974,
DELHI,WEST,2021-02-03,17,10007,3,10027,
DELHI,WEST,2021-02-04,18,8186,1,8205,
DELHI,WEST,2021-02-05,17,8468,0,8485,
GOA,NORTH GOA,2021-02-01,34,763,1,798,
GOA,NORTH GOA,2021-02-02,50,846,0,896,
GOA,NORTH GOA,2021-02-03,24,659,0,683,
GOA,NORTH GOA,2021-02-04,29,677,1,707,
GOA,NORTH GOA,2021-02-05,22,755,2,779,
GOA,SOUTH GOA,2021-02-01,44,1139,1,1184,
GOA,SOUTH GOA,2021-02-02,64,1055,0,1119,
GOA,SOUTH GOA,2021-02-03,42,1095,2,1139,
GOA,SOUTH GOA,2021-02-04,45,1013,0,1058,
GOA,SOUTH GOA,2021-02-05,55,782,1,838,
GUJARAT,AHMADABAD,2021-02-01,176,3949,55,4180,
GUJARAT,AHMADABAD,2021-02-02,212,2537,14,2763,
GUJARAT,AHMADABAD,2021-02-03,184,4488,3,4675,
GUJARAT,AHMADABAD,2021-02-04,39,4009,91,4139,
GUJARAT,AHMADABAD,2021-02-05,42,3925,44,4011,
GUJARAT,AMRELI,2021-02-01,7,520,16,543,
GUJARAT,AMRELI,2021-02-02,1,485,3,489,
GUJARAT,AMRELI,2021-02-03,5,642,7,654,
GUJARAT,AMRELI,2021-02-04,10,583,0,593,
GUJARAT,AMRELI,2021-02-05,1,628,11,640,
GUJARAT,ANAND,2021-02-01,6,173,0,179,
GUJARAT,ANAND,2021-02-02,3,367,6,376,
GUJARAT,ANAND,2021-02-03,8,315,0,323,
GUJARAT,ANAND,2021-02-04,5,233,1,239,
GUJARAT,ANAND,2021-02-05,8,213,4,225,
GUJARAT,ARVALLI,2021-02-01,0,142,0,142,
GUJARAT,ARVALLI,2021-02-02,0,174,0,174,
GUJARAT,ARVALLI,2021-02-03,2,144,0,146,
GUJARAT,ARVALLI,2021-02-04,1,121,0,122,
GUJARAT,ARVALLI,2021-02-05,0,218,1,219,
GUJARAT,BANAS KANTHA,2021-02-01,1,253,1,255,
GUJARAT,BANAS KANTHA,2021-02-02,1,176,0,177,
GUJARAT,BANAS KANTHA,2021-02-03,0,208,0,208,
GUJARAT,BANAS KANTHA,2021-02-04,3,302,0,305,
GUJARAT,BANAS KANTHA,2021-02-05,1,235,0,236,
GUJARAT,BHARUCH,2021-02-01,6,245,0,251,
GUJARAT,BHARUCH,2021-02-02,5,488,1,494,
GUJARAT,BHARUCH,2021-02-03,1,532,0,533,
GUJARAT,BHARUCH,2021-02-04,5,490,5,500,
GUJARAT,BHARUCH,2021-02-05,3,373,0,376,
GUJARAT,BHAVNAGAR,2021-02-01,0,542,0,542,
GUJARAT,BHAVNAGAR,2021-02-02,1,775,0,776,
GUJARAT,BHAVNAGAR,2021-02-03,7,807,0,814,
GUJARAT,BHAVNAGAR,2021-02-04,7,976,4,987,
GUJARAT,BHAVNAGAR,2021-02-05,0,615,5,620,
GUJARAT,BOTAD,2021-02-01,0,380,0,380,
GUJARAT,BOTAD,2021-02-02,0,429,0,429,
GUJARAT,BOTAD,2021-02-03,0,324,0,324,
GUJARAT,BOTAD,2021-02-04,0,415,0,415,
GUJARAT,BOTAD,2021-02-05,0,282,0,282,
GUJARAT,CHHOTAUDEPUR,2021-02-01,0,272,0,272,
GUJARAT,CHHOTAUDEPUR,2021-02-02,1,385,1,387,
GUJARAT,CHHOTAUDEPUR,2021-02-03,0,170,0,170,
GUJARAT,CHHOTAUDEPUR,2021-02-04,1,239,0,240,
GUJARAT,CHHOTAUDEPUR,2021-02-05,0,184,0,184,
GUJARAT,DANG,2021-02-01,0,106,0,106,
GUJARAT,DANG,2021-02-02,0,84,0,84,
GUJARAT,DANG,2021-02-03,0,59,0,59,
GUJARAT,DANG,2021-02-04,0,79,0,79,
GUJARAT,DANG,2021-02-05,0,109,0,109,
GUJARAT,DEVBHUMI DWARKA,2021-02-01,0,32,0,32,
GUJARAT,DEVBHUMI DWARKA,2021-02-02,1,107,5,113,
GUJARAT,DEVBHUMI DWARKA,2021-02-03,2,123,0,125,
GUJARAT,DEVBHUMI DWARKA,2021-02-04,0,110,1,111,
GUJARAT,DEVBHUMI DWARKA,2021-02-05,4,165,0,169,
GUJARAT,DOHAD,2021-02-01,3,416,0,419,
GUJARAT,DOHAD,2021-02-02,5,381,1,387,
GUJARAT,DOHAD,2021-02-03,6,499,0,505,
GUJARAT,DOHAD,2021-02-04,3,389,0,392,
GUJARAT,DOHAD,2021-02-05,3,352,2,357,
GUJARAT,GANDHINAGAR,2021-02-01,9,667,1,677,
GUJARAT,GANDHINAGAR,2021-02-02,2,845,0,847,
GUJARAT,GANDHINAGAR,2021-02-03,5,905,3,913,
GUJARAT,GANDHINAGAR,2021-02-04,8,568,3,579,
GUJARAT,GANDHINAGAR,2021-02-05,5,711,3,719,
GUJARAT,GIR SOMNATH,2021-02-01,4,403,1,408,
GUJARAT,GIR SOMNATH,2021-02-02,6,147,1,154,
GUJARAT,GIR SOMNATH,2021-02-03,3,252,0,255,
GUJARAT,GIR SOMNATH,2021-02-04,3,235,0,238,
GUJARAT,GIR SOMNATH,2021-02-05,4,293,0,297,
GUJARAT,JAMNAGAR,2021-02-01,8,476,1,485,
GUJARAT,JAMNAGAR,2021-02-02,7,575,4,586,
GUJARAT,JAMNAGAR,2021-02-03,4,889,1,894,
GUJARAT,JAMNAGAR,2021-02-04,7,1210,2,1219,
GUJARAT,JAMNAGAR,2021-02-05,3,1121,3,1127,
GUJARAT,JUNAGADH,2021-02-01,4,410,1,415,
GUJARAT,JUNAGADH,2021-02-02,10,550,0,560,
GUJARAT,JUNAGADH,2021-02-03,11,570,0,581,
GUJARAT,JUNAGADH,2021-02-04,9,481,2,492,
GUJARAT,JUNAGADH,2021-02-05,7,677,0,684,
GUJARAT,KACHCHH,2021-02-01,16,333,5,354,
GUJARAT,KACHCHH,2021-02-02,8,361,20,389,
GUJARAT,KACHCHH,2021-02-03,19,341,0,360,
GUJARAT,KACHCHH,2021-02-04,21,216,52,289,
GUJARAT,KACHCHH,2021-02-05,20,255,19,294,
GUJARAT,KHEDA,2021-02-01,21,315,5,341,
GUJARAT,KHEDA,2021-02-02,2,570,0,572,
GUJARAT,KHEDA,2021-02-03,2,352,4,358,
GUJARAT,KHEDA,2021-02-04,2,462,1,465,
GUJARAT,KHEDA,2021-02-05,3,421,1,425,
GUJARAT,MAHESANA,2021-02-01,1,293,1,295,
GUJARAT,MAHESANA,2021-02-02,1,180,2,183,
GUJARAT,MAHESANA,2021-02-03,1,375,0,376,
GUJARAT,MAHESANA,2021-02-04,1,382,1,384,
GUJARAT,MAHESANA,2021-02-05,2,516,6,524,
GUJARAT,MAHISAGAR,2021-02-01,4,254,0,258,
GUJARAT,MAHISAGAR,2021-02-02,5,300,1,306,
GUJARAT,MAHISAGAR,2021-02-03,5,434,0,439,
GUJARAT,MAHISAGAR,2021-02-04,4,354,0,358,
GUJARAT,MAHISAGAR,2021-02-05,2,327,0,329,
GUJARAT,MORBI,2021-02-01,9,444,1,454,
GUJARAT,MORBI,2021-02-02,2,388,12,402,
GUJARAT,MORBI,2021-02-03,7,470,6,483,
GUJARAT,MORBI,2021-02-04,6,484,20,510,
GUJARAT,MORBI,2021-02-05,2,324,23,349,
GUJARAT,NARMADA,2021-02-01,4,35,0,39,
GUJARAT,NARMADA,2021-02-02,8,21,14,43,
GUJARAT,NARMADA,2021-02-03,3,23,0,26,
GUJARAT,NARMADA,2021-02-04,14,20,0,34,
GUJARAT,NARMADA,2021-02-05,0,35,0,35,
GUJARAT,NAVSARI,2021-02-01,3,236,1,240,
GUJARAT,NAVSARI,2021-02-02,2,225,4,231,
GUJARAT,NAVSARI,2021-02-03,1,253,1,255,
GUJARAT,NAVSARI,2021-02-04,2,274,0,276,
GUJARAT,NAVSARI,2021-02-05,2,230,1,233,
GUJARAT,PANCH MAHALS,2021-02-01,1,245,0,246,
GUJARAT,PANCH MAHALS,2021-02-02,5,293,2,300,
GUJARAT,PANCH MAHALS,2021-02-03,4,252,0,256,
GUJARAT,PANCH MAHALS,2021-02-04,3,363,0,366,
GUJARAT,PANCH MAHALS,2021-02-05,6,583,2,591,
GUJARAT,PATAN,2021-02-01,0,171,1,172,
GUJARAT,PATAN,2021-02-02,0,278,1,279,
GUJARAT,PATAN,2021-02-03,0,258,0,258,
GUJARAT,PATAN,2021-02-04,2,441,5,448,
GUJARAT,PATAN,2021-02-05,1,515,1,517,
GUJARAT,PORBANDAR,2021-02-01,0,263,0,263,
GUJARAT,PORBANDAR,2021-02-02,1,482,1,484,
GUJARAT,PORBANDAR,2021-02-03,2,474,0,476,
GUJARAT,PORBANDAR,2021-02-04,0,501,0,501,
GUJARAT,PORBANDAR,2021-02-05,0,522,0,522,
GUJARAT,RAJKOT,2021-02-01,21,953,15,989,
GUJARAT,RAJKOT,2021-02-02,33,1420,78,1531,
GUJARAT,RAJKOT,2021-02-03,45,1064,17,1126,
GUJARAT,RAJKOT,2021-02-04,40,1785,12,1837,
GUJARAT,RAJKOT,2021-02-05,48,1033,45,1126,
GUJARAT,SABAR KANTHA,2021-02-01,1,150,2,153,
GUJARAT,SABAR KANTHA,2021-02-02,4,189,2,195,
GUJARAT,SABAR KANTHA,2021-02-03,5,288,5,298,
GUJARAT,SABAR KANTHA,2021-02-04,2,138,13,153,
GUJARAT,SABAR KANTHA,2021-02-05,4,150,6,160,
GUJARAT,SURAT,2021-02-01,21,1804,22,1847,
GUJARAT,SURAT,2021-02-02,24,1714,35,1773,
GUJARAT,SURAT,2021-02-03,35,1915,8,1958,
GUJARAT,SURAT,2021-02-04,36,1894,6,1936,
GUJARAT,SURAT,2021-02-05,30,1868,9,1907,
GUJARAT,SURENDRANAGAR,2021-02-01,1,342,0,343,
GUJARAT,SURENDRANAGAR,2021-02-02,2,1252,5,1259,
GUJARAT,SURENDRANAGAR,2021-02-03,1,1610,0,1611,
GUJARAT,SURENDRANAGAR,2021-02-04,0,680,3,683,
GUJARAT,SURENDRANAGAR,2021-02-05,0,965,1,966,
GUJARAT,TAPI,2021-02-01,5,432,2,439,
GUJARAT,TAPI,2021-02-02,0,356,49,405,
GUJARAT,TAPI,2021-02-03,4,505,0,509,
GUJARAT,TAPI,2021-02-04,4,540,1,545,
GUJARAT,TAPI,2021-02-05,0,325,0,325,
GUJARAT,VADODARA,2021-02-01,65,996,17,1078,
GUJARAT,VADODARA,2021-02-02,57,1212,31,1300,
GUJARAT,VADODARA,2021-02-03,56,1379,8,1443,
GUJARAT,VADODARA,2021-02-04,72,1126,3,1201,
GUJARAT,VADODARA,2021-02-05,67,1495,19,1581,
GUJARAT,VALSAD,2021-02-01,2,315,0,317,
GUJARAT,VALSAD,2021-02-02,2,317,0,319,
GUJARAT,VALSAD,2021-02-03,6,346,0,352,
GUJARAT,VALSAD,2021-02-04,1,244,0,245,
GUJARAT,VALSAD,2021-02-05,1,332,0,333,
HARYANA,AMBALA,2021-02-01,19,855,20,894,
HARYANA,AMBALA,2021-02-02,21,968,15,1004,
HARYANA,AMBALA,2021-02-03,5,1219,12,1236,
HARYANA,AMBALA,2021-02-04,11,1410,37,1458,
HARYANA,AMBALA,2021-02-05,13,1472,22,1507,
HARYANA,BHIWANI,2021-02-01,0,566,1,567,
HARYANA,BHIWANI,2021-02-02,1,852,0,853,
HARYANA,BHIWANI,2021-02-03,1,864,0,865,
HARYANA,BHIWANI,2021-02-04,0,1582,3,1585,
HARYANA,BHIWANI,2021-02-05,1,666,1,668,
HARYANA,CHARKI DADRI,2021-02-01,0,373,0,373,
HARYANA,CHARKI DADRI,2021-02-02,0,241,0,241,
HARYANA,CHARKI DADRI,2021-02-03,0,148,0,148,
HARYANA,CHARKI DADRI,2021-02-04,0,466,0,466,
HARYANA,CHARKI DADRI,2021-02-05,0,219,0,219,
HARYANA,FARIDABAD,2021-02-01,11,678,3,692,
HARYANA,FARIDABAD,2021-02-02,13,1248,8,1269,
HARYANA,FARIDABAD,2021-02-03,15,854,1,870,
HARYANA,FARIDABAD,2021-02-04,12,2131,9,2152,
HARYANA,FARIDABAD,2021-02-05,18,2022,14,2054,
HARYANA,FATEHABAD,2021-02-01,0,206,0,206,
HARYANA,FATEHABAD,2021-02-02,4,473,1,478,
HARYANA,FATEHABAD,2021-02-03,1,249,0,250,
HARYANA,FATEHABAD,2021-02-04,1,461,0,462,
HARYANA,FATEHABAD,2021-02-05,1,512,14,527,
HARYANA,GURUGRAM,2021-02-01,33,3009,10,3052,
HARYANA,GURUGRAM,2021-02-02,25,2897,9,2931,
HARYANA,GURUGRAM,2021-02-03,24,3269,6,3299,
HARYANA,GURUGRAM,2021-02-04,31,3295,16,3342,
HARYANA,GURUGRAM,2021-02-05,30,4523,15,4568,
HARYANA,HISAR,2021-02-01,3,1098,2,1103,
HARYANA,HISAR,2021-02-02,1,414,0,415,
HARYANA,HISAR,2021-02-03,0,788,1,789,
HARYANA,HISAR,2021-02-04,3,1122,1,1126,
HARYANA,HISAR,2021-02-05,6,1261,0,1267,
HARYANA,JHAJJAR,2021-02-01,0,1133,0,1133,
HARYANA,JHAJJAR,2021-02-02,1,1295,1,1297,
HARYANA,JHAJJAR,2021-02-03,0,1444,0,1444,
HARYANA,JHAJJAR,2021-02-04,0,1370,1,1371,
HARYANA,JHAJJAR,2021-02-05,1,1414,0,1415,
HARYANA,JIND,2021-02-01,0,312,6,318,
HARYANA,JIND,2021-02-02,3,271,1,275,
HARYANA,JIND,2021-02-03,1,232,1,234,
HARYANA,JIND,2021-02-04,0,569,2,571,
HARYANA,JIND,2021-02-05,4,616,1,621,
HARYANA,KAITHAL,2021-02-01,2,73,3,78,
HARYANA,KAITHAL,2021-02-02,9,123,1,133,
HARYANA,KAITHAL,2021-02-03,4,124,0,128,
HARYANA,KAITHAL,2021-02-04,3,89,1,93,
HARYANA,KAITHAL,2021-02-05,3,277,1,281,
HARYANA,KARNAL,2021-02-01,9,473,3,485,
HARYANA,KARNAL,2021-02-02,7,761,2,770,
HARYANA,KARNAL,2021-02-03,10,866,1,877,
HARYANA,KARNAL,2021-02-04,3,839,13,855,
HARYANA,KARNAL,2021-02-05,7,1052,12,1071,
HARYANA,KURUKSHETRA,2021-02-01,12,346,2,360,
HARYANA,KURUKSHETRA,2021-02-02,11,610,6,627,
HARYANA,KURUKSHETRA,2021-02-03,15,801,6,822,
HARYANA,KURUKSHETRA,2021-02-04,5,410,3,418,
HARYANA,KURUKSHETRA,2021-02-05,7,321,6,334,
HARYANA,MAHENDRAGARH,2021-02-01,1,393,5,399,
HARYANA,MAHENDRAGARH,2021-02-02,2,164,0,166,
HARYANA,MAHENDRAGARH,2021-02-03,0,337,0,337,
HARYANA,MAHENDRAGARH,2021-02-04,1,136,0,137,
HARYANA,MAHENDRAGARH,2021-02-05,0,44,1,45,
HARYANA,NUH,2021-02-01,0,584,2,586,
HARYANA,NUH,2021-02-02,0,281,0,281,
HARYANA,NUH,2021-02-03,0,684,0,684,
HARYANA,NUH,2021-02-04,0,649,0,649,
HARYANA,NUH,2021-02-05,2,338,0,340,
HARYANA,PALWAL,2021-02-01,0,181,0,181,
HARYANA,PALWAL,2021-02-02,0,259,0,259,
HARYANA,PALWAL,2021-02-03,0,250,0,250,
HARYANA,PALWAL,2021-02-04,1,354,0,355,
HARYANA,PALWAL,2021-02-05,0,447,0,447,
HARYANA,PANCHKULA,2021-02-01,14,437,6,457,
HARYANA,PANCHKULA,2021-02-02,17,1066,5,1088,
HARYANA,PANCHKULA,2021-02-03,20,888,2,910,
HARYANA,PANCHKULA,2021-02-04,16,1141,15,1172,
HARYANA,PANCHKULA,2021-02-05,14,1010,22,1046,
HARYANA,PANIPAT,2021-02-01,0,560,0,560,
HARYANA,PANIPAT,2021-02-02,4,458,0,462,
HARYANA,PANIPAT,2021-02-03,4,740,1,745,
HARYANA,PANIPAT,2021-02-04,4,566,1,571,
HARYANA,PANIPAT,2021-02-05,12,599,2,613,
HARYANA,REWARI,2021-02-01,1,154,2,157,
HARYANA,REWARI,2021-02-02,1,282,0,283,
HARYANA,REWARI,2021-02-03,0,352,2,354,
HARYANA,REWARI,2021-02-04,0,408,4,412,
HARYANA,REWARI,2021-02-05,0,645,4,649,
HARYANA,ROHTAK,2021-02-01,3,240,0,243,
HARYANA,ROHTAK,2021-02-02,5,482,0,487,
HARYANA,ROHTAK,2021-02-03,2,835,0,837,
HARYANA,ROHTAK,2021-02-04,0,1013,0,1013,
HARYANA,ROHTAK,2021-02-05,6,1020,0,1026,
HARYANA,SIRSA,2021-02-01,3,955,14,972,
HARYANA,SIRSA,2021-02-02,3,1274,37,1314,
HARYANA,SIRSA,2021-02-03,2,1167,57,1226,
HARYANA,SIRSA,2021-02-04,5,1203,8,1216,
HARYANA,SIRSA,2021-02-05,3,598,2,603,
HARYANA,SONIPAT,2021-02-01,2,1160,0,1162,
HARYANA,SONIPAT,2021-02-02,4,1356,1,1361,
HARYANA,SONIPAT,2021-02-03,2,1687,0,1689,
HARYANA,SONIPAT,2021-02-04,1,1319,3,1323,
HARYANA,SONIPAT,2021-02-05,3,1746,0,1749,
HARYANA,YAMUNANAGAR,2021-02-01,5,745,14,764,
HARYANA,YAMUNANAGAR,2021-02-02,6,737,17,760,
HARYANA,YAMUNANAGAR,2021-02-03,7,926,11,944,
HARYANA,YAMUNANAGAR,2021-02-04,7,1107,8,1122,
HARYANA,YAMUNANAGAR,2021-02-05,2,1014,8,1024,
HIMACHAL PRADESH,BILASPUR,2021-02-01,0,302,0,302,
HIMACHAL PRADESH,BILASPUR,2021-02-02,1,350,7,358,
HIMACHAL PRADESH,BILASPUR,2021-02-03,0,263,0,263,
HIMACHAL PRADESH,BILASPUR,2021-02-04,6,258,0,264,
HIMACHAL PRADESH,BILASPUR,2021-02-05,1,208,0,209,
HIMACHAL PRADESH,CHAMBA,2021-02-01,0,392,5,397,
HIMACHAL PRADESH,CHAMBA,2021-02-02,2,335,7,344,
HIMACHAL PRADESH,CHAMBA,2021-02-03,1,959,17,977,
HIMACHAL PRADESH,CHAMBA,2021-02-04,0,593,2,595,
HIMACHAL PRADESH,CHAMBA,2021-02-05,2,378,1,381,
HIMACHAL PRADESH,HAMIRPUR,2021-02-01,1,186,0,187,
HIMACHAL PRADESH,HAMIRPUR,2021-02-02,2,577,1,580,
HIMACHAL PRADESH,HAMIRPUR,2021-02-03,3,382,0,385,
HIMACHAL PRADESH,HAMIRPUR,2021-02-04,1,365,0,366,
HIMACHAL PRADESH,HAMIRPUR,2021-02-05,5,467,0,472,
HIMACHAL PRADESH,KANGRA,2021-02-01,8,1171,2,1181,
HIMACHAL PRADESH,KANGRA,2021-02-02,7,1057,3,1067,
HIMACHAL PRADESH,KANGRA,2021-02-03,4,622,5,631,
HIMACHAL PRADESH,KANGRA,2021-02-04,12,659,1,672,
HIMACHAL PRADESH,KANGRA,2021-02-05,2,1023,1,1026,
HIMACHAL PRADESH,KINNAUR,2021-02-01,0,27,0,27,
HIMACHAL PRADESH,KINNAUR,2021-02-02,0,19,0,19,
HIMACHAL PRADESH,KINNAUR,2021-02-03,4,7,0,11,
HIMACHAL PRADESH,KINNAUR,2021-02-04,5,133,0,138,
HIMACHAL PRADESH,KINNAUR,2021-02-05,0,2,0,2,
HIMACHAL PRADESH,KULLU,2021-02-01,0,165,0,165,
HIMACHAL PRADESH,KULLU,2021-02-02,3,209,2,214,
HIMACHAL PRADESH,KULLU,2021-02-03,0,179,4,183,
HIMACHAL PRADESH,KULLU,2021-02-04,0,117,1,118,
HIMACHAL PRADESH,KULLU,2021-02-05,4,164,5,173,
HIMACHAL PRADESH,LAHUL AND SPITI,2021-02-01,0,1,0,1,
HIMACHAL PRADESH,LAHUL AND SPITI,2021-02-02,0,4,0,4,
HIMACHAL PRADESH,LAHUL AND SPITI,2021-02-03,0,4,0,4,
HIMACHAL PRADESH,LAHUL AND SPITI,2021-02-04,0,3,0,3,
HIMACHAL PRADESH,LAHUL AND SPITI,2021-02-05,0,2,0,2,
HIMACHAL PRADESH,MANDI,2021-02-01,4,558,3,565,
HIMACHAL PRADESH,MANDI,2021-02-02,7,1074,31,1112,
HIMACHAL PRADESH,MANDI,2021-02-03,43,1614,73,1730,
HIMACHAL PRADESH,MANDI,2021-02-04,26,2261,41,2328,
HIMACHAL PRADESH,MANDI,2021-02-05,58,2109,102,2269,
HIMACHAL PRADESH,SHIMLA,2021-02-01,6,546,6,558,
HIMACHAL PRADESH,SHIMLA,2021-02-02,2,464,8,474,
HIMACHAL PRADESH,SHIMLA,2021-02-03,11,470,7,488,
HIMACHAL PRADESH,SHIMLA,2021-02-04,2,236,4,242,
HIMACHAL PRADESH,SHIMLA,2021-02-05,3,168,3,174,
HIMACHAL PRADESH,SIRMAUR,2021-02-01,2,90,1,93,
HIMACHAL PRADESH,SIRMAUR,2021-02-02,5,486,3,494,
HIMACHAL PRADESH,SIRMAUR,2021-02-03,3,463,0,466,
HIMACHAL PRADESH,SIRMAUR,2021-02-04,0,128,1,129,
HIMACHAL PRADESH,SIRMAUR,2021-02-05,2,154,0,156,
HIMACHAL PRADESH,SOLAN,2021-02-01,5,344,2,351,
HIMACHAL PRADESH,SOLAN,2021-02-02,4,575,3,582,
HIMACHAL PRADESH,SOLAN,2021-02-03,7,476,0,483,
HIMACHAL PRADESH,SOLAN,2021-02-04,3,425,0,428,
HIMACHAL PRADESH,SOLAN,2021-02-05,3,459,0,462,
HIMACHAL PRADESH,UNA,2021-02-01,3,648,1,652,
HIMACHAL PRADESH,UNA,2021-02-02,7,330,1,338,
HIMACHAL PRADESH,UNA,2021-02-03,2,442,1,445,
HIMACHAL PRADESH,UNA,2021-02-04,6,519,1,526,
HIMACHAL PRADESH,UNA,2021-02-05,13,320,1,334,
INDIA,INDIA,2021-02-01,3,3,0,6,
INDIA,INDIA,2021-02-02,6,0,0,6,
INDIA,INDIA,2021-02-03,2,2,0,4,
INDIA,INDIA,2021-02-04,3,3,0,6,
INDIA,INDIA,2021-02-05,3,1,0,4,
JAMMU AND KASHMIR,ANANTNAG,2021-02-01,4,189,0,193,
JAMMU AND KASHMIR,ANANTNAG,2021-02-02,5,269,0,274,
JAMMU AND KASHMIR,ANANTNAG,2021-02-03,4,259,1,264,
JAMMU AND KASHMIR,ANANTNAG,2021-02-04,9,347,0,356,
JAMMU AND KASHMIR,ANANTNAG,2021-02-05,6,226,0,232,
JAMMU AND KASHMIR,BANDIPORA,2021-02-01,2,67,0,69,
JAMMU AND KASHMIR,BANDIPORA,2021-02-02,0,73,0,73,
JAMMU AND KASHMIR,BANDIPORA,2021-02-03,0,21,0,21,
JAMMU AND KASHMIR,BANDIPORA,2021-02-04,0,109,1,110,
JAMMU AND KASHMIR,BANDIPORA,2021-02-05,1,54,0,55,
JAMMU AND KASHMIR,BARAMULLA,2021-02-01,4,165,0,169,
JAMMU AND KASHMIR,BARAMULLA,2021-02-02,4,215,0,219,
JAMMU AND KASHMIR,BARAMULLA,2021-02-03,2,228,1,231,
JAMMU AND KASHMIR,BARAMULLA,2021-02-04,2,242,0,244,
JAMMU AND KASHMIR,BARAMULLA,2021-02-05,1,281,0,282,
JAMMU AND KASHMIR,BUDGAM,2021-02-01,1,753,0,754,
JAMMU AND KASHMIR,BUDGAM,2021-02-02,1,856,0,857,
JAMMU AND KASHMIR,BUDGAM,2021-02-03,1,505,1,507,
JAMMU AND KASHMIR,BUDGAM,2021-02-04,5,676,0,681,
JAMMU AND KASHMIR,BUDGAM,2021-02-05,0,553,0,553,
JAMMU AND KASHMIR,DODA,2021-02-01,0,71,0,71,
JAMMU AND KASHMIR,DODA,2021-02-02,1,51,0,52,
JAMMU AND KASHMIR,DODA,2021-02-03,1,65,0,66,
JAMMU AND KASHMIR,DODA,2021-02-04,0,37,0,37,
JAMMU AND KASHMIR,DODA,2021-02-05,2,31,0,33,
JAMMU AND KASHMIR,GANDERBAL,2021-02-01,0,85,0,85,
JAMMU AND KASHMIR,GANDERBAL,2021-02-02,2,132,0,134,
JAMMU AND KASHMIR,GANDERBAL,2021-02-03,0,151,0,151,
JAMMU AND KASHMIR,GANDERBAL,2021-02-04,16,118,0,134,
JAMMU AND KASHMIR,GANDERBAL,2021-02-05,0,143,0,143,
JAMMU AND KASHMIR,JAMMU,2021-02-01,20,846,1,867,
JAMMU AND KASHMIR,JAMMU,2021-02-02,28,924,2,954,
JAMMU AND KASHMIR,JAMMU,2021-02-03,32,743,1,776,
JAMMU AND KASHMIR,JAMMU,2021-02-04,21,674,1,696,
JAMMU AND KASHMIR,JAMMU,2021-02-05,20,634,0,654,
JAMMU AND KASHMIR,KATHUA,2021-02-01,0,24,0,24,
JAMMU AND KASHMIR,KATHUA,2021-02-02,0,38,0,38,
JAMMU AND KASHMIR,KATHUA,2021-02-03,1,85,0,86,
JAMMU AND KASHMIR,KATHUA,2021-02-04,2,146,0,148,
JAMMU AND KASHMIR,KATHUA,2021-02-05,0,121,0,121,
JAMMU AND KASHMIR,KISHTWAR,2021-02-01,0,49,0,49,
JAMMU AND KASHMIR,KISHTWAR,2021-02-02,0,40,0,40,
JAMMU AND KASHMIR,KISHTWAR,2021-02-03,1,43,0,44,
JAMMU AND KASHMIR,KISHTWAR,2021-02-04,2,110,0,112,
JAMMU AND KASHMIR,KISHTWAR,2021-02-05,0,110,0,110,
JAMMU AND KASHMIR,KULGAM,2021-02-01,1,145,0,146,
JAMMU AND KASHMIR,KULGAM,2021-02-02,0,215,0,215,
JAMMU AND KASHMIR,KULGAM,2021-02-03,2,180,0,182,
JAMMU AND KASHMIR,KULGAM,2021-02-04,1,160,0,161,
JAMMU AND KASHMIR,KULGAM,2021-02-05,0,59,0,59,
JAMMU AND KASHMIR,KUPWARA,2021-02-01,0,390,0,390,
JAMMU AND KASHMIR,KUPWARA,2021-02-02,0,43,0,43,
JAMMU AND KASHMIR,KUPWARA,2021-02-03,0,82,1,83,
JAMMU AND KASHMIR,KUPWARA,2021-02-04,1,74,1,76,
JAMMU AND KASHMIR,KUPWARA,2021-02-05,0,29,0,29,
JAMMU AND KASHMIR,POONCH,2021-02-01,0,449,0,449,
JAMMU AND KASHMIR,POONCH,2021-02-02,0,211,0,211,
JAMMU AND KASHMIR,POONCH,2021-02-03,4,326,0,330,
JAMMU AND KASHMIR,POONCH,2021-02-04,0,347,0,347,
JAMMU AND KASHMIR,POONCH,2021-02-05,1,194,0,195,
JAMMU AND KASHMIR,PULWAMA,2021-02-01,16,658,1,675,
JAMMU AND KASHMIR,PULWAMA,2021-02-02,13,472,1,486,
JAMMU AND KASHMIR,PULWAMA,2021-02-03,35,515,8,558,
JAMMU AND KASHMIR,PULWAMA,2021-02-04,13,452,0,465,
JAMMU AND KASHMIR,PULWAMA,2021-02-05,16,442,3,461,
JAMMU AND KASHMIR,RAJOURI,2021-02-01,0,118,0,118,
JAMMU AND KASHMIR,RAJOURI,2021-02-02,1,98,0,99,
JAMMU AND KASHMIR,RAJOURI,2021-02-03,0,153,0,153,
JAMMU AND KASHMIR,RAJOURI,2021-02-04,0,134,0,134,
JAMMU AND KASHMIR,RAJOURI,2021-02-05,1,123,0,124,
JAMMU AND KASHMIR,RAMBAN,2021-02-01,1,166,0,167,
JAMMU AND KASHMIR,RAMBAN,2021-02-02,0,168,0,168,
JAMMU AND KASHMIR,RAMBAN,2021-02-03,0,277,0,277,
JAMMU AND KASHMIR,RAMBAN,2021-02-04,0,153,0,153,
JAMMU AND KASHMIR,RAMBAN,2021-02-05,0,139,0,139,
JAMMU AND KASHMIR,REASI,2021-02-01,6,122,0,128,
JAMMU AND KASHMIR,REASI,2021-02-02,3,103,0,106,
JAMMU AND KASHMIR,REASI,2021-02-03,4,118,0,122,
JAMMU AND KASHMIR,REASI,2021-02-04,1,61,0,62,
JAMMU AND KASHMIR,REASI,2021-02-05,0,109,0,109,
JAMMU AND KASHMIR,SAMBA,2021-02-01,2,111,0,113,
JAMMU AND KASHMIR,SAMBA,2021-02-02,1,134,0,135,
JAMMU AND KASHMIR,SAMBA,2021-02-03,0,208,0,208,
JAMMU AND KASHMIR,SAMBA,2021-02-04,0,106,0,106,
JAMMU AND KASHMIR,SAMBA,2021-02-05,1,131,0,132,
JAMMU AND KASHMIR,SHOPIAN,2021-02-01,0,61,0,61,
JAMMU AND KASHMIR,SHOPIAN,2021-02-02,3,443,0,446,
JAMMU AND KASHMIR,SHOPIAN,2021-02-03,3,501,0,504,
JAMMU AND KASHMIR,SHOPIAN,2021-02-04,7,382,0,389,
JAMMU AND KASHMIR,SHOPIAN,2021-02-05,1,245,0,246,
JAMMU AND KASHMIR,SRINAGAR,2021-02-01,11,2667,4,2682,
JAMMU AND KASHMIR,SRINAGAR,2021-02-02,46,2868,2,2916,
JAMMU AND KASHMIR,SRINAGAR,2021-02-03,20,1601,4,1625,
JAMMU AND KASHMIR,SRINAGAR,2021-02-04,37,2042,1,2080,
JAMMU AND KASHMIR,SRINAGAR,2021-02-05,23,3721,0,3744,
JAMMU AND KASHMIR,UDHAMPUR,2021-02-01,0,469,0,469,
JAMMU AND KASHMIR,UDHAMPUR,2021-02-02,4,349,0,353,
JAMMU AND KASHMIR,UDHAMPUR,2021-02-03,1,652,0,653,
JAMMU AND KASHMIR,UDHAMPUR,2021-02-04,1,496,1,498,
JAMMU AND KASHMIR,UDHAMPUR,2021-02-05,1,549,0,550,
JHARKHAND,BOKARO,2021-02-01,8,713,4,725,
JHARKHAND,BOKARO,2021-02-02,2,290,0,292,
JHARKHAND,BOKARO,2021-02-03,0,479,0,479,
JHARKHAND,BOKARO,2021-02-04,1,478,2,481,
JHARKHAND,BOKARO,2021-02-05,2,385,0,387,
JHARKHAND,CHATRA,2021-02-01,0,830,0,830,
JHARKHAND,CHATRA,2021-02-02,1,409,0,410,
JHARKHAND,CHATRA,2021-02-03,0,112,0,112,
JHARKHAND,CHATRA,2021-02-04,1,209,0,210,
JHARKHAND,CHATRA,2021-02-05,0,29,0,29,
JHARKHAND,DEOGHAR,2021-02-01,0,839,0,839,
JHARKHAND,DEOGHAR,2021-02-02,1,849,7,857,
JHARKHAND,DEOGHAR,2021-02-03,0,397,7,404,
JHARKHAND,DEOGHAR,2021-02-04,0,657,0,657,
JHARKHAND,DEOGHAR,2021-02-05,0,1128,0,1128,
JHARKHAND,DHANBAD,2021-02-01,3,570,0,573,
JHARKHAND,DHANBAD,2021-02-02,0,409,0,409,
JHARKHAND,DHANBAD,2021-02-03,15,581,2,598,
JHARKHAND,DHANBAD,2021-02-04,11,925,0,936,
JHARKHAND,DHANBAD,2021-02-05,9,769,0,778,
JHARKHAND,DUMKA,2021-02-01,3,562,0,565,
JHARKHAND,DUMKA,2021-02-02,0,341,0,341,
JHARKHAND,DUMKA,2021-02-03,0,437,0,437,
JHARKHAND,DUMKA,2021-02-04,4,234,0,238,
JHARKHAND,DUMKA,2021-02-05,1,140,0,141,
JHARKHAND,EAST SINGHBUM,2021-02-01,12,1399,1,1412,
JHARKHAND,EAST SINGHBUM,2021-02-02,12,1993,0,2005,
JHARKHAND,EAST SINGHBUM,2021-02-03,8,1862,45,1915,
JHARKHAND,EAST SINGHBUM,2021-02-04,8,1381,1,1390,
JHARKHAND,EAST SINGHBUM,2021-02-05,6,1232,0,1238,
JHARKHAND,GARHWA,2021-02-01,0,1399,0,1399,
JHARKHAND,GARHWA,2021-02-02,0,1390,1,1391,
JHARKHAND,GARHWA,2021-02-03,2,1044,0,1046,
JHARKHAND,GARHWA,2021-02-04,0,396,1,397,
JHARKHAND,GARHWA,2021-02-05,1,365,0,366,
JHARKHAND,GIRIDIH,2021-02-01,0,463,1,464,
JHARKHAND,GIRIDIH,2021-02-02,0,470,0,470,
JHARKHAND,GIRIDIH,2021-02-03,1,351,0,352,
JHARKHAND,GIRIDIH,2021-02-04,1,288,0,289,
JHARKHAND,GIRIDIH,2021-02-05,1,317,0,318,
JHARKHAND,GODDA,2021-02-01,0,172,0,172,
JHARKHAND,GODDA,2021-02-02,1,702,0,703,
JHARKHAND,GODDA,2021-02-03,1,318,0,319,
JHARKHAND,GODDA,2021-02-04,0,278,0,278,
JHARKHAND,GODDA,2021-02-05,0,335,0,335,
JHARKHAND,GUMLA,2021-02-01,2,18,0,20,
JHARKHAND,GUMLA,2021-02-02,2,120,0,122,
JHARKHAND,GUMLA,2021-02-03,2,19,0,21,
JHARKHAND,GUMLA,2021-02-04,1,310,0,311,
JHARKHAND,GUMLA,2021-02-05,0,334,0,334,
JHARKHAND,HAZARIBAGH,2021-02-01,4,585,2,591,
JHARKHAND,HAZARIBAGH,2021-02-02,2,362,0,364,
JHARKHAND,HAZARIBAGH,2021-02-03,1,479,0,480,
JHARKHAND,HAZARIBAGH,2021-02-04,0,185,0,185,
JHARKHAND,HAZARIBAGH,2021-02-05,1,160,0,161,
JHARKHAND,JAMTARA,2021-02-01,0,15,0,15,
JHARKHAND,JAMTARA,2021-02-02,0,245,0,245,
JHARKHAND,JAMTARA,2021-02-03,0,169,0,169,
JHARKHAND,JAMTARA,2021-02-04,0,256,10,266,
JHARKHAND,JAMTARA,2021-02-05,0,216,0,216,
JHARKHAND,KHUNTI,2021-02-01,0,361,0,361,
JHARKHAND,KHUNTI,2021-02-02,1,226,0,227,
JHARKHAND,KHUNTI,2021-02-03,2,248,0,250,
JHARKHAND,KHUNTI,2021-02-04,1,169,0,170,
JHARKHAND,KHUNTI,2021-02-05,1,208,0,209,
JHARKHAND,KODERMA,2021-02-01,1,137,6,144,
JHARKHAND,KODERMA,2021-02-02,1,759,0,760,
JHARKHAND,KODERMA,2021-02-03,0,394,1,395,
JHARKHAND,KODERMA,2021-02-04,1,226,0,227,
JHARKHAND,KODERMA,2021-02-05,0,421,0,421,
JHARKHAND,LATEHAR,2021-02-01,0,165,2,167,
JHARKHAND,LATEHAR,2021-02-02,1,37,0,38,
JHARKHAND,LATEHAR,2021-02-03,4,203,0,207,
JHARKHAND,LATEHAR,2021-02-04,1,266,0,267,
JHARKHAND,LATEHAR,2021-02-05,2,419,0,421,
JHARKHAND,LOHARDAGA,2021-02-01,0,254,0,254,
JHARKHAND,LOHARDAGA,2021-02-02,0,33,0,33,
JHARKHAND,LOHARDAGA,2021-02-03,0,39,0,39,
JHARKHAND,LOHARDAGA,2021-02-04,0,225,0,225,
JHARKHAND,LOHARDAGA,2021-02-05,0,18,0,18,
JHARKHAND,PAKUR,2021-02-01,0,589,0,589,
JHARKHAND,PAKUR,2021-02-02,0,638,0,638,
JHARKHAND,PAKUR,2021-02-03,0,574,0,574,
JHARKHAND,PAKUR,2021-02-04,0,355,0,355,
JHARKHAND,PAKUR,2021-02-05,0,196,0,196,
JHARKHAND,PALAMU,2021-02-01,4,880,1,885,
JHARKHAND,PALAMU,2021-02-02,0,1308,0,1308,
JHARKHAND,PALAMU,2021-02-03,2,1180,0,1182,
JHARKHAND,PALAMU,2021-02-04,2,1319,0,1321,
JHARKHAND,PALAMU,2021-02-05,0,943,0,943,
JHARKHAND,RAMGARH,2021-02-01,0,251,0,251,
JHARKHAND,RAMGARH,2021-02-02,2,361,1,364,
JHARKHAND,RAMGARH,2021-02-03,2,100,0,102,
JHARKHAND,RAMGARH,2021-02-04,0,81,0,81,
JHARKHAND,RAMGARH,2021-02-05,0,30,0,30,
JHARKHAND,RANCHI,2021-02-01,33,432,0,465,
JHARKHAND,RANCHI,2021-02-02,43,571,0,614,
JHARKHAND,RANCHI,2021-02-03,36,599,1,636,
JHARKHAND,RANCHI,2021-02-04,40,619,0,659,
JHARKHAND,RANCHI,2021-02-05,39,434,1,474,
JHARKHAND,SAHEBGANJ,2021-02-01,0,242,0,242,
JHARKHAND,SAHEBGANJ,2021-02-02,0,138,1,139,
JHARKHAND,SAHEBGANJ,2021-02-03,0,178,0,178,
JHARKHAND,SAHEBGANJ,2021-02-04,0,200,0,200,
JHARKHAND,SAHEBGANJ,2021-02-05,0,67,0,67,
JHARKHAND,SARAIKELA KHARSAWAN,2021-02-01,0,481,0,481,
JHARKHAND,SARAIKELA KHARSAWAN,2021-02-02,0,278,0,278,
JHARKHAND,SARAIKELA KHARSAWAN,2021-02-03,2,39,0,41,
JHARKHAND,SARAIKELA KHARSAWAN,2021-02-04,1,365,1,367,
JHARKHAND,SARAIKELA KHARSAWAN,2021-02-05,0,591,0,591,
JHARKHAND,SIMDEGA,2021-02-01,0,154,0,154,
JHARKHAND,SIMDEGA,2021-02-02,1,277,0,278,
JHARKHAND,SIMDEGA,2021-02-03,0,62,0,62,
JHARKHAND,SIMDEGA,2021-02-04,0,122,0,122,
JHARKHAND,SIMDEGA,2021-02-05,1,195,0,196,
JHARKHAND,WEST SINGHBHUM,2021-02-01,0,351,0,351,
JHARKHAND,WEST SINGHBHUM,2021-02-02,0,780,0,780,
JHARKHAND,WEST SINGHBHUM,2021-02-03,1,782,0,783,
JHARKHAND,WEST SINGHBHUM,2021-02-04,0,899,0,899,
JHARKHAND,WEST SINGHBHUM,2021-02-05,0,1007,1,1008,
KARNATAKA,BAGALKOTE,2021-02-01,0,514,6,520,
KARNATAKA,BAGALKOTE,2021-02-02,2,346,1,349,
KARNATAKA,BAGALKOTE,2021-02-03,0,1366,13,1379,
KARNATAKA,BAGALKOTE,2021-02-04,2,837,0,839,
KARNATAKA,BAGALKOTE,2021-02-05,0,1120,0,1120,
KARNATAKA,BALLARI,2021-02-01,8,519,9,536,
KARNATAKA,BALLARI,2021-02-02,7,1589,11,1607,
KARNATAKA,BALLARI,2021-02-03,5,1201,14,1220,
KARNATAKA,BALLARI,2021-02-04,3,1782,38,1823,
KARNATAKA,BALLARI,2021-02-05,3,1412,35,1450,
KARNATAKA,BELAGAVI,2021-02-01,6,2719,29,2754,
KARNATAKA,BELAGAVI,2021-02-02,15,1799,0,1814,
KARNATAKA,BELAGAVI,2021-02-03,4,3005,4,3013,
KARNATAKA,BELAGAVI,2021-02-04,12,3273,9,3294,
KARNATAKA,BELAGAVI,2021-02-05,5,2880,5,2890,
KARNATAKA,BENGALURU RURAL,2021-02-01,8,1011,0,1019,
KARNATAKA,BENGALURU RURAL,2021-02-02,9,1393,1,1403,
KARNATAKA,BENGALURU RURAL,2021-02-03,17,1216,0,1233,
KARNATAKA,BENGALURU RURAL,2021-02-04,6,1205,0,1211,
KARNATAKA,BENGALURU RURAL,2021-02-05,7,1139,0,1146,
KARNATAKA,BENGALURU URBAN,2021-02-01,231,30597,64,30892,
KARNATAKA,BENGALURU URBAN,2021-02-02,305,32626,91,33022,
KARNATAKA,BENGALURU URBAN,2021-02-03,279,32348,86,32713,
KARNATAKA,BENGALURU URBAN,2021-02-04,272,30435,46,30753,
KARNATAKA,BENGALURU URBAN,2021-02-05,271,29633,110,30014,
KARNATAKA,BIDAR,2021-02-01,9,815,0,824,
KARNATAKA,BIDAR,2021-02-02,2,962,0,964,
KARNATAKA,BIDAR,2021-02-03,19,1386,0,1405,
KARNATAKA,BIDAR,2021-02-04,9,883,2,894,
KARNATAKA,BIDAR,2021-02-05,10,945,0,955,
KARNATAKA,CHAMARAJANAGARA,2021-02-01,2,248,0,250,
KARNATAKA,CHAMARAJANAGARA,2021-02-02,4,911,3,918,
KARNATAKA,CHAMARAJANAGARA,2021-02-03,0,707,3,710,
KARNATAKA,CHAMARAJANAGARA,2021-02-04,6,707,0,713,
KARNATAKA,CHAMARAJANAGARA,2021-02-05,3,938,4,945,
KARNATAKA,CHIKKABALLAPURA,2021-02-01,9,2522,11,2542,
KARNATAKA,CHIKKABALLAPURA,2021-02-02,4,2059,14,2077,
KARNATAKA,CHIKKABALLAPURA,2021-02-03,3,2172,6,2181,
KARNATAKA,CHIKKABALLAPURA,2021-02-04,7,2215,13,2235,
KARNATAKA,CHIKKABALLAPURA,2021-02-05,7,2063,10,2080,
KARNATAKA,CHIKKAMAGALURU,2021-02-01,0,477,2,479,
KARNATAKA,CHIKKAMAGALURU,2021-02-02,2,1247,16,1265,
KARNATAKA,CHIKKAMAGALURU,2021-02-03,3,883,3,889,
KARNATAKA,CHIKKAMAGALURU,2021-02-04,8,837,13,858,
KARNATAKA,CHIKKAMAGALURU,2021-02-05,3,1024,21,1048,
KARNATAKA,CHITRADURGA,2021-02-01,6,1723,1,1730,
KARNATAKA,CHITRADURGA,2021-02-02,10,1905,1,1916,
KARNATAKA,CHITRADURGA,2021-02-03,16,1663,0,1679,
KARNATAKA,CHITRADURGA,2021-02-04,8,1669,2,1679,
KARNATAKA,CHITRADURGA,2021-02-05,10,1734,1,1745,
KARNATAKA,DAKSHINA KANNADA,2021-02-01,25,1283,2,1310,
KARNATAKA,DAKSHINA KANNADA,2021-02-02,67,1369,0,1436,
KARNATAKA,DAKSHINA KANNADA,2021-02-03,40,1496,1,1537,
KARNATAKA,DAKSHINA KANNADA,2021-02-04,24,1671,1,1696,
KARNATAKA,DAKSHINA KANNADA,2021-02-05,27,1535,3,1565,
KARNATAKA,DAVANGERE,2021-02-01,7,738,10,755,
KARNATAKA,DAVANGERE,2021-02-02,11,793,6,810,
KARNATAKA,DAVANGERE,2021-02-03,5,551,67,623,
KARNATAKA,DAVANGERE,2021-02-04,4,1037,19,1060,
KARNATAKA,DAVANGERE,2021-02-05,4,586,72,662,
KARNATAKA,DHARWAD,2021-02-01,4,939,70,1013,
KARNATAKA,DHARWAD,2021-02-02,11,1792,67,1870,
KARNATAKA,DHARWAD,2021-02-03,10,2104,172,2286,
KARNATAKA,DHARWAD,2021-02-04,6,2061,146,2213,
KARNATAKA,DHARWAD,2021-02-05,14,2325,95,2434,
KARNATAKA,GADAG,2021-02-01,2,786,78,866,
KARNATAKA,GADAG,2021-02-02,0,1104,76,1180,
KARNATAKA,GADAG,2021-02-03,1,1451,76,1528,
KARNATAKA,GADAG,2021-02-04,2,1110,127,1239,
KARNATAKA,GADAG,2021-02-05,2,1036,91,1129,
KARNATAKA,HASSAN,2021-02-01,10,1884,62,1956,
KARNATAKA,HASSAN,2021-02-02,10,2103,38,2151,
KARNATAKA,HASSAN,2021-02-03,14,2674,55,2743,
KARNATAKA,HASSAN,2021-02-04,8,2414,87,2509,
KARNATAKA,HASSAN,2021-02-05,19,1883,50,1952,
KARNATAKA,HAVERI,2021-02-01,0,1170,0,1170,
KARNATAKA,HAVERI,2021-02-02,0,587,0,587,
KARNATAKA,HAVERI,2021-02-03,0,818,0,818,
KARNATAKA,HAVERI,2021-02-04,1,965,0,966,
KARNATAKA,HAVERI,2021-02-05,0,1063,0,1063,
KARNATAKA,KALABURAGI,2021-02-01,17,664,2,683,
KARNATAKA,KALABURAGI,2021-02-02,25,1745,1,1771,
KARNATAKA,KALABURAGI,2021-02-03,17,1794,12,1823,
KARNATAKA,KALABURAGI,2021-02-04,21,1543,2,1566,
KARNATAKA,KALABURAGI,2021-02-05,13,1805,6,1824,
KARNATAKA,KODAGU,2021-02-01,5,630,4,639,
KARNATAKA,KODAGU,2021-02-02,7,380,3,390,
KARNATAKA,KODAGU,2021-02-03,8,758,7,773,
KARNATAKA,KODAGU,2021-02-04,6,1659,24,1689,
KARNATAKA,KODAGU,2021-02-05,9,1723,24,1756,
KARNATAKA,KOLAR,2021-02-01,2,795,0,797,
KARNATAKA,KOLAR,2021-02-02,4,1518,1,1523,
KARNATAKA,KOLAR,2021-02-03,5,2054,4,2063,
KARNATAKA,KOLAR,2021-02-04,4,1947,3,1954,
KARNATAKA,KOLAR,2021-02-05,1,1803,12,1816,
KARNATAKA,KOPPAL,2021-02-01,3,742,6,751,
KARNATAKA,KOPPAL,2021-02-02,1,1141,3,1145,
KARNATAKA,KOPPAL,2021-02-03,0,1452,13,1465,
KARNATAKA,KOPPAL,2021-02-04,1,605,2,608,
KARNATAKA,KOPPAL,2021-02-05,1,1349,3,1353,
KARNATAKA,MANDYA,2021-02-01,6,1655,3,1664,
KARNATAKA,MANDYA,2021-02-02,7,2266,5,2278,
KARNATAKA,MANDYA,2021-02-03,9,1947,0,1956,
KARNATAKA,MANDYA,2021-02-04,5,2343,11,2359,
KARNATAKA,MANDYA,2021-02-05,5,1820,4,1829,
KARNATAKA,MYSURU,2021-02-01,19,1701,0,1720,
KARNATAKA,MYSURU,2021-02-02,33,3332,13,3378,
KARNATAKA,MYSURU,2021-02-03,14,2547,1,2562,
KARNATAKA,MYSURU,2021-02-04,27,2915,2,2944,
KARNATAKA,MYSURU,2021-02-05,14,2478,20,2512,
KARNATAKA,RAICHUR,2021-02-01,2,453,0,455,
KARNATAKA,RAICHUR,2021-02-02,2,165,1,168,
KARNATAKA,RAICHUR,2021-02-03,4,1106,23,1133,
KARNATAKA,RAICHUR,2021-02-04,1,1074,16,1091,
KARNATAKA,RAICHUR,2021-02-05,2,914,2,918,
KARNATAKA,RAMANAGARA,2021-02-01,2,733,0,735,
KARNATAKA,RAMANAGARA,2021-02-02,1,635,2,638,
KARNATAKA,RAMANAGARA,2021-02-03,1,624,0,625,
KARNATAKA,RAMANAGARA,2021-02-04,1,1054,0,1055,
KARNATAKA,RAMANAGARA,2021-02-05,3,887,0,890,
KARNATAKA,SHIVAMOGGA,2021-02-01,6,1223,0,1229,
KARNATAKA,SHIVAMOGGA,2021-02-02,3,1355,0,1358,
KARNATAKA,SHIVAMOGGA,2021-02-03,6,1403,0,1409,
KARNATAKA,SHIVAMOGGA,2021-02-04,5,1286,9,1300,
KARNATAKA,SHIVAMOGGA,2021-02-05,3,1508,0,1511,
KARNATAKA,TUMAKURU,2021-02-01,18,1914,32,1964,
KARNATAKA,TUMAKURU,2021-02-02,26,1633,10,1669,
KARNATAKA,TUMAKURU,2021-02-03,8,2359,3,2370,
KARNATAKA,TUMAKURU,2021-02-04,39,1414,36,1489,
KARNATAKA,TUMAKURU,2021-02-05,25,2867,2,2894,
KARNATAKA,UDUPI,2021-02-01,13,981,0,994,
KARNATAKA,UDUPI,2021-02-02,3,1313,0,1316,
KARNATAKA,UDUPI,2021-02-03,11,954,0,965,
KARNATAKA,UDUPI,2021-02-04,19,1400,0,1419,
KARNATAKA,UDUPI,2021-02-05,5,1221,0,1226,
KARNATAKA,UTTARA KANNADA,2021-02-01,8,1105,84,1197,
KARNATAKA,UTTARA KANNADA,2021-02-02,7,1226,194,1427,
KARNATAKA,UTTARA KANNADA,2021-02-03,17,1473,115,1605,
KARNATAKA,UTTARA KANNADA,2021-02-04,5,1196,105,1306,
KARNATAKA,UTTARA KANNADA,2021-02-05,10,2042,253,2305,
KARNATAKA,VIJAYAPURA,2021-02-01,4,1110,0,1114,
KARNATAKA,VIJAYAPURA,2021-02-02,0,350,0,350,
KARNATAKA,VIJAYAPURA,2021-02-03,4,805,1,810,
KARNATAKA,VIJAYAPURA,2021-02-04,3,901,0,904,
KARNATAKA,VIJAYAPURA,2021-02-05,2,1013,0,1015,
KARNATAKA,YADGIR,2021-02-01,0,399,0,399,
KARNATAKA,YADGIR,2021-02-02,0,855,0,855,
KARNATAKA,YADGIR,2021-02-03,1,847,0,848,
KARNATAKA,YADGIR,2021-02-04,0,1091,0,1091,
KARNATAKA,YADGIR,2021-02-05,2,1112,0,1114,
KERALA,ALAPPUZHA,2021-02-01,373,3049,3,3425,
KERALA,ALAPPUZHA,2021-02-02,432,3061,3,3496,
KERALA,ALAPPUZHA,2021-02-03,555,3839,11,4405,
KERALA,ALAPPUZHA,2021-02-04,238,2963,6,3207,
KERALA,ALAPPUZHA,2021-02-05,360,4200,5,4565,
KERALA,ERNAKULAM,2021-02-01,871,4979,17,5867,
KERALA,ERNAKULAM,2021-02-02,1031,6074,33,7138,
KERALA,ERNAKULAM,2021-02-03,882,6899,34,7815,
KERALA,ERNAKULAM,2021-02-04,483,5263,13,5759,
KERALA,ERNAKULAM,2021-02-05,868,8050,20,8938,
KERALA,IDUKKI,2021-02-01,160,1373,1,1534,
KERALA,IDUKKI,2021-02-02,259,2249,10,2518,
KERALA,IDUKKI,2021-02-03,313,3880,44,4237,
KERALA,IDUKKI,2021-02-04,236,2136,4,2376,
KERALA,IDUKKI,2021-02-05,281,3467,4,3752,
KERALA,KANNUR,2021-02-01,337,2510,2,2849,
KERALA,KANNUR,2021-02-02,384,2434,2,2820,
KERALA,KANNUR,2021-02-03,309,3094,4,3407,
KERALA,KANNUR,2021-02-04,166,2681,2,2849,
KERALA,KANNUR,2021-02-05,318,3870,3,4191,
KERALA,KASARAGOD,2021-02-01,102,1315,1,1418,
KERALA,KASARAGOD,2021-02-02,125,1574,25,1724,
KERALA,KASARAGOD,2021-02-03,97,1344,0,1441,
KERALA,KASARAGOD,2021-02-04,85,988,0,1073,
KERALA,KASARAGOD,2021-02-05,117,1885,58,2060,
KERALA,KOLLAM,2021-02-01,637,3791,0,4428,
KERALA,KOLLAM,2021-02-02,664,3753,1,4418,
KERALA,KOLLAM,2021-02-03,653,4614,0,5267,
KERALA,KOLLAM,2021-02-04,449,3862,0,4311,
KERALA,KOLLAM,2021-02-05,607,6509,0,7116,
KERALA,KOTTAYAM,2021-02-01,593,2920,15,3528,
KERALA,KOTTAYAM,2021-02-02,687,3365,36,4088,
KERALA,KOTTAYAM,2021-02-03,537,4770,22,5329,
KERALA,KOTTAYAM,2021-02-04,431,4395,17,4843,
KERALA,KOTTAYAM,2021-02-05,451,5542,27,6020,
KERALA,KOZHIKODE,2021-02-01,529,3548,4,4081,
KERALA,KOZHIKODE,2021-02-02,848,4658,42,5548,
KERALA,KOZHIKODE,2021-02-03,781,4889,48,5718,
KERALA,KOZHIKODE,2021-02-04,500,3889,12,4401,
KERALA,KOZHIKODE,2021-02-05,797,6265,22,7084,
KERALA,MALAPPURAM,2021-02-01,526,3884,4,4414,
KERALA,MALAPPURAM,2021-02-02,303,3015,1,3319,
KERALA,MALAPPURAM,2021-02-03,456,3529,2,3987,
KERALA,MALAPPURAM,2021-02-04,408,3032,2,3442,
KERALA,MALAPPURAM,2021-02-05,600,4072,3,4675,
KERALA,PALAKKAD,2021-02-01,287,2210,4,2501,
KERALA,PALAKKAD,2021-02-02,256,2828,1,3085,
KERALA,PALAKKAD,2021-02-03,277,3236,1,3514,
KERALA,PALAKKAD,2021-02-04,151,3168,1,3320,
KERALA,PALAKKAD,2021-02-05,263,5973,1,6237,
KERALA,PATHANAMTHITTA,2021-02-01,651,2637,1,3289,
KERALA,PATHANAMTHITTA,2021-02-02,557,2398,2,2957,
KERALA,PATHANAMTHITTA,2021-02-03,669,3731,1,4401,
KERALA,PATHANAMTHITTA,2021-02-04,390,2757,0,3147,
KERALA,PATHANAMTHITTA,2021-02-05,528,5301,3,5832,
KERALA,THIRUVANANTHAPURAM,2021-02-01,460,4086,2,4548,
KERALA,THIRUVANANTHAPURAM,2021-02-02,639,4890,1,5530,
KERALA,THIRUVANANTHAPURAM,2021-02-03,533,4667,0,5200,
KERALA,THIRUVANANTHAPURAM,2021-02-04,414,3945,0,4359,
KERALA,THIRUVANANTHAPURAM,2021-02-05,649,7180,0,7829,
KERALA,THRISSUR,2021-02-01,530,3542,2,4074,
KERALA,THRISSUR,2021-02-02,615,3730,1,4346,
KERALA,THRISSUR,2021-02-03,472,5087,0,5559,
KERALA,THRISSUR,2021-02-04,417,7355,0,7772,
KERALA,THRISSUR,2021-02-05,608,7709,1,8318,
KERALA,WAYANAD,2021-02-01,196,1096,4,1296,
KERALA,WAYANAD,2021-02-02,252,1433,5,1690,
KERALA,WAYANAD,2021-02-03,180,1406,9,1595,
KERALA,WAYANAD,2021-02-04,110,769,10,889,
KERALA,WAYANAD,2021-02-05,223,2474,3,2700,
LADAKH,KARGIL,2021-02-01,0,53,0,53,
LADAKH,KARGIL,2021-02-02,0,64,0,64,
LADAKH,KARGIL,2021-02-03,0,136,0,136,
LADAKH,KARGIL,2021-02-04,0,44,0,44,
LADAKH,KARGIL,2021-02-05,0,59,0,59,
LADAKH,LEH LADAKH,2021-02-01,3,154,1,158,
LADAKH,LEH LADAKH,2021-02-02,3,158,0,161,
LADAKH,LEH LADAKH,2021-02-03,9,216,0,225,
LADAKH,LEH LADAKH,2021-02-04,3,149,1,153,
LADAKH,LEH LADAKH,2021-02-05,4,110,1,115,
LAKSHADWEEP,LAKSHADWEEP DISTRICT,2021-02-01,0,101,0,101,
LAKSHADWEEP,LAKSHADWEEP DISTRICT,2021-02-02,0,195,0,195,
LAKSHADWEEP,LAKSHADWEEP DISTRICT,2021-02-03,0,267,0,267,
LAKSHADWEEP,LAKSHADWEEP DISTRICT,2021-02-04,1,316,0,317,
LAKSHADWEEP,LAKSHADWEEP DISTRICT,2021-02-05,1,591,0,592,
MADHYA PRADESH,AGAR MALWA,2021-02-01,1,269,0,270,
MADHYA PRADESH,AGAR MALWA,2021-02-02,0,237,0,237,
MADHYA PRADESH,AGAR MALWA,2021-02-03,0,118,1,119,
MADHYA PRADESH,AGAR MALWA,2021-02-04,0,253,0,253,
MADHYA PRADESH,AGAR MALWA,2021-02-05,0,183,0,183,
MADHYA PRADESH,ALIRAJPUR,2021-02-01,0,86,0,86,
MADHYA PRADESH,ALIRAJPUR,2021-02-02,1,163,0,164,
MADHYA PRADESH,ALIRAJPUR,2021-02-03,1,65,0,66,
MADHYA PRADESH,ALIRAJPUR,2021-02-04,0,102,0,102,
MADHYA PRADESH,ALIRAJPUR,2021-02-05,0,82,1,83,
MADHYA PRADESH,ANUPPUR,2021-02-01,0,72,0,72,
MADHYA PRADESH,ANUPPUR,2021-02-02,1,87,0,88,
MADHYA PRADESH,ANUPPUR,2021-02-03,1,267,31,299,
MADHYA PRADESH,ANUPPUR,2021-02-04,1,310,58,369,
MADHYA PRADESH,ANUPPUR,2021-02-05,3,171,14,188,
MADHYA PRADESH,ASHOKNAGAR,2021-02-01,0,224,0,224,
MADHYA PRADESH,ASHOKNAGAR,2021-02-02,0,78,0,78,
MADHYA PRADESH,ASHOKNAGAR,2021-02-03,0,197,0,197,
MADHYA PRADESH,ASHOKNAGAR,2021-02-04,0,77,0,77,
MADHYA PRADESH,ASHOKNAGAR,2021-02-05,1,242,0,243,
MADHYA PRADESH,BALAGHAT,2021-02-01,5,347,0,352,
MADHYA PRADESH,BALAGHAT,2021-02-02,1,341,0,342,
MADHYA PRADESH,BALAGHAT,2021-02-03,0,423,1,424,
MADHYA PRADESH,BALAGHAT,2021-02-04,0,499,0,499,
MADHYA PRADESH,BALAGHAT,2021-02-05,1,235,0,236,
MADHYA PRADESH,BARWANI,2021-02-01,5,243,0,248,
MADHYA PRADESH,BARWANI,2021-02-02,4,241,0,245,
MADHYA PRADESH,BARWANI,2021-02-03,2,155,0,157,
MADHYA PRADESH,BARWANI,2021-02-04,4,167,0,171,
MADHYA PRADESH,BARWANI,2021-02-05,1,183,0,184,
MADHYA PRADESH,BETUL,2021-02-01,5,272,2,279,
MADHYA PRADESH,BETUL,2021-02-02,5,280,3,288,
MADHYA PRADESH,BETUL,2021-02-03,7,270,0,277,
MADHYA PRADESH,BETUL,2021-02-04,7,226,3,236,
MADHYA PRADESH,BETUL,2021-02-05,2,274,3,279,
MADHYA PRADESH,BHIND,2021-02-01,1,315,0,316,
MADHYA PRADESH,BHIND,2021-02-02,0,194,1,195,
MADHYA PRADESH,BHIND,2021-02-03,1,125,0,126,
MADHYA PRADESH,BHIND,2021-02-04,0,216,1,217,
MADHYA PRADESH,BHIND,2021-02-05,1,74,0,75,
MADHYA PRADESH,BHOPAL,2021-02-01,80,1572,8,1660,
MADHYA PRADESH,BHOPAL,2021-02-02,94,1906,12,2012,
MADHYA PRADESH,BHOPAL,2021-02-03,53,1725,8,1786,
MADHYA PRADESH,BHOPAL,2021-02-04,66,1579,18,1663,
MADHYA PRADESH,BHOPAL,2021-02-05,68,1659,15,1742,
MADHYA PRADESH,BURHANPUR,2021-02-01,1,191,0,192,
MADHYA PRADESH,BURHANPUR,2021-02-02,0,109,0,109,
MADHYA PRADESH,BURHANPUR,2021-02-03,0,53,0,53,
MADHYA PRADESH,BURHANPUR,2021-02-04,0,130,0,130,
MADHYA PRADESH,BURHANPUR,2021-02-05,0,118,0,118,
MADHYA PRADESH,CHHATARPUR,2021-02-01,1,257,0,258,
MADHYA PRADESH,CHHATARPUR,2021-02-02,2,141,0,143,
MADHYA PRADESH,CHHATARPUR,2021-02-03,0,193,0,193,
MADHYA PRADESH,CHHATARPUR,2021-02-04,0,194,0,194,
MADHYA PRADESH,CHHATARPUR,2021-02-05,4,258,0,262,
MADHYA PRADESH,CHHINDWARA,2021-02-01,7,334,2,343,
MADHYA PRADESH,CHHINDWARA,2021-02-02,20,414,2,436,
MADHYA PRADESH,CHHINDWARA,2021-02-03,5,499,8,512,
MADHYA PRADESH,CHHINDWARA,2021-02-04,7,400,2,409,
MADHYA PRADESH,CHHINDWARA,2021-02-05,5,415,13,433,
MADHYA PRADESH,DAMOH,2021-02-01,5,229,3,237,
MADHYA PRADESH,DAMOH,2021-02-02,1,51,0,52,
MADHYA PRADESH,DAMOH,2021-02-03,1,165,0,166,
MADHYA PRADESH,DAMOH,2021-02-04,2,178,0,180,
MADHYA PRADESH,DAMOH,2021-02-05,4,225,1,230,
MADHYA PRADESH,DATIA,2021-02-01,0,271,7,278,
MADHYA PRADESH,DATIA,2021-02-02,0,277,1,278,
MADHYA PRADESH,DATIA,2021-02-03,1,144,0,145,
MADHYA PRADESH,DATIA,2021-02-04,2,111,0,113,
MADHYA PRADESH,DATIA,2021-02-05,1,195,8,204,
MADHYA PRADESH,DEWAS,2021-02-01,11,277,0,288,
MADHYA PRADESH,DEWAS,2021-02-02,0,606,2,608,
MADHYA PRADESH,DEWAS,2021-02-03,17,302,0,319,
MADHYA PRADESH,DEWAS,2021-02-04,9,469,1,479,
MADHYA PRADESH,DEWAS,2021-02-05,15,437,0,452,
MADHYA PRADESH,DHAR,2021-02-01,3,150,0,153,
MADHYA PRADESH,DHAR,2021-02-02,2,236,0,238,
MADHYA PRADESH,DHAR,2021-02-03,5,101,0,106,
MADHYA PRADESH,DHAR,2021-02-04,4,112,0,116,
MADHYA PRADESH,DHAR,2021-02-05,4,182,4,190,
MADHYA PRADESH,DINDORI,2021-02-01,2,120,0,122,
MADHYA PRADESH,DINDORI,2021-02-02,3,476,0,479,
MADHYA PRADESH,DINDORI,2021-02-03,3,446,0,449,
MADHYA PRADESH,DINDORI,2021-02-04,3,473,0,476,
MADHYA PRADESH,DINDORI,2021-02-05,0,486,0,486,
MADHYA PRADESH,EAST NIMAR,2021-02-01,3,226,0,229,
MADHYA PRADESH,EAST NIMAR,2021-02-02,0,90,0,90,
MADHYA PRADESH,EAST NIMAR,2021-02-03,0,301,2,303,
MADHYA PRADESH,EAST NIMAR,2021-02-04,2,343,0,345,
MADHYA PRADESH,EAST NIMAR,2021-02-05,0,292,0,292,
MADHYA PRADESH,GUNA,2021-02-01,0,279,0,279,
MADHYA PRADESH,GUNA,2021-02-02,1,172,0,173,
MADHYA PRADESH,GUNA,2021-02-03,1,208,0,209,
MADHYA PRADESH,GUNA,2021-02-04,0,240,0,240,
MADHYA PRADESH,GUNA,2021-02-05,0,99,0,99,
MADHYA PRADESH,GWALIOR,2021-02-01,6,894,2,902,
MADHYA PRADESH,GWALIOR,2021-02-02,7,519,2,528,
MADHYA PRADESH,GWALIOR,2021-02-03,17,551,1,569,
MADHYA PRADESH,GWALIOR,2021-02-04,3,619,1,623,
MADHYA PRADESH,GWALIOR,2021-02-05,4,617,1,622,
MADHYA PRADESH,HARDA,2021-02-01,1,222,0,223,
MADHYA PRADESH,HARDA,2021-02-02,1,234,3,238,
MADHYA PRADESH,HARDA,2021-02-03,0,172,0,172,
MADHYA PRADESH,HARDA,2021-02-04,1,262,0,263,
MADHYA PRADESH,HARDA,2021-02-05,0,256,3,259,
MADHYA PRADESH,HOSHANGABAD,2021-02-01,1,235,0,236,
MADHYA PRADESH,HOSHANGABAD,2021-02-02,6,205,0,211,
MADHYA PRADESH,HOSHANGABAD,2021-02-03,4,247,1,252,
MADHYA PRADESH,HOSHANGABAD,2021-02-04,1,236,0,237,
MADHYA PRADESH,HOSHANGABAD,2021-02-05,4,120,0,124,
MADHYA PRADESH,INDORE,2021-02-01,64,2121,0,2185,
MADHYA PRADESH,INDORE,2021-02-02,49,1946,0,1995,
MADHYA PRADESH,INDORE,2021-02-03,51,1783,0,1834,
MADHYA PRADESH,INDORE,2021-02-04,44,2150,0,2194,
MADHYA PRADESH,INDORE,2021-02-05,78,1439,4,1521,
MADHYA PRADESH,JABALPUR,2021-02-01,16,299,1,316,
MADHYA PRADESH,JABALPUR,2021-02-02,24,373,10,407,
MADHYA PRADESH,JABALPUR,2021-02-03,5,350,0,355,
MADHYA PRADESH,JABALPUR,2021-02-04,12,319,0,331,
MADHYA PRADESH,JABALPUR,2021-02-05,27,540,1,568,
MADHYA PRADESH,JHABUA,2021-02-01,1,261,0,262,
MADHYA PRADESH,JHABUA,2021-02-02,4,112,0,116,
MADHYA PRADESH,JHABUA,2021-02-03,2,269,1,272,
MADHYA PRADESH,JHABUA,2021-02-04,4,164,0,168,
MADHYA PRADESH,JHABUA,2021-02-05,2,218,0,220,
MADHYA PRADESH,KATNI,2021-02-01,2,313,0,315,
MADHYA PRADESH,KATNI,2021-02-02,4,164,0,168,
MADHYA PRADESH,KATNI,2021-02-03,0,299,0,299,
MADHYA PRADESH,KATNI,2021-02-04,0,72,0,72,
MADHYA PRADESH,KATNI,2021-02-05,2,301,0,303,
MADHYA PRADESH,KHARGONE,2021-02-01,2,150,0,152,
MADHYA PRADESH,KHARGONE,2021-02-02,1,273,0,274,
MADHYA PRADESH,KHARGONE,2021-02-03,4,325,0,329,
MADHYA PRADESH,KHARGONE,2021-02-04,5,290,0,295,
MADHYA PRADESH,KHARGONE,2021-02-05,3,335,3,341,
MADHYA PRADESH,MANDLA,2021-02-01,2,89,0,91,
MADHYA PRADESH,MANDLA,2021-02-02,0,477,1,478,
MADHYA PRADESH,MANDLA,2021-02-03,0,563,0,563,
MADHYA PRADESH,MANDLA,2021-02-04,0,342,0,342,
MADHYA PRADESH,MANDLA,2021-02-05,0,284,0,284,
MADHYA PRADESH,MANDSAUR,2021-02-01,0,94,0,94,
MADHYA PRADESH,MANDSAUR,2021-02-02,0,115,1,116,
MADHYA PRADESH,MANDSAUR,2021-02-03,4,118,2,124,
MADHYA PRADESH,MANDSAUR,2021-02-04,1,154,1,156,
MADHYA PRADESH,MANDSAUR,2021-02-05,3,104,0,107,
MADHYA PRADESH,MORENA,2021-02-01,0,312,0,312,
MADHYA PRADESH,MORENA,2021-02-02,0,226,1,227,
MADHYA PRADESH,MORENA,2021-02-03,0,344,0,344,
MADHYA PRADESH,MORENA,2021-02-04,0,340,1,341,
MADHYA PRADESH,MORENA,2021-02-05,1,342,1,344,
MADHYA PRADESH,NARSINGHPUR,2021-02-01,2,283,0,285,
MADHYA PRADESH,NARSINGHPUR,2021-02-02,1,572,1,574,
MADHYA PRADESH,NARSINGHPUR,2021-02-03,5,536,0,541,
MADHYA PRADESH,NARSINGHPUR,2021-02-04,2,371,0,373,
MADHYA PRADESH,NARSINGHPUR,2021-02-05,0,368,4,372,
MADHYA PRADESH,NEEMUCH,2021-02-01,0,104,0,104,
MADHYA PRADESH,NEEMUCH,2021-02-02,2,76,0,78,
MADHYA PRADESH,NEEMUCH,2021-02-03,0,72,0,72,
MADHYA PRADESH,NEEMUCH,2021-02-04,4,177,2,183,
MADHYA PRADESH,NEEMUCH,2021-02-05,1,111,0,112,
MADHYA PRADESH,NIWARI,2021-02-01,0,186,0,186,
MADHYA PRADESH,NIWARI,2021-02-02,0,157,0,157,
MADHYA PRADESH,NIWARI,2021-02-03,0,26,0,26,
MADHYA PRADESH,NIWARI,2021-02-04,1,85,0,86,
MADHYA PRADESH,NIWARI,2021-02-05,0,15,0,15,
MADHYA PRADESH,PANNA,2021-02-01,0,16,0,16,
MADHYA PRADESH,PANNA,2021-02-02,1,31,0,32,
MADHYA PRADESH,PANNA,2021-02-03,0,34,0,34,
MADHYA PRADESH,PANNA,2021-02-04,2,190,1,193,
MADHYA PRADESH,PANNA,2021-02-05,2,55,0,57,
MADHYA PRADESH,RAISEN,2021-02-01,3,111,0,114,
MADHYA PRADESH,RAISEN,2021-02-02,4,79,0,83,
MADHYA PRADESH,RAISEN,2021-02-03,0,104,0,104,
MADHYA PRADESH,RAISEN,2021-02-04,2,186,0,188,
MADHYA PRADESH,RAISEN,2021-02-05,7,74,1,82,
MADHYA PRADESH,RAJGARH,2021-02-01,4,224,2,230,
MADHYA PRADESH,RAJGARH,2021-02-02,4,173,0,177,
MADHYA PRADESH,RAJGARH,2021-02-03,5,96,1,102,
MADHYA PRADESH,RAJGARH,2021-02-04,1,241,0,242,
MADHYA PRADESH,RAJGARH,2021-02-05,0,142,0,142,
MADHYA PRADESH,RATLAM,2021-02-01,14,268,1,283,
MADHYA PRADESH,RATLAM,2021-02-02,0,218,0,218,
MADHYA PRADESH,RATLAM,2021-02-03,2,230,1,233,
MADHYA PRADESH,RATLAM,2021-02-04,3,354,5,362,
MADHYA PRADESH,RATLAM,2021-02-05,1,222,0,223,
MADHYA PRADESH,REWA,2021-02-01,4,280,0,284,
MADHYA PRADESH,REWA,2021-02-02,6,576,1,583,
MADHYA PRADESH,REWA,2021-02-03,5,467,1,473,
MADHYA PRADESH,REWA,2021-02-04,5,552,3,560,
MADHYA PRADESH,REWA,2021-02-05,2,226,3,231,
MADHYA PRADESH,SAGAR,2021-02-01,7,363,0,370,
MADHYA PRADESH,SAGAR,2021-02-02,2,620,2,624,
MADHYA PRADESH,SAGAR,2021-02-03,5,744,1,750,
MADHYA PRADESH,SAGAR,2021-02-04,7,642,1,650,
MADHYA PRADESH,SAGAR,2021-02-05,6,752,0,758,
MADHYA PRADESH,SATNA,2021-02-01,1,285,0,286,
MADHYA PRADESH,SATNA,2021-02-02,2,175,3,180,
MADHYA PRADESH,SATNA,2021-02-03,1,167,0,168,
MADHYA PRADESH,SATNA,2021-02-04,5,302,0,307,
MADHYA PRADESH,SATNA,2021-02-05,3,289,0,292,
MADHYA PRADESH,SEHORE,2021-02-01,4,180,0,184,
MADHYA PRADESH,SEHORE,2021-02-02,0,173,13,186,
MADHYA PRADESH,SEHORE,2021-02-03,0,289,0,289,
MADHYA PRADESH,SEHORE,2021-02-04,3,310,0,313,
MADHYA PRADESH,SEHORE,2021-02-05,2,199,0,201,
MADHYA PRADESH,SEONI,2021-02-01,1,110,31,142,
MADHYA PRADESH,SEONI,2021-02-02,4,174,0,178,
MADHYA PRADESH,SEONI,2021-02-03,0,284,0,284,
MADHYA PRADESH,SEONI,2021-02-04,4,210,0,214,
MADHYA PRADESH,SEONI,2021-02-05,0,234,3,237,
MADHYA PRADESH,SHAHDOL,2021-02-01,1,12,0,13,
MADHYA PRADESH,SHAHDOL,2021-02-02,2,35,0,37,
MADHYA PRADESH,SHAHDOL,2021-02-03,1,102,3,106,
MADHYA PRADESH,SHAHDOL,2021-02-04,3,153,3,159,
MADHYA PRADESH,SHAHDOL,2021-02-05,0,59,1,60,
MADHYA PRADESH,SHAJAPUR,2021-02-01,1,249,0,250,
MADHYA PRADESH,SHAJAPUR,2021-02-02,0,156,0,156,
MADHYA PRADESH,SHAJAPUR,2021-02-03,0,170,0,170,
MADHYA PRADESH,SHAJAPUR,2021-02-04,0,203,0,203,
MADHYA PRADESH,SHAJAPUR,2021-02-05,2,229,0,231,
MADHYA PRADESH,SHEOPUR,2021-02-01,0,47,0,47,
MADHYA PRADESH,SHEOPUR,2021-02-02,6,224,1,231,
MADHYA PRADESH,SHEOPUR,2021-02-03,1,41,0,42,
MADHYA PRADESH,SHEOPUR,2021-02-04,1,22,0,23,
MADHYA PRADESH,SHEOPUR,2021-02-05,2,341,0,343,
MADHYA PRADESH,SHIVPURI,2021-02-01,2,101,0,103,
MADHYA PRADESH,SHIVPURI,2021-02-02,2,82,0,84,
MADHYA PRADESH,SHIVPURI,2021-02-03,3,256,2,261,
MADHYA PRADESH,SHIVPURI,2021-02-04,0,104,1,105,
MADHYA PRADESH,SHIVPURI,2021-02-05,2,174,1,177,
MADHYA PRADESH,SIDHI,2021-02-01,0,12,0,12,
MADHYA PRADESH,SIDHI,2021-02-02,2,120,0,122,
MADHYA PRADESH,SIDHI,2021-02-03,4,311,1,316,
MADHYA PRADESH,SIDHI,2021-02-04,2,150,0,152,
MADHYA PRADESH,SIDHI,2021-02-05,5,132,0,137,
MADHYA PRADESH,SINGRAULI,2021-02-01,0,153,0,153,
MADHYA PRADESH,SINGRAULI,2021-02-02,0,179,0,179,
MADHYA PRADESH,SINGRAULI,2021-02-03,1,59,0,60,
MADHYA PRADESH,SINGRAULI,2021-02-04,1,276,2,279,
MADHYA PRADESH,SINGRAULI,2021-02-05,0,166,0,166,
MADHYA PRADESH,TIKAMGARH,2021-02-01,3,229,2,234,
MADHYA PRADESH,TIKAMGARH,2021-02-02,1,87,2,90,
MADHYA PRADESH,TIKAMGARH,2021-02-03,2,182,0,184,
MADHYA PRADESH,TIKAMGARH,2021-02-04,1,162,0,163,
MADHYA PRADESH,TIKAMGARH,2021-02-05,0,183,5,188,
MADHYA PRADESH,UJJAIN,2021-02-01,1,132,5,138,
MADHYA PRADESH,UJJAIN,2021-02-02,20,406,0,426,
MADHYA PRADESH,UJJAIN,2021-02-03,2,137,0,139,
MADHYA PRADESH,UJJAIN,2021-02-04,10,219,0,229,
MADHYA PRADESH,UJJAIN,2021-02-05,22,622,0,644,
MADHYA PRADESH,UMARIA,2021-02-01,3,105,17,125,
MADHYA PRADESH,UMARIA,2021-02-02,1,210,8,219,
MADHYA PRADESH,UMARIA,2021-02-03,1,49,10,60,
MADHYA PRADESH,UMARIA,2021-02-04,3,136,0,139,
MADHYA PRADESH,UMARIA,2021-02-05,0,63,0,63,
MADHYA PRADESH,VIDISHA,2021-02-01,0,89,1,90,
MADHYA PRADESH,VIDISHA,2021-02-02,2,124,1,127,
MADHYA PRADESH,VIDISHA,2021-02-03,0,118,1,119,
MADHYA PRADESH,VIDISHA,2021-02-04,2,125,8,135,
MADHYA PRADESH,VIDISHA,2021-02-05,2,148,1,151,
MAHARASHTRA,AHMEDNAGAR,2021-02-01,64,2583,0,2647,
MAHARASHTRA,AHMEDNAGAR,2021-02-02,113,813,1,927,
MAHARASHTRA,AHMEDNAGAR,2021-02-03,103,2110,0,2213,
MAHARASHTRA,AHMEDNAGAR,2021-02-04,61,1127,1,1189,
MAHARASHTRA,AHMEDNAGAR,2021-02-05,103,1704,0,1807,
MAHARASHTRA,AKOLA,2021-02-01,18,207,0,225,
MAHARASHTRA,AKOLA,2021-02-02,28,331,0,359,
MAHARASHTRA,AKOLA,2021-02-03,28,285,0,313,
MAHARASHTRA,AKOLA,2021-02-04,54,307,0,361,
MAHARASHTRA,AKOLA,2021-02-05,53,227,0,280,
MAHARASHTRA,AMRAVATI,2021-02-01,173,1008,1,1182,
MAHARASHTRA,AMRAVATI,2021-02-02,111,617,0,728,
MAHARASHTRA,AMRAVATI,2021-02-03,169,765,5,939,
MAHARASHTRA,AMRAVATI,2021-02-04,180,545,6,731,
MAHARASHTRA,AMRAVATI,2021-02-05,227,806,12,1045,
MAHARASHTRA,AURANGABAD,2021-02-01,28,733,2,763,
MAHARASHTRA,AURANGABAD,2021-02-02,33,873,4,910,
MAHARASHTRA,AURANGABAD,2021-02-03,54,1052,0,1106,
MAHARASHTRA,AURANGABAD,2021-02-04,31,1141,2,1174,
MAHARASHTRA,AURANGABAD,2021-02-05,55,585,1,641,
MAHARASHTRA,BEED,2021-02-01,16,504,0,520,
MAHARASHTRA,BEED,2021-02-02,30,708,2,740,
MAHARASHTRA,BEED,2021-02-03,52,537,0,589,
MAHARASHTRA,BEED,2021-02-04,35,501,0,536,
MAHARASHTRA,BEED,2021-02-05,19,455,0,474,
MAHARASHTRA,BHANDARA,2021-02-01,9,285,0,294,
MAHARASHTRA,BHANDARA,2021-02-02,14,240,0,254,
MAHARASHTRA,BHANDARA,2021-02-03,12,458,1,471,
MAHARASHTRA,BHANDARA,2021-02-04,25,432,0,457,
MAHARASHTRA,BHANDARA,2021-02-05,16,160,0,176,
MAHARASHTRA,BULDHANA,2021-02-01,41,978,4,1023,
MAHARASHTRA,BULDHANA,2021-02-02,60,1002,7,1069,
MAHARASHTRA,BULDHANA,2021-02-03,53,992,18,1063,
MAHARASHTRA,BULDHANA,2021-02-04,80,578,5,663,
MAHARASHTRA,BULDHANA,2021-02-05,54,827,11,892,
MAHARASHTRA,CHANDRAPUR,2021-02-01,14,521,5,540,
MAHARASHTRA,CHANDRAPUR,2021-02-02,17,561,2,580,
MAHARASHTRA,CHANDRAPUR,2021-02-03,11,557,1,569,
MAHARASHTRA,CHANDRAPUR,2021-02-04,15,390,0,405,
MAHARASHTRA,CHANDRAPUR,2021-02-05,15,401,1,417,
MAHARASHTRA,DHULE,2021-02-01,17,341,1,359,
MAHARASHTRA,DHULE,2021-02-02,20,291,0,311,
MAHARASHTRA,DHULE,2021-02-03,18,264,0,282,
MAHARASHTRA,DHULE,2021-02-04,9,93,0,102,
MAHARASHTRA,DHULE,2021-02-05,16,180,1,197,
MAHARASHTRA,GADCHIROLI,2021-02-01,3,675,1,679,
MAHARASHTRA,GADCHIROLI,2021-02-02,8,786,2,796,
MAHARASHTRA,GADCHIROLI,2021-02-03,5,517,1,523,
MAHARASHTRA,GADCHIROLI,2021-02-04,1,544,1,546,
MAHARASHTRA,GADCHIROLI,2021-02-05,5,676,1,682,
MAHARASHTRA,GONDIA,2021-02-01,6,363,0,369,
MAHARASHTRA,GONDIA,2021-02-02,4,403,1,408,
MAHARASHTRA,GONDIA,2021-02-03,10,414,0,424,
MAHARASHTRA,GONDIA,2021-02-04,8,653,0,661,
MAHARASHTRA,GONDIA,2021-02-05,16,369,2,387,
MAHARASHTRA,HINGOLI,2021-02-01,0,9,0,9,
MAHARASHTRA,HINGOLI,2021-02-02,11,250,0,261,
MAHARASHTRA,HINGOLI,2021-02-03,3,368,0,371,
MAHARASHTRA,HINGOLI,2021-02-04,2,249,0,251,
MAHARASHTRA,HINGOLI,2021-02-05,3,263,0,266,
MAHARASHTRA,JALGAON,2021-02-01,34,1100,0,1134,
MAHARASHTRA,JALGAON,2021-02-02,52,1501,0,1553,
MAHARASHTRA,JALGAON,2021-02-03,39,996,14,1049,
MAHARASHTRA,JALGAON,2021-02-04,50,450,0,500,
MAHARASHTRA,JALGAON,2021-02-05,40,801,1,842,
MAHARASHTRA,JALNA,2021-02-01,11,222,0,233,
MAHARASHTRA,JALNA,2021-02-02,14,248,0,262,
MAHARASHTRA,JALNA,2021-02-03,7,366,0,373,
MAHARASHTRA,JALNA,2021-02-04,18,392,0,410,
MAHARASHTRA,JALNA,2021-02-05,41,422,0,463,
MAHARASHTRA,KOLHAPUR,2021-02-01,8,454,0,462,
MAHARASHTRA,KOLHAPUR,2021-02-02,16,653,5,674,
MAHARASHTRA,KOLHAPUR,2021-02-03,10,946,4,960,
MAHARASHTRA,KOLHAPUR,2021-02-04,24,991,4,1019,
MAHARASHTRA,KOLHAPUR,2021-02-05,13,1096,0,1109,
MAHARASHTRA,LATUR,2021-02-01,23,590,1,614,
MAHARASHTRA,LATUR,2021-02-02,35,768,1,804,
MAHARASHTRA,LATUR,2021-02-03,23,611,4,638,
MAHARASHTRA,LATUR,2021-02-04,34,677,3,714,
MAHARASHTRA,LATUR,2021-02-05,44,511,7,562,
MAHARASHTRA,MUMBAI,2021-02-01,336,11028,10,11374,
MAHARASHTRA,MUMBAI,2021-02-02,505,12817,6,13328,
MAHARASHTRA,MUMBAI,2021-02-03,412,13061,10,13483,
MAHARASHTRA,MUMBAI,2021-02-04,386,10862,17,11265,
MAHARASHTRA,MUMBAI,2021-02-05,410,10749,15,11174,
MAHARASHTRA,MUMBAI SUBURBAN,2021-02-01,87,2404,1,2492,
MAHARASHTRA,MUMBAI SUBURBAN,2021-02-02,94,2981,6,3081,
MAHARASHTRA,MUMBAI SUBURBAN,2021-02-03,108,2657,4,2769,
MAHARASHTRA,MUMBAI SUBURBAN,2021-02-04,115,2790,7,2912,
MAHARASHTRA,MUMBAI SUBURBAN,2021-02-05,75,2759,10,2844,
MAHARASHTRA,NAGPUR,2021-02-01,189,2629,13,2831,
MAHARASHTRA,NAGPUR,2021-02-02,267,3093,19,3379,
MAHARASHTRA,NAGPUR,2021-02-03,300,3365,19,3684,
MAHARASHTRA,NAGPUR,2021-02-04,259,3334,24,3617,
MAHARASHTRA,NAGPUR,2021-02-05,362,3184,20,3566,
MAHARASHTRA,NANDED,2021-02-01,22,674,4,700,
MAHARASHTRA,NANDED,2021-02-02,16,564,1,581,
MAHARASHTRA,NANDED,2021-02-03,18,473,8,499,
MAHARASHTRA,NANDED,2021-02-04,11,381,4,396,
MAHARASHTRA,NANDED,2021-02-05,27,402,1,430,
MAHARASHTRA,NANDURBAR,2021-02-01,10,320,0,330,
MAHARASHTRA,NANDURBAR,2021-02-02,16,529,0,545,
MAHARASHTRA,NANDURBAR,2021-02-03,55,225,0,280,
MAHARASHTRA,NANDURBAR,2021-02-04,35,377,0,412,
MAHARASHTRA,NANDURBAR,2021-02-05,41,209,0,250,
MAHARASHTRA,NASHIK,2021-02-01,135,1033,5,1173,
MAHARASHTRA,NASHIK,2021-02-02,562,2115,5,2682,
MAHARASHTRA,NASHIK,2021-02-03,184,1450,6,1640,
MAHARASHTRA,NASHIK,2021-02-04,179,1322,2,1503,
MAHARASHTRA,NASHIK,2021-02-05,148,975,0,1123,
MAHARASHTRA,OSMANABAD,2021-02-01,4,504,2,510,
MAHARASHTRA,OSMANABAD,2021-02-02,13,538,2,553,
MAHARASHTRA,OSMANABAD,2021-02-03,9,514,0,523,
MAHARASHTRA,OSMANABAD,2021-02-04,16,666,4,686,
MAHARASHTRA,OSMANABAD,2021-02-05,23,602,5,630,
MAHARASHTRA,PALGHAR,2021-02-01,32,1276,2,1310,
MAHARASHTRA,PALGHAR,2021-02-02,41,1007,3,1051,
MAHARASHTRA,PALGHAR,2021-02-03,46,832,4,882,
MAHARASHTRA,PALGHAR,2021-02-04,41,1020,2,1063,
MAHARASHTRA,PALGHAR,2021-02-05,27,1041,3,1071,
MAHARASHTRA,PARBHANI,2021-02-01,3,574,1,578,
MAHARASHTRA,PARBHANI,2021-02-02,4,347,0,351,
MAHARASHTRA,PARBHANI,2021-02-03,7,1120,0,1127,
MAHARASHTRA,PARBHANI,2021-02-04,7,932,0,939,
MAHARASHTRA,PARBHANI,2021-02-05,4,720,0,724,
MAHARASHTRA,PUNE,2021-02-01,388,4104,40,4532,
MAHARASHTRA,PUNE,2021-02-02,551,5427,115,6093,
MAHARASHTRA,PUNE,2021-02-03,532,4804,132,5468,
MAHARASHTRA,PUNE,2021-02-04,456,5324,87,5867,
MAHARASHTRA,PUNE,2021-02-05,412,5082,74,5568,
MAHARASHTRA,RAIGAD,2021-02-01,52,1298,10,1360,
MAHARASHTRA,RAIGAD,2021-02-02,81,1398,1,1480,
MAHARASHTRA,RAIGAD,2021-02-03,59,1410,3,1472,
MAHARASHTRA,RAIGAD,2021-02-04,65,1110,1,1176,
MAHARASHTRA,RAIGAD,2021-02-05,61,933,2,996,
MAHARASHTRA,RATNAGIRI,2021-02-01,12,469,0,481,
MAHARASHTRA,RATNAGIRI,2021-02-02,31,862,0,893,
MAHARASHTRA,RATNAGIRI,2021-02-03,26,531,0,557,
MAHARASHTRA,RATNAGIRI,2021-02-04,43,976,0,1019,
MAHARASHTRA,RATNAGIRI,2021-02-05,14,780,1,795,
MAHARASHTRA,SANGLI,2021-02-01,22,581,8,611,
MAHARASHTRA,SANGLI,2021-02-02,13,593,10,616,
MAHARASHTRA,SANGLI,2021-02-03,14,722,4,740,
MAHARASHTRA,SANGLI,2021-02-04,21,589,7,617,
MAHARASHTRA,SANGLI,2021-02-05,23,549,0,572,
MAHARASHTRA,SATARA,2021-02-01,41,960,1,1002,
MAHARASHTRA,SATARA,2021-02-02,63,723,0,786,
MAHARASHTRA,SATARA,2021-02-03,63,646,5,714,
MAHARASHTRA,SATARA,2021-02-04,68,822,6,896,
MAHARASHTRA,SATARA,2021-02-05,65,1014,12,1091,
MAHARASHTRA,SINDHUDURG,2021-02-01,11,188,0,199,
MAHARASHTRA,SINDHUDURG,2021-02-02,7,202,0,209,
MAHARASHTRA,SINDHUDURG,2021-02-03,8,314,0,322,
MAHARASHTRA,SINDHUDURG,2021-02-04,5,378,0,383,
MAHARASHTRA,SINDHUDURG,2021-02-05,7,113,0,120,
MAHARASHTRA,SOLAPUR,2021-02-01,48,1497,3,1548,
MAHARASHTRA,SOLAPUR,2021-02-02,57,1462,2,1521,
MAHARASHTRA,SOLAPUR,2021-02-03,61,1269,0,1330,
MAHARASHTRA,SOLAPUR,2021-02-04,63,1520,16,1599,
MAHARASHTRA,SOLAPUR,2021-02-05,47,1262,17,1326,
MAHARASHTRA,THANE,2021-02-01,257,6237,6,6500,
MAHARASHTRA,THANE,2021-02-02,394,7077,8,7479,
MAHARASHTRA,THANE,2021-02-03,300,6595,23,6918,
MAHARASHTRA,THANE,2021-02-04,369,7314,10,7693,
MAHARASHTRA,THANE,2021-02-05,364,7405,7,7776,
MAHARASHTRA,WARDHA,2021-02-01,41,637,8,686,
MAHARASHTRA,WARDHA,2021-02-02,28,423,6,457,
MAHARASHTRA,WARDHA,2021-02-03,42,356,5,403,
MAHARASHTRA,WARDHA,2021-02-04,39,332,8,379,
MAHARASHTRA,WARDHA,2021-02-05,60,344,3,407,
MAHARASHTRA,WASHIM,2021-02-01,17,279,1,297,
MAHARASHTRA,WASHIM,2021-02-02,10,289,3,302,
MAHARASHTRA,WASHIM,2021-02-03,14,245,1,260,
MAHARASHTRA,WASHIM,2021-02-04,24,156,0,180,
MAHARASHTRA,WASHIM,2021-02-05,14,199,0,213,
MAHARASHTRA,YAVATMAL,2021-02-01,38,237,0,275,
MAHARASHTRA,YAVATMAL,2021-02-02,34,322,0,356,
MAHARASHTRA,YAVATMAL,2021-02-03,42,452,1,495,
MAHARASHTRA,YAVATMAL,2021-02-04,54,521,0,575,
MAHARASHTRA,YAVATMAL,2021-02-05,65,376,1,442,
MANIPUR,BISHNUPUR,2021-02-01,0,124,0,124,
MANIPUR,BISHNUPUR,2021-02-02,0,94,0,94,
MANIPUR,BISHNUPUR,2021-02-03,3,103,0,106,
MANIPUR,BISHNUPUR,2021-02-04,1,162,0,163,
MANIPUR,BISHNUPUR,2021-02-05,2,104,0,106,
MANIPUR,CHANDEL,2021-02-01,0,39,0,39,
MANIPUR,CHANDEL,2021-02-02,0,51,0,51,
MANIPUR,CHANDEL,2021-02-03,2,14,0,16,
MANIPUR,CHANDEL,2021-02-04,0,57,0,57,
MANIPUR,CHANDEL,2021-02-05,3,11,0,14,
MANIPUR,CHURACHANDPUR,2021-02-01,0,123,0,123,
MANIPUR,CHURACHANDPUR,2021-02-02,2,64,0,66,
MANIPUR,CHURACHANDPUR,2021-02-03,5,178,0,183,
MANIPUR,CHURACHANDPUR,2021-02-04,2,135,0,137,
MANIPUR,CHURACHANDPUR,2021-02-05,0,96,0,96,
MANIPUR,IMPHAL EAST,2021-02-01,2,182,0,184,
MANIPUR,IMPHAL EAST,2021-02-02,5,278,0,283,
MANIPUR,IMPHAL EAST,2021-02-03,2,212,0,214,
MANIPUR,IMPHAL EAST,2021-02-04,3,312,0,315,
MANIPUR,IMPHAL EAST,2021-02-05,0,154,0,154,
MANIPUR,IMPHAL WEST,2021-02-01,6,664,0,670,
MANIPUR,IMPHAL WEST,2021-02-02,0,715,0,715,
MANIPUR,IMPHAL WEST,2021-02-03,3,601,0,604,
MANIPUR,IMPHAL WEST,2021-02-04,0,372,0,372,
MANIPUR,IMPHAL WEST,2021-02-05,0,471,0,471,
MANIPUR,JIRIBAM,2021-02-01,0,7,0,7,
MANIPUR,JIRIBAM,2021-02-02,0,4,0,4,
MANIPUR,JIRIBAM,2021-02-03,0,9,0,9,
MANIPUR,JIRIBAM,2021-02-04,0,5,0,5,
MANIPUR,JIRIBAM,2021-02-05,0,1,0,1,
MANIPUR,KAKCHING,2021-02-01,0,60,0,60,
MANIPUR,KAKCHING,2021-02-02,1,44,0,45,
MANIPUR,KAKCHING,2021-02-03,0,54,0,54,
MANIPUR,KAKCHING,2021-02-04,1,112,0,113,
MANIPUR,KAKCHING,2021-02-05,2,94,0,96,
MANIPUR,KAMJONG,2021-02-01,0,18,0,18,
MANIPUR,KAMJONG,2021-02-02,0,32,0,32,
MANIPUR,KAMJONG,2021-02-03,0,13,0,13,
MANIPUR,KAMJONG,2021-02-04,0,10,0,10,
MANIPUR,KAMJONG,2021-02-05,0,9,0,9,
MANIPUR,KANGPOKPI,2021-02-01,0,62,0,62,
MANIPUR,KANGPOKPI,2021-02-02,0,26,0,26,
MANIPUR,KANGPOKPI,2021-02-03,0,18,0,18,
MANIPUR,KANGPOKPI,2021-02-04,0,59,0,59,
MANIPUR,KANGPOKPI,2021-02-05,0,50,0,50,
MANIPUR,NONEY,2021-02-01,0,1,0,1,
MANIPUR,NONEY,2021-02-02,0,1,0,1,
MANIPUR,NONEY,2021-02-03,0,3,0,3,
MANIPUR,NONEY,2021-02-04,0,1,0,1,
MANIPUR,NONEY,2021-02-05,0,1,0,1,
MANIPUR,SENAPATI,2021-02-01,0,87,0,87,
MANIPUR,SENAPATI,2021-02-02,1,56,1,58,
MANIPUR,SENAPATI,2021-02-03,1,40,0,41,
MANIPUR,SENAPATI,2021-02-04,0,52,0,52,
MANIPUR,SENAPATI,2021-02-05,0,28,0,28,
MANIPUR,TAMENGLONG,2021-02-01,2,93,0,95,
MANIPUR,TAMENGLONG,2021-02-02,0,93,0,93,
MANIPUR,TAMENGLONG,2021-02-03,0,42,0,42,
MANIPUR,TAMENGLONG,2021-02-04,2,388,0,390,
MANIPUR,TAMENGLONG,2021-02-05,0,50,0,50,
MANIPUR,TENGNOUPAL,2021-02-01,1,3,0,4,
MANIPUR,TENGNOUPAL,2021-02-02,0,7,0,7,
MANIPUR,TENGNOUPAL,2021-02-03,0,9,0,9,
MANIPUR,TENGNOUPAL,2021-02-04,0,6,0,6,
MANIPUR,TENGNOUPAL,2021-02-05,0,3,0,3,
MANIPUR,THOUBAL,2021-02-01,7,133,0,140,
MANIPUR,THOUBAL,2021-02-02,0,152,0,152,
MANIPUR,THOUBAL,2021-02-03,2,175,0,177,
MANIPUR,THOUBAL,2021-02-04,6,162,0,168,
MANIPUR,THOUBAL,2021-02-05,12,175,0,187,
MANIPUR,UKHRUL,2021-02-01,1,121,0,122,
MANIPUR,UKHRUL,2021-02-02,6,186,0,192,
MANIPUR,UKHRUL,2021-02-03,9,152,0,161,
MANIPUR,UKHRUL,2021-02-04,2,191,0,193,
MANIPUR,UKHRUL,2021-02-05,3,74,0,77,
MEGHALAYA,EAST GARO HILLS,2021-02-01,0,41,0,41,
MEGHALAYA,EAST GARO HILLS,2021-02-02,0,24,0,24,
MEGHALAYA,EAST GARO HILLS,2021-02-03,0,11,0,11,
MEGHALAYA,EAST GARO HILLS,2021-02-04,0,23,0,23,
MEGHALAYA,EAST GARO HILLS,2021-02-05,0,19,0,19,
MEGHALAYA,EAST JAINTIA HILLS,2021-02-01,0,146,0,146,
MEGHALAYA,EAST JAINTIA HILLS,2021-02-02,0,56,0,56,
MEGHALAYA,EAST JAINTIA HILLS,2021-02-03,0,121,1,122,
MEGHALAYA,EAST JAINTIA HILLS,2021-02-04,2,56,0,58,
MEGHALAYA,EAST JAINTIA HILLS,2021-02-05,0,36,0,36,
MEGHALAYA,EAST KHASI HILLS,2021-02-01,1,1106,1,1108,
MEGHALAYA,EAST KHASI HILLS,2021-02-02,8,816,1,825,
MEGHALAYA,EAST KHASI HILLS,2021-02-03,23,807,0,830,
MEGHALAYA,EAST KHASI HILLS,2021-02-04,9,611,0,620,
MEGHALAYA,EAST KHASI HILLS,2021-02-05,25,868,1,894,
MEGHALAYA,NORTH GARO HILLS,2021-02-01,0,3,0,3,
MEGHALAYA,NORTH GARO HILLS,2021-02-02,0,18,0,18,
MEGHALAYA,NORTH GARO HILLS,2021-02-03,0,8,0,8,
MEGHALAYA,NORTH GARO HILLS,2021-02-04,0,19,0,19,
MEGHALAYA,NORTH GARO HILLS,2021-02-05,0,10,0,10,
MEGHALAYA,RI BHOI,2021-02-01,0,206,0,206,
MEGHALAYA,RI BHOI,2021-02-02,0,126,0,126,
MEGHALAYA,RI BHOI,2021-02-03,2,93,0,95,
MEGHALAYA,RI BHOI,2021-02-04,14,102,0,116,
MEGHALAYA,RI BHOI,2021-02-05,1,60,0,61,
MEGHALAYA,SOUTH GARO HILLS,2021-02-01,0,39,0,39,
MEGHALAYA,SOUTH GARO HILLS,2021-02-02,0,12,0,12,
MEGHALAYA,SOUTH GARO HILLS,2021-02-03,1,15,0,16,
MEGHALAYA,SOUTH GARO HILLS,2021-02-04,0,10,0,10,
MEGHALAYA,SOUTH GARO HILLS,2021-02-05,0,24,0,24,
MEGHALAYA,SOUTH WEST GARO HILLS,2021-02-01,0,15,0,15,
MEGHALAYA,SOUTH WEST GARO HILLS,2021-02-02,0,22,0,22,
MEGHALAYA,SOUTH WEST GARO HILLS,2021-02-03,0,25,0,25,
MEGHALAYA,SOUTH WEST GARO HILLS,2021-02-04,0,24,0,24,
MEGHALAYA,SOUTH WEST GARO HILLS,2021-02-05,0,24,0,24,
MEGHALAYA,SOUTH WEST KHASI HILLS,2021-02-01,0,3,0,3,
MEGHALAYA,SOUTH WEST KHASI HILLS,2021-02-02,0,2,0,2,
MEGHALAYA,SOUTH WEST KHASI HILLS,2021-02-03,0,16,0,16,
MEGHALAYA,SOUTH WEST KHASI HILLS,2021-02-04,0,5,0,5,
MEGHALAYA,SOUTH WEST KHASI HILLS,2021-02-05,0,13,0,13,
MEGHALAYA,WEST GARO HILLS,2021-02-01,0,98,0,98,
MEGHALAYA,WEST GARO HILLS,2021-02-02,0,68,0,68,
MEGHALAYA,WEST GARO HILLS,2021-02-03,0,70,0,70,
MEGHALAYA,WEST GARO HILLS,2021-02-04,1,119,0,120,
MEGHALAYA,WEST GARO HILLS,2021-02-05,0,95,0,95,
MEGHALAYA,WEST JAINTIA HILLS,2021-02-01,0,58,0,58,
MEGHALAYA,WEST JAINTIA HILLS,2021-02-02,0,66,0,66,
MEGHALAYA,WEST JAINTIA HILLS,2021-02-03,0,35,0,35,
MEGHALAYA,WEST JAINTIA HILLS,2021-02-04,1,46,0,47,
MEGHALAYA,WEST JAINTIA HILLS,2021-02-05,1,68,0,69,
MEGHALAYA,WEST KHASI HILLS,2021-02-01,1,88,0,89,
MEGHALAYA,WEST KHASI HILLS,2021-02-02,0,59,0,59,
MEGHALAYA,WEST KHASI HILLS,2021-02-03,0,79,0,79,
MEGHALAYA,WEST KHASI HILLS,2021-02-04,0,28,0,28,
MEGHALAYA,WEST KHASI HILLS,2021-02-05,0,104,0,104,
MIZORAM,AIZAWL,2021-02-01,2,749,0,751,
MIZORAM,AIZAWL,2021-02-02,1,478,0,479,
MIZORAM,AIZAWL,2021-02-03,2,756,0,758,
MIZORAM,AIZAWL,2021-02-04,4,495,0,499,
MIZORAM,AIZAWL,2021-02-05,0,666,0,666,
MIZORAM,CHAMPHAI,2021-02-01,0,13,0,13,
MIZORAM,CHAMPHAI,2021-02-02,0,6,0,6,
MIZORAM,CHAMPHAI,2021-02-03,0,5,0,5,
MIZORAM,CHAMPHAI,2021-02-04,0,16,0,16,
MIZORAM,CHAMPHAI,2021-02-05,0,7,0,7,
MIZORAM,HNAHTHIAL,2021-02-01,0,25,0,25,
MIZORAM,HNAHTHIAL,2021-02-03,0,3,0,3,
MIZORAM,HNAHTHIAL,2021-02-04,0,8,0,8,
MIZORAM,HNAHTHIAL,2021-02-05,0,6,0,6,
MIZORAM,KHAWZAWL,2021-02-01,0,9,0,9,
MIZORAM,KHAWZAWL,2021-02-02,0,1,0,1,
MIZORAM,KHAWZAWL,2021-02-03,0,4,0,4,
MIZORAM,KHAWZAWL,2021-02-05,0,8,0,8,
MIZORAM,KOLASIB,2021-02-01,0,215,0,215,
MIZORAM,KOLASIB,2021-02-02,0,297,0,297,
MIZORAM,KOLASIB,2021-02-03,0,267,0,267,
MIZORAM,KOLASIB,2021-02-04,0,363,0,363,
MIZORAM,KOLASIB,2021-02-05,0,252,0,252,
MIZORAM,LAWNGTLAI,2021-02-01,0,43,0,43,
MIZORAM,LAWNGTLAI,2021-02-02,1,17,0,18,
MIZORAM,LAWNGTLAI,2021-02-03,0,20,0,20,
MIZORAM,LAWNGTLAI,2021-02-04,0,90,0,90,
MIZORAM,LAWNGTLAI,2021-02-05,0,19,0,19,
MIZORAM,LUNGLEI,2021-02-01,0,48,0,48,
MIZORAM,LUNGLEI,2021-02-02,1,43,0,44,
MIZORAM,LUNGLEI,2021-02-03,0,28,0,28,
MIZORAM,LUNGLEI,2021-02-04,1,112,0,113,
MIZORAM,LUNGLEI,2021-02-05,0,65,0,65,
MIZORAM,MAMIT,2021-02-01,0,56,0,56,
MIZORAM,MAMIT,2021-02-02,0,102,0,102,
MIZORAM,MAMIT,2021-02-03,0,95,0,95,
MIZORAM,MAMIT,2021-02-04,0,68,0,68,
MIZORAM,MAMIT,2021-02-05,0,78,0,78,
MIZORAM,SAIHA,2021-02-01,0,21,0,21,
MIZORAM,SAIHA,2021-02-02,0,21,0,21,
MIZORAM,SAIHA,2021-02-03,0,24,0,24,
MIZORAM,SAIHA,2021-02-04,0,17,0,17,
MIZORAM,SAIHA,2021-02-05,0,7,0,7,
MIZORAM,SAITUAL,2021-02-01,0,16,0,16,
MIZORAM,SAITUAL,2021-02-02,0,16,0,16,
MIZORAM,SAITUAL,2021-02-03,0,2,0,2,
MIZORAM,SAITUAL,2021-02-04,0,3,0,3,
MIZORAM,SAITUAL,2021-02-05,0,3,0,3,
MIZORAM,SERCHHIP,2021-02-01,0,55,0,55,
MIZORAM,SERCHHIP,2021-02-02,0,5,0,5,
MIZORAM,SERCHHIP,2021-02-03,0,29,0,29,
MIZORAM,SERCHHIP,2021-02-04,0,15,0,15,
MIZORAM,SERCHHIP,2021-02-05,0,7,0,7,
NAGALAND,DIMAPUR,2021-02-01,1,72,0,73,
NAGALAND,DIMAPUR,2021-02-02,0,79,0,79,
NAGALAND,DIMAPUR,2021-02-03,2,94,0,96,
NAGALAND,DIMAPUR,2021-02-04,0,67,0,67,
NAGALAND,DIMAPUR,2021-02-05,0,82,0,82,
NAGALAND,KIPHIRE,2021-02-01,0,6,0,6,
NAGALAND,KIPHIRE,2021-02-02,0,4,0,4,
NAGALAND,KIPHIRE,2021-02-03,0,3,0,3,
NAGALAND,KIPHIRE,2021-02-04,0,5,0,5,
NAGALAND,KIPHIRE,2021-02-05,0,1,0,1,
NAGALAND,KOHIMA,2021-02-01,0,55,0,55,
NAGALAND,KOHIMA,2021-02-02,1,9,0,10,
NAGALAND,KOHIMA,2021-02-03,0,9,0,9,
NAGALAND,KOHIMA,2021-02-04,0,6,0,6,
NAGALAND,KOHIMA,2021-02-05,0,9,0,9,
NAGALAND,LONGLENG,2021-02-01,0,2,0,2,
NAGALAND,LONGLENG,2021-02-03,0,2,0,2,
NAGALAND,LONGLENG,2021-02-04,0,4,0,4,
NAGALAND,LONGLENG,2021-02-05,0,2,0,2,
NAGALAND,MOKOKCHUNG,2021-02-01,0,10,0,10,
NAGALAND,MOKOKCHUNG,2021-02-02,3,30,0,33,
NAGALAND,MOKOKCHUNG,2021-02-03,0,9,0,9,
NAGALAND,MOKOKCHUNG,2021-02-04,0,2,0,2,
NAGALAND,MOKOKCHUNG,2021-02-05,10,41,0,51,
NAGALAND,MON,2021-02-03,0,5,0,5,
NAGALAND,MON,2021-02-04,0,1,0,1,
NAGALAND,MON,2021-02-05,0,2,0,2,
NAGALAND,PEREN,2021-02-01,0,3,0,3,
NAGALAND,PEREN,2021-02-02,0,1,0,1,
NAGALAND,PEREN,2021-02-04,0,1,0,1,
NAGALAND,PEREN,2021-02-05,0,2,0,2,
NAGALAND,PHEK,2021-02-02,0,1,0,1,
NAGALAND,PHEK,2021-02-03,0,2,0,2,
NAGALAND,PHEK,2021-02-05,0,3,0,3,
NAGALAND,TUENSANG,2021-02-01,0,1,0,1,
NAGALAND,TUENSANG,2021-02-03,0,3,0,3,
NAGALAND,WOKHA,2021-02-05,0,2,0,2,
NAGALAND,ZUNHEBOTO,2021-02-04,0,1,0,1,
NAGALAND,ZUNHEBOTO,2021-02-05,0,1,0,1,
ODISHA,ANUGUL,2021-02-01,17,401,0,418,
ODISHA,ANUGUL,2021-02-02,3,391,0,394,
ODISHA,ANUGUL,2021-02-03,0,344,0,344,
ODISHA,ANUGUL,2021-02-04,6,458,0,464,
ODISHA,ANUGUL,2021-02-05,11,353,0,364,
ODISHA,BALANGIR,2021-02-01,1,937,1,939,
ODISHA,BALANGIR,2021-02-02,0,1008,0,1008,
ODISHA,BALANGIR,2021-02-03,3,1014,1,1018,
ODISHA,BALANGIR,2021-02-04,0,872,1,873,
ODISHA,BALANGIR,2021-02-05,2,1114,0,1116,
ODISHA,BALESHWAR,2021-02-01,12,3506,1,3519,
ODISHA,BALESHWAR,2021-02-02,7,3162,4,3173,
ODISHA,BALESHWAR,2021-02-03,5,3073,5,3083,
ODISHA,BALESHWAR,2021-02-04,23,3106,2,3131,
ODISHA,BALESHWAR,2021-02-05,5,2966,4,2975,
ODISHA,BARGARH,2021-02-01,7,433,2,442,
ODISHA,BARGARH,2021-02-02,1,410,0,411,
ODISHA,BARGARH,2021-02-03,8,402,0,410,
ODISHA,BARGARH,2021-02-04,6,365,0,371,
ODISHA,BARGARH,2021-02-05,2,463,0,465,
ODISHA,BHADRAK,2021-02-01,0,770,2,772,
ODISHA,BHADRAK,2021-02-02,0,636,2,638,
ODISHA,BHADRAK,2021-02-03,0,547,2,549,
ODISHA,BHADRAK,2021-02-04,0,545,0,545,
ODISHA,BHADRAK,2021-02-05,2,545,0,547,
ODISHA,BOUDH,2021-02-01,0,314,0,314,
ODISHA,BOUDH,2021-02-02,2,260,0,262,
ODISHA,BOUDH,2021-02-03,0,195,0,195,
ODISHA,BOUDH,2021-02-04,0,209,0,209,
ODISHA,BOUDH,2021-02-05,0,262,0,262,
ODISHA,CUTTACK,2021-02-01,7,1368,0,1375,
ODISHA,CUTTACK,2021-02-02,8,1287,0,1295,
ODISHA,CUTTACK,2021-02-03,15,1548,0,1563,
ODISHA,CUTTACK,2021-02-04,3,1259,1,1263,
ODISHA,CUTTACK,2021-02-05,6,1260,0,1266,
ODISHA,DEOGARH,2021-02-01,1,105,0,106,
ODISHA,DEOGARH,2021-02-02,0,114,0,114,
ODISHA,DEOGARH,2021-02-03,0,290,0,290,
ODISHA,DEOGARH,2021-02-04,0,308,0,308,
ODISHA,DEOGARH,2021-02-05,2,135,0,137,
ODISHA,DHENKANAL,2021-02-01,6,223,0,229,
ODISHA,DHENKANAL,2021-02-02,1,373,0,374,
ODISHA,DHENKANAL,2021-02-03,0,498,0,498,
ODISHA,DHENKANAL,2021-02-04,1,321,0,322,
ODISHA,DHENKANAL,2021-02-05,0,389,0,389,
ODISHA,GAJAPATI,2021-02-01,1,282,0,283,
ODISHA,GAJAPATI,2021-02-02,1,343,1,345,
ODISHA,GAJAPATI,2021-02-03,2,146,0,148,
ODISHA,GAJAPATI,2021-02-04,1,460,1,462,
ODISHA,GAJAPATI,2021-02-05,2,334,1,337,
ODISHA,GANJAM,2021-02-01,0,1046,64,1110,
ODISHA,GANJAM,2021-02-02,0,890,37,927,
ODISHA,GANJAM,2021-02-03,0,955,0,955,
ODISHA,GANJAM,2021-02-04,1,898,0,899,
ODISHA,GANJAM,2021-02-05,0,1090,54,1144,
ODISHA,JAGATSINGHAPUR,2021-02-01,3,563,0,566,
ODISHA,JAGATSINGHAPUR,2021-02-02,1,505,0,506,
ODISHA,JAGATSINGHAPUR,2021-02-03,0,673,0,673,
ODISHA,JAGATSINGHAPUR,2021-02-04,1,625,0,626,
ODISHA,JAGATSINGHAPUR,2021-02-05,0,562,1,563,
ODISHA,JAJAPUR,2021-02-01,4,350,0,354,
ODISHA,JAJAPUR,2021-02-02,2,265,0,267,
ODISHA,JAJAPUR,2021-02-03,1,478,0,479,
ODISHA,JAJAPUR,2021-02-04,11,218,0,229,
ODISHA,JAJAPUR,2021-02-05,1,525,0,526,
ODISHA,JHARSUGUDA,2021-02-01,0,375,1,376,
ODISHA,JHARSUGUDA,2021-02-02,0,313,0,313,
ODISHA,JHARSUGUDA,2021-02-03,3,414,0,417,
ODISHA,JHARSUGUDA,2021-02-04,3,295,0,298,
ODISHA,JHARSUGUDA,2021-02-05,0,346,0,346,
ODISHA,KALAHANDI,2021-02-01,0,421,0,421,
ODISHA,KALAHANDI,2021-02-02,1,283,0,284,
ODISHA,KALAHANDI,2021-02-03,1,176,0,177,
ODISHA,KALAHANDI,2021-02-04,2,278,0,280,
ODISHA,KALAHANDI,2021-02-05,1,296,0,297,
ODISHA,KANDHAMAL,2021-02-01,0,601,0,601,
ODISHA,KANDHAMAL,2021-02-02,1,735,0,736,
ODISHA,KANDHAMAL,2021-02-03,0,696,0,696,
ODISHA,KANDHAMAL,2021-02-04,0,539,1,540,
ODISHA,KANDHAMAL,2021-02-05,1,521,0,522,
ODISHA,KENDRAPARA,2021-02-01,1,1162,0,1163,
ODISHA,KENDRAPARA,2021-02-02,0,1049,0,1049,
ODISHA,KENDRAPARA,2021-02-03,0,1129,0,1129,
ODISHA,KENDRAPARA,2021-02-04,2,1069,0,1071,
ODISHA,KENDRAPARA,2021-02-05,0,1014,2,1016,
ODISHA,KENDUJHAR,2021-02-01,2,332,0,334,
ODISHA,KENDUJHAR,2021-02-02,1,311,0,312,
ODISHA,KENDUJHAR,2021-02-03,1,636,0,637,
ODISHA,KENDUJHAR,2021-02-04,1,821,0,822,
ODISHA,KENDUJHAR,2021-02-05,1,793,0,794,
ODISHA,KHORDHA,2021-02-01,10,1404,5,1419,
ODISHA,KHORDHA,2021-02-02,9,1339,1,1349,
ODISHA,KHORDHA,2021-02-03,11,1419,4,1434,
ODISHA,KHORDHA,2021-02-04,10,1407,2,1419,
ODISHA,KHORDHA,2021-02-05,5,1623,3,1631,
ODISHA,KORAPUT,2021-02-01,0,960,0,960,
ODISHA,KORAPUT,2021-02-02,1,929,0,930,
ODISHA,KORAPUT,2021-02-03,1,1214,0,1215,
ODISHA,KORAPUT,2021-02-04,0,1204,0,1204,
ODISHA,KORAPUT,2021-02-05,0,1007,0,1007,
ODISHA,MALKANGIRI,2021-02-01,0,364,0,364,
ODISHA,MALKANGIRI,2021-02-02,0,279,0,279,
ODISHA,MALKANGIRI,2021-02-03,0,281,0,281,
ODISHA,MALKANGIRI,2021-02-04,0,304,0,304,
ODISHA,MALKANGIRI,2021-02-05,0,239,0,239,
ODISHA,MAYURBHANJ,2021-02-01,2,1161,0,1163,
ODISHA,MAYURBHANJ,2021-02-02,0,1183,0,1183,
ODISHA,MAYURBHANJ,2021-02-03,10,1257,0,1267,
ODISHA,MAYURBHANJ,2021-02-04,3,1234,0,1237,
ODISHA,MAYURBHANJ,2021-02-05,5,1487,0,1492,
ODISHA,NABARANGPUR,2021-02-01,0,599,0,599,
ODISHA,NABARANGPUR,2021-02-02,0,537,0,537,
ODISHA,NABARANGPUR,2021-02-03,1,595,0,596,
ODISHA,NABARANGPUR,2021-02-04,0,540,0,540,
ODISHA,NABARANGPUR,2021-02-05,1,670,0,671,
ODISHA,NAYAGARH,2021-02-01,0,791,0,791,
ODISHA,NAYAGARH,2021-02-02,0,1003,0,1003,
ODISHA,NAYAGARH,2021-02-03,0,859,0,859,
ODISHA,NAYAGARH,2021-02-04,0,690,0,690,
ODISHA,NAYAGARH,2021-02-05,0,509,0,509,
ODISHA,NUAPADA,2021-02-01,7,192,1,200,
ODISHA,NUAPADA,2021-02-02,4,173,0,177,
ODISHA,NUAPADA,2021-02-03,0,161,0,161,
ODISHA,NUAPADA,2021-02-04,3,168,0,171,
ODISHA,NUAPADA,2021-02-05,1,157,0,158,
ODISHA,PURI,2021-02-01,2,845,0,847,
ODISHA,PURI,2021-02-02,7,758,2,767,
ODISHA,PURI,2021-02-03,7,725,0,732,
ODISHA,PURI,2021-02-04,1,676,0,677,
ODISHA,PURI,2021-02-05,1,686,0,687,
ODISHA,RAYAGADA,2021-02-01,6,545,0,551,
ODISHA,RAYAGADA,2021-02-02,1,548,0,549,
ODISHA,RAYAGADA,2021-02-03,1,665,0,666,
ODISHA,RAYAGADA,2021-02-04,4,419,1,424,
ODISHA,RAYAGADA,2021-02-05,5,898,0,903,
ODISHA,SAMBALPUR,2021-02-01,3,539,0,542,
ODISHA,SAMBALPUR,2021-02-02,11,449,0,460,
ODISHA,SAMBALPUR,2021-02-03,23,453,1,477,
ODISHA,SAMBALPUR,2021-02-04,14,544,0,558,
ODISHA,SAMBALPUR,2021-02-05,9,479,0,488,
ODISHA,SONEPUR,2021-02-01,0,269,0,269,
ODISHA,SONEPUR,2021-02-02,0,392,1,393,
ODISHA,SONEPUR,2021-02-03,0,258,0,258,
ODISHA,SONEPUR,2021-02-04,0,261,0,261,
ODISHA,SONEPUR,2021-02-05,0,378,0,378,
ODISHA,SUNDARGARH,2021-02-01,5,822,0,827,
ODISHA,SUNDARGARH,2021-02-02,9,665,1,675,
ODISHA,SUNDARGARH,2021-02-03,17,617,0,634,
ODISHA,SUNDARGARH,2021-02-04,38,737,0,775,
ODISHA,SUNDARGARH,2021-02-05,14,1024,0,1038,
PUDUCHERRY,KARAIKAL,2021-02-01,4,349,0,353,
PUDUCHERRY,KARAIKAL,2021-02-02,4,547,0,551,
PUDUCHERRY,KARAIKAL,2021-02-03,12,584,0,596,
PUDUCHERRY,KARAIKAL,2021-02-04,10,478,0,488,
PUDUCHERRY,KARAIKAL,2021-02-05,6,548,0,554,
PUDUCHERRY,MAHE,2021-02-01,12,233,0,245,
PUDUCHERRY,MAHE,2021-02-02,4,405,0,409,
PUDUCHERRY,MAHE,2021-02-03,11,403,0,414,
PUDUCHERRY,MAHE,2021-02-04,16,473,0,489,
PUDUCHERRY,MAHE,2021-02-05,1,350,0,351,
PUDUCHERRY,PONDICHERRY,2021-02-01,20,535,0,555,
PUDUCHERRY,PONDICHERRY,2021-02-02,14,517,4,535,
PUDUCHERRY,PONDICHERRY,2021-02-03,18,546,5,569,
PUDUCHERRY,PONDICHERRY,2021-02-04,27,508,3,538,
PUDUCHERRY,PONDICHERRY,2021-02-05,28,510,1,539,
PUDUCHERRY,YANAM,2021-02-01,0,189,0,189,
PUDUCHERRY,YANAM,2021-02-02,0,239,0,239,
PUDUCHERRY,YANAM,2021-02-03,0,208,0,208,
PUDUCHERRY,YANAM,2021-02-04,0,237,0,237,
PUDUCHERRY,YANAM,2021-02-05,0,106,0,106,
PUNJAB,AMRITSAR,2021-02-01,5,872,1,878,
PUNJAB,AMRITSAR,2021-02-02,30,862,7,899,
PUNJAB,AMRITSAR,2021-02-03,11,1244,1,1256,
PUNJAB,AMRITSAR,2021-02-04,12,1310,1,1323,
PUNJAB,AMRITSAR,2021-02-05,20,788,3,811,
PUNJAB,BARNALA,2021-02-01,3,126,0,129,
PUNJAB,BARNALA,2021-02-02,4,193,1,198,
PUNJAB,BARNALA,2021-02-03,2,318,4,324,
PUNJAB,BARNALA,2021-02-04,1,660,0,661,
PUNJAB,BARNALA,2021-02-05,1,755,2,758,
PUNJAB,BATHINDA,2021-02-01,7,387,7,401,
PUNJAB,BATHINDA,2021-02-02,7,906,5,918,
PUNJAB,BATHINDA,2021-02-03,8,939,12,959,
PUNJAB,BATHINDA,2021-02-04,17,787,5,809,
PUNJAB,BATHINDA,2021-02-05,14,1172,11,1197,
PUNJAB,FARIDKOT,2021-02-01,1,122,0,123,
PUNJAB,FARIDKOT,2021-02-02,3,330,1,334,
PUNJAB,FARIDKOT,2021-02-03,4,94,0,98,
PUNJAB,FARIDKOT,2021-02-04,7,194,1,202,
PUNJAB,FARIDKOT,2021-02-05,1,253,5,259,
PUNJAB,FATEHGARH SAHIB,2021-02-01,2,254,2,258,
PUNJAB,FATEHGARH SAHIB,2021-02-02,12,304,0,316,
PUNJAB,FATEHGARH SAHIB,2021-02-03,2,420,1,423,
PUNJAB,FATEHGARH SAHIB,2021-02-04,8,126,0,134,
PUNJAB,FATEHGARH SAHIB,2021-02-05,5,658,0,663,
PUNJAB,FAZILKA,2021-02-01,1,45,1,47,
PUNJAB,FAZILKA,2021-02-02,1,177,2,180,
PUNJAB,FAZILKA,2021-02-03,0,234,0,234,
PUNJAB,FAZILKA,2021-02-04,1,294,3,298,
PUNJAB,FAZILKA,2021-02-05,0,240,0,240,
PUNJAB,FIROZEPUR,2021-02-01,0,100,0,100,
PUNJAB,FIROZEPUR,2021-02-02,1,282,1,284,
PUNJAB,FIROZEPUR,2021-02-03,0,144,0,144,
PUNJAB,FIROZEPUR,2021-02-04,2,243,1,246,
PUNJAB,FIROZEPUR,2021-02-05,3,316,3,322,
PUNJAB,GURDASPUR,2021-02-01,5,1185,6,1196,
PUNJAB,GURDASPUR,2021-02-02,8,1497,7,1512,
PUNJAB,GURDASPUR,2021-02-03,3,1224,7,1234,
PUNJAB,GURDASPUR,2021-02-04,7,895,2,904,
PUNJAB,GURDASPUR,2021-02-05,8,1708,2,1718,
PUNJAB,HOSHIARPUR,2021-02-01,24,924,10,958,
PUNJAB,HOSHIARPUR,2021-02-02,21,468,2,491,
PUNJAB,HOSHIARPUR,2021-02-03,11,689,0,700,
PUNJAB,HOSHIARPUR,2021-02-04,6,813,1,820,
PUNJAB,HOSHIARPUR,2021-02-05,17,1385,9,1411,
PUNJAB,JALANDHAR,2021-02-01,45,1135,29,1209,
PUNJAB,JALANDHAR,2021-02-02,39,2259,28,2326,
PUNJAB,JALANDHAR,2021-02-03,32,2317,23,2372,
PUNJAB,JALANDHAR,2021-02-04,35,2538,18,2591,
PUNJAB,JALANDHAR,2021-02-05,37,2170,27,2234,
PUNJAB,KAPURTHALA,2021-02-01,6,707,0,713,
PUNJAB,KAPURTHALA,2021-02-02,9,450,1,460,
PUNJAB,KAPURTHALA,2021-02-03,6,982,1,989,
PUNJAB,KAPURTHALA,2021-02-04,8,544,7,559,
PUNJAB,KAPURTHALA,2021-02-05,10,659,1,670,
PUNJAB,LUDHIANA,2021-02-01,42,2005,5,2052,
PUNJAB,LUDHIANA,2021-02-02,42,1384,7,1433,
PUNJAB,LUDHIANA,2021-02-03,33,2665,18,2716,
PUNJAB,LUDHIANA,2021-02-04,63,2198,6,2267,
PUNJAB,LUDHIANA,2021-02-05,31,1589,4,1624,
PUNJAB,MANSA,2021-02-01,0,134,3,137,
PUNJAB,MANSA,2021-02-02,0,291,0,291,
PUNJAB,MANSA,2021-02-03,3,249,0,252,
PUNJAB,MANSA,2021-02-04,2,417,0,419,
PUNJAB,MANSA,2021-02-05,1,315,0,316,
PUNJAB,MOGA,2021-02-01,1,108,2,111,
PUNJAB,MOGA,2021-02-02,3,217,7,227,
PUNJAB,MOGA,2021-02-03,7,166,3,176,
PUNJAB,MOGA,2021-02-04,1,222,4,227,
PUNJAB,MOGA,2021-02-05,2,336,5,343,
PUNJAB,PATHANKOT,2021-02-01,0,337,0,337,
PUNJAB,PATHANKOT,2021-02-02,1,638,0,639,
PUNJAB,PATHANKOT,2021-02-03,2,105,0,107,
PUNJAB,PATHANKOT,2021-02-04,0,782,50,832,
PUNJAB,PATHANKOT,2021-02-05,2,393,2,397,
PUNJAB,PATIALA,2021-02-01,21,731,3,755,
PUNJAB,PATIALA,2021-02-02,19,1033,2,1054,
PUNJAB,PATIALA,2021-02-03,28,1114,3,1145,
PUNJAB,PATIALA,2021-02-04,15,808,0,823,
PUNJAB,PATIALA,2021-02-05,16,1503,1,1520,
PUNJAB,RUPNAGAR,2021-02-01,1,346,4,351,
PUNJAB,RUPNAGAR,2021-02-02,7,456,1,464,
PUNJAB,RUPNAGAR,2021-02-03,7,501,1,509,
PUNJAB,RUPNAGAR,2021-02-04,13,501,0,514,
PUNJAB,RUPNAGAR,2021-02-05,6,421,0,427,
PUNJAB,S.A.S NAGAR,2021-02-01,39,997,17,1053,
PUNJAB,S.A.S NAGAR,2021-02-02,24,1048,13,1085,
PUNJAB,S.A.S NAGAR,2021-02-03,37,1024,6,1067,
PUNJAB,S.A.S NAGAR,2021-02-04,27,1038,2,1067,
PUNJAB,S.A.S NAGAR,2021-02-05,28,938,2,968,
PUNJAB,SANGRUR,2021-02-01,1,821,7,829,
PUNJAB,SANGRUR,2021-02-02,1,1134,3,1138,
PUNJAB,SANGRUR,2021-02-03,3,651,0,654,
PUNJAB,SANGRUR,2021-02-04,3,1084,1,1088,
PUNJAB,SANGRUR,2021-02-05,2,1021,1,1024,
PUNJAB,SHAHID BHAGAT SINGH NAGAR,2021-02-01,6,571,0,577,
PUNJAB,SHAHID BHAGAT SINGH NAGAR,2021-02-02,32,128,0,160,
PUNJAB,SHAHID BHAGAT SINGH NAGAR,2021-02-03,33,754,0,787,
PUNJAB,SHAHID BHAGAT SINGH NAGAR,2021-02-04,17,702,0,719,
PUNJAB,SHAHID BHAGAT SINGH NAGAR,2021-02-05,26,814,0,840,
PUNJAB,SRI MUKTSAR SAHIB,2021-02-01,1,128,0,129,
PUNJAB,SRI MUKTSAR SAHIB,2021-02-02,1,131,0,132,
PUNJAB,SRI MUKTSAR SAHIB,2021-02-03,3,215,2,220,
PUNJAB,SRI MUKTSAR SAHIB,2021-02-04,2,219,1,222,
PUNJAB,SRI MUKTSAR SAHIB,2021-02-05,2,264,0,266,
PUNJAB,TARN TARAN,2021-02-01,0,389,1,390,
PUNJAB,TARN TARAN,2021-02-02,0,213,0,213,
PUNJAB,TARN TARAN,2021-02-03,0,264,0,264,
PUNJAB,TARN TARAN,2021-02-04,2,333,0,335,
PUNJAB,TARN TARAN,2021-02-05,0,205,0,205,
RAJASTHAN,AJMER,2021-02-01,2,60,672,734,
RAJASTHAN,AJMER,2021-02-02,1,66,628,695,
RAJASTHAN,AJMER,2021-02-03,1,62,540,603,
RAJASTHAN,AJMER,2021-02-04,1,48,506,555,
RAJASTHAN,AJMER,2021-02-05,2,51,615,668,
RAJASTHAN,ALWAR,2021-02-01,234,1289,3,1526,
RAJASTHAN,ALWAR,2021-02-02,219,1128,29,1376,
RAJASTHAN,ALWAR,2021-02-03,230,2224,13,2467,
RAJASTHAN,ALWAR,2021-02-04,5,1614,9,1628,
RAJASTHAN,ALWAR,2021-02-05,223,2353,7,2583,
RAJASTHAN,BANSWARA,2021-02-01,1,30,1,32,
RAJASTHAN,BANSWARA,2021-02-02,0,53,1,54,
RAJASTHAN,BANSWARA,2021-02-03,3,107,0,110,
RAJASTHAN,BANSWARA,2021-02-04,0,55,0,55,
RAJASTHAN,BANSWARA,2021-02-05,0,58,0,58,
RAJASTHAN,BARAN,2021-02-01,0,159,0,159,
RAJASTHAN,BARAN,2021-02-02,0,81,0,81,
RAJASTHAN,BARAN,2021-02-03,1,230,0,231,
RAJASTHAN,BARAN,2021-02-04,2,68,0,70,
RAJASTHAN,BARAN,2021-02-05,3,142,0,145,
RAJASTHAN,BARMER,2021-02-01,0,390,1,391,
RAJASTHAN,BARMER,2021-02-02,0,148,0,148,
RAJASTHAN,BARMER,2021-02-03,36,326,0,362,
RAJASTHAN,BARMER,2021-02-04,39,266,1,306,
RAJASTHAN,BARMER,2021-02-05,0,229,0,229,
RAJASTHAN,BHARATPUR,2021-02-01,2,32,4,38,
RAJASTHAN,BHARATPUR,2021-02-02,2,265,3,270,
RAJASTHAN,BHARATPUR,2021-02-03,5,398,1,404,
RAJASTHAN,BHARATPUR,2021-02-04,1,182,5,188,
RAJASTHAN,BHARATPUR,2021-02-05,5,417,4,426,
RAJASTHAN,BHILWARA,2021-02-01,5,276,2,283,
RAJASTHAN,BHILWARA,2021-02-02,15,314,5,334,
RAJASTHAN,BHILWARA,2021-02-03,23,262,2,287,
RAJASTHAN,BHILWARA,2021-02-04,15,320,6,341,
RAJASTHAN,BHILWARA,2021-02-05,12,371,1,384,
RAJASTHAN,BIKANER,2021-02-01,1,944,3,948,
RAJASTHAN,BIKANER,2021-02-02,0,984,0,984,
RAJASTHAN,BIKANER,2021-02-03,4,1740,3,1747,
RAJASTHAN,BIKANER,2021-02-04,5,1730,2,1737,
RAJASTHAN,BIKANER,2021-02-05,5,1892,3,1900,
RAJASTHAN,BUNDI,2021-02-01,0,192,3,195,
RAJASTHAN,BUNDI,2021-02-02,0,287,1,288,
RAJASTHAN,BUNDI,2021-02-03,0,220,1,221,
RAJASTHAN,BUNDI,2021-02-04,4,290,1,295,
RAJASTHAN,BUNDI,2021-02-05,2,188,1,191,
RAJASTHAN,CHITTORGARH,2021-02-01,0,935,13,948,
RAJASTHAN,CHITTORGARH,2021-02-02,0,761,1,762,
RAJASTHAN,CHITTORGARH,2021-02-03,0,565,5,570,
RAJASTHAN,CHITTORGARH,2021-02-04,13,681,9,703,
RAJASTHAN,CHITTORGARH,2021-02-05,0,959,6,965,
RAJASTHAN,CHURU,2021-02-01,0,94,47,141,
RAJASTHAN,CHURU,2021-02-02,1,350,1,352,
RAJASTHAN,CHURU,2021-02-03,1,310,0,311,
RAJASTHAN,CHURU,2021-02-04,1,434,2,437,
RAJASTHAN,CHURU,2021-02-05,0,454,0,454,
RAJASTHAN,DAUSA,2021-02-01,0,194,4,198,
RAJASTHAN,DAUSA,2021-02-02,2,287,15,304,
RAJASTHAN,DAUSA,2021-02-03,2,294,4,300,
RAJASTHAN,DAUSA,2021-02-04,0,294,4,298,
RAJASTHAN,DAUSA,2021-02-05,0,249,7,256,
RAJASTHAN,DHOLPUR,2021-02-01,3,542,0,545,
RAJASTHAN,DHOLPUR,2021-02-02,2,194,4,200,
RAJASTHAN,DHOLPUR,2021-02-03,4,449,15,468,
RAJASTHAN,DHOLPUR,2021-02-04,0,520,29,549,
RAJASTHAN,DHOLPUR,2021-02-05,0,608,8,616,
RAJASTHAN,DUNGARPUR,2021-02-01,0,152,1,153,
RAJASTHAN,DUNGARPUR,2021-02-02,6,134,0,140,
RAJASTHAN,DUNGARPUR,2021-02-03,3,167,0,170,
RAJASTHAN,DUNGARPUR,2021-02-04,1,335,1,337,
RAJASTHAN,DUNGARPUR,2021-02-05,0,402,0,402,
RAJASTHAN,GANGANAGAR,2021-02-01,30,104,8,142,
RAJASTHAN,GANGANAGAR,2021-02-02,32,81,0,113,
RAJASTHAN,GANGANAGAR,2021-02-03,9,110,1,120,
RAJASTHAN,GANGANAGAR,2021-02-04,19,113,0,132,
RAJASTHAN,GANGANAGAR,2021-02-05,13,62,1,76,
RAJASTHAN,HANUMANGARH,2021-02-01,1,80,1,82,
RAJASTHAN,HANUMANGARH,2021-02-02,0,348,1,349,
RAJASTHAN,HANUMANGARH,2021-02-03,0,583,1,584,
RAJASTHAN,HANUMANGARH,2021-02-04,0,784,1,785,
RAJASTHAN,HANUMANGARH,2021-02-05,0,573,1,574,
RAJASTHAN,JAIPUR,2021-02-01,44,2378,251,2673,
RAJASTHAN,JAIPUR,2021-02-02,19,2387,221,2627,
RAJASTHAN,JAIPUR,2021-02-03,37,1840,194,2071,
RAJASTHAN,JAIPUR,2021-02-04,33,2175,312,2520,
RAJASTHAN,JAIPUR,2021-02-05,26,1915,257,2198,
RAJASTHAN,JAISALMER,2021-02-01,32,186,2,220,
RAJASTHAN,JAISALMER,2021-02-02,42,83,2,127,
RAJASTHAN,JAISALMER,2021-02-03,2,138,0,140,
RAJASTHAN,JAISALMER,2021-02-04,2,122,1,125,
RAJASTHAN,JAISALMER,2021-02-05,3,156,1,160,
RAJASTHAN,JALORE,2021-02-01,5,1465,1,1471,
RAJASTHAN,JALORE,2021-02-02,8,1584,2,1594,
RAJASTHAN,JALORE,2021-02-03,3,1105,1,1109,
RAJASTHAN,JALORE,2021-02-04,0,1422,18,1440,
RAJASTHAN,JALORE,2021-02-05,0,935,8,943,
RAJASTHAN,JHALAWAR,2021-02-01,22,182,9,213,
RAJASTHAN,JHALAWAR,2021-02-02,5,309,0,314,
RAJASTHAN,JHALAWAR,2021-02-03,6,165,2,173,
RAJASTHAN,JHALAWAR,2021-02-04,7,384,5,396,
RAJASTHAN,JHALAWAR,2021-02-05,1,393,0,394,
RAJASTHAN,JHUNJHUNU,2021-02-01,0,66,4,70,
RAJASTHAN,JHUNJHUNU,2021-02-02,1,84,8,93,
RAJASTHAN,JHUNJHUNU,2021-02-03,0,71,4,75,
RAJASTHAN,JHUNJHUNU,2021-02-04,0,114,7,121,
RAJASTHAN,JHUNJHUNU,2021-02-05,1,91,3,95,
RAJASTHAN,JODHPUR,2021-02-01,7,608,3,618,
RAJASTHAN,JODHPUR,2021-02-02,17,1090,2,1109,
RAJASTHAN,JODHPUR,2021-02-03,23,1104,5,1132,
RAJASTHAN,JODHPUR,2021-02-04,13,809,3,825,
RAJASTHAN,JODHPUR,2021-02-05,12,830,2,844,
RAJASTHAN,KARAULI,2021-02-01,0,129,2,131,
RAJASTHAN,KARAULI,2021-02-02,1,33,2,36,
RAJASTHAN,KARAULI,2021-02-03,0,21,2,23,
RAJASTHAN,KARAULI,2021-02-04,0,27,4,31,
RAJASTHAN,KARAULI,2021-02-05,1,25,4,30,
RAJASTHAN,KOTA,2021-02-01,0,2088,2,2090,
RAJASTHAN,KOTA,2021-02-02,0,1549,2,1551,
RAJASTHAN,KOTA,2021-02-03,34,1066,1,1101,
RAJASTHAN,KOTA,2021-02-04,142,857,4,1003,
RAJASTHAN,KOTA,2021-02-05,84,1254,2,1340,
RAJASTHAN,NAGAUR,2021-02-01,0,200,261,461,
RAJASTHAN,NAGAUR,2021-02-02,0,69,220,289,
RAJASTHAN,NAGAUR,2021-02-03,7,260,177,444,
RAJASTHAN,NAGAUR,2021-02-04,72,338,361,771,
RAJASTHAN,NAGAUR,2021-02-05,82,234,332,648,
RAJASTHAN,PALI,2021-02-01,0,24,2,26,
RAJASTHAN,PALI,2021-02-02,1,26,0,27,
RAJASTHAN,PALI,2021-02-03,0,16,10,26,
RAJASTHAN,PALI,2021-02-04,1,16,4,21,
RAJASTHAN,PALI,2021-02-05,1,12,3,16,
RAJASTHAN,PRATAPGARH,2021-02-01,12,6,1,19,
RAJASTHAN,PRATAPGARH,2021-02-02,0,8,0,8,
RAJASTHAN,PRATAPGARH,2021-02-03,0,7,0,7,
RAJASTHAN,PRATAPGARH,2021-02-04,1,6,0,7,
RAJASTHAN,PRATAPGARH,2021-02-05,0,1,0,1,
RAJASTHAN,RAJSAMAND,2021-02-01,9,361,0,370,
RAJASTHAN,RAJSAMAND,2021-02-02,5,331,2,338,
RAJASTHAN,RAJSAMAND,2021-02-03,4,337,1,342,
RAJASTHAN,RAJSAMAND,2021-02-04,2,141,1,144,
RAJASTHAN,RAJSAMAND,2021-02-05,9,215,0,224,
RAJASTHAN,SAWAI MADHOPUR,2021-02-01,0,336,14,350,
RAJASTHAN,SAWAI MADHOPUR,2021-02-02,0,31,2,33,
RAJASTHAN,SAWAI MADHOPUR,2021-02-03,0,53,1,54,
RAJASTHAN,SAWAI MADHOPUR,2021-02-04,2,235,19,256,
RAJASTHAN,SAWAI MADHOPUR,2021-02-05,2,330,9,341,
RAJASTHAN,SIKAR,2021-02-01,0,331,9,340,
RAJASTHAN,SIKAR,2021-02-02,2,539,4,545,
RAJASTHAN,SIKAR,2021-02-03,1,364,8,373,
RAJASTHAN,SIKAR,2021-02-04,3,320,12,335,
RAJASTHAN,SIKAR,2021-02-05,1,204,6,211,
RAJASTHAN,SIROHI,2021-02-01,0,115,0,115,
RAJASTHAN,SIROHI,2021-02-02,13,312,0,325,
RAJASTHAN,SIROHI,2021-02-03,4,328,0,332,
RAJASTHAN,SIROHI,2021-02-04,0,270,0,270,
RAJASTHAN,SIROHI,2021-02-05,34,390,0,424,
RAJASTHAN,TONK,2021-02-01,0,155,41,196,
RAJASTHAN,TONK,2021-02-02,0,532,46,578,
RAJASTHAN,TONK,2021-02-03,0,323,40,363,
RAJASTHAN,TONK,2021-02-04,0,283,20,303,
RAJASTHAN,TONK,2021-02-05,1,345,26,372,
RAJASTHAN,UDAIPUR,2021-02-01,29,392,0,421,
RAJASTHAN,UDAIPUR,2021-02-02,39,821,1,861,
RAJASTHAN,UDAIPUR,2021-02-03,50,665,7,722,
RAJASTHAN,UDAIPUR,2021-02-04,26,635,6,667,
RAJASTHAN,UDAIPUR,2021-02-05,30,570,2,602,
SIKKIM,EAST DISTRICT,2021-02-01,2,175,6,183,
SIKKIM,EAST DISTRICT,2021-02-02,4,155,0,159,
SIKKIM,EAST DISTRICT,2021-02-03,6,151,0,157,
SIKKIM,EAST DISTRICT,2021-02-04,1,112,0,113,
SIKKIM,EAST DISTRICT,2021-02-05,2,106,0,108,
SIKKIM,NORTH DISTRICT,2021-02-01,0,3,0,3,
SIKKIM,NORTH DISTRICT,2021-02-02,0,4,0,4,
SIKKIM,NORTH DISTRICT,2021-02-03,0,4,0,4,
SIKKIM,NORTH DISTRICT,2021-02-04,0,4,1,5,
SIKKIM,SOUTH DISTRICT,2021-02-01,1,3,0,4,
SIKKIM,SOUTH DISTRICT,2021-02-02,0,7,0,7,
SIKKIM,SOUTH DISTRICT,2021-02-03,0,40,0,40,
SIKKIM,SOUTH DISTRICT,2021-02-04,0,9,0,9,
SIKKIM,SOUTH DISTRICT,2021-02-05,0,6,0,6,
SIKKIM,WEST DISTRICT,2021-02-01,0,7,0,7,
SIKKIM,WEST DISTRICT,2021-02-02,0,6,0,6,
SIKKIM,WEST DISTRICT,2021-02-03,0,1,0,1,
SIKKIM,WEST DISTRICT,2021-02-04,0,8,0,8,
SIKKIM,WEST DISTRICT,2021-02-05,0,2,0,2,
TAMIL NADU,ARIYALUR,2021-02-01,9,314,0,323,
TAMIL NADU,ARIYALUR,2021-02-02,0,554,0,554,
TAMIL NADU,ARIYALUR,2021-02-03,3,531,0,534,
TAMIL NADU,ARIYALUR,2021-02-04,3,846,0,849,
TAMIL NADU,ARIYALUR,2021-02-05,4,658,0,662,
TAMIL NADU,CHENGALPATTU,2021-02-01,25,2679,2,2706,
TAMIL NADU,CHENGALPATTU,2021-02-02,18,3478,1,3497,
TAMIL NADU,CHENGALPATTU,2021-02-03,28,2189,0,2217,
TAMIL NADU,CHENGALPATTU,2021-02-04,30,3344,1,3375,
TAMIL NADU,CHENGALPATTU,2021-02-05,32,3618,0,3650,
TAMIL NADU,CHENNAI,2021-02-01,149,8169,12,8330,
TAMIL NADU,CHENNAI,2021-02-02,178,9817,4,9999,
TAMIL NADU,CHENNAI,2021-02-03,227,8053,3,8283,
TAMIL NADU,CHENNAI,2021-02-04,186,9937,9,10132,
TAMIL NADU,CHENNAI,2021-02-05,255,11520,17,11792,
TAMIL NADU,COIMBATORE,2021-02-01,51,1554,0,1605,
TAMIL NADU,COIMBATORE,2021-02-02,73,2139,1,2213,
TAMIL NADU,COIMBATORE,2021-02-03,72,2209,0,2281,
TAMIL NADU,COIMBATORE,2021-02-04,58,2597,0,2655,
TAMIL NADU,COIMBATORE,2021-02-05,63,2244,0,2307,
TAMIL NADU,CUDDALORE,2021-02-01,2,1121,1,1124,
TAMIL NADU,CUDDALORE,2021-02-02,4,1700,1,1705,
TAMIL NADU,CUDDALORE,2021-02-03,26,1423,0,1449,
TAMIL NADU,CUDDALORE,2021-02-04,25,2089,0,2114,
TAMIL NADU,CUDDALORE,2021-02-05,2,1686,0,1688,
TAMIL NADU,DHARMAPURI,2021-02-01,4,529,0,533,
TAMIL NADU,DHARMAPURI,2021-02-02,2,811,0,813,
TAMIL NADU,DHARMAPURI,2021-02-03,2,513,0,515,
TAMIL NADU,DHARMAPURI,2021-02-04,7,740,0,747,
TAMIL NADU,DHARMAPURI,2021-02-05,2,945,0,947,
TAMIL NADU,DINDIGUL,2021-02-01,8,113,0,121,
TAMIL NADU,DINDIGUL,2021-02-02,6,157,0,163,
TAMIL NADU,DINDIGUL,2021-02-03,3,169,0,172,
TAMIL NADU,DINDIGUL,2021-02-04,14,152,5,171,
TAMIL NADU,DINDIGUL,2021-02-05,6,272,2,280,
TAMIL NADU,ERODE,2021-02-01,24,755,0,779,
TAMIL NADU,ERODE,2021-02-02,15,1362,0,1377,
TAMIL NADU,ERODE,2021-02-03,21,1611,0,1632,
TAMIL NADU,ERODE,2021-02-04,18,1388,0,1406,
TAMIL NADU,ERODE,2021-02-05,17,1757,0,1774,
TAMIL NADU,KALLAKURICHI,2021-02-01,0,82,0,82,
TAMIL NADU,KALLAKURICHI,2021-02-02,2,396,0,398,
TAMIL NADU,KALLAKURICHI,2021-02-03,1,370,0,371,
TAMIL NADU,KALLAKURICHI,2021-02-04,1,331,0,332,
TAMIL NADU,KALLAKURICHI,2021-02-05,0,409,0,409,
TAMIL NADU,KANCHIPURAM,2021-02-01,13,2635,3,2651,
TAMIL NADU,KANCHIPURAM,2021-02-02,19,2250,0,2269,
TAMIL NADU,KANCHIPURAM,2021-02-03,13,2212,3,2228,
TAMIL NADU,KANCHIPURAM,2021-02-04,14,2458,1,2473,
TAMIL NADU,KANCHIPURAM,2021-02-05,10,2239,1,2250,
TAMIL NADU,KANNIYAKUMARI,2021-02-01,6,1790,5,1801,
TAMIL NADU,KANNIYAKUMARI,2021-02-02,16,1796,4,1816,
TAMIL NADU,KANNIYAKUMARI,2021-02-03,16,1744,7,1767,
TAMIL NADU,KANNIYAKUMARI,2021-02-04,8,1290,2,1300,
TAMIL NADU,KANNIYAKUMARI,2021-02-05,15,1865,4,1884,
TAMIL NADU,KARUR,2021-02-01,5,955,0,960,
TAMIL NADU,KARUR,2021-02-02,6,1133,0,1139,
TAMIL NADU,KARUR,2021-02-03,5,800,1,806,
TAMIL NADU,KARUR,2021-02-04,5,1146,0,1151,
TAMIL NADU,KARUR,2021-02-05,5,1090,1,1096,
TAMIL NADU,KRISHNAGIRI,2021-02-01,3,1012,0,1015,
TAMIL NADU,KRISHNAGIRI,2021-02-02,3,1358,0,1361,
TAMIL NADU,KRISHNAGIRI,2021-02-03,0,1339,0,1339,
TAMIL NADU,KRISHNAGIRI,2021-02-04,4,750,1,755,
TAMIL NADU,KRISHNAGIRI,2021-02-05,2,921,1,924,
TAMIL NADU,MADURAI,2021-02-01,6,3007,1,3014,
TAMIL NADU,MADURAI,2021-02-02,11,3776,1,3788,
TAMIL NADU,MADURAI,2021-02-03,19,2304,0,2323,
TAMIL NADU,MADURAI,2021-02-04,13,3049,1,3063,
TAMIL NADU,MADURAI,2021-02-05,16,2936,0,2952,
TAMIL NADU,NAGAPATTINAM,2021-02-01,6,271,0,277,
TAMIL NADU,NAGAPATTINAM,2021-02-02,11,631,0,642,
TAMIL NADU,NAGAPATTINAM,2021-02-03,2,535,0,537,
TAMIL NADU,NAGAPATTINAM,2021-02-04,9,381,0,390,
TAMIL NADU,NAGAPATTINAM,2021-02-05,11,674,0,685,
TAMIL NADU,NAMAKKAL,2021-02-01,8,1128,0,1136,
TAMIL NADU,NAMAKKAL,2021-02-02,12,934,0,946,
TAMIL NADU,NAMAKKAL,2021-02-03,3,1746,5,1754,
TAMIL NADU,NAMAKKAL,2021-02-04,11,284,0,295,
TAMIL NADU,NAMAKKAL,2021-02-05,4,1043,2,1049,
TAMIL NADU,PERAMBALUR,2021-02-01,1,202,0,203,
TAMIL NADU,PERAMBALUR,2021-02-02,1,264,0,265,
TAMIL NADU,PERAMBALUR,2021-02-03,1,201,0,202,
TAMIL NADU,PERAMBALUR,2021-02-04,0,271,0,271,
TAMIL NADU,PERAMBALUR,2021-02-05,1,224,0,225,
TAMIL NADU,PUDUKKOTTAI,2021-02-01,2,196,0,198,
TAMIL NADU,PUDUKKOTTAI,2021-02-02,2,644,1,647,
TAMIL NADU,PUDUKKOTTAI,2021-02-03,1,757,1,759,
TAMIL NADU,PUDUKKOTTAI,2021-02-04,5,801,1,807,
TAMIL NADU,PUDUKKOTTAI,2021-02-05,1,1078,3,1082,
TAMIL NADU,RAMANATHAPURAM,2021-02-01,2,746,0,748,
TAMIL NADU,RAMANATHAPURAM,2021-02-02,0,872,0,872,
TAMIL NADU,RAMANATHAPURAM,2021-02-03,2,1057,1,1060,
TAMIL NADU,RAMANATHAPURAM,2021-02-04,3,935,1,939,
TAMIL NADU,RAMANATHAPURAM,2021-02-05,3,920,1,924,
TAMIL NADU,RANIPET,2021-02-01,4,173,0,177,
TAMIL NADU,RANIPET,2021-02-02,4,523,0,527,
TAMIL NADU,RANIPET,2021-02-03,8,406,0,414,
TAMIL NADU,RANIPET,2021-02-04,5,492,0,497,
TAMIL NADU,RANIPET,2021-02-05,2,446,0,448,
TAMIL NADU,SALEM,2021-02-01,11,508,0,519,
TAMIL NADU,SALEM,2021-02-02,8,796,0,804,
TAMIL NADU,SALEM,2021-02-03,4,277,0,281,
TAMIL NADU,SALEM,2021-02-04,12,227,0,239,
TAMIL NADU,SALEM,2021-02-05,9,283,1,293,
TAMIL NADU,SIVAGANGA,2021-02-01,3,206,0,209,
TAMIL NADU,SIVAGANGA,2021-02-02,8,585,0,593,
TAMIL NADU,SIVAGANGA,2021-02-03,5,638,0,643,
TAMIL NADU,SIVAGANGA,2021-02-04,0,560,0,560,
TAMIL NADU,SIVAGANGA,2021-02-05,0,479,0,479,
TAMIL NADU,TENKASI,2021-02-01,2,431,0,433,
TAMIL NADU,TENKASI,2021-02-02,4,637,2,643,
TAMIL NADU,TENKASI,2021-02-03,4,556,0,560,
TAMIL NADU,TENKASI,2021-02-04,0,548,0,548,
TAMIL NADU,TENKASI,2021-02-05,6,592,1,599,
TAMIL NADU,THANJAVUR,2021-02-01,13,671,2,686,
TAMIL NADU,THANJAVUR,2021-02-02,34,1039,2,1075,
TAMIL NADU,THANJAVUR,2021-02-03,23,785,3,811,
TAMIL NADU,THANJAVUR,2021-02-04,18,840,0,858,
TAMIL NADU,THANJAVUR,2021-02-05,28,834,1,863,
TAMIL NADU,THE NILGIRIS,2021-02-01,7,884,0,891,
TAMIL NADU,THE NILGIRIS,2021-02-02,8,958,0,966,
TAMIL NADU,THE NILGIRIS,2021-02-03,7,860,0,867,
TAMIL NADU,THE NILGIRIS,2021-02-04,4,907,0,911,
TAMIL NADU,THE NILGIRIS,2021-02-05,12,887,1,900,
TAMIL NADU,THENI,2021-02-01,4,434,0,438,
TAMIL NADU,THENI,2021-02-02,4,278,0,282,
TAMIL NADU,THENI,2021-02-03,3,505,0,508,
TAMIL NADU,THENI,2021-02-04,6,271,0,277,
TAMIL NADU,THENI,2021-02-05,4,485,1,490,
TAMIL NADU,THIRUVALLUR,2021-02-01,23,2799,1,2823,
TAMIL NADU,THIRUVALLUR,2021-02-02,38,1692,1,1731,
TAMIL NADU,THIRUVALLUR,2021-02-03,25,3396,1,3422,
TAMIL NADU,THIRUVALLUR,2021-02-04,29,2107,2,2138,
TAMIL NADU,THIRUVALLUR,2021-02-05,18,1365,3,1386,
TAMIL NADU,THIRUVARUR,2021-02-01,4,738,0,742,
TAMIL NADU,THIRUVARUR,2021-02-02,6,823,0,829,
TAMIL NADU,THIRUVARUR,2021-02-03,12,456,1,469,
TAMIL NADU,THIRUVARUR,2021-02-04,8,1119,0,1127,
TAMIL NADU,THIRUVARUR,2021-02-05,9,1273,0,1282,
TAMIL NADU,TIRUCHIRAPPALLI,2021-02-01,5,1129,2,1136,
TAMIL NADU,TIRUCHIRAPPALLI,2021-02-02,20,1486,4,1510,
TAMIL NADU,TIRUCHIRAPPALLI,2021-02-03,11,1522,0,1533,
TAMIL NADU,TIRUCHIRAPPALLI,2021-02-04,22,1565,1,1588,
TAMIL NADU,TIRUCHIRAPPALLI,2021-02-05,19,1438,0,1457,
TAMIL NADU,TIRUNELVELI,2021-02-01,7,1086,1,1094,
TAMIL NADU,TIRUNELVELI,2021-02-02,12,1229,0,1241,
TAMIL NADU,TIRUNELVELI,2021-02-03,5,1074,1,1080,
TAMIL NADU,TIRUNELVELI,2021-02-04,7,1158,0,1165,
TAMIL NADU,TIRUNELVELI,2021-02-05,11,1059,0,1070,
TAMIL NADU,TIRUPATHUR,2021-02-01,0,2161,4,2165,
TAMIL NADU,TIRUPATHUR,2021-02-02,2,2272,1,2275,
TAMIL NADU,TIRUPATHUR,2021-02-03,3,2236,0,2239,
TAMIL NADU,TIRUPATHUR,2021-02-04,8,2009,1,2018,
TAMIL NADU,TIRUPATHUR,2021-02-05,3,2417,15,2435,
TAMIL NADU,TIRUPPUR,2021-02-01,15,1213,13,1241,
TAMIL NADU,TIRUPPUR,2021-02-02,22,1828,3,1853,
TAMIL NADU,TIRUPPUR,2021-02-03,26,2374,1,2401,
TAMIL NADU,TIRUPPUR,2021-02-04,13,2079,0,2092,
TAMIL NADU,TIRUPPUR,2021-02-05,26,2270,8,2304,
TAMIL NADU,TIRUVANNAMALAI,2021-02-01,3,900,2,905,
TAMIL NADU,TIRUVANNAMALAI,2021-02-02,0,559,0,559,
TAMIL NADU,TIRUVANNAMALAI,2021-02-03,3,720,1,724,
TAMIL NADU,TIRUVANNAMALAI,2021-02-04,18,701,0,719,
TAMIL NADU,TIRUVANNAMALAI,2021-02-05,4,661,0,665,
TAMIL NADU,TUTICORIN,2021-02-01,1,377,1,379,
TAMIL NADU,TUTICORIN,2021-02-02,2,1031,0,1033,
TAMIL NADU,TUTICORIN,2021-02-03,2,891,0,893,
TAMIL NADU,TUTICORIN,2021-02-04,0,980,0,980,
TAMIL NADU,TUTICORIN,2021-02-05,1,983,0,984,
TAMIL NADU,VELLORE,2021-02-01,9,1421,1,1431,
TAMIL NADU,VELLORE,2021-02-02,10,1569,4,1583,
TAMIL NADU,VELLORE,2021-02-03,12,1719,0,1731,
TAMIL NADU,VELLORE,2021-02-04,15,1686,0,1701,
TAMIL NADU,VELLORE,2021-02-05,21,1613,0,1634,
TAMIL NADU,VILLUPURAM,2021-02-01,3,670,0,673,
TAMIL NADU,VILLUPURAM,2021-02-02,3,577,0,580,
TAMIL NADU,VILLUPURAM,2021-02-03,2,836,1,839,
TAMIL NADU,VILLUPURAM,2021-02-04,6,981,1,988,
TAMIL NADU,VILLUPURAM,2021-02-05,5,1001,2,1008,
TAMIL NADU,VIRUDHUNAGAR,2021-02-01,6,1087,1,1094,
TAMIL NADU,VIRUDHUNAGAR,2021-02-02,1,1132,1,1134,
TAMIL NADU,VIRUDHUNAGAR,2021-02-03,0,1145,0,1145,
TAMIL NADU,VIRUDHUNAGAR,2021-02-04,2,998,0,1000,
TAMIL NADU,VIRUDHUNAGAR,2021-02-05,7,326,1,334,
TELANGANA,ADILABAD,2021-02-01,0,355,0,355,
TELANGANA,ADILABAD,2021-02-02,0,345,0,345,
TELANGANA,ADILABAD,2021-02-03,0,358,0,358,
TELANGANA,ADILABAD,2021-02-04,0,332,0,332,
TELANGANA,ADILABAD,2021-02-05,1,291,0,292,
TELANGANA,BHADRADRI KOTHAGUDEM,2021-02-01,0,1342,0,1342,
TELANGANA,BHADRADRI KOTHAGUDEM,2021-02-02,0,1096,0,1096,
TELANGANA,BHADRADRI KOTHAGUDEM,2021-02-03,0,983,0,983,
TELANGANA,BHADRADRI KOTHAGUDEM,2021-02-04,0,884,0,884,
TELANGANA,BHADRADRI KOTHAGUDEM,2021-02-05,0,768,0,768,
TELANGANA,HYDERABAD,2021-02-01,18,6412,3,6433,
TELANGANA,HYDERABAD,2021-02-02,39,8297,3,8339,
TELANGANA,HYDERABAD,2021-02-03,31,7138,2,7171,
TELANGANA,HYDERABAD,2021-02-04,18,7096,1,7115,
TELANGANA,HYDERABAD,2021-02-05,22,6436,4,6462,
TELANGANA,JAGITIAL,2021-02-01,0,956,0,956,
TELANGANA,JAGITIAL,2021-02-02,0,1045,0,1045,
TELANGANA,JAGITIAL,2021-02-03,0,792,0,792,
TELANGANA,JAGITIAL,2021-02-04,0,580,0,580,
TELANGANA,JAGITIAL,2021-02-05,0,538,0,538,
TELANGANA,JANGOAN,2021-02-01,0,614,0,614,
TELANGANA,JANGOAN,2021-02-02,0,611,0,611,
TELANGANA,JANGOAN,2021-02-03,0,604,0,604,
TELANGANA,JANGOAN,2021-02-04,0,557,0,557,
TELANGANA,JANGOAN,2021-02-05,0,533,0,533,
TELANGANA,JAYASHANKAR BHUPALAPALLY,2021-02-01,0,598,0,598,
TELANGANA,JAYASHANKAR BHUPALAPALLY,2021-02-02,0,527,0,527,
TELANGANA,JAYASHANKAR BHUPALAPALLY,2021-02-03,0,454,0,454,
TELANGANA,JAYASHANKAR BHUPALAPALLY,2021-02-04,0,421,0,421,
TELANGANA,JAYASHANKAR BHUPALAPALLY,2021-02-05,0,276,0,276,
TELANGANA,JOGULAMBA GADWAL,2021-02-01,0,872,0,872,
TELANGANA,JOGULAMBA GADWAL,2021-02-02,0,810,0,810,
TELANGANA,JOGULAMBA GADWAL,2021-02-03,0,824,0,824,
TELANGANA,JOGULAMBA GADWAL,2021-02-04,0,691,0,691,
TELANGANA,JOGULAMBA GADWAL,2021-02-05,0,926,0,926,
TELANGANA,KAMAREDDY,2021-02-01,1,725,0,726,
TELANGANA,KAMAREDDY,2021-02-02,0,546,0,546,
TELANGANA,KAMAREDDY,2021-02-03,0,841,0,841,
TELANGANA,KAMAREDDY,2021-02-04,0,809,0,809,
TELANGANA,KAMAREDDY,2021-02-05,0,657,0,657,
TELANGANA,KARIMNAGAR,2021-02-01,1,1379,0,1380,
TELANGANA,KARIMNAGAR,2021-02-02,0,1503,0,1503,
TELANGANA,KARIMNAGAR,2021-02-03,0,1322,0,1322,
TELANGANA,KARIMNAGAR,2021-02-04,0,1206,0,1206,
TELANGANA,KARIMNAGAR,2021-02-05,0,1285,0,1285,
TELANGANA,KHAMMAM,2021-02-01,2,1521,0,1523,
TELANGANA,KHAMMAM,2021-02-02,0,1158,0,1158,
TELANGANA,KHAMMAM,2021-02-03,0,1097,0,1097,
TELANGANA,KHAMMAM,2021-02-04,1,790,0,791,
TELANGANA,KHAMMAM,2021-02-05,0,694,0,694,
TELANGANA,KUMURAM BHEEM ASIFABAD,2021-02-01,0,490,0,490,
TELANGANA,KUMURAM BHEEM ASIFABAD,2021-02-02,0,555,0,555,
TELANGANA,KUMURAM BHEEM ASIFABAD,2021-02-03,0,595,0,595,
TELANGANA,KUMURAM BHEEM ASIFABAD,2021-02-04,0,655,0,655,
TELANGANA,KUMURAM BHEEM ASIFABAD,2021-02-05,0,613,0,613,
TELANGANA,MAHABUBABAD,2021-02-01,0,429,0,429,
TELANGANA,MAHABUBABAD,2021-02-02,0,410,0,410,
TELANGANA,MAHABUBABAD,2021-02-03,0,501,0,501,
TELANGANA,MAHABUBABAD,2021-02-04,0,401,1,402,
TELANGANA,MAHABUBABAD,2021-02-05,0,454,0,454,
TELANGANA,MAHABUBNAGAR,2021-02-01,0,996,0,996,
TELANGANA,MAHABUBNAGAR,2021-02-02,0,961,0,961,
TELANGANA,MAHABUBNAGAR,2021-02-03,0,906,0,906,
TELANGANA,MAHABUBNAGAR,2021-02-04,0,823,0,823,
TELANGANA,MAHABUBNAGAR,2021-02-05,0,629,0,629,
TELANGANA,MANCHERIAL,2021-02-01,0,728,0,728,
TELANGANA,MANCHERIAL,2021-02-02,0,760,0,760,
TELANGANA,MANCHERIAL,2021-02-03,1,823,0,824,
TELANGANA,MANCHERIAL,2021-02-04,0,650,0,650,
TELANGANA,MANCHERIAL,2021-02-05,0,729,0,729,
TELANGANA,MEDAK,2021-02-01,0,509,0,509,
TELANGANA,MEDAK,2021-02-02,0,549,0,549,
TELANGANA,MEDAK,2021-02-03,0,385,0,385,
TELANGANA,MEDAK,2021-02-04,1,367,0,368,
TELANGANA,MEDAK,2021-02-05,0,426,0,426,
TELANGANA,MEDCHAL MALKAJGIRI,2021-02-01,0,1456,0,1456,
TELANGANA,MEDCHAL MALKAJGIRI,2021-02-02,2,1545,1,1548,
TELANGANA,MEDCHAL MALKAJGIRI,2021-02-03,0,1578,0,1578,
TELANGANA,MEDCHAL MALKAJGIRI,2021-02-04,1,1620,0,1621,
TELANGANA,MEDCHAL MALKAJGIRI,2021-02-05,0,1622,0,1622,
TELANGANA,MULUGU,2021-02-01,0,149,0,149,
TELANGANA,MULUGU,2021-02-02,0,211,0,211,
TELANGANA,MULUGU,2021-02-03,0,362,0,362,
TELANGANA,MULUGU,2021-02-04,0,183,0,183,
TELANGANA,MULUGU,2021-02-05,0,137,0,137,
TELANGANA,NAGARKURNOOL,2021-02-01,0,1057,0,1057,
TELANGANA,NAGARKURNOOL,2021-02-02,0,1119,0,1119,
TELANGANA,NAGARKURNOOL,2021-02-03,0,1165,0,1165,
TELANGANA,NAGARKURNOOL,2021-02-04,0,1164,0,1164,
TELANGANA,NAGARKURNOOL,2021-02-05,0,1087,0,1087,
TELANGANA,NALGONDA,2021-02-01,0,1375,0,1375,
TELANGANA,NALGONDA,2021-02-02,1,1383,0,1384,
TELANGANA,NALGONDA,2021-02-03,1,1276,0,1277,
TELANGANA,NALGONDA,2021-02-04,0,1306,0,1306,
TELANGANA,NALGONDA,2021-02-05,0,1287,0,1287,
TELANGANA,NARAYANPET,2021-02-01,0,268,0,268,
TELANGANA,NARAYANPET,2021-02-02,0,291,0,291,
TELANGANA,NARAYANPET,2021-02-03,0,270,0,270,
TELANGANA,NARAYANPET,2021-02-04,0,267,0,267,
TELANGANA,NARAYANPET,2021-02-05,0,215,0,215,
TELANGANA,NIRMAL,2021-02-01,0,707,0,707,
TELANGANA,NIRMAL,2021-02-02,0,682,0,682,
TELANGANA,NIRMAL,2021-02-03,0,479,0,479,
TELANGANA,NIRMAL,2021-02-04,0,524,0,524,
TELANGANA,NIRMAL,2021-02-05,0,362,0,362,
TELANGANA,NIZAMABAD,2021-02-01,0,1074,0,1074,
TELANGANA,NIZAMABAD,2021-02-02,0,1040,0,1040,
TELANGANA,NIZAMABAD,2021-02-03,1,1100,0,1101,
TELANGANA,NIZAMABAD,2021-02-04,0,802,0,802,
TELANGANA,NIZAMABAD,2021-02-05,3,742,0,745,
TELANGANA,PEDDAPALLI,2021-02-01,0,1324,0,1324,
TELANGANA,PEDDAPALLI,2021-02-02,0,1206,0,1206,
TELANGANA,PEDDAPALLI,2021-02-03,0,1145,0,1145,
TELANGANA,PEDDAPALLI,2021-02-04,0,894,0,894,
TELANGANA,PEDDAPALLI,2021-02-05,0,1012,0,1012,
TELANGANA,RAJANNA SIRCILLA,2021-02-01,0,465,0,465,
TELANGANA,RAJANNA SIRCILLA,2021-02-02,0,483,0,483,
TELANGANA,RAJANNA SIRCILLA,2021-02-03,0,458,0,458,
TELANGANA,RAJANNA SIRCILLA,2021-02-04,0,346,0,346,
TELANGANA,RAJANNA SIRCILLA,2021-02-05,0,344,0,344,
TELANGANA,RANGA REDDY,2021-02-01,3,2390,2,2395,
TELANGANA,RANGA REDDY,2021-02-02,2,2659,0,2661,
TELANGANA,RANGA REDDY,2021-02-03,1,2511,0,2512,
TELANGANA,RANGA REDDY,2021-02-04,4,2500,0,2504,
TELANGANA,RANGA REDDY,2021-02-05,0,2094,0,2094,
TELANGANA,SANGAREDDY,2021-02-01,1,1171,0,1172,
TELANGANA,SANGAREDDY,2021-02-02,1,1282,0,1283,
TELANGANA,SANGAREDDY,2021-02-03,0,1073,0,1073,
TELANGANA,SANGAREDDY,2021-02-04,0,1028,0,1028,
TELANGANA,SANGAREDDY,2021-02-05,3,1132,2,1137,
TELANGANA,SIDDIPET,2021-02-01,0,1302,0,1302,
TELANGANA,SIDDIPET,2021-02-02,0,1458,0,1458,
TELANGANA,SIDDIPET,2021-02-03,0,1581,0,1581,
TELANGANA,SIDDIPET,2021-02-04,0,1396,0,1396,
TELANGANA,SIDDIPET,2021-02-05,0,926,0,926,
TELANGANA,SURYAPET,2021-02-01,0,1182,0,1182,
TELANGANA,SURYAPET,2021-02-02,0,1179,0,1179,
TELANGANA,SURYAPET,2021-02-03,0,1133,0,1133,
TELANGANA,SURYAPET,2021-02-04,0,1228,0,1228,
TELANGANA,SURYAPET,2021-02-05,0,1136,0,1136,
TELANGANA,VIKARABAD,2021-02-01,0,599,0,599,
TELANGANA,VIKARABAD,2021-02-02,0,779,0,779,
TELANGANA,VIKARABAD,2021-02-03,0,756,0,756,
TELANGANA,VIKARABAD,2021-02-04,0,673,0,673,
TELANGANA,VIKARABAD,2021-02-05,0,700,0,700,
TELANGANA,WANAPARTHY,2021-02-01,0,605,0,605,
TELANGANA,WANAPARTHY,2021-02-02,0,516,0,516,
TELANGANA,WANAPARTHY,2021-02-03,0,533,0,533,
TELANGANA,WANAPARTHY,2021-02-04,1,534,0,535,
TELANGANA,WANAPARTHY,2021-02-05,0,520,0,520,
TELANGANA,WARANGAL RURAL,2021-02-01,0,799,0,799,
TELANGANA,WARANGAL RURAL,2021-02-02,7,658,0,665,
TELANGANA,WARANGAL RURAL,2021-02-03,2,762,0,764,
TELANGANA,WARANGAL RURAL,2021-02-04,4,528,0,532,
TELANGANA,WARANGAL RURAL,2021-02-05,1,471,0,472,
TELANGANA,WARANGAL URBAN,2021-02-01,0,1858,0,1858,
TELANGANA,WARANGAL URBAN,2021-02-02,0,2086,0,2086,
TELANGANA,WARANGAL URBAN,2021-02-03,0,2896,0,2896,
TELANGANA,WARANGAL URBAN,2021-02-04,0,2735,0,2735,
TELANGANA,WARANGAL URBAN,2021-02-05,1,2314,0,2315,
TELANGANA,YADADRI BHUVANAGIRI,2021-02-01,0,590,0,590,
TELANGANA,YADADRI BHUVANAGIRI,2021-02-02,0,476,0,476,
TELANGANA,YADADRI BHUVANAGIRI,2021-02-03,0,499,0,499,
TELANGANA,YADADRI BHUVANAGIRI,2021-02-04,0,366,0,366,
TELANGANA,YADADRI BHUVANAGIRI,2021-02-05,0,400,0,400,
TRIPURA,DHALAI,2021-02-01,0,17,0,17,
TRIPURA,DHALAI,2021-02-02,0,17,0,17,
TRIPURA,DHALAI,2021-02-03,0,20,0,20,
TRIPURA,DHALAI,2021-02-04,0,19,0,19,
TRIPURA,DHALAI,2021-02-05,0,77,0,77,
TRIPURA,GOMATI,2021-02-01,0,19,0,19,
TRIPURA,GOMATI,2021-02-02,0,32,0,32,
TRIPURA,GOMATI,2021-02-03,0,57,0,57,
TRIPURA,GOMATI,2021-02-04,0,44,0,44,
TRIPURA,GOMATI,2021-02-05,0,47,0,47,
TRIPURA,KHOWAI,2021-02-01,0,22,0,22,
TRIPURA,KHOWAI,2021-02-02,0,25,1,26,
TRIPURA,KHOWAI,2021-02-03,0,33,0,33,
TRIPURA,KHOWAI,2021-02-04,0,16,0,16,
TRIPURA,KHOWAI,2021-02-05,0,19,0,19,
TRIPURA,NORTH TRIPURA,2021-02-01,0,67,0,67,
TRIPURA,NORTH TRIPURA,2021-02-02,1,73,0,74,
TRIPURA,NORTH TRIPURA,2021-02-03,0,68,0,68,
TRIPURA,NORTH TRIPURA,2021-02-04,0,66,0,66,
TRIPURA,NORTH TRIPURA,2021-02-05,0,59,0,59,
TRIPURA,SEPAHIJALA,2021-02-01,0,9,0,9,
TRIPURA,SEPAHIJALA,2021-02-02,0,92,0,92,
TRIPURA,SEPAHIJALA,2021-02-03,0,56,0,56,
TRIPURA,SEPAHIJALA,2021-02-04,0,43,0,43,
TRIPURA,SEPAHIJALA,2021-02-05,0,20,0,20,
TRIPURA,SOUTH TRIPURA,2021-02-01,0,23,0,23,
TRIPURA,SOUTH TRIPURA,2021-02-02,1,95,0,96,
TRIPURA,SOUTH TRIPURA,2021-02-03,0,52,0,52,
TRIPURA,SOUTH TRIPURA,2021-02-04,0,24,0,24,
TRIPURA,SOUTH TRIPURA,2021-02-05,1,63,0,64,
TRIPURA,UNAKOTI,2021-02-01,0,8,0,8,
TRIPURA,UNAKOTI,2021-02-02,0,18,0,18,
TRIPURA,UNAKOTI,2021-02-03,0,10,0,10,
TRIPURA,UNAKOTI,2021-02-04,0,5,0,5,
TRIPURA,UNAKOTI,2021-02-05,0,4,0,4,
TRIPURA,WEST TRIPURA,2021-02-01,1,72,0,73,
TRIPURA,WEST TRIPURA,2021-02-02,0,230,0,230,
TRIPURA,WEST TRIPURA,2021-02-03,1,196,0,197,
TRIPURA,WEST TRIPURA,2021-02-04,0,235,0,235,
TRIPURA,WEST TRIPURA,2021-02-05,1,185,0,186,
UTTAR PRADESH,AGRA,2021-02-01,7,1813,1,1821,
UTTAR PRADESH,AGRA,2021-02-02,4,2460,1,2465,
UTTAR PRADESH,AGRA,2021-02-03,8,2482,1,2491,
UTTAR PRADESH,AGRA,2021-02-04,7,1736,1,1744,
UTTAR PRADESH,AGRA,2021-02-05,2,2354,2,2358,
UTTAR PRADESH,ALIGARH,2021-02-01,3,2790,2,2795,
UTTAR PRADESH,ALIGARH,2021-02-02,5,2522,3,2530,
UTTAR PRADESH,ALIGARH,2021-02-03,4,2449,11,2464,
UTTAR PRADESH,ALIGARH,2021-02-04,5,2733,7,2745,
UTTAR PRADESH,ALIGARH,2021-02-05,1,2981,3,2985,
UTTAR PRADESH,AMBEDKAR NAGAR,2021-02-01,0,616,14,630,
UTTAR PRADESH,AMBEDKAR NAGAR,2021-02-02,0,1256,15,1271,
UTTAR PRADESH,AMBEDKAR NAGAR,2021-02-03,3,1521,17,1541,
UTTAR PRADESH,AMBEDKAR NAGAR,2021-02-04,0,1249,27,1276,
UTTAR PRADESH,AMBEDKAR NAGAR,2021-02-05,1,1104,5,1110,
UTTAR PRADESH,AMETHI,2021-02-01,1,884,0,885,
UTTAR PRADESH,AMETHI,2021-02-02,0,1201,21,1222,
UTTAR PRADESH,AMETHI,2021-02-03,1,1613,0,1614,
UTTAR PRADESH,AMETHI,2021-02-04,1,644,61,706,
UTTAR PRADESH,AMETHI,2021-02-05,0,1003,1,1004,
UTTAR PRADESH,AMROHA,2021-02-01,4,1004,0,1008,
UTTAR PRADESH,AMROHA,2021-02-02,0,897,1,898,
UTTAR PRADESH,AMROHA,2021-02-03,1,931,0,932,
UTTAR PRADESH,AMROHA,2021-02-04,3,1066,0,1069,
UTTAR PRADESH,AMROHA,2021-02-05,2,1672,0,1674,
UTTAR PRADESH,AURAIYA,2021-02-01,0,874,46,920,
UTTAR PRADESH,AURAIYA,2021-02-02,6,933,63,1002,
UTTAR PRADESH,AURAIYA,2021-02-03,3,871,30,904,
UTTAR PRADESH,AURAIYA,2021-02-04,1,838,10,849,
UTTAR PRADESH,AURAIYA,2021-02-05,27,595,5,627,
UTTAR PRADESH,AYODHYA,2021-02-01,5,1236,2,1243,
UTTAR PRADESH,AYODHYA,2021-02-02,2,1551,0,1553,
UTTAR PRADESH,AYODHYA,2021-02-03,5,1782,0,1787,
UTTAR PRADESH,AYODHYA,2021-02-04,0,1283,1,1284,
UTTAR PRADESH,AYODHYA,2021-02-05,8,1517,2,1527,
UTTAR PRADESH,AZAMGARH,2021-02-01,1,695,1,697,
UTTAR PRADESH,AZAMGARH,2021-02-02,10,498,5,513,
UTTAR PRADESH,AZAMGARH,2021-02-03,1,1425,4,1430,
UTTAR PRADESH,AZAMGARH,2021-02-04,0,620,0,620,
UTTAR PRADESH,AZAMGARH,2021-02-05,6,699,2,707,
UTTAR PRADESH,BAGHPAT,2021-02-01,1,1479,20,1500,
UTTAR PRADESH,BAGHPAT,2021-02-02,1,497,17,515,
UTTAR PRADESH,BAGHPAT,2021-02-03,0,1335,53,1388,
UTTAR PRADESH,BAGHPAT,2021-02-04,0,1815,18,1833,
UTTAR PRADESH,BAGHPAT,2021-02-05,1,1419,50,1470,
UTTAR PRADESH,BAHRAICH,2021-02-01,1,1547,14,1562,
UTTAR PRADESH,BAHRAICH,2021-02-02,3,1875,0,1878,
UTTAR PRADESH,BAHRAICH,2021-02-03,0,1775,0,1775,
UTTAR PRADESH,BAHRAICH,2021-02-04,2,1781,10,1793,
UTTAR PRADESH,BAHRAICH,2021-02-05,1,1705,1,1707,
UTTAR PRADESH,BALLIA,2021-02-01,2,428,1,431,
UTTAR PRADESH,BALLIA,2021-02-02,2,465,4,471,
UTTAR PRADESH,BALLIA,2021-02-03,2,839,2,843,
UTTAR PRADESH,BALLIA,2021-02-04,0,772,1,773,
UTTAR PRADESH,BALLIA,2021-02-05,0,1010,0,1010,
UTTAR PRADESH,BALRAMPUR,2021-02-01,0,1062,0,1062,
UTTAR PRADESH,BALRAMPUR,2021-02-02,1,1374,0,1375,
UTTAR PRADESH,BALRAMPUR,2021-02-03,0,1197,13,1210,
UTTAR PRADESH,BALRAMPUR,2021-02-04,0,952,0,952,
UTTAR PRADESH,BALRAMPUR,2021-02-05,2,1063,0,1065,
UTTAR PRADESH,BANDA,2021-02-01,3,2172,1,2176,
UTTAR PRADESH,BANDA,2021-02-02,2,1751,6,1759,
UTTAR PRADESH,BANDA,2021-02-03,1,1867,21,1889,
UTTAR PRADESH,BANDA,2021-02-04,4,1844,32,1880,
UTTAR PRADESH,BANDA,2021-02-05,0,1868,0,1868,
UTTAR PRADESH,BARABANKI,2021-02-01,1,1044,0,1045,
UTTAR PRADESH,BARABANKI,2021-02-02,0,1363,0,1363,
UTTAR PRADESH,BARABANKI,2021-02-03,4,1256,1,1261,
UTTAR PRADESH,BARABANKI,2021-02-04,0,1405,1,1406,
UTTAR PRADESH,BARABANKI,2021-02-05,3,1410,1,1414,
UTTAR PRADESH,BAREILLY,2021-02-01,5,2196,14,2215,
UTTAR PRADESH,BAREILLY,2021-02-02,11,2708,3,2722,
UTTAR PRADESH,BAREILLY,2021-02-03,13,2031,8,2052,
UTTAR PRADESH,BAREILLY,2021-02-04,8,2385,4,2397,
UTTAR PRADESH,BAREILLY,2021-02-05,3,2957,0,2960,
UTTAR PRADESH,BASTI,2021-02-01,0,834,10,844,
UTTAR PRADESH,BASTI,2021-02-02,3,870,45,918,
UTTAR PRADESH,BASTI,2021-02-03,16,1137,45,1198,
UTTAR PRADESH,BASTI,2021-02-04,11,1040,18,1069,
UTTAR PRADESH,BASTI,2021-02-05,6,1048,91,1145,
UTTAR PRADESH,BHADOHI,2021-02-01,1,1534,0,1535,
UTTAR PRADESH,BHADOHI,2021-02-02,1,1507,1,1509,
UTTAR PRADESH,BHADOHI,2021-02-03,0,1502,0,1502,
UTTAR PRADESH,BHADOHI,2021-02-04,4,1487,0,1491,
UTTAR PRADESH,BHADOHI,2021-02-05,2,1524,0,1526,
UTTAR PRADESH,BIJNOR,2021-02-01,4,1315,1,1320,
UTTAR PRADESH,BIJNOR,2021-02-02,2,1510,1,1513,
UTTAR PRADESH,BIJNOR,2021-02-03,3,812,0,815,
UTTAR PRADESH,BIJNOR,2021-02-04,3,2466,0,2469,
UTTAR PRADESH,BIJNOR,2021-02-05,0,1427,0,1427,
UTTAR PRADESH,BUDAUN,2021-02-01,4,1657,26,1687,
UTTAR PRADESH,BUDAUN,2021-02-02,1,1003,17,1021,
UTTAR PRADESH,BUDAUN,2021-02-03,1,1953,9,1963,
UTTAR PRADESH,BUDAUN,2021-02-04,0,3012,84,3096,
UTTAR PRADESH,BUDAUN,2021-02-05,0,1435,44,1479,
UTTAR PRADESH,BULANDSHAHR,2021-02-01,3,1428,0,1431,
UTTAR PRADESH,BULANDSHAHR,2021-02-02,1,1937,3,1941,
UTTAR PRADESH,BULANDSHAHR,2021-02-03,2,1599,9,1610,
UTTAR PRADESH,BULANDSHAHR,2021-02-04,0,1313,33,1346,
UTTAR PRADESH,BULANDSHAHR,2021-02-05,1,1723,39,1763,
UTTAR PRADESH,CHANDAULI,2021-02-01,2,909,74,985,
UTTAR PRADESH,CHANDAULI,2021-02-02,7,1284,13,1304,
UTTAR PRADESH,CHANDAULI,2021-02-03,0,1507,3,1510,
UTTAR PRADESH,CHANDAULI,2021-02-04,1,1221,3,1225,
UTTAR PRADESH,CHANDAULI,2021-02-05,0,1318,20,1338,
UTTAR PRADESH,CHITRAKOOT,2021-02-01,0,767,1,768,
UTTAR PRADESH,CHITRAKOOT,2021-02-02,0,965,0,965,
UTTAR PRADESH,CHITRAKOOT,2021-02-03,0,1228,5,1233,
UTTAR PRADESH,CHITRAKOOT,2021-02-04,1,1005,20,1026,
UTTAR PRADESH,CHITRAKOOT,2021-02-05,0,1498,0,1498,
UTTAR PRADESH,DEORIA,2021-02-01,1,1013,65,1079,
UTTAR PRADESH,DEORIA,2021-02-02,1,144,10,155,
UTTAR PRADESH,DEORIA,2021-02-03,2,523,44,569,
UTTAR PRADESH,DEORIA,2021-02-04,0,540,58,598,
UTTAR PRADESH,DEORIA,2021-02-05,0,820,43,863,
UTTAR PRADESH,ETAH,2021-02-01,0,655,1,656,
UTTAR PRADESH,ETAH,2021-02-02,0,667,39,706,
UTTAR PRADESH,ETAH,2021-02-03,4,1170,7,1181,
UTTAR PRADESH,ETAH,2021-02-04,0,2078,7,2085,
UTTAR PRADESH,ETAH,2021-02-05,1,871,2,874,
UTTAR PRADESH,ETAWAH,2021-02-01,1,402,51,454,
UTTAR PRADESH,ETAWAH,2021-02-02,3,2590,62,2655,
UTTAR PRADESH,ETAWAH,2021-02-03,0,755,106,861,
UTTAR PRADESH,ETAWAH,2021-02-04,0,1700,121,1821,
UTTAR PRADESH,ETAWAH,2021-02-05,0,2279,69,2348,
UTTAR PRADESH,FARRUKHABAD,2021-02-01,3,1152,50,1205,
UTTAR PRADESH,FARRUKHABAD,2021-02-02,0,670,64,734,
UTTAR PRADESH,FARRUKHABAD,2021-02-03,0,720,76,796,
UTTAR PRADESH,FARRUKHABAD,2021-02-04,0,598,20,618,
UTTAR PRADESH,FARRUKHABAD,2021-02-05,1,953,11,965,
UTTAR PRADESH,FATEHPUR,2021-02-01,0,619,53,672,
UTTAR PRADESH,FATEHPUR,2021-02-02,2,1376,157,1535,
UTTAR PRADESH,FATEHPUR,2021-02-03,1,1248,72,1321,
UTTAR PRADESH,FATEHPUR,2021-02-04,0,928,79,1007,
UTTAR PRADESH,FATEHPUR,2021-02-05,1,2096,36,2133,
UTTAR PRADESH,FIROZABAD,2021-02-01,3,1562,10,1575,
UTTAR PRADESH,FIROZABAD,2021-02-02,0,4213,5,4218,
UTTAR PRADESH,FIROZABAD,2021-02-03,0,2484,12,2496,
UTTAR PRADESH,FIROZABAD,2021-02-04,2,1805,3,1810,
UTTAR PRADESH,FIROZABAD,2021-02-05,1,2451,0,2452,
UTTAR PRADESH,GAUTAM BUDDHA NAGAR,2021-02-01,15,1914,80,2009,
UTTAR PRADESH,GAUTAM BUDDHA NAGAR,2021-02-02,16,2484,17,2517,
UTTAR PRADESH,GAUTAM BUDDHA NAGAR,2021-02-03,33,2538,25,2596,
UTTAR PRADESH,GAUTAM BUDDHA NAGAR,2021-02-04,16,2549,27,2592,
UTTAR PRADESH,GAUTAM BUDDHA NAGAR,2021-02-05,24,2554,135,2713,
UTTAR PRADESH,GHAZIABAD,2021-02-01,15,1730,11,1756,
UTTAR PRADESH,GHAZIABAD,2021-02-02,23,3341,114,3478,
UTTAR PRADESH,GHAZIABAD,2021-02-03,29,2491,5,2525,
UTTAR PRADESH,GHAZIABAD,2021-02-04,27,2407,45,2479,
UTTAR PRADESH,GHAZIABAD,2021-02-05,13,2675,4,2692,
UTTAR PRADESH,GHAZIPUR,2021-02-01,3,373,1,377,
UTTAR PRADESH,GHAZIPUR,2021-02-02,1,1137,0,1138,
UTTAR PRADESH,GHAZIPUR,2021-02-03,2,1015,20,1037,
UTTAR PRADESH,GHAZIPUR,2021-02-04,1,824,17,842,
UTTAR PRADESH,GHAZIPUR,2021-02-05,5,535,10,550,
UTTAR PRADESH,GONDA,2021-02-01,1,1214,2,1217,
UTTAR PRADESH,GONDA,2021-02-02,1,1190,3,1194,
UTTAR PRADESH,GONDA,2021-02-03,2,1801,3,1806,
UTTAR PRADESH,GONDA,2021-02-04,0,1624,0,1624,
UTTAR PRADESH,GONDA,2021-02-05,0,1344,0,1344,
UTTAR PRADESH,GORAKHPUR,2021-02-01,7,1184,21,1212,
UTTAR PRADESH,GORAKHPUR,2021-02-02,10,2300,24,2334,
UTTAR PRADESH,GORAKHPUR,2021-02-03,9,2972,83,3064,
UTTAR PRADESH,GORAKHPUR,2021-02-04,7,2570,21,2598,
UTTAR PRADESH,GORAKHPUR,2021-02-05,5,2879,121,3005,
UTTAR PRADESH,HAMIRPUR,2021-02-01,3,938,4,945,
UTTAR PRADESH,HAMIRPUR,2021-02-02,0,958,2,960,
UTTAR PRADESH,HAMIRPUR,2021-02-03,1,829,1,831,
UTTAR PRADESH,HAMIRPUR,2021-02-04,2,888,0,890,
UTTAR PRADESH,HAMIRPUR,2021-02-05,0,1469,3,1472,
UTTAR PRADESH,HAPUR,2021-02-01,3,1325,49,1377,
UTTAR PRADESH,HAPUR,2021-02-02,0,1020,55,1075,
UTTAR PRADESH,HAPUR,2021-02-03,0,2139,20,2159,
UTTAR PRADESH,HAPUR,2021-02-04,4,945,62,1011,
UTTAR PRADESH,HAPUR,2021-02-05,6,482,85,573,
UTTAR PRADESH,HARDOI,2021-02-01,3,1431,5,1439,
UTTAR PRADESH,HARDOI,2021-02-02,2,1525,0,1527,
UTTAR PRADESH,HARDOI,2021-02-03,3,1554,26,1583,
UTTAR PRADESH,HARDOI,2021-02-04,1,1465,66,1532,
UTTAR PRADESH,HARDOI,2021-02-05,5,1517,1,1523,
UTTAR PRADESH,HATHRAS,2021-02-01,0,755,0,755,
UTTAR PRADESH,HATHRAS,2021-02-02,1,1518,0,1519,
UTTAR PRADESH,HATHRAS,2021-02-03,0,940,1,941,
UTTAR PRADESH,HATHRAS,2021-02-04,0,960,33,993,
UTTAR PRADESH,HATHRAS,2021-02-05,0,1388,0,1388,
UTTAR PRADESH,JALAUN,2021-02-01,4,1153,1,1158,
UTTAR PRADESH,JALAUN,2021-02-02,1,1526,4,1531,
UTTAR PRADESH,JALAUN,2021-02-03,3,1242,0,1245,
UTTAR PRADESH,JALAUN,2021-02-04,3,1303,0,1306,
UTTAR PRADESH,JALAUN,2021-02-05,1,1245,1,1247,
UTTAR PRADESH,JAUNPUR,2021-02-01,2,1267,1,1270,
UTTAR PRADESH,JAUNPUR,2021-02-02,1,629,1,631,
UTTAR PRADESH,JAUNPUR,2021-02-03,0,2270,2,2272,
UTTAR PRADESH,JAUNPUR,2021-02-04,2,541,1,544,
UTTAR PRADESH,JAUNPUR,2021-02-05,4,2331,1,2336,
UTTAR PRADESH,JHANSI,2021-02-01,1,2184,11,2196,
UTTAR PRADESH,JHANSI,2021-02-02,2,2881,5,2888,
UTTAR PRADESH,JHANSI,2021-02-03,1,2806,2,2809,
UTTAR PRADESH,JHANSI,2021-02-04,2,2341,0,2343,
UTTAR PRADESH,JHANSI,2021-02-05,1,2672,1,2674,
UTTAR PRADESH,KANNAUJ,2021-02-01,0,1481,1,1482,
UTTAR PRADESH,KANNAUJ,2021-02-02,0,1583,1,1584,
UTTAR PRADESH,KANNAUJ,2021-02-03,0,1618,1,1619,
UTTAR PRADESH,KANNAUJ,2021-02-04,1,1378,0,1379,
UTTAR PRADESH,KANNAUJ,2021-02-05,0,1533,1,1534,
UTTAR PRADESH,KANPUR DEHAT,2021-02-01,0,850,2,852,
UTTAR PRADESH,KANPUR DEHAT,2021-02-02,1,1487,3,1491,
UTTAR PRADESH,KANPUR DEHAT,2021-02-03,3,1263,5,1271,
UTTAR PRADESH,KANPUR DEHAT,2021-02-04,1,1145,2,1148,
UTTAR PRADESH,KANPUR DEHAT,2021-02-05,2,972,2,976,
UTTAR PRADESH,KANPUR NAGAR,2021-02-01,9,2002,23,2034,
UTTAR PRADESH,KANPUR NAGAR,2021-02-02,6,2721,10,2737,
UTTAR PRADESH,KANPUR NAGAR,2021-02-03,12,2533,5,2550,
UTTAR PRADESH,KANPUR NAGAR,2021-02-04,6,2517,21,2544,
UTTAR PRADESH,KANPUR NAGAR,2021-02-05,5,2392,8,2405,
UTTAR PRADESH,KASGANJ,2021-02-01,0,1258,6,1264,
UTTAR PRADESH,KASGANJ,2021-02-02,0,164,6,170,
UTTAR PRADESH,KASGANJ,2021-02-03,0,1899,6,1905,
UTTAR PRADESH,KASGANJ,2021-02-04,0,1129,12,1141,
UTTAR PRADESH,KASGANJ,2021-02-05,0,855,16,871,
UTTAR PRADESH,KAUSHAMBI,2021-02-01,0,1252,1,1253,
UTTAR PRADESH,KAUSHAMBI,2021-02-02,0,1470,0,1470,
UTTAR PRADESH,KAUSHAMBI,2021-02-03,0,1117,1,1118,
UTTAR PRADESH,KAUSHAMBI,2021-02-04,0,1045,25,1070,
UTTAR PRADESH,KAUSHAMBI,2021-02-05,1,1051,42,1094,
UTTAR PRADESH,KHERI,2021-02-01,0,1643,25,1668,
UTTAR PRADESH,KHERI,2021-02-02,0,1226,26,1252,
UTTAR PRADESH,KHERI,2021-02-03,1,1289,18,1308,
UTTAR PRADESH,KHERI,2021-02-04,0,1445,0,1445,
UTTAR PRADESH,KHERI,2021-02-05,1,1812,0,1813,
UTTAR PRADESH,KUSHI NAGAR,2021-02-01,0,1269,37,1306,
UTTAR PRADESH,KUSHI NAGAR,2021-02-02,0,889,60,949,
UTTAR PRADESH,KUSHI NAGAR,2021-02-03,0,1300,8,1308,
UTTAR PRADESH,KUSHI NAGAR,2021-02-04,1,758,12,771,
UTTAR PRADESH,KUSHI NAGAR,2021-02-05,1,971,17,989,
UTTAR PRADESH,LALITPUR,2021-02-01,2,1237,0,1239,
UTTAR PRADESH,LALITPUR,2021-02-02,4,1663,2,1669,
UTTAR PRADESH,LALITPUR,2021-02-03,1,886,0,887,
UTTAR PRADESH,LALITPUR,2021-02-04,2,1507,8,1517,
UTTAR PRADESH,LALITPUR,2021-02-05,2,1030,0,1032,
UTTAR PRADESH,LUCKNOW,2021-02-01,24,5102,143,5269,
UTTAR PRADESH,LUCKNOW,2021-02-02,31,6276,122,6429,
UTTAR PRADESH,LUCKNOW,2021-02-03,35,6426,13,6474,
UTTAR PRADESH,LUCKNOW,2021-02-04,25,6004,159,6188,
UTTAR PRADESH,LUCKNOW,2021-02-05,35,6704,132,6871,
UTTAR PRADESH,MAHARAJGANJ,2021-02-01,0,548,42,590,
UTTAR PRADESH,MAHARAJGANJ,2021-02-02,1,942,41,984,
UTTAR PRADESH,MAHARAJGANJ,2021-02-03,3,1138,185,1326,
UTTAR PRADESH,MAHARAJGANJ,2021-02-04,3,699,65,767,
UTTAR PRADESH,MAHARAJGANJ,2021-02-05,0,610,91,701,
UTTAR PRADESH,MAHOBA,2021-02-01,1,623,5,629,
UTTAR PRADESH,MAHOBA,2021-02-02,0,625,79,704,
UTTAR PRADESH,MAHOBA,2021-02-03,0,591,15,606,
UTTAR PRADESH,MAHOBA,2021-02-04,1,570,15,586,
UTTAR PRADESH,MAHOBA,2021-02-05,1,580,56,637,
UTTAR PRADESH,MAINPURI,2021-02-01,0,1562,1,1563,
UTTAR PRADESH,MAINPURI,2021-02-02,1,1727,4,1732,
UTTAR PRADESH,MAINPURI,2021-02-03,1,1705,2,1708,
UTTAR PRADESH,MAINPURI,2021-02-04,4,1541,0,1545,
UTTAR PRADESH,MAINPURI,2021-02-05,8,1510,1,1519,
UTTAR PRADESH,MATHURA,2021-02-01,6,1140,7,1153,
UTTAR PRADESH,MATHURA,2021-02-02,5,596,0,601,
UTTAR PRADESH,MATHURA,2021-02-03,3,2792,9,2804,
UTTAR PRADESH,MATHURA,2021-02-04,2,2084,1,2087,
UTTAR PRADESH,MATHURA,2021-02-05,1,1354,2,1357,
UTTAR PRADESH,MAU,2021-02-01,0,1057,2,1059,
UTTAR PRADESH,MAU,2021-02-02,2,1805,3,1810,
UTTAR PRADESH,MAU,2021-02-03,1,811,2,814,
UTTAR PRADESH,MAU,2021-02-04,1,1175,2,1178,
UTTAR PRADESH,MAU,2021-02-05,0,584,10,594,
UTTAR PRADESH,MEERUT,2021-02-01,11,4456,8,4475,
UTTAR PRADESH,MEERUT,2021-02-02,12,3177,6,3195,
UTTAR PRADESH,MEERUT,2021-02-03,8,3462,10,3480,
UTTAR PRADESH,MEERUT,2021-02-04,7,3847,4,3858,
UTTAR PRADESH,MEERUT,2021-02-05,4,3877,1,3882,
UTTAR PRADESH,MIRZAPUR,2021-02-01,1,1673,0,1674,
UTTAR PRADESH,MIRZAPUR,2021-02-02,1,1370,0,1371,
UTTAR PRADESH,MIRZAPUR,2021-02-03,0,1397,0,1397,
UTTAR PRADESH,MIRZAPUR,2021-02-04,1,1283,0,1284,
UTTAR PRADESH,MIRZAPUR,2021-02-05,1,1574,0,1575,
UTTAR PRADESH,MORADABAD,2021-02-01,2,1865,1,1868,
UTTAR PRADESH,MORADABAD,2021-02-02,3,1871,0,1874,
UTTAR PRADESH,MORADABAD,2021-02-03,14,4080,12,4106,
UTTAR PRADESH,MORADABAD,2021-02-04,4,1532,0,1536,
UTTAR PRADESH,MORADABAD,2021-02-05,4,3302,1,3307,
UTTAR PRADESH,MUZAFFARNAGAR,2021-02-01,16,728,9,753,
UTTAR PRADESH,MUZAFFARNAGAR,2021-02-02,6,1687,0,1693,
UTTAR PRADESH,MUZAFFARNAGAR,2021-02-03,18,1210,5,1233,
UTTAR PRADESH,MUZAFFARNAGAR,2021-02-04,13,1634,2,1649,
UTTAR PRADESH,MUZAFFARNAGAR,2021-02-05,3,1297,2,1302,
UTTAR PRADESH,PILIBHIT,2021-02-01,0,1639,18,1657,
UTTAR PRADESH,PILIBHIT,2021-02-02,1,1719,1,1721,
UTTAR PRADESH,PILIBHIT,2021-02-03,0,2324,3,2327,
UTTAR PRADESH,PILIBHIT,2021-02-04,0,1652,0,1652,
UTTAR PRADESH,PILIBHIT,2021-02-05,1,1560,168,1729,
UTTAR PRADESH,PRATAPGARH,2021-02-01,1,1537,53,1591,
UTTAR PRADESH,PRATAPGARH,2021-02-02,6,1318,209,1533,
UTTAR PRADESH,PRATAPGARH,2021-02-03,1,3132,50,3183,
UTTAR PRADESH,PRATAPGARH,2021-02-04,2,1774,136,1912,
UTTAR PRADESH,PRATAPGARH,2021-02-05,0,1497,20,1517,
UTTAR PRADESH,PRAYAGRAJ,2021-02-01,13,3818,3,3834,
UTTAR PRADESH,PRAYAGRAJ,2021-02-02,3,4355,2,4360,
UTTAR PRADESH,PRAYAGRAJ,2021-02-03,3,3954,3,3960,
UTTAR PRADESH,PRAYAGRAJ,2021-02-04,7,3584,32,3623,
UTTAR PRADESH,PRAYAGRAJ,2021-02-05,11,5191,7,5209,
UTTAR PRADESH,RAE BARELI,2021-02-01,3,2136,0,2139,
UTTAR PRADESH,RAE BARELI,2021-02-02,4,2539,2,2545,
UTTAR PRADESH,RAE BARELI,2021-02-03,0,2421,1,2422,
UTTAR PRADESH,RAE BARELI,2021-02-04,1,1686,103,1790,
UTTAR PRADESH,RAE BARELI,2021-02-05,1,2172,11,2184,
UTTAR PRADESH,RAMPUR,2021-02-01,3,1629,65,1697,
UTTAR PRADESH,RAMPUR,2021-02-02,5,1459,41,1505,
UTTAR PRADESH,RAMPUR,2021-02-03,1,1528,14,1543,
UTTAR PRADESH,RAMPUR,2021-02-04,0,1232,36,1268,
UTTAR PRADESH,RAMPUR,2021-02-05,2,1674,35,1711,
UTTAR PRADESH,SAHARANPUR,2021-02-01,2,2585,122,2709,
UTTAR PRADESH,SAHARANPUR,2021-02-02,4,3115,108,3227,
UTTAR PRADESH,SAHARANPUR,2021-02-03,1,3129,61,3191,
UTTAR PRADESH,SAHARANPUR,2021-02-04,4,2314,13,2331,
UTTAR PRADESH,SAHARANPUR,2021-02-05,7,3413,42,3462,
UTTAR PRADESH,SAMBHAL,2021-02-01,1,1857,31,1889,
UTTAR PRADESH,SAMBHAL,2021-02-02,0,1481,125,1606,
UTTAR PRADESH,SAMBHAL,2021-02-03,1,1176,80,1257,
UTTAR PRADESH,SAMBHAL,2021-02-04,1,1153,142,1296,
UTTAR PRADESH,SAMBHAL,2021-02-05,0,1701,104,1805,
UTTAR PRADESH,SANT KABEER NAGAR,2021-02-01,3,1533,4,1540,
UTTAR PRADESH,SANT KABEER NAGAR,2021-02-02,2,704,3,709,
UTTAR PRADESH,SANT KABEER NAGAR,2021-02-03,2,1835,0,1837,
UTTAR PRADESH,SANT KABEER NAGAR,2021-02-04,0,884,0,884,
UTTAR PRADESH,SANT KABEER NAGAR,2021-02-05,2,1983,0,1985,
UTTAR PRADESH,SHAHJAHANPUR,2021-02-01,1,1603,79,1683,
UTTAR PRADESH,SHAHJAHANPUR,2021-02-02,3,796,14,813,
UTTAR PRADESH,SHAHJAHANPUR,2021-02-03,6,2564,0,2570,
UTTAR PRADESH,SHAHJAHANPUR,2021-02-04,1,723,188,912,
UTTAR PRADESH,SHAHJAHANPUR,2021-02-05,0,1249,9,1258,
UTTAR PRADESH,SHAMLI,2021-02-01,1,1194,2,1197,
UTTAR PRADESH,SHAMLI,2021-02-02,3,1868,1,1872,
UTTAR PRADESH,SHAMLI,2021-02-03,1,1312,1,1314,
UTTAR PRADESH,SHAMLI,2021-02-04,2,1013,1,1016,
UTTAR PRADESH,SHAMLI,2021-02-05,0,1160,0,1160,
UTTAR PRADESH,SHRAVASTI,2021-02-01,0,635,0,635,
UTTAR PRADESH,SHRAVASTI,2021-02-02,1,712,0,713,
UTTAR PRADESH,SHRAVASTI,2021-02-03,0,740,21,761,
UTTAR PRADESH,SHRAVASTI,2021-02-04,0,809,0,809,
UTTAR PRADESH,SHRAVASTI,2021-02-05,0,806,0,806,
UTTAR PRADESH,SIDDHARTH NAGAR,2021-02-01,0,721,0,721,
UTTAR PRADESH,SIDDHARTH NAGAR,2021-02-02,0,678,0,678,
UTTAR PRADESH,SIDDHARTH NAGAR,2021-02-03,0,1177,0,1177,
UTTAR PRADESH,SIDDHARTH NAGAR,2021-02-04,0,779,95,874,
UTTAR PRADESH,SIDDHARTH NAGAR,2021-02-05,0,1060,0,1060,
UTTAR PRADESH,SITAPUR,2021-02-01,0,1304,10,1314,
UTTAR PRADESH,SITAPUR,2021-02-02,2,1475,23,1500,
UTTAR PRADESH,SITAPUR,2021-02-03,1,1449,16,1466,
UTTAR PRADESH,SITAPUR,2021-02-04,1,1391,2,1394,
UTTAR PRADESH,SITAPUR,2021-02-05,5,1484,10,1499,
UTTAR PRADESH,SONBHADRA,2021-02-01,1,952,36,989,
UTTAR PRADESH,SONBHADRA,2021-02-02,2,963,338,1303,
UTTAR PRADESH,SONBHADRA,2021-02-03,2,1771,43,1816,
UTTAR PRADESH,SONBHADRA,2021-02-04,4,1628,29,1661,
UTTAR PRADESH,SONBHADRA,2021-02-05,2,1689,36,1727,
UTTAR PRADESH,SULTANPUR,2021-02-01,3,296,0,299,
UTTAR PRADESH,SULTANPUR,2021-02-02,1,987,11,999,
UTTAR PRADESH,SULTANPUR,2021-02-03,0,982,72,1054,
UTTAR PRADESH,SULTANPUR,2021-02-04,1,921,8,930,
UTTAR PRADESH,SULTANPUR,2021-02-05,0,845,28,873,
UTTAR PRADESH,UNNAO,2021-02-01,0,1676,61,1737,
UTTAR PRADESH,UNNAO,2021-02-02,1,1587,7,1595,
UTTAR PRADESH,UNNAO,2021-02-03,1,2205,136,2342,
UTTAR PRADESH,UNNAO,2021-02-04,0,954,10,964,
UTTAR PRADESH,UNNAO,2021-02-05,0,2647,22,2669,
UTTAR PRADESH,VARANASI,2021-02-01,23,1013,29,1065,
UTTAR PRADESH,VARANASI,2021-02-02,5,2508,14,2527,
UTTAR PRADESH,VARANASI,2021-02-03,7,2503,19,2529,
UTTAR PRADESH,VARANASI,2021-02-04,5,2310,70,2385,
UTTAR PRADESH,VARANASI,2021-02-05,7,2507,1,2515,
UTTARAKHAND,ALMORA,2021-02-01,3,147,0,150,
UTTARAKHAND,ALMORA,2021-02-02,1,207,0,208,
UTTARAKHAND,ALMORA,2021-02-03,1,99,0,100,
UTTARAKHAND,ALMORA,2021-02-04,2,242,0,244,
UTTARAKHAND,ALMORA,2021-02-05,0,305,0,305,
UTTARAKHAND,BAGESHWAR,2021-02-01,0,14,0,14,
UTTARAKHAND,BAGESHWAR,2021-02-02,1,261,1,263,
UTTARAKHAND,BAGESHWAR,2021-02-03,0,110,2,112,
UTTARAKHAND,BAGESHWAR,2021-02-04,1,500,1,502,
UTTARAKHAND,BAGESHWAR,2021-02-05,0,242,3,245,
UTTARAKHAND,CHAMOLI,2021-02-01,1,94,1,96,
UTTARAKHAND,CHAMOLI,2021-02-02,0,193,6,199,
UTTARAKHAND,CHAMOLI,2021-02-03,1,125,0,126,
UTTARAKHAND,CHAMOLI,2021-02-04,0,169,3,172,
UTTARAKHAND,CHAMOLI,2021-02-05,4,225,0,229,
UTTARAKHAND,CHAMPAWAT,2021-02-01,2,148,0,150,
UTTARAKHAND,CHAMPAWAT,2021-02-02,0,287,1,288,
UTTARAKHAND,CHAMPAWAT,2021-02-03,0,263,0,263,
UTTARAKHAND,CHAMPAWAT,2021-02-04,0,234,0,234,
UTTARAKHAND,CHAMPAWAT,2021-02-05,2,84,0,86,
UTTARAKHAND,DEHRADUN,2021-02-01,31,1930,6,1967,
UTTARAKHAND,DEHRADUN,2021-02-02,28,2711,5,2744,
UTTARAKHAND,DEHRADUN,2021-02-03,34,1304,4,1342,
UTTARAKHAND,DEHRADUN,2021-02-04,36,1307,3,1346,
UTTARAKHAND,DEHRADUN,2021-02-05,20,1535,3,1558,
UTTARAKHAND,HARIDWAR,2021-02-01,9,1660,56,1725,
UTTARAKHAND,HARIDWAR,2021-02-02,9,2692,8,2709,
UTTARAKHAND,HARIDWAR,2021-02-03,8,2330,9,2347,
UTTARAKHAND,HARIDWAR,2021-02-04,6,1066,0,1072,
UTTARAKHAND,HARIDWAR,2021-02-05,5,2250,32,2287,
UTTARAKHAND,NAINITAL,2021-02-01,9,864,0,873,
UTTARAKHAND,NAINITAL,2021-02-02,11,907,1,919,
UTTARAKHAND,NAINITAL,2021-02-03,13,855,1,869,
UTTARAKHAND,NAINITAL,2021-02-04,9,913,9,931,
UTTARAKHAND,NAINITAL,2021-02-05,14,1129,2,1145,
UTTARAKHAND,PAURI GARHWAL,2021-02-01,1,387,1,389,
UTTARAKHAND,PAURI GARHWAL,2021-02-02,1,500,5,506,
UTTARAKHAND,PAURI GARHWAL,2021-02-03,3,426,2,431,
UTTARAKHAND,PAURI GARHWAL,2021-02-04,2,300,1,303,
UTTARAKHAND,PAURI GARHWAL,2021-02-05,1,382,25,408,
UTTARAKHAND,PITHORAGARH,2021-02-01,0,284,1,285,
UTTARAKHAND,PITHORAGARH,2021-02-02,0,24,0,24,
UTTARAKHAND,PITHORAGARH,2021-02-03,1,281,0,282,
UTTARAKHAND,PITHORAGARH,2021-02-04,2,29,0,31,
UTTARAKHAND,PITHORAGARH,2021-02-05,7,54,0,61,
UTTARAKHAND,RUDRA PRAYAG,2021-02-01,0,22,0,22,
UTTARAKHAND,RUDRA PRAYAG,2021-02-02,0,80,2,82,
UTTARAKHAND,RUDRA PRAYAG,2021-02-03,0,150,2,152,
UTTARAKHAND,RUDRA PRAYAG,2021-02-04,0,85,1,86,
UTTARAKHAND,RUDRA PRAYAG,2021-02-05,1,80,20,101,
UTTARAKHAND,TEHRI GARHWAL,2021-02-01,2,380,8,390,
UTTARAKHAND,TEHRI GARHWAL,2021-02-02,1,425,0,426,
UTTARAKHAND,TEHRI GARHWAL,2021-02-03,0,81,0,81,
UTTARAKHAND,TEHRI GARHWAL,2021-02-04,0,113,0,113,
UTTARAKHAND,TEHRI GARHWAL,2021-02-05,0,478,1,479,
UTTARAKHAND,UDAM SINGH NAGAR,2021-02-01,9,953,33,995,
UTTARAKHAND,UDAM SINGH NAGAR,2021-02-02,4,1794,145,1943,
UTTARAKHAND,UDAM SINGH NAGAR,2021-02-03,16,1367,186,1569,
UTTARAKHAND,UDAM SINGH NAGAR,2021-02-04,2,1377,41,1420,
UTTARAKHAND,UDAM SINGH NAGAR,2021-02-05,9,1688,105,1802,
UTTARAKHAND,UTTAR KASHI,2021-02-01,0,460,18,478,
UTTARAKHAND,UTTAR KASHI,2021-02-02,1,297,2,300,
UTTARAKHAND,UTTAR KASHI,2021-02-03,0,182,0,182,
UTTARAKHAND,UTTAR KASHI,2021-02-04,0,354,0,354,
UTTARAKHAND,UTTAR KASHI,2021-02-05,0,242,0,242,
WEST BENGAL,24 PARAGANAS NORTH,2021-02-01,37,3166,16,3219,
WEST BENGAL,24 PARAGANAS NORTH,2021-02-02,43,3594,10,3647,
WEST BENGAL,24 PARAGANAS NORTH,2021-02-03,49,3517,18,3584,
WEST BENGAL,24 PARAGANAS NORTH,2021-02-04,42,3519,9,3570,
WEST BENGAL,24 PARAGANAS NORTH,2021-02-05,54,3523,15,3592,
WEST BENGAL,24 PARAGANAS SOUTH,2021-02-01,6,2801,3,2810,
WEST BENGAL,24 PARAGANAS SOUTH,2021-02-02,9,3003,7,3019,
WEST BENGAL,24 PARAGANAS SOUTH,2021-02-03,9,2966,21,2996,
WEST BENGAL,24 PARAGANAS SOUTH,2021-02-04,6,3030,7,3043,
WEST BENGAL,24 PARAGANAS SOUTH,2021-02-05,18,3508,10,3536,
WEST BENGAL,ALIPURDUAR,2021-02-01,1,906,74,981,
WEST BENGAL,ALIPURDUAR,2021-02-02,0,248,0,248,
WEST BENGAL,ALIPURDUAR,2021-02-03,0,142,39,181,
WEST BENGAL,ALIPURDUAR,2021-02-04,0,148,0,148,
WEST BENGAL,ALIPURDUAR,2021-02-05,0,94,0,94,
WEST BENGAL,BANKURA,2021-02-01,11,783,6,800,
WEST BENGAL,BANKURA,2021-02-02,5,691,1,697,
WEST BENGAL,BANKURA,2021-02-03,3,796,0,799,
WEST BENGAL,BANKURA,2021-02-04,4,646,1,651,
WEST BENGAL,BANKURA,2021-02-05,0,584,2,586,
WEST BENGAL,BIRBHUM,2021-02-01,2,713,3,718,
WEST BENGAL,BIRBHUM,2021-02-02,6,876,7,889,
WEST BENGAL,BIRBHUM,2021-02-03,4,1026,3,1033,
WEST BENGAL,BIRBHUM,2021-02-04,6,858,4,868,
WEST BENGAL,BIRBHUM,2021-02-05,5,719,3,727,
WEST BENGAL,COOCHBEHAR,2021-02-01,4,1266,0,1270,
WEST BENGAL,COOCHBEHAR,2021-02-02,3,983,0,986,
WEST BENGAL,COOCHBEHAR,2021-02-03,4,1334,0,1338,
WEST BENGAL,COOCHBEHAR,2021-02-04,0,1660,0,1660,
WEST BENGAL,COOCHBEHAR,2021-02-05,2,1481,0,1483,
WEST BENGAL,DARJEELING,2021-02-01,6,1001,0,1007,
WEST BENGAL,DARJEELING,2021-02-02,9,605,0,614,
WEST BENGAL,DARJEELING,2021-02-03,8,890,1,899,
WEST BENGAL,DARJEELING,2021-02-04,13,687,1,701,
WEST BENGAL,DARJEELING,2021-02-05,11,1183,7,1201,
WEST BENGAL,DINAJPUR DAKSHIN,2021-02-01,1,700,0,701,
WEST BENGAL,DINAJPUR DAKSHIN,2021-02-02,2,790,0,792,
WEST BENGAL,DINAJPUR DAKSHIN,2021-02-03,1,697,1,699,
WEST BENGAL,DINAJPUR DAKSHIN,2021-02-04,0,782,9,791,
WEST BENGAL,DINAJPUR DAKSHIN,2021-02-05,0,900,0,900,
WEST BENGAL,DINAJPUR UTTAR,2021-02-01,2,196,0,198,
WEST BENGAL,DINAJPUR UTTAR,2021-02-02,0,536,0,536,
WEST BENGAL,DINAJPUR UTTAR,2021-02-03,4,439,0,443,
WEST BENGAL,DINAJPUR UTTAR,2021-02-04,5,281,0,286,
WEST BENGAL,DINAJPUR UTTAR,2021-02-05,6,429,0,435,
WEST BENGAL,HOOGHLY,2021-02-01,8,838,79,925,
WEST BENGAL,HOOGHLY,2021-02-02,9,660,14,683,
WEST BENGAL,HOOGHLY,2021-02-03,10,803,95,908,
WEST BENGAL,HOOGHLY,2021-02-04,11,745,11,767,
WEST BENGAL,HOOGHLY,2021-02-05,7,677,56,740,
WEST BENGAL,HOWRAH,2021-02-01,4,1128,147,1279,
WEST BENGAL,HOWRAH,2021-02-02,10,1083,182,1275,
WEST BENGAL,HOWRAH,2021-02-03,11,1137,57,1205,
WEST BENGAL,HOWRAH,2021-02-04,5,1131,152,1288,
WEST BENGAL,HOWRAH,2021-02-05,8,1051,112,1171,
WEST BENGAL,JALPAIGURI,2021-02-01,0,413,0,413,
WEST BENGAL,JALPAIGURI,2021-02-02,3,267,0,270,
WEST BENGAL,JALPAIGURI,2021-02-03,5,361,2,368,
WEST BENGAL,JALPAIGURI,2021-02-04,4,697,0,701,
WEST BENGAL,JALPAIGURI,2021-02-05,5,960,2,967,
WEST BENGAL,JHARGRAM,2021-02-01,0,64,0,64,
WEST BENGAL,JHARGRAM,2021-02-02,0,36,0,36,
WEST BENGAL,JHARGRAM,2021-02-03,0,91,1,92,
WEST BENGAL,JHARGRAM,2021-02-04,0,53,0,53,
WEST BENGAL,JHARGRAM,2021-02-05,0,29,0,29,
WEST BENGAL,KALIMPONG,2021-02-01,0,151,0,151,
WEST BENGAL,KALIMPONG,2021-02-02,0,128,0,128,
WEST BENGAL,KALIMPONG,2021-02-03,0,68,0,68,
WEST BENGAL,KALIMPONG,2021-02-04,1,52,0,53,
WEST BENGAL,KALIMPONG,2021-02-05,0,68,0,68,
WEST BENGAL,KOLKATA,2021-02-01,65,2462,4,2531,
WEST BENGAL,KOLKATA,2021-02-02,79,2770,16,2865,
WEST BENGAL,KOLKATA,2021-02-03,76,2866,7,2949,
WEST BENGAL,KOLKATA,2021-02-04,67,2736,1,2804,
WEST BENGAL,KOLKATA,2021-02-05,70,2701,9,2780,
WEST BENGAL,MALDAH,2021-02-01,0,470,4,474,
WEST BENGAL,MALDAH,2021-02-02,4,719,1,724,
WEST BENGAL,MALDAH,2021-02-03,4,634,4,642,
WEST BENGAL,MALDAH,2021-02-04,3,675,1,679,
WEST BENGAL,MALDAH,2021-02-05,1,428,8,437,
WEST BENGAL,MEDINIPUR EAST,2021-02-01,3,695,0,698,
WEST BENGAL,MEDINIPUR EAST,2021-02-02,4,446,1,451,
WEST BENGAL,MEDINIPUR EAST,2021-02-03,4,444,1,449,
WEST BENGAL,MEDINIPUR EAST,2021-02-04,2,630,1,633,
WEST BENGAL,MEDINIPUR EAST,2021-02-05,5,750,2,757,
WEST BENGAL,MEDINIPUR WEST,2021-02-01,5,364,2,371,
WEST BENGAL,MEDINIPUR WEST,2021-02-02,1,254,2,257,
WEST BENGAL,MEDINIPUR WEST,2021-02-03,0,359,7,366,
WEST BENGAL,MEDINIPUR WEST,2021-02-04,3,367,5,375,
WEST BENGAL,MEDINIPUR WEST,2021-02-05,2,566,7,575,
WEST BENGAL,MURSHIDABAD,2021-02-01,2,1407,3,1412,
WEST BENGAL,MURSHIDABAD,2021-02-02,1,1359,3,1363,
WEST BENGAL,MURSHIDABAD,2021-02-03,2,1224,9,1235,
WEST BENGAL,MURSHIDABAD,2021-02-04,1,1361,0,1362,
WEST BENGAL,MURSHIDABAD,2021-02-05,1,1253,8,1262,
WEST BENGAL,NADIA,2021-02-01,9,653,0,662,
WEST BENGAL,NADIA,2021-02-02,8,559,11,578,
WEST BENGAL,NADIA,2021-02-03,11,662,5,678,
WEST BENGAL,NADIA,2021-02-04,14,738,16,768,
WEST BENGAL,NADIA,2021-02-05,6,592,13,611,
WEST BENGAL,PASCHIM BARDHAMAN,2021-02-01,7,777,1,785,
WEST BENGAL,PASCHIM BARDHAMAN,2021-02-02,12,622,1,635,
WEST BENGAL,PASCHIM BARDHAMAN,2021-02-03,8,835,5,848,
WEST BENGAL,PASCHIM BARDHAMAN,2021-02-04,13,817,2,832,
WEST BENGAL,PASCHIM BARDHAMAN,2021-02-05,15,903,0,918,
WEST BENGAL,PURBA BARDHAMAN,2021-02-01,2,659,0,661,
WEST BENGAL,PURBA BARDHAMAN,2021-02-02,2,768,0,770,
WEST BENGAL,PURBA BARDHAMAN,2021-02-03,1,758,1,760,
WEST BENGAL,PURBA BARDHAMAN,2021-02-04,1,931,0,932,
WEST BENGAL,PURBA BARDHAMAN,2021-02-05,3,785,0,788,
WEST BENGAL,PURULIA,2021-02-01,5,268,0,273,
WEST BENGAL,PURULIA,2021-02-02,3,418,0,421,
WEST BENGAL,PURULIA,2021-02-03,9,412,0,421,
WEST BENGAL,PURULIA,2021-02-04,2,385,1,388,
WEST BENGAL,PURULIA,2021-02-05,1,291,0,292,
ANDAMAN AND NICOBAR ISLANDS,NICOBARS,2021-02-06,0,12,0,12,0.0
ANDAMAN AND NICOBAR ISLANDS,NICOBARS,2021-02-07,0,9,0,9,0.0
ANDAMAN AND NICOBAR ISLANDS,NICOBARS,2021-02-08,0,8,0,8,0.0
ANDAMAN AND NICOBAR ISLANDS,NICOBARS,2021-02-09,0,6,0,6,0.0
ANDAMAN AND NICOBAR ISLANDS,NICOBARS,2021-02-10,2,15,0,17,0.0
ANDAMAN AND NICOBAR ISLANDS,NORTH AND MIDDLE ANDAMAN,2021-02-06,0,5,0,5,0.0
ANDAMAN AND NICOBAR ISLANDS,NORTH AND MIDDLE ANDAMAN,2021-02-07,0,1,0,1,0.0
ANDAMAN AND NICOBAR ISLANDS,NORTH AND MIDDLE ANDAMAN,2021-02-08,0,11,1,12,0.0
ANDAMAN AND NICOBAR ISLANDS,NORTH AND MIDDLE ANDAMAN,2021-02-09,0,10,0,10,0.0
ANDAMAN AND NICOBAR ISLANDS,NORTH AND MIDDLE ANDAMAN,2021-02-10,0,9,0,9,0.0
ANDAMAN AND NICOBAR ISLANDS,SOUTH ANDAMANS,2021-02-06,10,376,0,386,0.0
ANDAMAN AND NICOBAR ISLANDS,SOUTH ANDAMANS,2021-02-07,0,155,0,155,0.0
ANDAMAN AND NICOBAR ISLANDS,SOUTH ANDAMANS,2021-02-08,6,720,2,728,0.0
ANDAMAN AND NICOBAR ISLANDS,SOUTH ANDAMANS,2021-02-09,0,368,7,375,0.0
ANDAMAN AND NICOBAR ISLANDS,SOUTH ANDAMANS,2021-02-10,35,820,1,856,0.0
ANDHRA PRADESH,ANANTAPUR,2021-02-06,5,4401,1,4407,0.0
ANDHRA PRADESH,ANANTAPUR,2021-02-07,3,3516,0,3519,0.0
ANDHRA PRADESH,ANANTAPUR,2021-02-08,2,2053,1,2056,0.0
ANDHRA PRADESH,ANANTAPUR,2021-02-09,1,3211,1,3213,0.0
ANDHRA PRADESH,ANANTAPUR,2021-02-10,5,2510,1,2516,0.0
ANDHRA PRADESH,CHITTOOR,2021-02-06,27,2425,0,2452,0.0
ANDHRA PRADESH,CHITTOOR,2021-02-07,10,1585,0,1595,0.0
ANDHRA PRADESH,CHITTOOR,2021-02-08,37,3551,0,3588,0.0
ANDHRA PRADESH,CHITTOOR,2021-02-09,31,2560,0,2591,0.0
ANDHRA PRADESH,CHITTOOR,2021-02-10,16,2233,1,2250,0.0
ANDHRA PRADESH,EAST GODAVARI,2021-02-06,9,527,0,536,0.0
ANDHRA PRADESH,EAST GODAVARI,2021-02-07,7,1702,0,1709,0.0
ANDHRA PRADESH,EAST GODAVARI,2021-02-08,12,4241,0,4253,0.0
ANDHRA PRADESH,EAST GODAVARI,2021-02-09,5,1558,0,1563,0.0
ANDHRA PRADESH,EAST GODAVARI,2021-02-10,5,1209,0,1214,0.0
ANDHRA PRADESH,GUNTUR,2021-02-06,15,3047,0,3062,0.0
ANDHRA PRADESH,GUNTUR,2021-02-07,7,720,0,727,0.0
ANDHRA PRADESH,GUNTUR,2021-02-08,8,2822,0,2830,0.0
ANDHRA PRADESH,GUNTUR,2021-02-09,6,1434,0,1440,0.0
ANDHRA PRADESH,GUNTUR,2021-02-10,3,863,0,866,0.0
ANDHRA PRADESH,KRISHNA,2021-02-06,17,1407,0,1424,0.0
ANDHRA PRADESH,KRISHNA,2021-02-07,6,1235,0,1241,0.0
ANDHRA PRADESH,KRISHNA,2021-02-08,10,1629,0,1639,0.0
ANDHRA PRADESH,KRISHNA,2021-02-09,11,2203,0,2214,0.0
ANDHRA PRADESH,KRISHNA,2021-02-10,6,2139,1,2146,0.0
ANDHRA PRADESH,KURNOOL,2021-02-06,5,2623,0,2628,0.0
ANDHRA PRADESH,KURNOOL,2021-02-07,6,1387,0,1393,0.0
ANDHRA PRADESH,KURNOOL,2021-02-08,1,572,0,573,0.0
ANDHRA PRADESH,KURNOOL,2021-02-09,1,2237,0,2238,0.0
ANDHRA PRADESH,KURNOOL,2021-02-10,8,1077,0,1085,0.0
ANDHRA PRADESH,PRAKASAM,2021-02-06,7,3455,0,3462,0.0
ANDHRA PRADESH,PRAKASAM,2021-02-07,2,2448,0,2450,0.0
ANDHRA PRADESH,PRAKASAM,2021-02-08,3,981,1,985,0.0
ANDHRA PRADESH,PRAKASAM,2021-02-09,9,1808,0,1817,0.0
ANDHRA PRADESH,PRAKASAM,2021-02-10,2,437,0,439,0.0
ANDHRA PRADESH,SPSR NELLORE,2021-02-06,10,2169,0,2179,0.0
ANDHRA PRADESH,SPSR NELLORE,2021-02-07,1,2296,0,2297,0.0
ANDHRA PRADESH,SPSR NELLORE,2021-02-08,6,2372,0,2378,0.0
ANDHRA PRADESH,SPSR NELLORE,2021-02-09,6,1665,0,1671,0.0
ANDHRA PRADESH,SPSR NELLORE,2021-02-10,4,2430,0,2434,0.0
ANDHRA PRADESH,SRIKAKULAM,2021-02-06,6,2245,0,2251,0.0
ANDHRA PRADESH,SRIKAKULAM,2021-02-07,1,582,0,583,0.0
ANDHRA PRADESH,SRIKAKULAM,2021-02-08,2,1881,0,1883,0.0
ANDHRA PRADESH,SRIKAKULAM,2021-02-09,2,2159,0,2161,0.0
ANDHRA PRADESH,SRIKAKULAM,2021-02-10,4,1414,0,1418,0.0
ANDHRA PRADESH,VISAKHAPATANAM,2021-02-06,13,1219,0,1232,0.0
ANDHRA PRADESH,VISAKHAPATANAM,2021-02-07,7,319,2,328,0.0
ANDHRA PRADESH,VISAKHAPATANAM,2021-02-08,16,1473,0,1489,0.0
ANDHRA PRADESH,VISAKHAPATANAM,2021-02-09,15,1199,0,1214,0.0
ANDHRA PRADESH,VISAKHAPATANAM,2021-02-10,15,811,0,826,0.0
ANDHRA PRADESH,VIZIANAGARAM,2021-02-06,1,1215,0,1216,0.0
ANDHRA PRADESH,VIZIANAGARAM,2021-02-07,0,64,0,64,0.0
ANDHRA PRADESH,VIZIANAGARAM,2021-02-08,2,1621,0,1623,0.0
ANDHRA PRADESH,VIZIANAGARAM,2021-02-09,1,1083,0,1084,0.0
ANDHRA PRADESH,VIZIANAGARAM,2021-02-10,2,724,0,726,0.0
ANDHRA PRADESH,WEST GODAVARI,2021-02-06,0,2980,0,2980,0.0
ANDHRA PRADESH,WEST GODAVARI,2021-02-07,2,832,0,834,0.0
ANDHRA PRADESH,WEST GODAVARI,2021-02-08,4,3185,0,3189,0.0
ANDHRA PRADESH,WEST GODAVARI,2021-02-09,2,1701,0,1703,0.0
ANDHRA PRADESH,WEST GODAVARI,2021-02-10,2,2995,0,2997,0.0
ANDHRA PRADESH,Y.S.R.,2021-02-06,3,2898,0,2901,0.0
ANDHRA PRADESH,Y.S.R.,2021-02-07,2,4188,0,4190,0.0
ANDHRA PRADESH,Y.S.R.,2021-02-08,11,884,0,895,0.0
ANDHRA PRADESH,Y.S.R.,2021-02-09,4,3118,0,3122,0.0
ANDHRA PRADESH,Y.S.R.,2021-02-10,4,2116,0,2120,0.0
ARUNACHAL PRADESH,ANJAW,2021-02-06,0,7,0,7,0.0
ARUNACHAL PRADESH,ANJAW,2021-02-09,0,2,0,2,0.0
ARUNACHAL PRADESH,CHANGLANG,2021-02-07,0,2,0,2,0.0
ARUNACHAL PRADESH,CHANGLANG,2021-02-08,0,1,0,1,0.0
ARUNACHAL PRADESH,CHANGLANG,2021-02-09,0,1,0,1,0.0
ARUNACHAL PRADESH,CHANGLANG,2021-02-10,0,3,0,3,0.0
ARUNACHAL PRADESH,EAST KAMENG,2021-02-07,0,1,0,1,0.0
ARUNACHAL PRADESH,EAST KAMENG,2021-02-08,0,1,0,1,0.0
ARUNACHAL PRADESH,EAST SIANG,2021-02-06,0,34,0,34,0.0
ARUNACHAL PRADESH,EAST SIANG,2021-02-07,0,1,0,1,0.0
ARUNACHAL PRADESH,EAST SIANG,2021-02-08,0,50,0,50,0.0
ARUNACHAL PRADESH,EAST SIANG,2021-02-09,0,57,0,57,0.0
ARUNACHAL PRADESH,EAST SIANG,2021-02-10,0,47,0,47,0.0
ARUNACHAL PRADESH,KURUNG KUMEY,2021-02-10,0,1,0,1,0.0
ARUNACHAL PRADESH,LEPARADA,2021-02-09,3,7,0,10,0.0
ARUNACHAL PRADESH,LOHIT,2021-02-08,0,1,0,1,0.0
ARUNACHAL PRADESH,LONGDING,2021-02-09,0,1,0,1,0.0
ARUNACHAL PRADESH,LOWER DIBANG VALLEY,2021-02-06,0,70,0,70,0.0
ARUNACHAL PRADESH,LOWER DIBANG VALLEY,2021-02-07,0,1,0,1,0.0
ARUNACHAL PRADESH,LOWER DIBANG VALLEY,2021-02-08,0,1,0,1,0.0
ARUNACHAL PRADESH,LOWER SIANG,2021-02-06,0,15,0,15,0.0
ARUNACHAL PRADESH,LOWER SIANG,2021-02-07,0,7,0,7,0.0
ARUNACHAL PRADESH,LOWER SIANG,2021-02-08,0,11,0,11,0.0
ARUNACHAL PRADESH,LOWER SIANG,2021-02-09,0,7,0,7,0.0
ARUNACHAL PRADESH,LOWER SIANG,2021-02-10,0,11,0,11,0.0
ARUNACHAL PRADESH,LOWER SUBANSIRI,2021-02-08,0,19,0,19,0.0
ARUNACHAL PRADESH,LOWER SUBANSIRI,2021-02-10,0,46,0,46,0.0
ARUNACHAL PRADESH,NAMSAI,2021-02-09,0,4,0,4,0.0
ARUNACHAL PRADESH,NAMSAI,2021-02-10,0,1,0,1,0.0
ARUNACHAL PRADESH,PAPUM PARE,2021-02-06,0,55,0,55,0.0
ARUNACHAL PRADESH,PAPUM PARE,2021-02-07,0,2,0,2,0.0
ARUNACHAL PRADESH,PAPUM PARE,2021-02-08,0,22,0,22,0.0
ARUNACHAL PRADESH,PAPUM PARE,2021-02-09,0,40,0,40,0.0
ARUNACHAL PRADESH,PAPUM PARE,2021-02-10,0,51,0,51,0.0
ARUNACHAL PRADESH,SIANG,2021-02-08,0,1,0,1,0.0
ARUNACHAL PRADESH,SIANG,2021-02-09,0,1,0,1,0.0
ARUNACHAL PRADESH,TAWANG,2021-02-06,0,3,0,3,0.0
ARUNACHAL PRADESH,TAWANG,2021-02-08,0,2,0,2,0.0
ARUNACHAL PRADESH,TAWANG,2021-02-09,0,2,0,2,0.0
ARUNACHAL PRADESH,TAWANG,2021-02-10,0,3,0,3,0.0
ARUNACHAL PRADESH,TIRAP,2021-02-06,0,1,0,1,0.0
ARUNACHAL PRADESH,TIRAP,2021-02-10,0,1,0,1,0.0
ARUNACHAL PRADESH,UPPER SIANG,2021-02-09,0,2,0,2,0.0
ARUNACHAL PRADESH,UPPER SUBANSIRI,2021-02-07,0,1,0,1,0.0
ARUNACHAL PRADESH,WEST KAMENG,2021-02-06,0,90,0,90,0.0
ARUNACHAL PRADESH,WEST KAMENG,2021-02-07,0,1,0,1,0.0
ARUNACHAL PRADESH,WEST KAMENG,2021-02-08,0,14,0,14,0.0
ARUNACHAL PRADESH,WEST KAMENG,2021-02-09,0,41,0,41,0.0
ARUNACHAL PRADESH,WEST KAMENG,2021-02-10,0,4,0,4,0.0
ARUNACHAL PRADESH,WEST SIANG,2021-02-08,0,15,0,15,0.0
ARUNACHAL PRADESH,WEST SIANG,2021-02-09,1,11,0,12,0.0
ARUNACHAL PRADESH,WEST SIANG,2021-02-10,0,2,0,2,0.0
ASSAM,BAKSA,2021-02-06,0,43,0,43,0.0
ASSAM,BAKSA,2021-02-07,0,7,0,7,0.0
ASSAM,BAKSA,2021-02-08,0,85,0,85,0.0
ASSAM,BAKSA,2021-02-09,0,116,0,116,0.0
ASSAM,BAKSA,2021-02-10,0,149,0,149,0.0
ASSAM,BARPETA,2021-02-06,0,131,0,131,0.0
ASSAM,BARPETA,2021-02-07,0,67,0,67,0.0
ASSAM,BARPETA,2021-02-08,1,127,0,128,0.0
ASSAM,BARPETA,2021-02-09,1,127,0,128,0.0
ASSAM,BARPETA,2021-02-10,0,185,0,185,0.0
ASSAM,BISWANATH,2021-02-06,0,19,0,19,0.0
ASSAM,BISWANATH,2021-02-07,0,19,0,19,0.0
ASSAM,BISWANATH,2021-02-08,0,72,0,72,0.0
ASSAM,BISWANATH,2021-02-09,0,39,0,39,0.0
ASSAM,BISWANATH,2021-02-10,0,53,0,53,0.0
ASSAM,BONGAIGAON,2021-02-06,0,168,0,168,0.0
ASSAM,BONGAIGAON,2021-02-07,0,11,0,11,0.0
ASSAM,BONGAIGAON,2021-02-08,0,287,0,287,0.0
ASSAM,BONGAIGAON,2021-02-09,0,242,0,242,0.0
ASSAM,BONGAIGAON,2021-02-10,0,163,0,163,0.0
ASSAM,CACHAR,2021-02-06,1,170,31,202,0.0
ASSAM,CACHAR,2021-02-07,1,77,0,78,0.0
ASSAM,CACHAR,2021-02-08,0,171,3,174,0.0
ASSAM,CACHAR,2021-02-09,0,223,12,235,0.0
ASSAM,CACHAR,2021-02-10,1,278,80,359,0.0
ASSAM,CHARAIDEO,2021-02-06,0,111,0,111,0.0
ASSAM,CHARAIDEO,2021-02-07,0,11,0,11,0.0
ASSAM,CHARAIDEO,2021-02-08,0,230,0,230,0.0
ASSAM,CHARAIDEO,2021-02-09,0,138,0,138,0.0
ASSAM,CHARAIDEO,2021-02-10,0,133,0,133,0.0
ASSAM,CHIRANG,2021-02-06,0,45,0,45,0.0
ASSAM,CHIRANG,2021-02-07,0,2,0,2,0.0
ASSAM,CHIRANG,2021-02-08,0,78,0,78,0.0
ASSAM,CHIRANG,2021-02-09,0,120,0,120,0.0
ASSAM,CHIRANG,2021-02-10,0,77,0,77,0.0
ASSAM,DARRANG,2021-02-06,1,334,0,335,0.0
ASSAM,DARRANG,2021-02-07,0,93,0,93,0.0
ASSAM,DARRANG,2021-02-08,0,433,0,433,0.0
ASSAM,DARRANG,2021-02-09,1,404,0,405,0.0
ASSAM,DARRANG,2021-02-10,0,438,0,438,0.0
ASSAM,DHEMAJI,2021-02-06,0,137,1,138,0.0
ASSAM,DHEMAJI,2021-02-07,0,132,0,132,0.0
ASSAM,DHEMAJI,2021-02-08,0,287,0,287,0.0
ASSAM,DHEMAJI,2021-02-09,0,342,0,342,0.0
ASSAM,DHEMAJI,2021-02-10,1,57,0,58,0.0
ASSAM,DHUBRI,2021-02-06,0,169,0,169,0.0
ASSAM,DHUBRI,2021-02-07,0,11,0,11,0.0
ASSAM,DHUBRI,2021-02-08,1,293,0,294,0.0
ASSAM,DHUBRI,2021-02-09,0,225,0,225,0.0
ASSAM,DHUBRI,2021-02-10,1,178,0,179,0.0
ASSAM,DIBRUGARH,2021-02-06,2,316,0,318,0.0
ASSAM,DIBRUGARH,2021-02-07,0,291,0,291,0.0
ASSAM,DIBRUGARH,2021-02-08,11,332,0,343,0.0
ASSAM,DIBRUGARH,2021-02-09,8,401,0,409,0.0
ASSAM,DIBRUGARH,2021-02-10,3,288,2,293,0.0
ASSAM,DIMA HASAO,2021-02-06,1,17,0,18,0.0
ASSAM,DIMA HASAO,2021-02-07,0,68,0,68,0.0
ASSAM,DIMA HASAO,2021-02-08,0,90,0,90,0.0
ASSAM,DIMA HASAO,2021-02-09,0,78,0,78,0.0
ASSAM,DIMA HASAO,2021-02-10,0,13,0,13,0.0
ASSAM,GOALPARA,2021-02-06,0,268,0,268,0.0
ASSAM,GOALPARA,2021-02-07,0,110,0,110,0.0
ASSAM,GOALPARA,2021-02-08,1,401,0,402,0.0
ASSAM,GOALPARA,2021-02-09,0,358,0,358,0.0
ASSAM,GOALPARA,2021-02-10,1,241,0,242,0.0
ASSAM,GOLAGHAT,2021-02-06,0,378,0,378,0.0
ASSAM,GOLAGHAT,2021-02-07,1,107,0,108,0.0
ASSAM,GOLAGHAT,2021-02-08,0,287,0,287,0.0
ASSAM,GOLAGHAT,2021-02-09,0,284,0,284,0.0
ASSAM,GOLAGHAT,2021-02-10,0,187,0,187,0.0
ASSAM,HAILAKANDI,2021-02-06,0,212,22,234,0.0
ASSAM,HAILAKANDI,2021-02-07,0,58,0,58,0.0
ASSAM,HAILAKANDI,2021-02-08,0,328,2,330,0.0
ASSAM,HAILAKANDI,2021-02-09,0,213,4,217,0.0
ASSAM,HAILAKANDI,2021-02-10,0,312,2,314,0.0
ASSAM,HOJAI,2021-02-06,0,155,0,155,0.0
ASSAM,HOJAI,2021-02-07,0,34,0,34,0.0
ASSAM,HOJAI,2021-02-08,0,183,0,183,0.0
ASSAM,HOJAI,2021-02-09,0,218,0,218,0.0
ASSAM,HOJAI,2021-02-10,0,168,0,168,0.0
ASSAM,JORHAT,2021-02-06,1,428,0,429,0.0
ASSAM,JORHAT,2021-02-07,3,160,0,163,0.0
ASSAM,JORHAT,2021-02-08,1,657,0,658,0.0
ASSAM,JORHAT,2021-02-09,0,441,0,441,0.0
ASSAM,JORHAT,2021-02-10,1,557,0,558,0.0
ASSAM,KAMRUP,2021-02-06,2,556,0,558,0.0
ASSAM,KAMRUP,2021-02-07,0,99,0,99,0.0
ASSAM,KAMRUP,2021-02-08,0,794,0,794,0.0
ASSAM,KAMRUP,2021-02-09,0,825,0,825,0.0
ASSAM,KAMRUP,2021-02-10,0,690,0,690,0.0
ASSAM,KAMRUP METRO,2021-02-06,1,1873,1,1875,0.0
ASSAM,KAMRUP METRO,2021-02-07,2,1472,0,1474,0.0
ASSAM,KAMRUP METRO,2021-02-08,6,1819,0,1825,0.0
ASSAM,KAMRUP METRO,2021-02-09,1,1843,0,1844,0.0
ASSAM,KAMRUP METRO,2021-02-10,7,1571,1,1579,0.0
ASSAM,KARBI ANGLONG,2021-02-06,2,116,0,118,0.0
ASSAM,KARBI ANGLONG,2021-02-07,0,4,0,4,0.0
ASSAM,KARBI ANGLONG,2021-02-08,0,55,0,55,0.0
ASSAM,KARBI ANGLONG,2021-02-09,0,142,0,142,0.0
ASSAM,KARBI ANGLONG,2021-02-10,0,58,0,58,0.0
ASSAM,KARIMGANJ,2021-02-06,0,327,1,328,0.0
ASSAM,KARIMGANJ,2021-02-07,0,94,0,94,0.0
ASSAM,KARIMGANJ,2021-02-08,1,458,20,479,0.0
ASSAM,KARIMGANJ,2021-02-09,0,314,24,338,0.0
ASSAM,KARIMGANJ,2021-02-10,0,329,0,329,0.0
ASSAM,KOKRAJHAR,2021-02-06,0,33,0,33,0.0
ASSAM,KOKRAJHAR,2021-02-07,0,1,0,1,0.0
ASSAM,KOKRAJHAR,2021-02-08,2,38,0,40,0.0
ASSAM,KOKRAJHAR,2021-02-09,3,70,0,73,0.0
ASSAM,KOKRAJHAR,2021-02-10,1,35,0,36,0.0
ASSAM,LAKHIMPUR,2021-02-06,0,240,0,240,0.0
ASSAM,LAKHIMPUR,2021-02-07,0,143,0,143,0.0
ASSAM,LAKHIMPUR,2021-02-08,0,407,0,407,0.0
ASSAM,LAKHIMPUR,2021-02-09,0,284,0,284,0.0
ASSAM,LAKHIMPUR,2021-02-10,0,358,0,358,0.0
ASSAM,MAJULI,2021-02-06,0,60,0,60,0.0
ASSAM,MAJULI,2021-02-07,0,25,0,25,0.0
ASSAM,MAJULI,2021-02-08,0,29,0,29,0.0
ASSAM,MAJULI,2021-02-09,0,125,0,125,0.0
ASSAM,MAJULI,2021-02-10,0,46,0,46,0.0
ASSAM,MARIGAON,2021-02-06,0,83,0,83,0.0
ASSAM,MARIGAON,2021-02-07,0,282,0,282,0.0
ASSAM,MARIGAON,2021-02-08,0,144,0,144,0.0
ASSAM,MARIGAON,2021-02-09,0,75,0,75,0.0
ASSAM,MARIGAON,2021-02-10,0,64,0,64,0.0
ASSAM,NAGAON,2021-02-06,2,418,0,420,0.0
ASSAM,NAGAON,2021-02-07,0,100,0,100,0.0
ASSAM,NAGAON,2021-02-08,2,596,1,599,0.0
ASSAM,NAGAON,2021-02-09,0,436,0,436,0.0
ASSAM,NAGAON,2021-02-10,0,367,0,367,0.0
ASSAM,NALBARI,2021-02-06,1,54,0,55,0.0
ASSAM,NALBARI,2021-02-07,0,8,0,8,0.0
ASSAM,NALBARI,2021-02-08,0,51,0,51,0.0
ASSAM,NALBARI,2021-02-09,0,68,0,68,0.0
ASSAM,NALBARI,2021-02-10,0,77,0,77,0.0
ASSAM,SIVASAGAR,2021-02-06,0,295,0,295,0.0
ASSAM,SIVASAGAR,2021-02-07,0,81,0,81,0.0
ASSAM,SIVASAGAR,2021-02-08,0,254,0,254,0.0
ASSAM,SIVASAGAR,2021-02-09,0,207,0,207,0.0
ASSAM,SIVASAGAR,2021-02-10,1,568,0,569,0.0
ASSAM,SONITPUR,2021-02-06,1,251,1,253,0.0
ASSAM,SONITPUR,2021-02-07,0,67,0,67,0.0
ASSAM,SONITPUR,2021-02-08,0,277,0,277,0.0
ASSAM,SONITPUR,2021-02-09,0,208,0,208,0.0
ASSAM,SONITPUR,2021-02-10,1,365,0,366,0.0
ASSAM,SOUTH SALMARA MANCACHAR,2021-02-06,0,23,0,23,0.0
ASSAM,SOUTH SALMARA MANCACHAR,2021-02-07,0,7,0,7,0.0
ASSAM,SOUTH SALMARA MANCACHAR,2021-02-08,0,29,0,29,0.0
ASSAM,SOUTH SALMARA MANCACHAR,2021-02-09,0,27,0,27,0.0
ASSAM,SOUTH SALMARA MANCACHAR,2021-02-10,0,22,0,22,0.0
ASSAM,TINSUKIA,2021-02-06,0,184,0,184,0.0
ASSAM,TINSUKIA,2021-02-07,3,193,0,196,0.0
ASSAM,TINSUKIA,2021-02-08,0,234,0,234,0.0
ASSAM,TINSUKIA,2021-02-09,2,308,0,310,0.0
ASSAM,TINSUKIA,2021-02-10,1,91,0,92,0.0
ASSAM,UDALGURI,2021-02-06,0,10,0,10,0.0
ASSAM,UDALGURI,2021-02-08,0,19,0,19,0.0
ASSAM,UDALGURI,2021-02-09,0,6,0,6,0.0
ASSAM,UDALGURI,2021-02-10,0,19,0,19,0.0
ASSAM,WEST KARBI ANGLONG,2021-02-06,0,127,0,127,0.0
ASSAM,WEST KARBI ANGLONG,2021-02-07,1,61,0,62,0.0
ASSAM,WEST KARBI ANGLONG,2021-02-08,0,56,0,56,0.0
ASSAM,WEST KARBI ANGLONG,2021-02-09,0,200,0,200,0.0
ASSAM,WEST KARBI ANGLONG,2021-02-10,0,104,0,104,0.0
BIHAR,ARARIA,2021-02-06,0,545,0,545,0.0
BIHAR,ARARIA,2021-02-07,0,227,0,227,0.0
BIHAR,ARARIA,2021-02-08,4,522,0,526,0.0
BIHAR,ARARIA,2021-02-09,0,480,0,480,0.0
BIHAR,ARARIA,2021-02-10,0,630,5,635,0.0
BIHAR,ARWAL,2021-02-06,1,1210,0,1211,0.0
BIHAR,ARWAL,2021-02-07,4,538,1,543,0.0
BIHAR,ARWAL,2021-02-08,0,780,6,786,0.0
BIHAR,ARWAL,2021-02-09,3,916,3,922,0.0
BIHAR,ARWAL,2021-02-10,0,2019,2,2021,0.0
BIHAR,AURANGABAD,2021-02-06,1,533,0,534,0.0
BIHAR,AURANGABAD,2021-02-07,0,176,0,176,0.0
BIHAR,AURANGABAD,2021-02-08,4,1226,4,1234,0.0
BIHAR,AURANGABAD,2021-02-09,2,1051,0,1053,0.0
BIHAR,AURANGABAD,2021-02-10,2,1593,0,1595,0.0
BIHAR,BANKA,2021-02-06,2,1455,0,1457,0.0
BIHAR,BANKA,2021-02-07,5,2156,236,2397,0.0
BIHAR,BANKA,2021-02-08,6,1848,47,1901,0.0
BIHAR,BANKA,2021-02-09,0,2461,1,2462,0.0
BIHAR,BANKA,2021-02-10,0,1404,73,1477,0.0
BIHAR,BEGUSARAI,2021-02-06,1,2623,0,2624,0.0
BIHAR,BEGUSARAI,2021-02-07,0,660,0,660,0.0
BIHAR,BEGUSARAI,2021-02-08,3,2777,0,2780,0.0
BIHAR,BEGUSARAI,2021-02-09,4,3727,0,3731,0.0
BIHAR,BEGUSARAI,2021-02-10,1,3740,1,3742,0.0
BIHAR,BHAGALPUR,2021-02-06,0,1172,75,1247,0.0
BIHAR,BHAGALPUR,2021-02-07,0,1532,8,1540,0.0
BIHAR,BHAGALPUR,2021-02-08,4,2628,75,2707,0.0
BIHAR,BHAGALPUR,2021-02-09,1,1412,68,1481,0.0
BIHAR,BHAGALPUR,2021-02-10,0,1859,389,2248,0.0
BIHAR,BHOJPUR,2021-02-06,0,655,21,676,0.0
BIHAR,BHOJPUR,2021-02-07,0,283,0,283,0.0
BIHAR,BHOJPUR,2021-02-08,3,699,30,732,0.0
BIHAR,BHOJPUR,2021-02-09,0,646,20,666,0.0
BIHAR,BHOJPUR,2021-02-10,1,577,27,605,0.0
BIHAR,BUXAR,2021-02-06,0,1022,31,1053,0.0
BIHAR,BUXAR,2021-02-07,0,325,0,325,0.0
BIHAR,BUXAR,2021-02-08,2,955,74,1031,0.0
BIHAR,BUXAR,2021-02-09,0,734,0,734,0.0
BIHAR,BUXAR,2021-02-10,0,884,51,935,0.0
BIHAR,DARBHANGA,2021-02-06,0,2239,57,2296,0.0
BIHAR,DARBHANGA,2021-02-07,2,1911,0,1913,0.0
BIHAR,DARBHANGA,2021-02-08,4,1825,2,1831,0.0
BIHAR,DARBHANGA,2021-02-09,2,1803,0,1805,0.0
BIHAR,DARBHANGA,2021-02-10,0,2031,1,2032,0.0
BIHAR,GAYA,2021-02-06,3,3090,20,3113,0.0
BIHAR,GAYA,2021-02-07,0,1299,12,1311,0.0
BIHAR,GAYA,2021-02-08,13,3234,2,3249,0.0
BIHAR,GAYA,2021-02-09,1,1397,19,1417,0.0
BIHAR,GAYA,2021-02-10,3,2346,66,2415,0.0
BIHAR,GOPALGANJ,2021-02-06,0,643,0,643,0.0
BIHAR,GOPALGANJ,2021-02-07,0,261,0,261,0.0
BIHAR,GOPALGANJ,2021-02-08,0,495,0,495,0.0
BIHAR,GOPALGANJ,2021-02-09,0,439,0,439,0.0
BIHAR,GOPALGANJ,2021-02-10,0,652,79,731,0.0
BIHAR,JAMUI,2021-02-06,0,1548,1,1549,0.0
BIHAR,JAMUI,2021-02-07,2,911,0,913,0.0
BIHAR,JAMUI,2021-02-08,4,775,1,780,0.0
BIHAR,JAMUI,2021-02-09,1,956,0,957,0.0
BIHAR,JAMUI,2021-02-10,0,1036,1,1037,0.0
BIHAR,JEHANABAD,2021-02-06,2,1202,6,1210,0.0
BIHAR,JEHANABAD,2021-02-07,0,745,35,780,0.0
BIHAR,JEHANABAD,2021-02-08,2,910,2,914,0.0
BIHAR,JEHANABAD,2021-02-09,1,817,0,818,0.0
BIHAR,JEHANABAD,2021-02-10,0,990,5,995,0.0
BIHAR,KAIMUR (BHABUA),2021-02-06,0,859,0,859,0.0
BIHAR,KAIMUR (BHABUA),2021-02-07,0,761,0,761,0.0
BIHAR,KAIMUR (BHABUA),2021-02-08,1,898,0,899,0.0
BIHAR,KAIMUR (BHABUA),2021-02-09,0,2116,0,2116,0.0
BIHAR,KAIMUR (BHABUA),2021-02-10,3,2203,0,2206,0.0
BIHAR,KATIHAR,2021-02-06,0,911,0,911,0.0
BIHAR,KATIHAR,2021-02-07,0,1094,0,1094,0.0
BIHAR,KATIHAR,2021-02-08,2,760,0,762,0.0
BIHAR,KATIHAR,2021-02-09,2,1919,3,1924,0.0
BIHAR,KATIHAR,2021-02-10,0,984,0,984,0.0
BIHAR,KHAGARIA,2021-02-06,0,543,2,545,0.0
BIHAR,KHAGARIA,2021-02-07,0,794,0,794,0.0
BIHAR,KHAGARIA,2021-02-08,0,595,0,595,0.0
BIHAR,KHAGARIA,2021-02-09,0,512,0,512,0.0
BIHAR,KHAGARIA,2021-02-10,0,1051,1,1052,0.0
BIHAR,KISHANGANJ,2021-02-06,0,761,0,761,0.0
BIHAR,KISHANGANJ,2021-02-07,0,195,0,195,0.0
BIHAR,KISHANGANJ,2021-02-08,1,705,0,706,0.0
BIHAR,KISHANGANJ,2021-02-09,1,751,2,754,0.0
BIHAR,KISHANGANJ,2021-02-10,0,608,1,609,0.0
BIHAR,LAKHISARAI,2021-02-06,1,541,0,542,0.0
BIHAR,LAKHISARAI,2021-02-07,1,201,0,202,0.0
BIHAR,LAKHISARAI,2021-02-08,2,429,0,431,0.0
BIHAR,LAKHISARAI,2021-02-09,1,463,0,464,0.0
BIHAR,LAKHISARAI,2021-02-10,1,578,0,579,0.0
BIHAR,MADHEPURA,2021-02-06,1,1281,0,1282,0.0
BIHAR,MADHEPURA,2021-02-07,0,1268,0,1268,0.0
BIHAR,MADHEPURA,2021-02-08,4,1672,0,1676,0.0
BIHAR,MADHEPURA,2021-02-09,0,1517,0,1517,0.0
BIHAR,MADHEPURA,2021-02-10,0,1031,0,1031,0.0
BIHAR,MADHUBANI,2021-02-06,0,1197,14,1211,0.0
BIHAR,MADHUBANI,2021-02-07,2,517,8,527,0.0
BIHAR,MADHUBANI,2021-02-08,3,1773,24,1800,0.0
BIHAR,MADHUBANI,2021-02-09,0,1124,8,1132,0.0
BIHAR,MADHUBANI,2021-02-10,3,1011,1,1015,0.0
BIHAR,MUNGER,2021-02-06,1,1141,0,1142,0.0
BIHAR,MUNGER,2021-02-07,1,443,0,444,0.0
BIHAR,MUNGER,2021-02-08,1,1686,11,1698,0.0
BIHAR,MUNGER,2021-02-09,1,864,36,901,0.0
BIHAR,MUNGER,2021-02-10,0,997,15,1012,0.0
BIHAR,MUZAFFARPUR,2021-02-06,2,1316,0,1318,0.0
BIHAR,MUZAFFARPUR,2021-02-07,2,1526,0,1528,0.0
BIHAR,MUZAFFARPUR,2021-02-08,1,1385,0,1386,0.0
BIHAR,MUZAFFARPUR,2021-02-09,5,2056,0,2061,0.0
BIHAR,MUZAFFARPUR,2021-02-10,1,2035,0,2036,0.0
BIHAR,NALANDA,2021-02-06,2,2371,1,2374,0.0
BIHAR,NALANDA,2021-02-07,0,2569,2,2571,0.0
BIHAR,NALANDA,2021-02-08,0,2990,83,3073,0.0
BIHAR,NALANDA,2021-02-09,5,3301,2,3308,0.0
BIHAR,NALANDA,2021-02-10,0,3113,6,3119,0.0
BIHAR,NAWADA,2021-02-06,0,898,0,898,0.0
BIHAR,NAWADA,2021-02-07,0,943,0,943,0.0
BIHAR,NAWADA,2021-02-08,0,901,0,901,0.0
BIHAR,NAWADA,2021-02-09,0,1580,0,1580,0.0
BIHAR,NAWADA,2021-02-10,0,594,0,594,0.0
BIHAR,PASHCHIM CHAMPARAN,2021-02-06,1,1115,1,1117,0.0
BIHAR,PASHCHIM CHAMPARAN,2021-02-07,0,506,1,507,0.0
BIHAR,PASHCHIM CHAMPARAN,2021-02-08,1,1246,1,1248,0.0
BIHAR,PASHCHIM CHAMPARAN,2021-02-09,4,2030,0,2034,0.0
BIHAR,PASHCHIM CHAMPARAN,2021-02-10,0,605,1,606,0.0
BIHAR,PATNA,2021-02-06,22,3203,21,3246,0.0
BIHAR,PATNA,2021-02-07,20,2327,5,2352,0.0
BIHAR,PATNA,2021-02-08,28,3169,2,3199,0.0
BIHAR,PATNA,2021-02-09,12,3125,3,3140,0.0
BIHAR,PATNA,2021-02-10,36,3547,3,3586,0.0
BIHAR,PURBI CHAMPARAN,2021-02-06,1,3003,8,3012,0.0
BIHAR,PURBI CHAMPARAN,2021-02-07,1,1844,1,1846,0.0
BIHAR,PURBI CHAMPARAN,2021-02-08,0,1689,0,1689,0.0
BIHAR,PURBI CHAMPARAN,2021-02-09,3,2002,3,2008,0.0
BIHAR,PURBI CHAMPARAN,2021-02-10,1,2813,5,2819,0.0
BIHAR,PURNIA,2021-02-06,0,980,124,1104,0.0
BIHAR,PURNIA,2021-02-07,0,841,0,841,0.0
BIHAR,PURNIA,2021-02-08,0,1015,0,1015,0.0
BIHAR,PURNIA,2021-02-09,2,969,0,971,0.0
BIHAR,PURNIA,2021-02-10,5,900,0,905,0.0
BIHAR,ROHTAS,2021-02-06,2,1024,23,1049,0.0
BIHAR,ROHTAS,2021-02-07,0,437,0,437,0.0
BIHAR,ROHTAS,2021-02-08,0,1192,1,1193,0.0
BIHAR,ROHTAS,2021-02-09,2,2112,36,2150,0.0
BIHAR,ROHTAS,2021-02-10,4,1738,25,1767,0.0
BIHAR,SAHARSA,2021-02-06,1,640,3,644,0.0
BIHAR,SAHARSA,2021-02-07,7,135,0,142,0.0
BIHAR,SAHARSA,2021-02-08,1,642,141,784,0.0
BIHAR,SAHARSA,2021-02-09,0,419,1,420,0.0
BIHAR,SAHARSA,2021-02-10,1,805,0,806,0.0
BIHAR,SAMASTIPUR,2021-02-06,2,2091,25,2118,0.0
BIHAR,SAMASTIPUR,2021-02-07,2,2050,15,2067,0.0
BIHAR,SAMASTIPUR,2021-02-08,6,3171,22,3199,0.0
BIHAR,SAMASTIPUR,2021-02-09,1,2373,18,2392,0.0
BIHAR,SAMASTIPUR,2021-02-10,3,2690,28,2721,0.0
BIHAR,SARAN,2021-02-06,4,816,0,820,0.0
BIHAR,SARAN,2021-02-07,7,660,0,667,0.0
BIHAR,SARAN,2021-02-08,2,2585,1,2588,0.0
BIHAR,SARAN,2021-02-09,4,2362,1,2367,0.0
BIHAR,SARAN,2021-02-10,2,1932,0,1934,0.0
BIHAR,SHEIKHPURA,2021-02-06,0,60,5,65,0.0
BIHAR,SHEIKHPURA,2021-02-07,0,301,0,301,0.0
BIHAR,SHEIKHPURA,2021-02-08,0,387,3,390,0.0
BIHAR,SHEIKHPURA,2021-02-09,0,310,0,310,0.0
BIHAR,SHEIKHPURA,2021-02-10,0,693,13,706,0.0
BIHAR,SHEOHAR,2021-02-06,3,839,0,842,0.0
BIHAR,SHEOHAR,2021-02-07,0,257,0,257,0.0
BIHAR,SHEOHAR,2021-02-08,1,1076,0,1077,0.0
BIHAR,SHEOHAR,2021-02-09,0,415,0,415,0.0
BIHAR,SHEOHAR,2021-02-10,3,751,0,754,0.0
BIHAR,SITAMARHI,2021-02-06,0,879,0,879,0.0
BIHAR,SITAMARHI,2021-02-07,1,1051,0,1052,0.0
BIHAR,SITAMARHI,2021-02-08,1,879,0,880,0.0
BIHAR,SITAMARHI,2021-02-09,1,1174,1,1176,0.0
BIHAR,SITAMARHI,2021-02-10,0,824,0,824,0.0
BIHAR,SIWAN,2021-02-06,1,1045,0,1046,0.0
BIHAR,SIWAN,2021-02-07,1,1327,0,1328,0.0
BIHAR,SIWAN,2021-02-08,2,1564,0,1566,0.0
BIHAR,SIWAN,2021-02-09,7,1864,0,1871,0.0
BIHAR,SIWAN,2021-02-10,1,1404,1,1406,0.0
BIHAR,SUPAUL,2021-02-06,1,1315,5,1321,0.0
BIHAR,SUPAUL,2021-02-07,0,1008,0,1008,0.0
BIHAR,SUPAUL,2021-02-08,2,1155,22,1179,0.0
BIHAR,SUPAUL,2021-02-09,1,1418,44,1463,0.0
BIHAR,SUPAUL,2021-02-10,0,1225,15,1240,0.0
BIHAR,VAISHALI,2021-02-06,4,2507,94,2605,0.0
BIHAR,VAISHALI,2021-02-07,0,2139,38,2177,0.0
BIHAR,VAISHALI,2021-02-08,3,2568,12,2583,0.0
BIHAR,VAISHALI,2021-02-09,4,3236,0,3240,0.0
BIHAR,VAISHALI,2021-02-10,0,2931,0,2931,0.0
CHANDIGARH,CHANDIGARH,2021-02-06,25,1174,2,1201,0.0
CHANDIGARH,CHANDIGARH,2021-02-07,26,591,3,620,0.0
CHANDIGARH,CHANDIGARH,2021-02-08,26,1259,1,1286,0.0
CHANDIGARH,CHANDIGARH,2021-02-09,24,1473,3,1500,0.0
CHANDIGARH,CHANDIGARH,2021-02-10,21,1440,8,1469,0.0
CHHATTISGARH,BALOD,2021-02-06,3,934,0,937,0.0
CHHATTISGARH,BALOD,2021-02-07,3,561,0,564,0.0
CHHATTISGARH,BALOD,2021-02-08,1,850,0,851,0.0
CHHATTISGARH,BALOD,2021-02-09,2,942,0,944,0.0
CHHATTISGARH,BALOD,2021-02-10,4,921,0,925,0.0
CHHATTISGARH,BALODA BAZAR,2021-02-06,9,483,2,494,0.0
CHHATTISGARH,BALODA BAZAR,2021-02-07,6,273,0,279,0.0
CHHATTISGARH,BALODA BAZAR,2021-02-08,7,935,5,947,0.0
CHHATTISGARH,BALODA BAZAR,2021-02-09,24,579,28,631,0.0
CHHATTISGARH,BALODA BAZAR,2021-02-10,7,368,36,411,0.0
CHHATTISGARH,BALRAMPUR,2021-02-06,1,495,1,497,0.0
CHHATTISGARH,BALRAMPUR,2021-02-07,1,121,0,122,0.0
CHHATTISGARH,BALRAMPUR,2021-02-08,1,357,1,359,0.0
CHHATTISGARH,BALRAMPUR,2021-02-09,0,254,0,254,0.0
CHHATTISGARH,BALRAMPUR,2021-02-10,2,370,0,372,0.0
CHHATTISGARH,BASTAR,2021-02-06,5,906,0,911,0.0
CHHATTISGARH,BASTAR,2021-02-07,1,365,1,367,0.0
CHHATTISGARH,BASTAR,2021-02-08,6,1240,0,1246,0.0
CHHATTISGARH,BASTAR,2021-02-09,6,1130,0,1136,0.0
CHHATTISGARH,BASTAR,2021-02-10,5,2584,0,2589,0.0
CHHATTISGARH,BEMETARA,2021-02-06,3,461,0,464,0.0
CHHATTISGARH,BEMETARA,2021-02-07,1,353,1,355,0.0
CHHATTISGARH,BEMETARA,2021-02-08,5,773,0,778,0.0
CHHATTISGARH,BEMETARA,2021-02-09,4,349,0,353,0.0
CHHATTISGARH,BEMETARA,2021-02-10,2,616,0,618,0.0
CHHATTISGARH,BIJAPUR,2021-02-06,0,117,1,118,0.0
CHHATTISGARH,BIJAPUR,2021-02-07,0,57,0,57,0.0
CHHATTISGARH,BIJAPUR,2021-02-08,0,93,0,93,0.0
CHHATTISGARH,BIJAPUR,2021-02-09,0,105,0,105,0.0
CHHATTISGARH,BIJAPUR,2021-02-10,0,240,0,240,0.0
CHHATTISGARH,BILASPUR,2021-02-06,41,702,7,750,0.0
CHHATTISGARH,BILASPUR,2021-02-07,18,314,7,339,0.0
CHHATTISGARH,BILASPUR,2021-02-08,17,892,1,910,0.0
CHHATTISGARH,BILASPUR,2021-02-09,12,738,7,757,0.0
CHHATTISGARH,BILASPUR,2021-02-10,17,923,8,948,0.0
CHHATTISGARH,DANTEWADA,2021-02-06,0,264,1,265,0.0
CHHATTISGARH,DANTEWADA,2021-02-07,0,130,0,130,0.0
CHHATTISGARH,DANTEWADA,2021-02-08,0,467,0,467,0.0
CHHATTISGARH,DANTEWADA,2021-02-09,1,738,0,739,0.0
CHHATTISGARH,DANTEWADA,2021-02-10,0,520,0,520,0.0
CHHATTISGARH,DHAMTARI,2021-02-06,13,658,12,683,0.0
CHHATTISGARH,DHAMTARI,2021-02-07,3,99,5,107,0.0
CHHATTISGARH,DHAMTARI,2021-02-08,10,871,8,889,0.0
CHHATTISGARH,DHAMTARI,2021-02-09,9,677,52,738,0.0
CHHATTISGARH,DHAMTARI,2021-02-10,2,548,27,577,0.0
CHHATTISGARH,DURG,2021-02-06,48,1051,2,1101,0.0
CHHATTISGARH,DURG,2021-02-07,41,738,1,780,0.0
CHHATTISGARH,DURG,2021-02-08,39,1032,5,1076,0.0
CHHATTISGARH,DURG,2021-02-09,32,1177,1,1210,0.0
CHHATTISGARH,DURG,2021-02-10,38,903,2,943,0.0
CHHATTISGARH,GARIYABAND,2021-02-06,3,260,19,282,0.0
CHHATTISGARH,GARIYABAND,2021-02-07,5,61,2,68,0.0
CHHATTISGARH,GARIYABAND,2021-02-08,2,225,2,229,0.0
CHHATTISGARH,GARIYABAND,2021-02-09,4,256,5,265,0.0
CHHATTISGARH,GARIYABAND,2021-02-10,4,148,4,156,0.0
CHHATTISGARH,GAURELLA PENDRA MARWAHI,2021-02-06,0,70,0,70,0.0
CHHATTISGARH,GAURELLA PENDRA MARWAHI,2021-02-07,0,84,15,99,0.0
CHHATTISGARH,GAURELLA PENDRA MARWAHI,2021-02-08,0,333,9,342,0.0
CHHATTISGARH,GAURELLA PENDRA MARWAHI,2021-02-09,0,206,0,206,0.0
CHHATTISGARH,GAURELLA PENDRA MARWAHI,2021-02-10,0,169,1,170,0.0
CHHATTISGARH,JANJGIR CHAMPA,2021-02-06,4,1300,3,1307,0.0
CHHATTISGARH,JANJGIR CHAMPA,2021-02-07,3,1281,4,1288,0.0
CHHATTISGARH,JANJGIR CHAMPA,2021-02-08,4,1434,0,1438,0.0
CHHATTISGARH,JANJGIR CHAMPA,2021-02-09,9,2580,1,2590,0.0
CHHATTISGARH,JANJGIR CHAMPA,2021-02-10,2,1458,0,1460,0.0
CHHATTISGARH,JASHPUR,2021-02-06,5,484,0,489,0.0
CHHATTISGARH,JASHPUR,2021-02-07,4,88,0,92,0.0
CHHATTISGARH,JASHPUR,2021-02-08,3,384,0,387,0.0
CHHATTISGARH,JASHPUR,2021-02-09,0,528,0,528,0.0
CHHATTISGARH,JASHPUR,2021-02-10,2,277,0,279,0.0
CHHATTISGARH,KABIRDHAM,2021-02-06,2,157,5,164,0.0
CHHATTISGARH,KABIRDHAM,2021-02-07,2,353,4,359,0.0
CHHATTISGARH,KABIRDHAM,2021-02-08,0,442,5,447,0.0
CHHATTISGARH,KABIRDHAM,2021-02-09,1,74,0,75,0.0
CHHATTISGARH,KABIRDHAM,2021-02-10,3,478,2,483,0.0
CHHATTISGARH,KANKER,2021-02-06,4,162,0,166,0.0
CHHATTISGARH,KANKER,2021-02-07,3,107,0,110,0.0
CHHATTISGARH,KANKER,2021-02-08,2,330,0,332,0.0
CHHATTISGARH,KANKER,2021-02-09,3,647,0,650,0.0
CHHATTISGARH,KANKER,2021-02-10,2,619,0,621,0.0
CHHATTISGARH,KONDAGAON,2021-02-06,0,526,0,526,0.0
CHHATTISGARH,KONDAGAON,2021-02-07,0,138,0,138,0.0
CHHATTISGARH,KONDAGAON,2021-02-08,3,556,0,559,0.0
CHHATTISGARH,KONDAGAON,2021-02-09,3,565,0,568,0.0
CHHATTISGARH,KONDAGAON,2021-02-10,3,1376,0,1379,0.0
CHHATTISGARH,KORBA,2021-02-06,18,872,0,890,0.0
CHHATTISGARH,KORBA,2021-02-07,3,507,0,510,0.0
CHHATTISGARH,KORBA,2021-02-08,23,1113,1,1137,0.0
CHHATTISGARH,KORBA,2021-02-09,3,762,0,765,0.0
CHHATTISGARH,KORBA,2021-02-10,7,886,0,893,0.0
CHHATTISGARH,KOREA,2021-02-06,1,729,0,730,0.0
CHHATTISGARH,KOREA,2021-02-07,2,513,1,516,0.0
CHHATTISGARH,KOREA,2021-02-08,10,928,2,940,0.0
CHHATTISGARH,KOREA,2021-02-09,0,955,2,957,0.0
CHHATTISGARH,KOREA,2021-02-10,3,534,0,537,0.0
CHHATTISGARH,MAHASAMUND,2021-02-06,5,877,1,883,0.0
CHHATTISGARH,MAHASAMUND,2021-02-07,9,728,0,737,0.0
CHHATTISGARH,MAHASAMUND,2021-02-08,11,1386,0,1397,0.0
CHHATTISGARH,MAHASAMUND,2021-02-09,15,1481,10,1506,0.0
CHHATTISGARH,MAHASAMUND,2021-02-10,11,864,12,887,0.0
CHHATTISGARH,MUNGELI,2021-02-06,1,456,0,457,0.0
CHHATTISGARH,MUNGELI,2021-02-07,0,161,0,161,0.0
CHHATTISGARH,MUNGELI,2021-02-08,3,282,0,285,0.0
CHHATTISGARH,MUNGELI,2021-02-09,4,381,0,385,0.0
CHHATTISGARH,MUNGELI,2021-02-10,3,501,0,504,0.0
CHHATTISGARH,NARAYANPUR,2021-02-06,0,48,0,48,0.0
CHHATTISGARH,NARAYANPUR,2021-02-07,0,59,0,59,0.0
CHHATTISGARH,NARAYANPUR,2021-02-08,1,610,0,611,0.0
CHHATTISGARH,NARAYANPUR,2021-02-09,1,167,0,168,0.0
CHHATTISGARH,NARAYANPUR,2021-02-10,0,174,0,174,0.0
CHHATTISGARH,RAIGARH,2021-02-06,14,1081,1,1096,0.0
CHHATTISGARH,RAIGARH,2021-02-07,6,731,6,743,0.0
CHHATTISGARH,RAIGARH,2021-02-08,28,881,1,910,0.0
CHHATTISGARH,RAIGARH,2021-02-09,22,921,0,943,0.0
CHHATTISGARH,RAIGARH,2021-02-10,29,1487,1,1517,0.0
CHHATTISGARH,RAIPUR,2021-02-06,104,2166,31,2301,0.0
CHHATTISGARH,RAIPUR,2021-02-07,55,846,12,913,0.0
CHHATTISGARH,RAIPUR,2021-02-08,86,2030,13,2129,0.0
CHHATTISGARH,RAIPUR,2021-02-09,84,2035,21,2140,0.0
CHHATTISGARH,RAIPUR,2021-02-10,88,2195,19,2302,0.0
CHHATTISGARH,RAJNANDGAON,2021-02-06,7,794,2,803,0.0
CHHATTISGARH,RAJNANDGAON,2021-02-07,7,452,29,488,0.0
CHHATTISGARH,RAJNANDGAON,2021-02-08,9,719,31,759,0.0
CHHATTISGARH,RAJNANDGAON,2021-02-09,5,1214,0,1219,0.0
CHHATTISGARH,RAJNANDGAON,2021-02-10,8,921,14,943,0.0
CHHATTISGARH,SUKMA,2021-02-06,0,123,0,123,0.0
CHHATTISGARH,SUKMA,2021-02-07,0,10,0,10,0.0
CHHATTISGARH,SUKMA,2021-02-08,0,130,0,130,0.0
CHHATTISGARH,SUKMA,2021-02-09,0,109,0,109,0.0
CHHATTISGARH,SUKMA,2021-02-10,0,337,0,337,0.0
CHHATTISGARH,SURAJPUR,2021-02-06,5,896,6,907,0.0
CHHATTISGARH,SURAJPUR,2021-02-07,5,781,21,807,0.0
CHHATTISGARH,SURAJPUR,2021-02-08,17,762,0,779,0.0
CHHATTISGARH,SURAJPUR,2021-02-09,5,866,15,886,0.0
CHHATTISGARH,SURAJPUR,2021-02-10,7,1118,4,1129,0.0
CHHATTISGARH,SURGUJA,2021-02-06,4,478,0,482,0.0
CHHATTISGARH,SURGUJA,2021-02-07,8,224,1,233,0.0
CHHATTISGARH,SURGUJA,2021-02-08,10,494,0,504,0.0
CHHATTISGARH,SURGUJA,2021-02-09,8,551,0,559,0.0
CHHATTISGARH,SURGUJA,2021-02-10,9,480,0,489,0.0
DADRA AND NAGAR HAVELI,DADRA AND NAGAR HAVELI,2021-02-06,0,208,0,208,0.0
DADRA AND NAGAR HAVELI,DADRA AND NAGAR HAVELI,2021-02-07,0,96,0,96,0.0
DADRA AND NAGAR HAVELI,DADRA AND NAGAR HAVELI,2021-02-08,0,241,0,241,0.0
DADRA AND NAGAR HAVELI,DADRA AND NAGAR HAVELI,2021-02-09,0,337,0,337,0.0
DADRA AND NAGAR HAVELI,DADRA AND NAGAR HAVELI,2021-02-10,0,226,0,226,0.0
DAMAN AND DIU,DAMAN,2021-02-06,0,47,0,47,0.0
DAMAN AND DIU,DAMAN,2021-02-07,0,76,0,76,0.0
DAMAN AND DIU,DAMAN,2021-02-08,0,28,0,28,0.0
DAMAN AND DIU,DAMAN,2021-02-09,0,76,0,76,0.0
DAMAN AND DIU,DAMAN,2021-02-10,0,75,0,75,0.0
DAMAN AND DIU,DIU,2021-02-06,0,22,0,22,0.0
DAMAN AND DIU,DIU,2021-02-07,0,37,0,37,0.0
DAMAN AND DIU,DIU,2021-02-08,0,9,0,9,0.0
DAMAN AND DIU,DIU,2021-02-09,0,41,0,41,0.0
DAMAN AND DIU,DIU,2021-02-10,0,29,0,29,0.0
DELHI,CENTRAL,2021-02-06,6,3614,6,3626,0.0
DELHI,CENTRAL,2021-02-07,19,3309,0,3328,0.0
DELHI,CENTRAL,2021-02-08,10,3855,3,3868,0.0
DELHI,CENTRAL,2021-02-09,10,4993,2,5005,0.0
DELHI,CENTRAL,2021-02-10,12,5010,2,5024,0.0
DELHI,EAST,2021-02-06,16,3701,1,3718,0.0
DELHI,EAST,2021-02-07,7,3225,2,3234,0.0
DELHI,EAST,2021-02-08,9,4214,0,4223,0.0
DELHI,EAST,2021-02-09,8,4914,4,4926,0.0
DELHI,EAST,2021-02-10,19,5071,4,5094,0.0
DELHI,NEW DELHI,2021-02-06,22,4835,13,4870,0.0
DELHI,NEW DELHI,2021-02-07,10,3717,3,3730,0.0
DELHI,NEW DELHI,2021-02-08,17,4481,12,4510,0.0
DELHI,NEW DELHI,2021-02-09,20,6275,18,6313,0.0
DELHI,NEW DELHI,2021-02-10,19,5979,15,6013,0.0
DELHI,NORTH,2021-02-06,5,6305,1,6311,0.0
DELHI,NORTH,2021-02-07,18,9722,3,9743,0.0
DELHI,NORTH,2021-02-08,3,7634,20,7657,0.0
DELHI,NORTH,2021-02-09,11,7367,11,7389,0.0
DELHI,NORTH,2021-02-10,3,7035,5,7043,0.0
DELHI,NORTH EAST,2021-02-06,2,4303,9,4314,0.0
DELHI,NORTH EAST,2021-02-07,5,3747,10,3762,0.0
DELHI,NORTH EAST,2021-02-08,3,4739,26,4768,0.0
DELHI,NORTH EAST,2021-02-09,4,5891,8,5903,0.0
DELHI,NORTH EAST,2021-02-10,4,4960,8,4972,0.0
DELHI,NORTH WEST,2021-02-06,25,4358,15,4398,0.0
DELHI,NORTH WEST,2021-02-07,13,4694,11,4718,0.0
DELHI,NORTH WEST,2021-02-08,14,5614,17,5645,0.0
DELHI,NORTH WEST,2021-02-09,13,5328,28,5369,0.0
DELHI,NORTH WEST,2021-02-10,22,5001,20,5043,0.0
DELHI,SHAHDARA,2021-02-06,2,6285,6,6293,0.0
DELHI,SHAHDARA,2021-02-07,1,4486,5,4492,0.0
DELHI,SHAHDARA,2021-02-08,4,6323,2,6329,0.0
DELHI,SHAHDARA,2021-02-09,3,7023,1,7027,0.0
DELHI,SHAHDARA,2021-02-10,3,7260,13,7276,0.0
DELHI,SOUTH,2021-02-06,30,4641,7,4678,0.0
DELHI,SOUTH,2021-02-07,24,6560,3,6587,0.0
DELHI,SOUTH,2021-02-08,25,4993,14,5032,0.0
DELHI,SOUTH,2021-02-09,39,6843,19,6901,0.0
DELHI,SOUTH,2021-02-10,30,5259,16,5305,0.0
DELHI,SOUTH EAST,2021-02-06,5,4184,1,4190,0.0
DELHI,SOUTH EAST,2021-02-07,7,4576,2,4585,0.0
DELHI,SOUTH EAST,2021-02-08,4,3977,1,3982,0.0
DELHI,SOUTH EAST,2021-02-09,2,5525,1,5528,0.0
DELHI,SOUTH EAST,2021-02-10,16,5474,2,5492,0.0
DELHI,SOUTH WEST,2021-02-06,14,3577,2,3593,0.0
DELHI,SOUTH WEST,2021-02-07,25,2513,1,2539,0.0
DELHI,SOUTH WEST,2021-02-08,15,2162,2,2179,0.0
DELHI,SOUTH WEST,2021-02-09,17,3758,25,3800,0.0
DELHI,SOUTH WEST,2021-02-10,27,3685,6,3718,0.0
DELHI,WEST,2021-02-06,13,8294,3,8310,0.0
DELHI,WEST,2021-02-07,13,8682,2,8697,0.0
DELHI,WEST,2021-02-08,11,8252,1,8264,0.0
DELHI,WEST,2021-02-09,14,8774,5,8793,1.0
DELHI,WEST,2021-02-10,28,9340,0,9368,0.0
GOA,NORTH GOA,2021-02-06,30,661,1,692,0.0
GOA,NORTH GOA,2021-02-07,9,341,2,352,0.0
GOA,NORTH GOA,2021-02-08,21,663,1,685,0.0
GOA,NORTH GOA,2021-02-09,23,843,3,869,0.0
GOA,NORTH GOA,2021-02-10,27,799,2,828,0.0
GOA,SOUTH GOA,2021-02-06,31,673,0,704,0.0
GOA,SOUTH GOA,2021-02-07,25,369,0,394,0.0
GOA,SOUTH GOA,2021-02-08,57,795,0,852,0.0
GOA,SOUTH GOA,2021-02-09,35,860,1,896,0.0
GOA,SOUTH GOA,2021-02-10,54,889,0,943,0.0
GUJARAT,AHMADABAD,2021-02-06,40,3413,62,3515,0.0
GUJARAT,AHMADABAD,2021-02-07,41,1577,1,1619,0.0
GUJARAT,AHMADABAD,2021-02-08,34,3371,21,3426,0.0
GUJARAT,AHMADABAD,2021-02-09,45,2668,4,2717,0.0
GUJARAT,AHMADABAD,2021-02-10,60,2455,3,2518,0.0
GUJARAT,AMRELI,2021-02-06,1,472,0,473,0.0
GUJARAT,AMRELI,2021-02-07,2,244,0,246,0.0
GUJARAT,AMRELI,2021-02-08,9,465,3,477,0.0
GUJARAT,AMRELI,2021-02-09,1,476,0,477,0.0
GUJARAT,AMRELI,2021-02-10,6,563,9,578,0.0
GUJARAT,ANAND,2021-02-06,11,277,11,299,0.0
GUJARAT,ANAND,2021-02-07,2,112,0,114,0.0
GUJARAT,ANAND,2021-02-08,5,305,1,311,0.0
GUJARAT,ANAND,2021-02-09,12,406,0,418,0.0
GUJARAT,ANAND,2021-02-10,6,343,0,349,0.0
GUJARAT,ARVALLI,2021-02-06,1,187,0,188,0.0
GUJARAT,ARVALLI,2021-02-07,0,49,10,59,0.0
GUJARAT,ARVALLI,2021-02-08,0,218,0,218,0.0
GUJARAT,ARVALLI,2021-02-09,1,160,0,161,0.0
GUJARAT,ARVALLI,2021-02-10,1,298,3,302,0.0
GUJARAT,BANAS KANTHA,2021-02-06,1,175,0,176,0.0
GUJARAT,BANAS KANTHA,2021-02-07,2,50,0,52,0.0
GUJARAT,BANAS KANTHA,2021-02-08,1,197,0,198,0.0
GUJARAT,BANAS KANTHA,2021-02-09,2,279,0,281,0.0
GUJARAT,BANAS KANTHA,2021-02-10,3,345,0,348,0.0
GUJARAT,BHARUCH,2021-02-06,3,386,0,389,0.0
GUJARAT,BHARUCH,2021-02-07,0,61,0,61,0.0
GUJARAT,BHARUCH,2021-02-08,8,545,3,556,0.0
GUJARAT,BHARUCH,2021-02-09,2,431,0,433,0.0
GUJARAT,BHARUCH,2021-02-10,6,526,0,532,0.0
GUJARAT,BHAVNAGAR,2021-02-06,2,620,3,625,0.0
GUJARAT,BHAVNAGAR,2021-02-07,0,265,0,265,0.0
GUJARAT,BHAVNAGAR,2021-02-08,5,605,1,611,0.0
GUJARAT,BHAVNAGAR,2021-02-09,7,471,1,479,0.0
GUJARAT,BHAVNAGAR,2021-02-10,7,876,0,883,0.0
GUJARAT,BOTAD,2021-02-06,1,183,0,184,0.0
GUJARAT,BOTAD,2021-02-07,0,121,0,121,0.0
GUJARAT,BOTAD,2021-02-08,1,366,0,367,0.0
GUJARAT,BOTAD,2021-02-09,0,355,0,355,0.0
GUJARAT,BOTAD,2021-02-10,0,240,0,240,0.0
GUJARAT,CHHOTAUDEPUR,2021-02-06,2,170,0,172,0.0
GUJARAT,CHHOTAUDEPUR,2021-02-07,0,25,0,25,0.0
GUJARAT,CHHOTAUDEPUR,2021-02-08,0,165,1,166,0.0
GUJARAT,CHHOTAUDEPUR,2021-02-09,3,158,0,161,0.0
GUJARAT,CHHOTAUDEPUR,2021-02-10,0,115,0,115,0.0
GUJARAT,DANG,2021-02-06,0,50,0,50,0.0
GUJARAT,DANG,2021-02-07,0,21,0,21,0.0
GUJARAT,DANG,2021-02-08,0,138,0,138,0.0
GUJARAT,DANG,2021-02-09,0,127,0,127,0.0
GUJARAT,DANG,2021-02-10,0,123,0,123,0.0
GUJARAT,DEVBHUMI DWARKA,2021-02-06,1,129,0,130,0.0
GUJARAT,DEVBHUMI DWARKA,2021-02-07,2,49,0,51,0.0
GUJARAT,DEVBHUMI DWARKA,2021-02-08,11,134,0,145,0.0
GUJARAT,DEVBHUMI DWARKA,2021-02-09,5,193,1,199,0.0
GUJARAT,DEVBHUMI DWARKA,2021-02-10,0,158,0,158,0.0
GUJARAT,DOHAD,2021-02-06,0,282,0,282,0.0
GUJARAT,DOHAD,2021-02-07,5,158,0,163,0.0
GUJARAT,DOHAD,2021-02-08,1,225,0,226,0.0
GUJARAT,DOHAD,2021-02-09,0,394,0,394,0.0
GUJARAT,DOHAD,2021-02-10,1,417,0,418,0.0
GUJARAT,GANDHINAGAR,2021-02-06,10,516,27,553,0.0
GUJARAT,GANDHINAGAR,2021-02-07,4,222,0,226,0.0
GUJARAT,GANDHINAGAR,2021-02-08,6,746,1,753,0.0
GUJARAT,GANDHINAGAR,2021-02-09,8,760,0,768,0.0
GUJARAT,GANDHINAGAR,2021-02-10,11,826,1,838,0.0
GUJARAT,GIR SOMNATH,2021-02-06,3,228,0,231,0.0
GUJARAT,GIR SOMNATH,2021-02-07,4,102,0,106,0.0
GUJARAT,GIR SOMNATH,2021-02-08,7,308,0,315,0.0
GUJARAT,GIR SOMNATH,2021-02-09,1,224,0,225,0.0
GUJARAT,GIR SOMNATH,2021-02-10,17,423,0,440,0.0
GUJARAT,JAMNAGAR,2021-02-06,8,978,2,988,0.0
GUJARAT,JAMNAGAR,2021-02-07,15,502,0,517,0.0
GUJARAT,JAMNAGAR,2021-02-08,10,1007,5,1022,0.0
GUJARAT,JAMNAGAR,2021-02-09,9,1432,1,1442,0.0
GUJARAT,JAMNAGAR,2021-02-10,9,1245,2,1256,0.0
GUJARAT,JUNAGADH,2021-02-06,8,496,0,504,0.0
GUJARAT,JUNAGADH,2021-02-07,3,200,0,203,0.0
GUJARAT,JUNAGADH,2021-02-08,6,623,0,629,0.0
GUJARAT,JUNAGADH,2021-02-09,6,481,0,487,0.0
GUJARAT,JUNAGADH,2021-02-10,5,579,0,584,0.0
GUJARAT,KACHCHH,2021-02-06,15,247,11,273,0.0
GUJARAT,KACHCHH,2021-02-07,18,216,7,241,0.0
GUJARAT,KACHCHH,2021-02-08,17,309,3,329,0.0
GUJARAT,KACHCHH,2021-02-09,14,443,4,461,0.0
GUJARAT,KACHCHH,2021-02-10,12,367,0,379,0.0
GUJARAT,KHEDA,2021-02-06,2,242,3,247,0.0
GUJARAT,KHEDA,2021-02-07,4,173,0,177,0.0
GUJARAT,KHEDA,2021-02-08,0,306,2,308,0.0
GUJARAT,KHEDA,2021-02-09,6,557,4,567,0.0
GUJARAT,KHEDA,2021-02-10,3,547,0,550,0.0
GUJARAT,MAHESANA,2021-02-06,8,317,1,326,0.0
GUJARAT,MAHESANA,2021-02-07,1,200,0,201,0.0
GUJARAT,MAHESANA,2021-02-08,1,538,0,539,0.0
GUJARAT,MAHESANA,2021-02-09,3,519,1,523,0.0
GUJARAT,MAHESANA,2021-02-10,1,453,1,455,0.0
GUJARAT,MAHISAGAR,2021-02-06,1,148,0,149,0.0
GUJARAT,MAHISAGAR,2021-02-07,1,204,0,205,0.0
GUJARAT,MAHISAGAR,2021-02-08,1,288,0,289,0.0
GUJARAT,MAHISAGAR,2021-02-09,3,647,0,650,0.0
GUJARAT,MAHISAGAR,2021-02-10,4,615,0,619,0.0
GUJARAT,MORBI,2021-02-06,3,263,24,290,0.0
GUJARAT,MORBI,2021-02-07,3,123,10,136,0.0
GUJARAT,MORBI,2021-02-08,2,331,0,333,0.0
GUJARAT,MORBI,2021-02-09,3,296,15,314,0.0
GUJARAT,MORBI,2021-02-10,4,184,23,211,0.0
GUJARAT,NARMADA,2021-02-06,4,17,0,21,0.0
GUJARAT,NARMADA,2021-02-07,0,28,1,29,0.0
GUJARAT,NARMADA,2021-02-08,2,22,1,25,0.0
GUJARAT,NARMADA,2021-02-09,5,38,1,44,0.0
GUJARAT,NARMADA,2021-02-10,3,22,2,27,0.0
GUJARAT,NAVSARI,2021-02-06,1,200,0,201,0.0
GUJARAT,NAVSARI,2021-02-07,1,108,1,110,0.0
GUJARAT,NAVSARI,2021-02-08,0,369,0,369,0.0
GUJARAT,NAVSARI,2021-02-09,3,380,2,385,0.0
GUJARAT,NAVSARI,2021-02-10,1,326,0,327,0.0
GUJARAT,PANCH MAHALS,2021-02-06,2,311,0,313,0.0
GUJARAT,PANCH MAHALS,2021-02-07,2,233,2,237,0.0
GUJARAT,PANCH MAHALS,2021-02-08,5,224,0,229,0.0
GUJARAT,PANCH MAHALS,2021-02-09,4,352,0,356,0.0
GUJARAT,PANCH MAHALS,2021-02-10,4,429,2,435,0.0
GUJARAT,PATAN,2021-02-06,7,351,1,359,0.0
GUJARAT,PATAN,2021-02-07,0,44,0,44,0.0
GUJARAT,PATAN,2021-02-08,0,440,1,441,0.0
GUJARAT,PATAN,2021-02-09,0,351,0,351,0.0
GUJARAT,PATAN,2021-02-10,0,594,8,602,0.0
GUJARAT,PORBANDAR,2021-02-06,0,300,0,300,0.0
GUJARAT,PORBANDAR,2021-02-07,0,178,1,179,0.0
GUJARAT,PORBANDAR,2021-02-08,0,466,0,466,0.0
GUJARAT,PORBANDAR,2021-02-09,0,511,0,511,0.0
GUJARAT,PORBANDAR,2021-02-10,1,437,0,438,0.0
GUJARAT,RAJKOT,2021-02-06,40,1141,26,1207,0.0
GUJARAT,RAJKOT,2021-02-07,12,305,40,357,0.0
GUJARAT,RAJKOT,2021-02-08,26,1025,13,1064,0.0
GUJARAT,RAJKOT,2021-02-09,53,1175,13,1241,0.0
GUJARAT,RAJKOT,2021-02-10,19,1185,28,1232,0.0
GUJARAT,SABAR KANTHA,2021-02-06,5,137,6,148,0.0
GUJARAT,SABAR KANTHA,2021-02-07,3,103,6,112,0.0
GUJARAT,SABAR KANTHA,2021-02-08,4,120,3,127,0.0
GUJARAT,SABAR KANTHA,2021-02-09,6,156,1,163,0.0
GUJARAT,SABAR KANTHA,2021-02-10,8,162,2,172,0.0
GUJARAT,SURAT,2021-02-06,20,1634,0,1654,0.0
GUJARAT,SURAT,2021-02-07,14,813,2,829,0.0
GUJARAT,SURAT,2021-02-08,25,2142,1,2168,0.0
GUJARAT,SURAT,2021-02-09,16,1575,4,1595,0.0
GUJARAT,SURAT,2021-02-10,25,1714,0,1739,0.0
GUJARAT,SURENDRANAGAR,2021-02-06,1,997,0,998,0.0
GUJARAT,SURENDRANAGAR,2021-02-07,0,495,0,495,0.0
GUJARAT,SURENDRANAGAR,2021-02-08,1,1113,0,1114,0.0
GUJARAT,SURENDRANAGAR,2021-02-09,1,720,0,721,0.0
GUJARAT,SURENDRANAGAR,2021-02-10,3,700,0,703,0.0
GUJARAT,TAPI,2021-02-06,0,352,0,352,0.0
GUJARAT,TAPI,2021-02-07,0,144,0,144,0.0
GUJARAT,TAPI,2021-02-08,1,457,0,458,0.0
GUJARAT,TAPI,2021-02-09,4,491,6,501,0.0
GUJARAT,TAPI,2021-02-10,0,534,1,535,0.0
GUJARAT,VADODARA,2021-02-06,68,1091,12,1171,0.0
GUJARAT,VADODARA,2021-02-07,46,657,7,710,0.0
GUJARAT,VADODARA,2021-02-08,42,1364,36,1442,0.0
GUJARAT,VADODARA,2021-02-09,59,1616,28,1703,0.0
GUJARAT,VADODARA,2021-02-10,55,1428,46,1529,0.0
GUJARAT,VALSAD,2021-02-06,1,257,0,258,0.0
GUJARAT,VALSAD,2021-02-07,0,193,0,193,0.0
GUJARAT,VALSAD,2021-02-08,4,248,0,252,0.0
GUJARAT,VALSAD,2021-02-09,3,249,0,252,0.0
GUJARAT,VALSAD,2021-02-10,1,327,0,328,0.0
HARYANA,AMBALA,2021-02-06,14,1744,81,1839,0.0
HARYANA,AMBALA,2021-02-07,9,1261,15,1285,0.0
HARYANA,AMBALA,2021-02-08,16,825,31,872,0.0
HARYANA,AMBALA,2021-02-09,10,1084,33,1127,0.0
HARYANA,AMBALA,2021-02-10,9,1420,35,1464,0.0
HARYANA,BHIWANI,2021-02-06,1,434,0,435,0.0
HARYANA,BHIWANI,2021-02-07,0,401,0,401,0.0
HARYANA,BHIWANI,2021-02-08,1,1273,0,1274,0.0
HARYANA,BHIWANI,2021-02-09,2,1129,2,1133,0.0
HARYANA,BHIWANI,2021-02-10,0,1301,1,1302,0.0
HARYANA,CHARKI DADRI,2021-02-06,0,95,0,95,0.0
HARYANA,CHARKI DADRI,2021-02-07,0,919,1,920,0.0
HARYANA,CHARKI DADRI,2021-02-08,1,848,0,849,0.0
HARYANA,CHARKI DADRI,2021-02-09,0,481,0,481,0.0
HARYANA,CHARKI DADRI,2021-02-10,0,448,0,448,0.0
HARYANA,FARIDABAD,2021-02-06,8,2056,24,2088,0.0
HARYANA,FARIDABAD,2021-02-07,11,1936,16,1963,0.0
HARYANA,FARIDABAD,2021-02-08,8,1075,2,1085,0.0
HARYANA,FARIDABAD,2021-02-09,9,2124,3,2136,0.0
HARYANA,FARIDABAD,2021-02-10,14,2443,4,2461,0.0
HARYANA,FATEHABAD,2021-02-06,2,1140,0,1142,0.0
HARYANA,FATEHABAD,2021-02-07,0,463,0,463,0.0
HARYANA,FATEHABAD,2021-02-08,0,1265,0,1265,0.0
HARYANA,FATEHABAD,2021-02-09,0,579,0,579,0.0
HARYANA,FATEHABAD,2021-02-10,0,608,0,608,0.0
HARYANA,GURUGRAM,2021-02-06,22,2861,11,2894,0.0
HARYANA,GURUGRAM,2021-02-07,27,2943,8,2978,0.0
HARYANA,GURUGRAM,2021-02-08,29,3073,34,3136,0.0
HARYANA,GURUGRAM,2021-02-09,37,2899,22,2958,0.0
HARYANA,GURUGRAM,2021-02-10,41,2829,10,2880,0.0
HARYANA,HISAR,2021-02-06,2,1052,0,1054,0.0
HARYANA,HISAR,2021-02-07,1,805,1,807,0.0
HARYANA,HISAR,2021-02-08,0,1751,0,1751,0.0
HARYANA,HISAR,2021-02-09,4,930,2,936,0.0
HARYANA,HISAR,2021-02-10,6,1244,2,1252,0.0
HARYANA,JHAJJAR,2021-02-06,1,1519,0,1520,0.0
HARYANA,JHAJJAR,2021-02-07,0,1102,1,1103,0.0
HARYANA,JHAJJAR,2021-02-08,0,1327,0,1327,0.0
HARYANA,JHAJJAR,2021-02-09,2,1560,0,1562,0.0
HARYANA,JHAJJAR,2021-02-10,1,1612,4,1617,0.0
HARYANA,JIND,2021-02-06,1,500,0,501,0.0
HARYANA,JIND,2021-02-07,2,191,0,193,0.0
HARYANA,JIND,2021-02-08,1,389,1,391,0.0
HARYANA,JIND,2021-02-09,0,212,0,212,0.0
HARYANA,JIND,2021-02-10,1,551,0,552,0.0
HARYANA,KAITHAL,2021-02-06,2,330,28,360,0.0
HARYANA,KAITHAL,2021-02-07,4,152,0,156,0.0
HARYANA,KAITHAL,2021-02-08,3,348,1,352,0.0
HARYANA,KAITHAL,2021-02-09,3,478,1,482,0.0
HARYANA,KAITHAL,2021-02-10,1,507,6,514,0.0
HARYANA,KARNAL,2021-02-06,6,707,0,713,0.0
HARYANA,KARNAL,2021-02-07,1,113,0,114,0.0
HARYANA,KARNAL,2021-02-08,7,463,1,471,0.0
HARYANA,KARNAL,2021-02-09,4,1037,5,1046,0.0
HARYANA,KARNAL,2021-02-10,1,946,5,952,0.0
HARYANA,KURUKSHETRA,2021-02-06,4,767,3,774,0.0
HARYANA,KURUKSHETRA,2021-02-07,3,1031,1,1035,0.0
HARYANA,KURUKSHETRA,2021-02-08,8,867,1,876,0.0
HARYANA,KURUKSHETRA,2021-02-09,4,982,4,990,0.0
HARYANA,KURUKSHETRA,2021-02-10,9,930,3,942,0.0
HARYANA,MAHENDRAGARH,2021-02-06,0,129,1,130,0.0
HARYANA,MAHENDRAGARH,2021-02-07,0,262,0,262,0.0
HARYANA,MAHENDRAGARH,2021-02-08,0,23,1,24,0.0
HARYANA,MAHENDRAGARH,2021-02-09,1,331,2,334,0.0
HARYANA,MAHENDRAGARH,2021-02-10,0,299,0,299,0.0
HARYANA,NUH,2021-02-06,1,703,0,704,0.0
HARYANA,NUH,2021-02-07,1,9,0,10,0.0
HARYANA,NUH,2021-02-08,0,433,1,434,0.0
HARYANA,NUH,2021-02-09,0,235,0,235,0.0
HARYANA,NUH,2021-02-10,0,432,0,432,0.0
HARYANA,PALWAL,2021-02-06,3,152,0,155,0.0
HARYANA,PALWAL,2021-02-07,1,72,1,74,0.0
HARYANA,PALWAL,2021-02-08,1,430,0,431,0.0
HARYANA,PALWAL,2021-02-09,0,357,1,358,0.0
HARYANA,PALWAL,2021-02-10,0,78,0,78,0.0
HARYANA,PANCHKULA,2021-02-06,17,1036,13,1066,0.0
HARYANA,PANCHKULA,2021-02-07,11,470,1,482,0.0
HARYANA,PANCHKULA,2021-02-08,18,580,3,601,0.0
HARYANA,PANCHKULA,2021-02-09,12,947,8,967,0.0
HARYANA,PANCHKULA,2021-02-10,10,683,2,695,0.0
HARYANA,PANIPAT,2021-02-06,4,474,1,479,0.0
HARYANA,PANIPAT,2021-02-07,5,663,1,669,0.0
HARYANA,PANIPAT,2021-02-08,9,481,1,491,0.0
HARYANA,PANIPAT,2021-02-09,6,708,0,714,0.0
HARYANA,PANIPAT,2021-02-10,6,408,1,415,0.0
HARYANA,REWARI,2021-02-06,1,261,3,265,0.0
HARYANA,REWARI,2021-02-07,1,425,8,434,0.0
HARYANA,REWARI,2021-02-08,0,524,2,526,0.0
HARYANA,REWARI,2021-02-09,0,620,13,633,0.0
HARYANA,REWARI,2021-02-10,2,351,4,357,0.0
HARYANA,ROHTAK,2021-02-06,0,670,1,671,0.0
HARYANA,ROHTAK,2021-02-07,1,413,0,414,0.0
HARYANA,ROHTAK,2021-02-08,4,656,0,660,0.0
HARYANA,ROHTAK,2021-02-09,6,1231,0,1237,0.0
HARYANA,ROHTAK,2021-02-10,5,783,0,788,0.0
HARYANA,SIRSA,2021-02-06,2,921,27,950,0.0
HARYANA,SIRSA,2021-02-07,2,760,25,787,0.0
HARYANA,SIRSA,2021-02-08,1,947,0,948,0.0
HARYANA,SIRSA,2021-02-09,3,956,27,986,0.0
HARYANA,SIRSA,2021-02-10,2,622,18,642,0.0
HARYANA,SONIPAT,2021-02-06,2,1383,1,1386,0.0
HARYANA,SONIPAT,2021-02-07,0,1316,0,1316,0.0
HARYANA,SONIPAT,2021-02-08,6,1685,0,1691,0.0
HARYANA,SONIPAT,2021-02-09,2,1179,0,1181,0.0
HARYANA,SONIPAT,2021-02-10,0,1347,0,1347,0.0
HARYANA,YAMUNANAGAR,2021-02-06,8,502,3,513,0.0
HARYANA,YAMUNANAGAR,2021-02-07,2,94,1,97,0.0
HARYANA,YAMUNANAGAR,2021-02-08,9,712,0,721,0.0
HARYANA,YAMUNANAGAR,2021-02-09,4,858,3,865,0.0
HARYANA,YAMUNANAGAR,2021-02-10,4,1535,14,1553,0.0
HIMACHAL PRADESH,BILASPUR,2021-02-06,2,213,0,215,0.0
HIMACHAL PRADESH,BILASPUR,2021-02-07,1,54,0,55,0.0
HIMACHAL PRADESH,BILASPUR,2021-02-08,1,622,0,623,0.0
HIMACHAL PRADESH,BILASPUR,2021-02-09,4,897,0,901,0.0
HIMACHAL PRADESH,BILASPUR,2021-02-10,4,689,0,693,0.0
HIMACHAL PRADESH,CHAMBA,2021-02-06,4,419,0,423,0.0
HIMACHAL PRADESH,CHAMBA,2021-02-07,0,7,0,7,0.0
HIMACHAL PRADESH,CHAMBA,2021-02-08,0,169,0,169,0.0
HIMACHAL PRADESH,CHAMBA,2021-02-09,2,261,0,263,0.0
HIMACHAL PRADESH,CHAMBA,2021-02-10,3,429,0,432,0.0
HIMACHAL PRADESH,HAMIRPUR,2021-02-06,2,347,1,350,0.0
HIMACHAL PRADESH,HAMIRPUR,2021-02-07,0,313,0,313,0.0
HIMACHAL PRADESH,HAMIRPUR,2021-02-08,0,145,1,146,0.0
HIMACHAL PRADESH,HAMIRPUR,2021-02-09,1,476,0,477,0.0
HIMACHAL PRADESH,HAMIRPUR,2021-02-10,2,388,0,390,0.0
HIMACHAL PRADESH,KANGRA,2021-02-06,2,805,1,808,0.0
HIMACHAL PRADESH,KANGRA,2021-02-07,3,323,0,326,0.0
HIMACHAL PRADESH,KANGRA,2021-02-08,3,855,0,858,0.0
HIMACHAL PRADESH,KANGRA,2021-02-09,6,510,0,516,0.0
HIMACHAL PRADESH,KANGRA,2021-02-10,7,715,2,724,0.0
HIMACHAL PRADESH,KINNAUR,2021-02-06,2,35,1,38,0.0
HIMACHAL PRADESH,KINNAUR,2021-02-08,0,9,0,9,0.0
HIMACHAL PRADESH,KINNAUR,2021-02-09,0,12,0,12,0.0
HIMACHAL PRADESH,KINNAUR,2021-02-10,0,16,0,16,0.0
HIMACHAL PRADESH,KULLU,2021-02-06,2,120,0,122,0.0
HIMACHAL PRADESH,KULLU,2021-02-07,0,116,12,128,0.0
HIMACHAL PRADESH,KULLU,2021-02-08,1,440,3,444,0.0
HIMACHAL PRADESH,KULLU,2021-02-09,0,494,22,516,0.0
HIMACHAL PRADESH,KULLU,2021-02-10,6,557,5,568,0.0
HIMACHAL PRADESH,LAHUL AND SPITI,2021-02-06,0,4,0,4,0.0
HIMACHAL PRADESH,LAHUL AND SPITI,2021-02-07,0,4,0,4,0.0
HIMACHAL PRADESH,LAHUL AND SPITI,2021-02-09,0,4,0,4,0.0
HIMACHAL PRADESH,LAHUL AND SPITI,2021-02-10,0,1,0,1,0.0
HIMACHAL PRADESH,MANDI,2021-02-06,48,2158,75,2281,0.0
HIMACHAL PRADESH,MANDI,2021-02-07,11,260,11,282,0.0
HIMACHAL PRADESH,MANDI,2021-02-08,10,1182,5,1197,0.0
HIMACHAL PRADESH,MANDI,2021-02-09,34,1039,69,1142,0.0
HIMACHAL PRADESH,MANDI,2021-02-10,13,1108,29,1150,0.0
HIMACHAL PRADESH,SHIMLA,2021-02-06,3,280,4,287,0.0
HIMACHAL PRADESH,SHIMLA,2021-02-07,0,148,2,150,0.0
HIMACHAL PRADESH,SHIMLA,2021-02-08,3,540,8,551,0.0
HIMACHAL PRADESH,SHIMLA,2021-02-09,2,544,0,546,0.0
HIMACHAL PRADESH,SHIMLA,2021-02-10,5,485,3,493,0.0
HIMACHAL PRADESH,SIRMAUR,2021-02-06,4,483,5,492,0.0
HIMACHAL PRADESH,SIRMAUR,2021-02-07,1,107,1,109,0.0
HIMACHAL PRADESH,SIRMAUR,2021-02-08,1,128,0,129,0.0
HIMACHAL PRADESH,SIRMAUR,2021-02-09,3,175,0,178,0.0
HIMACHAL PRADESH,SIRMAUR,2021-02-10,6,485,3,494,0.0
HIMACHAL PRADESH,SOLAN,2021-02-06,5,376,0,381,0.0
HIMACHAL PRADESH,SOLAN,2021-02-07,0,301,1,302,0.0
HIMACHAL PRADESH,SOLAN,2021-02-08,3,332,1,336,0.0
HIMACHAL PRADESH,SOLAN,2021-02-09,2,720,0,722,0.0
HIMACHAL PRADESH,SOLAN,2021-02-10,2,632,0,634,0.0
HIMACHAL PRADESH,UNA,2021-02-06,4,456,0,460,0.0
HIMACHAL PRADESH,UNA,2021-02-07,8,322,2,332,0.0
HIMACHAL PRADESH,UNA,2021-02-08,7,588,3,598,0.0
HIMACHAL PRADESH,UNA,2021-02-09,2,351,1,354,0.0
HIMACHAL PRADESH,UNA,2021-02-10,18,515,0,533,0.0
INDIA,INDIA,2021-02-06,3,0,0,3,0.0
INDIA,INDIA,2021-02-07,0,1,1,2,0.0
INDIA,INDIA,2021-02-08,5,7,0,12,0.0
INDIA,INDIA,2021-02-09,3,4,0,7,0.0
INDIA,INDIA,2021-02-10,2,5,0,7,0.0
JAMMU AND KASHMIR,ANANTNAG,2021-02-06,4,478,0,482,0.0
JAMMU AND KASHMIR,ANANTNAG,2021-02-07,5,158,0,163,0.0
JAMMU AND KASHMIR,ANANTNAG,2021-02-08,3,215,0,218,0.0
JAMMU AND KASHMIR,ANANTNAG,2021-02-09,2,159,0,161,0.0
JAMMU AND KASHMIR,ANANTNAG,2021-02-10,6,292,0,298,0.0
JAMMU AND KASHMIR,BANDIPORA,2021-02-06,2,104,1,107,0.0
JAMMU AND KASHMIR,BANDIPORA,2021-02-08,0,98,0,98,0.0
JAMMU AND KASHMIR,BANDIPORA,2021-02-09,1,73,2,76,0.0
JAMMU AND KASHMIR,BANDIPORA,2021-02-10,1,79,2,82,0.0
JAMMU AND KASHMIR,BARAMULLA,2021-02-06,3,359,0,362,0.0
JAMMU AND KASHMIR,BARAMULLA,2021-02-07,0,89,0,89,0.0
JAMMU AND KASHMIR,BARAMULLA,2021-02-08,3,353,0,356,0.0
JAMMU AND KASHMIR,BARAMULLA,2021-02-09,3,266,0,269,0.0
JAMMU AND KASHMIR,BARAMULLA,2021-02-10,6,253,1,260,0.0
JAMMU AND KASHMIR,BUDGAM,2021-02-06,13,736,1,750,0.0
JAMMU AND KASHMIR,BUDGAM,2021-02-07,0,195,0,195,0.0
JAMMU AND KASHMIR,BUDGAM,2021-02-08,8,875,0,883,0.0
JAMMU AND KASHMIR,BUDGAM,2021-02-09,1,625,0,626,0.0
JAMMU AND KASHMIR,BUDGAM,2021-02-10,7,709,0,716,0.0
JAMMU AND KASHMIR,DODA,2021-02-06,0,28,0,28,0.0
JAMMU AND KASHMIR,DODA,2021-02-07,0,16,0,16,0.0
JAMMU AND KASHMIR,DODA,2021-02-08,0,8,0,8,0.0
JAMMU AND KASHMIR,DODA,2021-02-09,0,21,0,21,0.0
JAMMU AND KASHMIR,DODA,2021-02-10,1,9,0,10,0.0
JAMMU AND KASHMIR,GANDERBAL,2021-02-06,6,97,0,103,0.0
JAMMU AND KASHMIR,GANDERBAL,2021-02-08,3,111,0,114,0.0
JAMMU AND KASHMIR,GANDERBAL,2021-02-09,0,97,0,97,0.0
JAMMU AND KASHMIR,GANDERBAL,2021-02-10,1,136,0,137,0.0
JAMMU AND KASHMIR,JAMMU,2021-02-06,22,626,2,650,0.0
JAMMU AND KASHMIR,JAMMU,2021-02-07,5,296,1,302,0.0
JAMMU AND KASHMIR,JAMMU,2021-02-08,23,591,0,614,0.0
JAMMU AND KASHMIR,JAMMU,2021-02-09,20,740,2,762,0.0
JAMMU AND KASHMIR,JAMMU,2021-02-10,14,684,2,700,0.0
JAMMU AND KASHMIR,KATHUA,2021-02-06,1,191,0,192,0.0
JAMMU AND KASHMIR,KATHUA,2021-02-07,0,61,0,61,0.0
JAMMU AND KASHMIR,KATHUA,2021-02-08,1,135,0,136,0.0
JAMMU AND KASHMIR,KATHUA,2021-02-09,0,122,0,122,0.0
JAMMU AND KASHMIR,KATHUA,2021-02-10,1,130,1,132,0.0
JAMMU AND KASHMIR,KISHTWAR,2021-02-06,1,81,0,82,0.0
JAMMU AND KASHMIR,KISHTWAR,2021-02-07,0,29,0,29,0.0
JAMMU AND KASHMIR,KISHTWAR,2021-02-08,1,83,0,84,0.0
JAMMU AND KASHMIR,KISHTWAR,2021-02-09,1,36,0,37,0.0
JAMMU AND KASHMIR,KISHTWAR,2021-02-10,5,42,0,47,0.0
JAMMU AND KASHMIR,KULGAM,2021-02-06,1,250,0,251,0.0
JAMMU AND KASHMIR,KULGAM,2021-02-07,0,137,0,137,0.0
JAMMU AND KASHMIR,KULGAM,2021-02-08,0,136,0,136,0.0
JAMMU AND KASHMIR,KULGAM,2021-02-09,0,186,0,186,0.0
JAMMU AND KASHMIR,KULGAM,2021-02-10,0,138,0,138,0.0
JAMMU AND KASHMIR,KUPWARA,2021-02-06,1,154,1,156,0.0
JAMMU AND KASHMIR,KUPWARA,2021-02-07,1,45,0,46,0.0
JAMMU AND KASHMIR,KUPWARA,2021-02-08,0,109,0,109,0.0
JAMMU AND KASHMIR,KUPWARA,2021-02-09,0,24,0,24,0.0
JAMMU AND KASHMIR,KUPWARA,2021-02-10,0,80,0,80,0.0
JAMMU AND KASHMIR,POONCH,2021-02-06,2,205,0,207,0.0
JAMMU AND KASHMIR,POONCH,2021-02-07,0,55,0,55,0.0
JAMMU AND KASHMIR,POONCH,2021-02-08,1,184,0,185,0.0
JAMMU AND KASHMIR,POONCH,2021-02-09,0,164,0,164,0.0
JAMMU AND KASHMIR,POONCH,2021-02-10,0,148,0,148,0.0
JAMMU AND KASHMIR,PULWAMA,2021-02-06,10,369,0,379,0.0
JAMMU AND KASHMIR,PULWAMA,2021-02-07,0,76,0,76,0.0
JAMMU AND KASHMIR,PULWAMA,2021-02-08,17,453,5,475,0.0
JAMMU AND KASHMIR,PULWAMA,2021-02-09,5,471,0,476,0.0
JAMMU AND KASHMIR,PULWAMA,2021-02-10,7,449,0,456,0.0
JAMMU AND KASHMIR,RAJOURI,2021-02-06,0,233,0,233,0.0
JAMMU AND KASHMIR,RAJOURI,2021-02-07,0,57,0,57,0.0
JAMMU AND KASHMIR,RAJOURI,2021-02-08,0,269,0,269,0.0
JAMMU AND KASHMIR,RAJOURI,2021-02-09,1,131,0,132,0.0
JAMMU AND KASHMIR,RAJOURI,2021-02-10,0,269,0,269,0.0
JAMMU AND KASHMIR,RAMBAN,2021-02-06,1,185,0,186,0.0
JAMMU AND KASHMIR,RAMBAN,2021-02-07,0,78,0,78,0.0
JAMMU AND KASHMIR,RAMBAN,2021-02-08,0,110,0,110,0.0
JAMMU AND KASHMIR,RAMBAN,2021-02-09,3,190,0,193,0.0
JAMMU AND KASHMIR,RAMBAN,2021-02-10,0,225,0,225,0.0
JAMMU AND KASHMIR,REASI,2021-02-06,0,48,0,48,0.0
JAMMU AND KASHMIR,REASI,2021-02-07,0,23,0,23,0.0
JAMMU AND KASHMIR,REASI,2021-02-08,1,73,0,74,0.0
JAMMU AND KASHMIR,REASI,2021-02-09,5,133,0,138,0.0
JAMMU AND KASHMIR,REASI,2021-02-10,7,50,0,57,0.0
JAMMU AND KASHMIR,SAMBA,2021-02-06,0,92,0,92,0.0
JAMMU AND KASHMIR,SAMBA,2021-02-07,2,236,0,238,0.0
JAMMU AND KASHMIR,SAMBA,2021-02-08,2,166,0,168,0.0
JAMMU AND KASHMIR,SAMBA,2021-02-09,2,190,0,192,0.0
JAMMU AND KASHMIR,SAMBA,2021-02-10,0,222,0,222,0.0
JAMMU AND KASHMIR,SHOPIAN,2021-02-06,0,625,0,625,0.0
JAMMU AND KASHMIR,SHOPIAN,2021-02-07,1,452,0,453,0.0
JAMMU AND KASHMIR,SHOPIAN,2021-02-08,3,416,0,419,0.0
JAMMU AND KASHMIR,SHOPIAN,2021-02-09,2,158,0,160,0.0
JAMMU AND KASHMIR,SHOPIAN,2021-02-10,2,131,0,133,0.0
JAMMU AND KASHMIR,SRINAGAR,2021-02-06,48,3497,11,3556,0.0
JAMMU AND KASHMIR,SRINAGAR,2021-02-07,3,1816,0,1819,0.0
JAMMU AND KASHMIR,SRINAGAR,2021-02-08,76,2838,8,2922,0.0
JAMMU AND KASHMIR,SRINAGAR,2021-02-09,28,3337,1,3366,0.0
JAMMU AND KASHMIR,SRINAGAR,2021-02-10,26,2554,1,2581,0.0
JAMMU AND KASHMIR,UDHAMPUR,2021-02-06,7,352,0,359,0.0
JAMMU AND KASHMIR,UDHAMPUR,2021-02-07,0,176,0,176,0.0
JAMMU AND KASHMIR,UDHAMPUR,2021-02-08,8,571,0,579,0.0
JAMMU AND KASHMIR,UDHAMPUR,2021-02-09,6,409,0,415,0.0
JAMMU AND KASHMIR,UDHAMPUR,2021-02-10,0,575,0,575,0.0
JHARKHAND,BOKARO,2021-02-06,1,527,0,528,0.0
JHARKHAND,BOKARO,2021-02-07,2,77,1,80,0.0
JHARKHAND,BOKARO,2021-02-08,4,815,3,822,0.0
JHARKHAND,BOKARO,2021-02-09,4,243,6,253,0.0
JHARKHAND,BOKARO,2021-02-10,5,342,0,347,0.0
JHARKHAND,CHATRA,2021-02-06,0,159,0,159,0.0
JHARKHAND,CHATRA,2021-02-07,0,1,0,1,0.0
JHARKHAND,CHATRA,2021-02-08,0,47,0,47,0.0
JHARKHAND,CHATRA,2021-02-09,0,633,0,633,0.0
JHARKHAND,CHATRA,2021-02-10,2,193,0,195,0.0
JHARKHAND,DEOGHAR,2021-02-06,1,747,0,748,0.0
JHARKHAND,DEOGHAR,2021-02-07,0,608,0,608,0.0
JHARKHAND,DEOGHAR,2021-02-08,3,552,11,566,0.0
JHARKHAND,DEOGHAR,2021-02-09,0,383,0,383,0.0
JHARKHAND,DEOGHAR,2021-02-10,0,414,0,414,0.0
JHARKHAND,DHANBAD,2021-02-06,5,638,0,643,0.0
JHARKHAND,DHANBAD,2021-02-07,0,251,0,251,0.0
JHARKHAND,DHANBAD,2021-02-08,5,842,1,848,0.0
JHARKHAND,DHANBAD,2021-02-09,9,607,0,616,0.0
JHARKHAND,DHANBAD,2021-02-10,2,465,0,467,0.0
JHARKHAND,DUMKA,2021-02-06,8,513,0,521,0.0
JHARKHAND,DUMKA,2021-02-07,1,176,0,177,0.0
JHARKHAND,DUMKA,2021-02-08,0,228,0,228,0.0
JHARKHAND,DUMKA,2021-02-09,1,284,0,285,0.0
JHARKHAND,DUMKA,2021-02-10,1,124,0,125,0.0
JHARKHAND,EAST SINGHBUM,2021-02-06,18,1734,0,1752,0.0
JHARKHAND,EAST SINGHBUM,2021-02-07,14,714,2,730,0.0
JHARKHAND,EAST SINGHBUM,2021-02-08,13,2572,5,2590,0.0
JHARKHAND,EAST SINGHBUM,2021-02-09,5,3693,3,3701,0.0
JHARKHAND,EAST SINGHBUM,2021-02-10,39,3667,6,3712,0.0
JHARKHAND,GARHWA,2021-02-06,0,431,0,431,0.0
JHARKHAND,GARHWA,2021-02-07,0,1208,0,1208,0.0
JHARKHAND,GARHWA,2021-02-08,0,429,0,429,0.0
JHARKHAND,GARHWA,2021-02-09,0,371,1,372,0.0
JHARKHAND,GARHWA,2021-02-10,1,455,0,456,0.0
JHARKHAND,GIRIDIH,2021-02-06,0,415,0,415,0.0
JHARKHAND,GIRIDIH,2021-02-07,0,19,0,19,0.0
JHARKHAND,GIRIDIH,2021-02-08,1,364,0,365,0.0
JHARKHAND,GIRIDIH,2021-02-09,0,675,1,676,0.0
JHARKHAND,GIRIDIH,2021-02-10,0,807,0,807,0.0
JHARKHAND,GODDA,2021-02-06,0,69,0,69,0.0
JHARKHAND,GODDA,2021-02-07,0,39,0,39,0.0
JHARKHAND,GODDA,2021-02-08,0,286,0,286,0.0
JHARKHAND,GODDA,2021-02-09,0,217,0,217,0.0
JHARKHAND,GODDA,2021-02-10,0,209,0,209,0.0
JHARKHAND,GUMLA,2021-02-06,1,307,0,308,0.0
JHARKHAND,GUMLA,2021-02-07,1,131,0,132,0.0
JHARKHAND,GUMLA,2021-02-08,1,347,0,348,0.0
JHARKHAND,GUMLA,2021-02-09,1,859,0,860,0.0
JHARKHAND,GUMLA,2021-02-10,3,1324,0,1327,0.0
JHARKHAND,HAZARIBAGH,2021-02-06,1,293,1,295,0.0
JHARKHAND,HAZARIBAGH,2021-02-07,1,271,1,273,0.0
JHARKHAND,HAZARIBAGH,2021-02-08,1,175,0,176,0.0
JHARKHAND,HAZARIBAGH,2021-02-09,0,178,0,178,0.0
JHARKHAND,HAZARIBAGH,2021-02-10,1,476,1,478,0.0
JHARKHAND,JAMTARA,2021-02-06,1,269,1,271,0.0
JHARKHAND,JAMTARA,2021-02-07,0,109,0,109,0.0
JHARKHAND,JAMTARA,2021-02-08,1,83,0,84,0.0
JHARKHAND,JAMTARA,2021-02-09,0,209,0,209,0.0
JHARKHAND,JAMTARA,2021-02-10,0,636,1,637,0.0
JHARKHAND,KHUNTI,2021-02-06,0,443,0,443,0.0
JHARKHAND,KHUNTI,2021-02-07,1,8,0,9,0.0
JHARKHAND,KHUNTI,2021-02-08,0,540,0,540,0.0
JHARKHAND,KHUNTI,2021-02-09,0,127,0,127,0.0
JHARKHAND,KHUNTI,2021-02-10,0,203,0,203,0.0
JHARKHAND,KODERMA,2021-02-06,3,542,4,549,0.0
JHARKHAND,KODERMA,2021-02-07,0,720,0,720,0.0
JHARKHAND,KODERMA,2021-02-08,1,346,0,347,0.0
JHARKHAND,KODERMA,2021-02-09,2,129,0,131,0.0
JHARKHAND,KODERMA,2021-02-10,6,697,0,703,0.0
JHARKHAND,LATEHAR,2021-02-06,5,408,3,416,0.0
JHARKHAND,LATEHAR,2021-02-07,1,397,0,398,0.0
JHARKHAND,LATEHAR,2021-02-08,0,680,1,681,0.0
JHARKHAND,LATEHAR,2021-02-09,2,1011,0,1013,0.0
JHARKHAND,LATEHAR,2021-02-10,2,1245,0,1247,0.0
JHARKHAND,LOHARDAGA,2021-02-06,0,22,0,22,0.0
JHARKHAND,LOHARDAGA,2021-02-07,0,37,0,37,0.0
JHARKHAND,LOHARDAGA,2021-02-08,0,153,0,153,0.0
JHARKHAND,LOHARDAGA,2021-02-09,1,165,0,166,0.0
JHARKHAND,LOHARDAGA,2021-02-10,0,408,0,408,0.0
JHARKHAND,PAKUR,2021-02-06,0,2,0,2,0.0
JHARKHAND,PAKUR,2021-02-07,0,1,0,1,0.0
JHARKHAND,PAKUR,2021-02-09,0,317,0,317,0.0
JHARKHAND,PAKUR,2021-02-10,0,9,0,9,0.0
JHARKHAND,PALAMU,2021-02-06,0,1053,0,1053,0.0
JHARKHAND,PALAMU,2021-02-07,0,588,3,591,0.0
JHARKHAND,PALAMU,2021-02-08,0,1913,0,1913,0.0
JHARKHAND,PALAMU,2021-02-09,0,887,7,894,0.0
JHARKHAND,PALAMU,2021-02-10,1,1218,0,1219,0.0
JHARKHAND,RAMGARH,2021-02-06,0,44,0,44,0.0
JHARKHAND,RAMGARH,2021-02-07,3,260,0,263,0.0
JHARKHAND,RAMGARH,2021-02-08,0,355,0,355,0.0
JHARKHAND,RAMGARH,2021-02-09,2,211,0,213,0.0
JHARKHAND,RAMGARH,2021-02-10,0,41,0,41,0.0
JHARKHAND,RANCHI,2021-02-06,36,1136,1,1173,0.0
JHARKHAND,RANCHI,2021-02-07,36,1654,0,1690,0.0
JHARKHAND,RANCHI,2021-02-08,36,1816,0,1852,0.0
JHARKHAND,RANCHI,2021-02-09,56,2273,3,2332,0.0
JHARKHAND,RANCHI,2021-02-10,53,2640,3,2696,0.0
JHARKHAND,SAHEBGANJ,2021-02-06,0,280,1,281,0.0
JHARKHAND,SAHEBGANJ,2021-02-07,0,219,0,219,0.0
JHARKHAND,SAHEBGANJ,2021-02-08,1,342,0,343,0.0
JHARKHAND,SAHEBGANJ,2021-02-09,1,758,0,759,0.0
JHARKHAND,SAHEBGANJ,2021-02-10,0,1010,0,1010,0.0
JHARKHAND,SARAIKELA KHARSAWAN,2021-02-06,1,320,0,321,0.0
JHARKHAND,SARAIKELA KHARSAWAN,2021-02-07,0,8,0,8,0.0
JHARKHAND,SARAIKELA KHARSAWAN,2021-02-08,0,555,0,555,0.0
JHARKHAND,SARAIKELA KHARSAWAN,2021-02-09,0,432,0,432,0.0
JHARKHAND,SARAIKELA KHARSAWAN,2021-02-10,6,1021,0,1027,0.0
JHARKHAND,SIMDEGA,2021-02-06,0,167,0,167,0.0
JHARKHAND,SIMDEGA,2021-02-07,0,122,0,122,0.0
JHARKHAND,SIMDEGA,2021-02-08,1,133,0,134,0.0
JHARKHAND,SIMDEGA,2021-02-09,1,174,0,175,0.0
JHARKHAND,SIMDEGA,2021-02-10,0,169,0,169,0.0
JHARKHAND,WEST SINGHBHUM,2021-02-06,1,719,0,720,0.0
JHARKHAND,WEST SINGHBHUM,2021-02-07,45,8,0,53,0.0
JHARKHAND,WEST SINGHBHUM,2021-02-08,4,646,0,650,0.0
JHARKHAND,WEST SINGHBHUM,2021-02-09,0,1232,1,1233,0.0
JHARKHAND,WEST SINGHBHUM,2021-02-10,0,1110,0,1110,0.0
KARNATAKA,BAGALKOTE,2021-02-06,0,1666,8,1674,0.0
KARNATAKA,BAGALKOTE,2021-02-07,1,993,3,997,0.0
KARNATAKA,BAGALKOTE,2021-02-08,0,1628,1,1629,0.0
KARNATAKA,BAGALKOTE,2021-02-09,0,1278,3,1281,0.0
KARNATAKA,BAGALKOTE,2021-02-10,1,1330,5,1336,0.0
KARNATAKA,BALLARI,2021-02-06,1,1660,21,1682,0.0
KARNATAKA,BALLARI,2021-02-07,4,1327,54,1385,0.0
KARNATAKA,BALLARI,2021-02-08,7,1835,21,1863,0.0
KARNATAKA,BALLARI,2021-02-09,2,1630,14,1646,0.0
KARNATAKA,BALLARI,2021-02-10,3,1988,23,2014,0.0
KARNATAKA,BELAGAVI,2021-02-06,11,2815,9,2835,0.0
KARNATAKA,BELAGAVI,2021-02-07,0,187,0,187,0.0
KARNATAKA,BELAGAVI,2021-02-08,12,3454,3,3469,0.0
KARNATAKA,BELAGAVI,2021-02-09,17,3769,3,3789,0.0
KARNATAKA,BELAGAVI,2021-02-10,8,3510,5,3523,0.0
KARNATAKA,BENGALURU RURAL,2021-02-06,9,547,1,557,0.0
KARNATAKA,BENGALURU RURAL,2021-02-07,3,700,0,703,0.0
KARNATAKA,BENGALURU RURAL,2021-02-08,19,899,0,918,0.0
KARNATAKA,BENGALURU RURAL,2021-02-09,16,1116,0,1132,0.0
KARNATAKA,BENGALURU RURAL,2021-02-10,13,1121,3,1137,0.0
KARNATAKA,BENGALURU URBAN,2021-02-06,267,30716,17,31000,0.0
KARNATAKA,BENGALURU URBAN,2021-02-07,136,20240,34,20410,0.0
KARNATAKA,BENGALURU URBAN,2021-02-08,208,24339,163,24710,0.0
KARNATAKA,BENGALURU URBAN,2021-02-09,220,27064,49,27333,0.0
KARNATAKA,BENGALURU URBAN,2021-02-10,246,25512,175,25933,0.0
KARNATAKA,BIDAR,2021-02-06,19,818,0,837,0.0
KARNATAKA,BIDAR,2021-02-07,3,869,0,872,0.0
KARNATAKA,BIDAR,2021-02-08,5,373,0,378,0.0
KARNATAKA,BIDAR,2021-02-09,8,775,0,783,0.0
KARNATAKA,BIDAR,2021-02-10,0,1036,1,1037,0.0
KARNATAKA,CHAMARAJANAGARA,2021-02-06,2,730,1,733,0.0
KARNATAKA,CHAMARAJANAGARA,2021-02-07,2,570,0,572,0.0
KARNATAKA,CHAMARAJANAGARA,2021-02-08,0,231,1,232,0.0
KARNATAKA,CHAMARAJANAGARA,2021-02-09,4,963,1,968,0.0
KARNATAKA,CHAMARAJANAGARA,2021-02-10,1,668,1,670,0.0
KARNATAKA,CHIKKABALLAPURA,2021-02-06,5,2920,10,2935,0.0
KARNATAKA,CHIKKABALLAPURA,2021-02-07,1,2488,19,2508,0.0
KARNATAKA,CHIKKABALLAPURA,2021-02-08,5,2000,7,2012,0.0
KARNATAKA,CHIKKABALLAPURA,2021-02-09,7,1620,6,1633,0.0
KARNATAKA,CHIKKABALLAPURA,2021-02-10,6,1706,10,1722,0.0
KARNATAKA,CHIKKAMAGALURU,2021-02-06,3,1760,12,1775,0.0
KARNATAKA,CHIKKAMAGALURU,2021-02-07,2,930,2,934,0.0
KARNATAKA,CHIKKAMAGALURU,2021-02-08,3,1337,8,1348,0.0
KARNATAKA,CHIKKAMAGALURU,2021-02-09,4,1022,15,1041,0.0
KARNATAKA,CHIKKAMAGALURU,2021-02-10,3,1745,7,1755,0.0
KARNATAKA,CHITRADURGA,2021-02-06,15,1166,8,1189,0.0
KARNATAKA,CHITRADURGA,2021-02-07,13,1188,0,1201,0.0
KARNATAKA,CHITRADURGA,2021-02-08,11,729,4,744,0.0
KARNATAKA,CHITRADURGA,2021-02-09,11,1788,1,1800,0.0
KARNATAKA,CHITRADURGA,2021-02-10,10,1418,5,1433,0.0
KARNATAKA,DAKSHINA KANNADA,2021-02-06,41,1579,1,1621,0.0
KARNATAKA,DAKSHINA KANNADA,2021-02-07,16,655,1,672,0.0
KARNATAKA,DAKSHINA KANNADA,2021-02-08,30,1736,3,1769,0.0
KARNATAKA,DAKSHINA KANNADA,2021-02-09,22,1444,1,1467,0.0
KARNATAKA,DAKSHINA KANNADA,2021-02-10,36,1680,2,1718,0.0
KARNATAKA,DAVANGERE,2021-02-06,6,983,18,1007,0.0
KARNATAKA,DAVANGERE,2021-02-07,1,731,96,828,0.0
KARNATAKA,DAVANGERE,2021-02-08,1,1299,23,1323,0.0
KARNATAKA,DAVANGERE,2021-02-09,8,1181,87,1276,0.0
KARNATAKA,DAVANGERE,2021-02-10,7,1270,32,1309,0.0
KARNATAKA,DHARWAD,2021-02-06,10,2356,33,2399,0.0
KARNATAKA,DHARWAD,2021-02-07,9,892,3,904,0.0
KARNATAKA,DHARWAD,2021-02-08,2,1630,34,1666,0.0
KARNATAKA,DHARWAD,2021-02-09,7,2009,14,2030,0.0
KARNATAKA,DHARWAD,2021-02-10,9,1686,24,1719,0.0
KARNATAKA,GADAG,2021-02-06,0,1250,118,1368,0.0
KARNATAKA,GADAG,2021-02-07,1,1077,76,1154,0.0
KARNATAKA,GADAG,2021-02-08,2,897,113,1012,0.0
KARNATAKA,GADAG,2021-02-09,3,1192,105,1300,0.0
KARNATAKA,GADAG,2021-02-10,2,1458,53,1513,0.0
KARNATAKA,HASSAN,2021-02-06,13,1008,94,1115,0.0
KARNATAKA,HASSAN,2021-02-07,11,50,10,71,0.0
KARNATAKA,HASSAN,2021-02-08,8,3248,48,3304,0.0
KARNATAKA,HASSAN,2021-02-09,10,2661,15,2686,0.0
KARNATAKA,HASSAN,2021-02-10,12,1289,26,1327,0.0
KARNATAKA,HAVERI,2021-02-06,0,817,1,818,0.0
KARNATAKA,HAVERI,2021-02-07,0,792,0,792,0.0
KARNATAKA,HAVERI,2021-02-08,0,1249,0,1249,0.0
KARNATAKA,HAVERI,2021-02-09,1,303,0,304,0.0
KARNATAKA,HAVERI,2021-02-10,1,667,0,668,0.0
KARNATAKA,KALABURAGI,2021-02-06,20,1948,10,1978,0.0
KARNATAKA,KALABURAGI,2021-02-07,17,810,2,829,0.0
KARNATAKA,KALABURAGI,2021-02-08,8,504,0,512,0.0
KARNATAKA,KALABURAGI,2021-02-09,29,680,4,713,0.0
KARNATAKA,KALABURAGI,2021-02-10,9,2496,15,2520,0.0
KARNATAKA,KODAGU,2021-02-06,9,378,4,391,0.0
KARNATAKA,KODAGU,2021-02-07,0,17,0,17,0.0
KARNATAKA,KODAGU,2021-02-08,3,507,18,528,0.0
KARNATAKA,KODAGU,2021-02-09,11,691,12,714,0.0
KARNATAKA,KODAGU,2021-02-10,6,813,9,828,0.0
KARNATAKA,KOLAR,2021-02-06,8,1681,0,1689,0.0
KARNATAKA,KOLAR,2021-02-07,6,1432,2,1440,0.0
KARNATAKA,KOLAR,2021-02-08,2,593,11,606,0.0
KARNATAKA,KOLAR,2021-02-09,3,1734,4,1741,0.0
KARNATAKA,KOLAR,2021-02-10,6,1872,7,1885,0.0
KARNATAKA,KOPPAL,2021-02-06,0,744,1,745,0.0
KARNATAKA,KOPPAL,2021-02-07,1,451,2,454,0.0
KARNATAKA,KOPPAL,2021-02-08,0,298,0,298,0.0
KARNATAKA,KOPPAL,2021-02-09,0,788,3,791,0.0
KARNATAKA,KOPPAL,2021-02-10,0,680,7,687,0.0
KARNATAKA,MANDYA,2021-02-06,1,1776,7,1784,0.0
KARNATAKA,MANDYA,2021-02-07,4,751,1,756,0.0
KARNATAKA,MANDYA,2021-02-08,3,1034,6,1043,0.0
KARNATAKA,MANDYA,2021-02-09,5,2001,3,2009,0.0
KARNATAKA,MANDYA,2021-02-10,6,1925,9,1940,0.0
KARNATAKA,MYSURU,2021-02-06,34,2940,2,2976,0.0
KARNATAKA,MYSURU,2021-02-07,76,2560,5,2641,0.0
KARNATAKA,MYSURU,2021-02-08,16,1363,1,1380,0.0
KARNATAKA,MYSURU,2021-02-09,31,2549,1,2581,0.0
KARNATAKA,MYSURU,2021-02-10,19,2407,1,2427,0.0
KARNATAKA,RAICHUR,2021-02-06,1,1132,5,1138,0.0
KARNATAKA,RAICHUR,2021-02-07,1,807,16,824,0.0
KARNATAKA,RAICHUR,2021-02-08,0,1426,1,1427,0.0
KARNATAKA,RAICHUR,2021-02-09,1,118,9,128,0.0
KARNATAKA,RAICHUR,2021-02-10,1,1426,14,1441,0.0
KARNATAKA,RAMANAGARA,2021-02-06,0,544,0,544,0.0
KARNATAKA,RAMANAGARA,2021-02-07,0,154,0,154,0.0
KARNATAKA,RAMANAGARA,2021-02-08,0,764,0,764,0.0
KARNATAKA,RAMANAGARA,2021-02-09,1,538,0,539,0.0
KARNATAKA,RAMANAGARA,2021-02-10,4,573,2,579,0.0
KARNATAKA,SHIVAMOGGA,2021-02-06,7,1374,0,1381,0.0
KARNATAKA,SHIVAMOGGA,2021-02-07,4,585,1,590,0.0
KARNATAKA,SHIVAMOGGA,2021-02-08,7,720,1,728,0.0
KARNATAKA,SHIVAMOGGA,2021-02-09,5,706,3,714,0.0
KARNATAKA,SHIVAMOGGA,2021-02-10,6,916,2,924,0.0
KARNATAKA,TUMAKURU,2021-02-06,22,2689,1,2712,0.0
KARNATAKA,TUMAKURU,2021-02-07,5,1290,8,1303,0.0
KARNATAKA,TUMAKURU,2021-02-08,24,1921,38,1983,0.0
KARNATAKA,TUMAKURU,2021-02-09,15,2582,4,2601,0.0
KARNATAKA,TUMAKURU,2021-02-10,25,1602,50,1677,0.0
KARNATAKA,UDUPI,2021-02-06,13,988,0,1001,0.0
KARNATAKA,UDUPI,2021-02-07,8,1113,0,1121,0.0
KARNATAKA,UDUPI,2021-02-08,6,1510,2,1518,0.0
KARNATAKA,UDUPI,2021-02-09,6,1060,2,1068,0.0
KARNATAKA,UDUPI,2021-02-10,14,899,0,913,0.0
KARNATAKA,UTTARA KANNADA,2021-02-06,3,2046,336,2385,0.0
KARNATAKA,UTTARA KANNADA,2021-02-07,4,2091,181,2276,0.0
KARNATAKA,UTTARA KANNADA,2021-02-08,7,977,187,1171,0.0
KARNATAKA,UTTARA KANNADA,2021-02-09,3,1405,101,1509,0.0
KARNATAKA,UTTARA KANNADA,2021-02-10,10,1285,291,1586,0.0
KARNATAKA,VIJAYAPURA,2021-02-06,7,1609,0,1616,0.0
KARNATAKA,VIJAYAPURA,2021-02-07,4,1412,0,1416,0.0
KARNATAKA,VIJAYAPURA,2021-02-08,6,1080,0,1086,0.0
KARNATAKA,VIJAYAPURA,2021-02-09,4,825,0,829,0.0
KARNATAKA,VIJAYAPURA,2021-02-10,4,1400,3,1407,0.0
KARNATAKA,YADGIR,2021-02-06,1,729,0,730,0.0
KARNATAKA,YADGIR,2021-02-07,1,499,0,500,0.0
KARNATAKA,YADGIR,2021-02-08,1,362,0,363,0.0
KARNATAKA,YADGIR,2021-02-09,0,556,0,556,0.0
KARNATAKA,YADGIR,2021-02-10,6,1295,1,1302,0.0
KERALA,ALAPPUZHA,2021-02-06,489,3745,13,4247,0.0
KERALA,ALAPPUZHA,2021-02-07,319,3034,2,3355,0.0
KERALA,ALAPPUZHA,2021-02-08,372,2831,10,3213,0.0
KERALA,ALAPPUZHA,2021-02-09,387,3518,11,3916,0.0
KERALA,ALAPPUZHA,2021-02-10,372,3061,2,3435,0.0
KERALA,ERNAKULAM,2021-02-06,1068,8286,24,9378,0.0
KERALA,ERNAKULAM,2021-02-07,554,3944,17,4515,0.0
KERALA,ERNAKULAM,2021-02-08,550,6016,2,6568,0.0
KERALA,ERNAKULAM,2021-02-09,876,8467,14,9357,0.0
KERALA,ERNAKULAM,2021-02-10,714,8518,7,9239,0.0
KERALA,IDUKKI,2021-02-06,242,2201,7,2450,0.0
KERALA,IDUKKI,2021-02-07,293,3215,7,3515,0.0
KERALA,IDUKKI,2021-02-08,115,1827,2,1944,0.0
KERALA,IDUKKI,2021-02-09,170,2565,4,2739,0.0
KERALA,IDUKKI,2021-02-10,224,2460,9,2693,0.0
KERALA,KANNUR,2021-02-06,268,3963,6,4237,0.0
KERALA,KANNUR,2021-02-07,274,2439,3,2716,0.0
KERALA,KANNUR,2021-02-08,242,2239,0,2481,0.0
KERALA,KANNUR,2021-02-09,280,2730,5,3015,0.0
KERALA,KANNUR,2021-02-10,274,3156,4,3434,0.0
KERALA,KASARAGOD,2021-02-06,95,1808,0,1903,0.0
KERALA,KASARAGOD,2021-02-07,88,935,6,1029,0.0
KERALA,KASARAGOD,2021-02-08,105,1297,4,1406,0.0
KERALA,KASARAGOD,2021-02-09,112,1586,1,1699,0.0
KERALA,KASARAGOD,2021-02-10,109,1934,0,2043,0.0
KERALA,KOLLAM,2021-02-06,545,5700,0,6245,0.0
KERALA,KOLLAM,2021-02-07,859,5078,6,5943,0.0
KERALA,KOLLAM,2021-02-08,497,4116,0,4613,0.0
KERALA,KOLLAM,2021-02-09,850,5350,2,6202,0.0
KERALA,KOLLAM,2021-02-10,664,4667,0,5331,0.0
KERALA,KOTTAYAM,2021-02-06,775,4812,74,5661,0.0
KERALA,KOTTAYAM,2021-02-07,425,2817,40,3282,0.0
KERALA,KOTTAYAM,2021-02-08,488,3200,23,3711,0.0
KERALA,KOTTAYAM,2021-02-09,621,4960,32,5613,0.0
KERALA,KOTTAYAM,2021-02-10,584,4449,40,5073,0.0
KERALA,KOZHIKODE,2021-02-06,972,7908,36,8916,0.0
KERALA,KOZHIKODE,2021-02-07,582,3166,26,3774,0.0
KERALA,KOZHIKODE,2021-02-08,445,4368,12,4825,0.0
KERALA,KOZHIKODE,2021-02-09,774,5242,25,6041,0.0
KERALA,KOZHIKODE,2021-02-10,707,5297,35,6039,0.0
KERALA,MALAPPURAM,2021-02-06,601,4405,0,5006,0.0
KERALA,MALAPPURAM,2021-02-07,508,2826,5,3339,0.0
KERALA,MALAPPURAM,2021-02-08,573,3334,2,3909,0.0
KERALA,MALAPPURAM,2021-02-09,364,3329,2,3695,0.0
KERALA,MALAPPURAM,2021-02-10,482,3676,2,4160,0.0
KERALA,PALAKKAD,2021-02-06,280,6044,1,6325,0.0
KERALA,PALAKKAD,2021-02-07,171,2843,0,3014,0.0
KERALA,PALAKKAD,2021-02-08,160,3119,3,3282,0.0
KERALA,PALAKKAD,2021-02-09,228,3291,0,3519,0.0
KERALA,PALAKKAD,2021-02-10,227,2756,3,2986,0.0
KERALA,PATHANAMTHITTA,2021-02-06,647,4395,2,5044,0.0
KERALA,PATHANAMTHITTA,2021-02-07,272,2576,1,2849,0.0
KERALA,PATHANAMTHITTA,2021-02-08,453,2759,2,3214,0.0
KERALA,PATHANAMTHITTA,2021-02-09,547,3137,2,3686,0.0
KERALA,PATHANAMTHITTA,2021-02-10,735,3584,5,4324,0.0
KERALA,THIRUVANANTHAPURAM,2021-02-06,610,7111,0,7721,0.0
KERALA,THIRUVANANTHAPURAM,2021-02-07,563,4265,0,4828,0.0
KERALA,THIRUVANANTHAPURAM,2021-02-08,565,5452,1,6018,0.0
KERALA,THIRUVANANTHAPURAM,2021-02-09,529,6230,14,6773,0.0
KERALA,THIRUVANANTHAPURAM,2021-02-10,483,5920,5,6408,0.0
KERALA,THRISSUR,2021-02-06,600,7518,0,8118,0.0
KERALA,THRISSUR,2021-02-07,387,4998,2,5387,0.0
KERALA,THRISSUR,2021-02-08,449,4366,0,4815,0.0
KERALA,THRISSUR,2021-02-09,575,5490,0,6065,0.0
KERALA,THRISSUR,2021-02-10,462,5485,0,5947,0.0
KERALA,WAYANAD,2021-02-06,250,1575,9,1834,0.0
KERALA,WAYANAD,2021-02-07,162,900,10,1072,0.0
KERALA,WAYANAD,2021-02-08,77,1255,0,1332,0.0
KERALA,WAYANAD,2021-02-09,181,1166,2,1349,0.0
KERALA,WAYANAD,2021-02-10,217,1642,9,1868,0.0
LADAKH,KARGIL,2021-02-06,0,30,0,30,0.0
LADAKH,KARGIL,2021-02-07,0,33,0,33,0.0
LADAKH,KARGIL,2021-02-08,0,155,0,155,0.0
LADAKH,KARGIL,2021-02-09,0,68,1,69,0.0
LADAKH,KARGIL,2021-02-10,0,51,0,51,0.0
LADAKH,LEH LADAKH,2021-02-06,2,150,0,152,0.0
LADAKH,LEH LADAKH,2021-02-07,0,49,0,49,0.0
LADAKH,LEH LADAKH,2021-02-08,5,138,2,145,0.0
LADAKH,LEH LADAKH,2021-02-09,5,187,2,194,0.0
LADAKH,LEH LADAKH,2021-02-10,3,123,0,126,0.0
LAKSHADWEEP,LAKSHADWEEP DISTRICT,2021-02-06,1,1053,0,1054,0.0
LAKSHADWEEP,LAKSHADWEEP DISTRICT,2021-02-07,0,809,0,809,0.0
LAKSHADWEEP,LAKSHADWEEP DISTRICT,2021-02-08,1,744,0,745,0.0
LAKSHADWEEP,LAKSHADWEEP DISTRICT,2021-02-09,4,640,0,644,0.0
LAKSHADWEEP,LAKSHADWEEP DISTRICT,2021-02-10,2,758,0,760,0.0
MADHYA PRADESH,AGAR MALWA,2021-02-06,0,134,0,134,0.0
MADHYA PRADESH,AGAR MALWA,2021-02-07,0,57,0,57,0.0
MADHYA PRADESH,AGAR MALWA,2021-02-08,2,167,0,169,0.0
MADHYA PRADESH,AGAR MALWA,2021-02-09,0,102,0,102,0.0
MADHYA PRADESH,AGAR MALWA,2021-02-10,1,231,0,232,0.0
MADHYA PRADESH,ALIRAJPUR,2021-02-06,0,42,0,42,0.0
MADHYA PRADESH,ALIRAJPUR,2021-02-07,0,40,0,40,0.0
MADHYA PRADESH,ALIRAJPUR,2021-02-08,0,201,0,201,0.0
MADHYA PRADESH,ALIRAJPUR,2021-02-09,0,91,0,91,0.0
MADHYA PRADESH,ALIRAJPUR,2021-02-10,1,76,0,77,0.0
MADHYA PRADESH,ANUPPUR,2021-02-06,1,157,0,158,0.0
MADHYA PRADESH,ANUPPUR,2021-02-07,1,106,0,107,0.0
MADHYA PRADESH,ANUPPUR,2021-02-08,1,127,2,130,0.0
MADHYA PRADESH,ANUPPUR,2021-02-09,0,212,6,218,0.0
MADHYA PRADESH,ANUPPUR,2021-02-10,0,171,18,189,0.0
MADHYA PRADESH,ASHOKNAGAR,2021-02-06,0,67,0,67,0.0
MADHYA PRADESH,ASHOKNAGAR,2021-02-07,0,161,0,161,0.0
MADHYA PRADESH,ASHOKNAGAR,2021-02-08,0,65,0,65,0.0
MADHYA PRADESH,ASHOKNAGAR,2021-02-09,0,33,0,33,0.0
MADHYA PRADESH,ASHOKNAGAR,2021-02-10,0,127,0,127,0.0
MADHYA PRADESH,BALAGHAT,2021-02-06,0,358,0,358,0.0
MADHYA PRADESH,BALAGHAT,2021-02-07,1,345,0,346,0.0
MADHYA PRADESH,BALAGHAT,2021-02-08,0,277,0,277,0.0
MADHYA PRADESH,BALAGHAT,2021-02-09,1,295,0,296,0.0
MADHYA PRADESH,BALAGHAT,2021-02-10,2,481,0,483,0.0
MADHYA PRADESH,BARWANI,2021-02-06,2,97,0,99,0.0
MADHYA PRADESH,BARWANI,2021-02-07,4,208,0,212,0.0
MADHYA PRADESH,BARWANI,2021-02-08,4,132,0,136,0.0
MADHYA PRADESH,BARWANI,2021-02-09,1,178,0,179,0.0
MADHYA PRADESH,BARWANI,2021-02-10,3,167,0,170,0.0
MADHYA PRADESH,BETUL,2021-02-06,6,273,0,279,0.0
MADHYA PRADESH,BETUL,2021-02-07,10,176,3,189,0.0
MADHYA PRADESH,BETUL,2021-02-08,2,434,9,445,0.0
MADHYA PRADESH,BETUL,2021-02-09,5,261,4,270,0.0
MADHYA PRADESH,BETUL,2021-02-10,6,133,7,146,0.0
MADHYA PRADESH,BHIND,2021-02-06,0,158,0,158,0.0
MADHYA PRADESH,BHIND,2021-02-07,0,129,0,129,0.0
MADHYA PRADESH,BHIND,2021-02-08,0,324,0,324,0.0
MADHYA PRADESH,BHIND,2021-02-09,0,205,0,205,0.0
MADHYA PRADESH,BHIND,2021-02-10,0,221,1,222,0.0
MADHYA PRADESH,BHOPAL,2021-02-06,65,1421,13,1499,0.0
MADHYA PRADESH,BHOPAL,2021-02-07,66,997,7,1070,0.0
MADHYA PRADESH,BHOPAL,2021-02-08,43,1307,4,1354,0.0
MADHYA PRADESH,BHOPAL,2021-02-09,56,1601,7,1664,0.0
MADHYA PRADESH,BHOPAL,2021-02-10,40,1214,1,1255,0.0
MADHYA PRADESH,BURHANPUR,2021-02-06,0,147,0,147,0.0
MADHYA PRADESH,BURHANPUR,2021-02-07,0,106,0,106,0.0
MADHYA PRADESH,BURHANPUR,2021-02-08,1,148,0,149,0.0
MADHYA PRADESH,BURHANPUR,2021-02-09,0,103,0,103,0.0
MADHYA PRADESH,BURHANPUR,2021-02-10,1,152,0,153,0.0
MADHYA PRADESH,CHHATARPUR,2021-02-06,0,146,0,146,0.0
MADHYA PRADESH,CHHATARPUR,2021-02-07,0,229,0,229,0.0
MADHYA PRADESH,CHHATARPUR,2021-02-08,0,331,2,333,0.0
MADHYA PRADESH,CHHATARPUR,2021-02-09,1,178,0,179,0.0
MADHYA PRADESH,CHHATARPUR,2021-02-10,1,257,1,259,0.0
MADHYA PRADESH,CHHINDWARA,2021-02-06,7,334,6,347,0.0
MADHYA PRADESH,CHHINDWARA,2021-02-07,3,289,3,295,0.0
MADHYA PRADESH,CHHINDWARA,2021-02-08,7,295,3,305,0.0
MADHYA PRADESH,CHHINDWARA,2021-02-09,9,407,1,417,0.0
MADHYA PRADESH,CHHINDWARA,2021-02-10,9,460,3,472,0.0
MADHYA PRADESH,DAMOH,2021-02-06,5,179,0,184,0.0
MADHYA PRADESH,DAMOH,2021-02-07,4,148,0,152,0.0
MADHYA PRADESH,DAMOH,2021-02-08,5,305,0,310,0.0
MADHYA PRADESH,DAMOH,2021-02-09,6,158,0,164,0.0
MADHYA PRADESH,DAMOH,2021-02-10,2,134,0,136,0.0
MADHYA PRADESH,DATIA,2021-02-06,1,108,0,109,0.0
MADHYA PRADESH,DATIA,2021-02-07,1,77,1,79,0.0
MADHYA PRADESH,DATIA,2021-02-08,2,257,4,263,0.0
MADHYA PRADESH,DATIA,2021-02-09,1,145,6,152,0.0
MADHYA PRADESH,DATIA,2021-02-10,0,156,4,160,0.0
MADHYA PRADESH,DEWAS,2021-02-06,3,118,0,121,0.0
MADHYA PRADESH,DEWAS,2021-02-07,3,35,0,38,0.0
MADHYA PRADESH,DEWAS,2021-02-08,17,78,0,95,0.0
MADHYA PRADESH,DEWAS,2021-02-09,6,135,0,141,0.0
MADHYA PRADESH,DEWAS,2021-02-10,7,224,0,231,0.0
MADHYA PRADESH,DHAR,2021-02-06,5,124,0,129,0.0
MADHYA PRADESH,DHAR,2021-02-07,1,93,0,94,0.0
MADHYA PRADESH,DHAR,2021-02-08,3,198,0,201,0.0
MADHYA PRADESH,DHAR,2021-02-09,3,205,0,208,0.0
MADHYA PRADESH,DHAR,2021-02-10,2,307,0,309,0.0
MADHYA PRADESH,DINDORI,2021-02-06,5,589,0,594,0.0
MADHYA PRADESH,DINDORI,2021-02-07,0,451,0,451,0.0
MADHYA PRADESH,DINDORI,2021-02-08,1,498,0,499,0.0
MADHYA PRADESH,DINDORI,2021-02-09,0,390,0,390,0.0
MADHYA PRADESH,DINDORI,2021-02-10,2,360,0,362,0.0
MADHYA PRADESH,EAST NIMAR,2021-02-06,0,107,0,107,0.0
MADHYA PRADESH,EAST NIMAR,2021-02-07,2,299,0,301,0.0
MADHYA PRADESH,EAST NIMAR,2021-02-08,0,145,0,145,0.0
MADHYA PRADESH,EAST NIMAR,2021-02-09,0,328,1,329,0.0
MADHYA PRADESH,EAST NIMAR,2021-02-10,1,262,0,263,0.0
MADHYA PRADESH,GUNA,2021-02-06,0,321,0,321,0.0
MADHYA PRADESH,GUNA,2021-02-07,0,291,0,291,0.0
MADHYA PRADESH,GUNA,2021-02-08,1,261,0,262,0.0
MADHYA PRADESH,GUNA,2021-02-09,0,123,0,123,0.0
MADHYA PRADESH,GUNA,2021-02-10,4,338,0,342,0.0
MADHYA PRADESH,GWALIOR,2021-02-06,11,749,1,761,0.0
MADHYA PRADESH,GWALIOR,2021-02-07,7,600,3,610,0.0
MADHYA PRADESH,GWALIOR,2021-02-08,4,587,1,592,0.0
MADHYA PRADESH,GWALIOR,2021-02-09,2,702,1,705,0.0
MADHYA PRADESH,GWALIOR,2021-02-10,5,539,0,544,0.0
MADHYA PRADESH,HARDA,2021-02-06,1,225,0,226,0.0
MADHYA PRADESH,HARDA,2021-02-07,3,203,0,206,0.0
MADHYA PRADESH,HARDA,2021-02-08,0,258,0,258,0.0
MADHYA PRADESH,HARDA,2021-02-09,1,258,0,259,0.0
MADHYA PRADESH,HARDA,2021-02-10,3,186,0,189,0.0
MADHYA PRADESH,HOSHANGABAD,2021-02-06,4,207,1,212,0.0
MADHYA PRADESH,HOSHANGABAD,2021-02-07,0,126,0,126,0.0
MADHYA PRADESH,HOSHANGABAD,2021-02-08,2,203,0,205,0.0
MADHYA PRADESH,HOSHANGABAD,2021-02-09,2,232,0,234,0.0
MADHYA PRADESH,HOSHANGABAD,2021-02-10,5,275,1,281,0.0
MADHYA PRADESH,INDORE,2021-02-06,71,1280,0,1351,0.0
MADHYA PRADESH,INDORE,2021-02-07,35,826,0,861,0.0
MADHYA PRADESH,INDORE,2021-02-08,59,1433,0,1492,0.0
MADHYA PRADESH,INDORE,2021-02-09,58,1414,0,1472,0.0
MADHYA PRADESH,INDORE,2021-02-10,52,1276,0,1328,0.0
MADHYA PRADESH,JABALPUR,2021-02-06,27,628,4,659,0.0
MADHYA PRADESH,JABALPUR,2021-02-07,13,197,2,212,0.0
MADHYA PRADESH,JABALPUR,2021-02-08,9,713,1,723,0.0
MADHYA PRADESH,JABALPUR,2021-02-09,21,567,1,589,0.0
MADHYA PRADESH,JABALPUR,2021-02-10,12,576,1,589,0.0
MADHYA PRADESH,JHABUA,2021-02-06,3,204,0,207,0.0
MADHYA PRADESH,JHABUA,2021-02-07,0,116,0,116,0.0
MADHYA PRADESH,JHABUA,2021-02-08,0,224,0,224,0.0
MADHYA PRADESH,JHABUA,2021-02-09,1,156,0,157,0.0
MADHYA PRADESH,JHABUA,2021-02-10,0,198,0,198,0.0
MADHYA PRADESH,KATNI,2021-02-06,2,117,1,120,0.0
MADHYA PRADESH,KATNI,2021-02-07,2,198,0,200,0.0
MADHYA PRADESH,KATNI,2021-02-08,2,51,0,53,0.0
MADHYA PRADESH,KATNI,2021-02-09,0,264,0,264,0.0
MADHYA PRADESH,KATNI,2021-02-10,0,12,0,12,0.0
MADHYA PRADESH,KHARGONE,2021-02-06,2,213,0,215,0.0
MADHYA PRADESH,KHARGONE,2021-02-07,8,69,0,77,0.0
MADHYA PRADESH,KHARGONE,2021-02-08,9,387,0,396,0.0
MADHYA PRADESH,KHARGONE,2021-02-09,4,200,0,204,0.0
MADHYA PRADESH,KHARGONE,2021-02-10,2,323,0,325,0.0
MADHYA PRADESH,MANDLA,2021-02-06,0,271,0,271,0.0
MADHYA PRADESH,MANDLA,2021-02-07,0,683,0,683,0.0
MADHYA PRADESH,MANDLA,2021-02-08,0,350,0,350,0.0
MADHYA PRADESH,MANDLA,2021-02-09,1,319,0,320,0.0
MADHYA PRADESH,MANDLA,2021-02-10,1,456,0,457,0.0
MADHYA PRADESH,MANDSAUR,2021-02-06,0,150,3,153,0.0
MADHYA PRADESH,MANDSAUR,2021-02-07,2,36,0,38,0.0
MADHYA PRADESH,MANDSAUR,2021-02-08,3,107,0,110,0.0
MADHYA PRADESH,MANDSAUR,2021-02-09,2,91,0,93,0.0
MADHYA PRADESH,MANDSAUR,2021-02-10,2,100,1,103,0.0
MADHYA PRADESH,MORENA,2021-02-06,0,406,0,406,0.0
MADHYA PRADESH,MORENA,2021-02-07,2,220,0,222,0.0
MADHYA PRADESH,MORENA,2021-02-08,1,421,0,422,0.0
MADHYA PRADESH,MORENA,2021-02-09,0,254,8,262,0.0
MADHYA PRADESH,MORENA,2021-02-10,0,321,0,321,0.0
MADHYA PRADESH,NARSINGHPUR,2021-02-06,0,481,0,481,0.0
MADHYA PRADESH,NARSINGHPUR,2021-02-07,0,584,0,584,0.0
MADHYA PRADESH,NARSINGHPUR,2021-02-08,1,304,0,305,0.0
MADHYA PRADESH,NARSINGHPUR,2021-02-09,0,448,0,448,0.0
MADHYA PRADESH,NARSINGHPUR,2021-02-10,4,399,0,403,0.0
MADHYA PRADESH,NEEMUCH,2021-02-06,2,175,0,177,0.0
MADHYA PRADESH,NEEMUCH,2021-02-07,0,31,0,31,0.0
MADHYA PRADESH,NEEMUCH,2021-02-08,1,133,1,135,0.0
MADHYA PRADESH,NEEMUCH,2021-02-09,1,74,0,75,0.0
MADHYA PRADESH,NEEMUCH,2021-02-10,3,123,0,126,0.0
MADHYA PRADESH,NIWARI,2021-02-06,0,109,0,109,0.0
MADHYA PRADESH,NIWARI,2021-02-07,1,136,0,137,0.0
MADHYA PRADESH,NIWARI,2021-02-08,2,115,0,117,0.0
MADHYA PRADESH,NIWARI,2021-02-09,0,47,0,47,0.0
MADHYA PRADESH,NIWARI,2021-02-10,2,161,0,163,0.0
MADHYA PRADESH,PANNA,2021-02-06,2,93,0,95,0.0
MADHYA PRADESH,PANNA,2021-02-07,0,32,0,32,0.0
MADHYA PRADESH,PANNA,2021-02-08,2,61,0,63,0.0
MADHYA PRADESH,PANNA,2021-02-09,1,64,0,65,0.0
MADHYA PRADESH,PANNA,2021-02-10,2,64,0,66,0.0
MADHYA PRADESH,RAISEN,2021-02-06,1,95,1,97,0.0
MADHYA PRADESH,RAISEN,2021-02-07,0,23,0,23,0.0
MADHYA PRADESH,RAISEN,2021-02-08,1,130,0,131,0.0
MADHYA PRADESH,RAISEN,2021-02-09,2,119,0,121,0.0
MADHYA PRADESH,RAISEN,2021-02-10,1,135,0,136,0.0
MADHYA PRADESH,RAJGARH,2021-02-06,2,132,0,134,0.0
MADHYA PRADESH,RAJGARH,2021-02-07,1,116,3,120,0.0
MADHYA PRADESH,RAJGARH,2021-02-08,5,159,0,164,0.0
MADHYA PRADESH,RAJGARH,2021-02-09,1,162,0,163,0.0
MADHYA PRADESH,RAJGARH,2021-02-10,1,158,0,159,0.0
MADHYA PRADESH,RATLAM,2021-02-06,5,231,0,236,0.0
MADHYA PRADESH,RATLAM,2021-02-07,5,37,0,42,0.0
MADHYA PRADESH,RATLAM,2021-02-08,4,273,2,279,0.0
MADHYA PRADESH,RATLAM,2021-02-09,4,206,2,212,0.0
MADHYA PRADESH,RATLAM,2021-02-10,3,219,11,233,0.0
MADHYA PRADESH,REWA,2021-02-06,2,449,2,453,0.0
MADHYA PRADESH,REWA,2021-02-07,1,672,11,684,0.0
MADHYA PRADESH,REWA,2021-02-08,4,324,0,328,0.0
MADHYA PRADESH,REWA,2021-02-09,1,622,1,624,0.0
MADHYA PRADESH,REWA,2021-02-10,6,583,2,591,0.0
MADHYA PRADESH,SAGAR,2021-02-06,3,632,0,635,0.0
MADHYA PRADESH,SAGAR,2021-02-07,6,629,0,635,0.0
MADHYA PRADESH,SAGAR,2021-02-08,3,540,5,548,0.0
MADHYA PRADESH,SAGAR,2021-02-09,4,772,2,778,0.0
MADHYA PRADESH,SAGAR,2021-02-10,6,696,2,704,0.0
MADHYA PRADESH,SATNA,2021-02-06,1,310,0,311,0.0
MADHYA PRADESH,SATNA,2021-02-07,0,126,0,126,0.0
MADHYA PRADESH,SATNA,2021-02-08,0,179,0,179,0.0
MADHYA PRADESH,SATNA,2021-02-09,1,414,2,417,0.0
MADHYA PRADESH,SATNA,2021-02-10,1,202,0,203,0.0
MADHYA PRADESH,SEHORE,2021-02-06,1,250,0,251,0.0
MADHYA PRADESH,SEHORE,2021-02-07,3,239,0,242,0.0
MADHYA PRADESH,SEHORE,2021-02-08,0,312,0,312,0.0
MADHYA PRADESH,SEHORE,2021-02-09,0,243,0,243,0.0
MADHYA PRADESH,SEHORE,2021-02-10,0,246,2,248,0.0
MADHYA PRADESH,SEONI,2021-02-06,1,188,0,189,0.0
MADHYA PRADESH,SEONI,2021-02-07,1,213,1,215,0.0
MADHYA PRADESH,SEONI,2021-02-08,2,198,0,200,0.0
MADHYA PRADESH,SEONI,2021-02-09,1,273,0,274,0.0
MADHYA PRADESH,SEONI,2021-02-10,1,460,1,462,0.0
MADHYA PRADESH,SHAHDOL,2021-02-06,0,14,0,14,0.0
MADHYA PRADESH,SHAHDOL,2021-02-08,0,19,0,19,0.0
MADHYA PRADESH,SHAHDOL,2021-02-09,2,17,0,19,0.0
MADHYA PRADESH,SHAHDOL,2021-02-10,4,94,0,98,0.0
MADHYA PRADESH,SHAJAPUR,2021-02-06,1,91,0,92,0.0
MADHYA PRADESH,SHAJAPUR,2021-02-07,1,175,0,176,0.0
MADHYA PRADESH,SHAJAPUR,2021-02-08,0,249,1,250,0.0
MADHYA PRADESH,SHAJAPUR,2021-02-09,0,142,0,142,0.0
MADHYA PRADESH,SHAJAPUR,2021-02-10,3,281,0,284,0.0
MADHYA PRADESH,SHEOPUR,2021-02-06,0,33,1,34,0.0
MADHYA PRADESH,SHEOPUR,2021-02-07,1,30,0,31,0.0
MADHYA PRADESH,SHEOPUR,2021-02-08,1,316,1,318,0.0
MADHYA PRADESH,SHEOPUR,2021-02-09,1,127,0,128,0.0
MADHYA PRADESH,SHEOPUR,2021-02-10,0,33,0,33,0.0
MADHYA PRADESH,SHIVPURI,2021-02-06,1,218,0,219,0.0
MADHYA PRADESH,SHIVPURI,2021-02-07,0,71,0,71,0.0
MADHYA PRADESH,SHIVPURI,2021-02-08,0,189,0,189,0.0
MADHYA PRADESH,SHIVPURI,2021-02-09,1,159,1,161,0.0
MADHYA PRADESH,SHIVPURI,2021-02-10,0,226,4,230,0.0
MADHYA PRADESH,SIDHI,2021-02-06,0,75,0,75,0.0
MADHYA PRADESH,SIDHI,2021-02-07,0,5,0,5,0.0
MADHYA PRADESH,SIDHI,2021-02-08,4,178,0,182,0.0
MADHYA PRADESH,SIDHI,2021-02-09,1,32,0,33,0.0
MADHYA PRADESH,SIDHI,2021-02-10,2,131,0,133,0.0
MADHYA PRADESH,SINGRAULI,2021-02-06,3,108,0,111,0.0
MADHYA PRADESH,SINGRAULI,2021-02-07,1,102,0,103,0.0
MADHYA PRADESH,SINGRAULI,2021-02-08,1,199,0,200,0.0
MADHYA PRADESH,SINGRAULI,2021-02-09,0,17,0,17,0.0
MADHYA PRADESH,SINGRAULI,2021-02-10,8,99,0,107,0.0
MADHYA PRADESH,TIKAMGARH,2021-02-06,0,188,5,193,0.0
MADHYA PRADESH,TIKAMGARH,2021-02-07,1,282,1,284,0.0
MADHYA PRADESH,TIKAMGARH,2021-02-08,2,163,0,165,0.0
MADHYA PRADESH,TIKAMGARH,2021-02-09,0,116,0,116,0.0
MADHYA PRADESH,TIKAMGARH,2021-02-10,0,277,0,277,0.0
MADHYA PRADESH,UJJAIN,2021-02-06,0,615,0,615,0.0
MADHYA PRADESH,UJJAIN,2021-02-07,1,141,0,142,0.0
MADHYA PRADESH,UJJAIN,2021-02-08,0,254,1,255,0.0
MADHYA PRADESH,UJJAIN,2021-02-09,2,39,0,41,0.0
MADHYA PRADESH,UJJAIN,2021-02-10,0,325,0,325,0.0
MADHYA PRADESH,UMARIA,2021-02-06,0,43,0,43,0.0
MADHYA PRADESH,UMARIA,2021-02-07,0,17,0,17,0.0
MADHYA PRADESH,UMARIA,2021-02-08,0,48,0,48,0.0
MADHYA PRADESH,UMARIA,2021-02-09,0,52,0,52,0.0
MADHYA PRADESH,UMARIA,2021-02-10,1,136,10,147,0.0
MADHYA PRADESH,VIDISHA,2021-02-06,1,108,1,110,0.0
MADHYA PRADESH,VIDISHA,2021-02-07,2,32,1,35,0.0
MADHYA PRADESH,VIDISHA,2021-02-08,0,158,2,160,0.0
MADHYA PRADESH,VIDISHA,2021-02-09,2,128,4,134,0.0
MADHYA PRADESH,VIDISHA,2021-02-10,3,84,1,88,0.0
MAHARASHTRA,AHMEDNAGAR,2021-02-06,43,918,1,962,0.0
MAHARASHTRA,AHMEDNAGAR,2021-02-07,74,870,0,944,0.0
MAHARASHTRA,AHMEDNAGAR,2021-02-08,68,678,3,749,0.0
MAHARASHTRA,AHMEDNAGAR,2021-02-09,84,619,0,703,0.0
MAHARASHTRA,AHMEDNAGAR,2021-02-10,132,1213,1,1346,0.0
MAHARASHTRA,AKOLA,2021-02-06,53,408,0,461,0.0
MAHARASHTRA,AKOLA,2021-02-07,61,189,0,250,0.0
MAHARASHTRA,AKOLA,2021-02-08,33,129,4,166,0.0
MAHARASHTRA,AKOLA,2021-02-09,87,336,3,426,0.0
MAHARASHTRA,AKOLA,2021-02-10,73,304,1,378,0.0
MAHARASHTRA,AMRAVATI,2021-02-06,194,839,10,1043,0.0
MAHARASHTRA,AMRAVATI,2021-02-07,174,372,2,548,0.0
MAHARASHTRA,AMRAVATI,2021-02-08,292,710,8,1010,0.0
MAHARASHTRA,AMRAVATI,2021-02-09,351,665,4,1020,0.0
MAHARASHTRA,AMRAVATI,2021-02-10,373,760,5,1138,0.0
MAHARASHTRA,AURANGABAD,2021-02-06,35,663,0,698,0.0
MAHARASHTRA,AURANGABAD,2021-02-07,43,674,0,717,0.0
MAHARASHTRA,AURANGABAD,2021-02-08,41,933,0,974,0.0
MAHARASHTRA,AURANGABAD,2021-02-09,75,1078,1,1154,0.0
MAHARASHTRA,AURANGABAD,2021-02-10,53,1250,0,1303,0.0
MAHARASHTRA,BEED,2021-02-06,26,401,0,427,0.0
MAHARASHTRA,BEED,2021-02-07,21,287,0,308,0.0
MAHARASHTRA,BEED,2021-02-08,24,351,0,375,0.0
MAHARASHTRA,BEED,2021-02-09,26,560,0,586,0.0
MAHARASHTRA,BEED,2021-02-10,21,460,0,481,0.0
MAHARASHTRA,BHANDARA,2021-02-06,5,276,0,281,0.0
MAHARASHTRA,BHANDARA,2021-02-07,11,172,0,183,0.0
MAHARASHTRA,BHANDARA,2021-02-08,3,207,1,211,0.0
MAHARASHTRA,BHANDARA,2021-02-09,5,180,0,185,0.0
MAHARASHTRA,BHANDARA,2021-02-10,7,453,0,460,0.0
MAHARASHTRA,BULDHANA,2021-02-06,30,268,23,321,0.0
MAHARASHTRA,BULDHANA,2021-02-07,41,195,53,289,0.0
MAHARASHTRA,BULDHANA,2021-02-08,17,146,6,169,0.0
MAHARASHTRA,BULDHANA,2021-02-09,52,319,17,388,0.0
MAHARASHTRA,BULDHANA,2021-02-10,30,296,23,349,0.0
MAHARASHTRA,CHANDRAPUR,2021-02-06,7,369,0,376,0.0
MAHARASHTRA,CHANDRAPUR,2021-02-07,9,124,0,133,0.0
MAHARASHTRA,CHANDRAPUR,2021-02-08,11,589,1,601,0.0
MAHARASHTRA,CHANDRAPUR,2021-02-09,7,530,2,539,0.0
MAHARASHTRA,CHANDRAPUR,2021-02-10,22,454,2,478,0.0
MAHARASHTRA,DHULE,2021-02-06,17,123,0,140,0.0
MAHARASHTRA,DHULE,2021-02-07,9,22,0,31,0.0
MAHARASHTRA,DHULE,2021-02-08,7,195,0,202,0.0
MAHARASHTRA,DHULE,2021-02-09,23,280,4,307,0.0
MAHARASHTRA,DHULE,2021-02-10,17,228,0,245,0.0
MAHARASHTRA,GADCHIROLI,2021-02-06,3,322,0,325,0.0
MAHARASHTRA,GADCHIROLI,2021-02-07,2,265,0,267,0.0
MAHARASHTRA,GADCHIROLI,2021-02-08,1,373,1,375,0.0
MAHARASHTRA,GADCHIROLI,2021-02-09,5,314,0,319,0.0
MAHARASHTRA,GADCHIROLI,2021-02-10,0,354,0,354,0.0
MAHARASHTRA,GONDIA,2021-02-06,6,166,0,172,0.0
MAHARASHTRA,GONDIA,2021-02-07,8,35,0,43,0.0
MAHARASHTRA,GONDIA,2021-02-08,3,589,3,595,0.0
MAHARASHTRA,GONDIA,2021-02-09,5,244,0,249,0.0
MAHARASHTRA,GONDIA,2021-02-10,6,183,2,191,0.0
MAHARASHTRA,HINGOLI,2021-02-06,8,644,0,652,0.0
MAHARASHTRA,HINGOLI,2021-02-07,2,14,0,16,0.0
MAHARASHTRA,HINGOLI,2021-02-08,1,15,0,16,0.0
MAHARASHTRA,HINGOLI,2021-02-09,4,472,0,476,0.0
MAHARASHTRA,HINGOLI,2021-02-10,1,193,0,194,0.0
MAHARASHTRA,JALGAON,2021-02-06,44,377,2,423,0.0
MAHARASHTRA,JALGAON,2021-02-07,55,466,0,521,0.0
MAHARASHTRA,JALGAON,2021-02-08,51,498,0,549,0.0
MAHARASHTRA,JALGAON,2021-02-09,54,878,0,932,0.0
MAHARASHTRA,JALGAON,2021-02-10,60,664,0,724,0.0
MAHARASHTRA,JALNA,2021-02-06,15,253,0,268,0.0
MAHARASHTRA,JALNA,2021-02-07,1,575,0,576,0.0
MAHARASHTRA,JALNA,2021-02-08,36,446,0,482,0.0
MAHARASHTRA,JALNA,2021-02-09,6,429,0,435,0.0
MAHARASHTRA,JALNA,2021-02-10,25,415,0,440,0.0
MAHARASHTRA,KOLHAPUR,2021-02-06,22,852,1,875,0.0
MAHARASHTRA,KOLHAPUR,2021-02-07,9,555,1,565,0.0
MAHARASHTRA,KOLHAPUR,2021-02-08,6,576,1,583,0.0
MAHARASHTRA,KOLHAPUR,2021-02-09,13,979,14,1006,0.0
MAHARASHTRA,KOLHAPUR,2021-02-10,18,845,14,877,0.0
MAHARASHTRA,LATUR,2021-02-06,19,500,4,523,0.0
MAHARASHTRA,LATUR,2021-02-07,24,334,0,358,0.0
MAHARASHTRA,LATUR,2021-02-08,43,546,8,597,0.0
MAHARASHTRA,LATUR,2021-02-09,30,856,23,909,0.0
MAHARASHTRA,LATUR,2021-02-10,59,886,3,948,0.0
MAHARASHTRA,MUMBAI,2021-02-06,444,11424,34,11902,0.0
MAHARASHTRA,MUMBAI,2021-02-07,349,6715,24,7088,0.0
MAHARASHTRA,MUMBAI,2021-02-08,365,11128,19,11512,0.0
MAHARASHTRA,MUMBAI,2021-02-09,499,10871,14,11384,0.0
MAHARASHTRA,MUMBAI,2021-02-10,479,13016,24,13519,0.0
MAHARASHTRA,MUMBAI SUBURBAN,2021-02-06,97,2529,8,2634,0.0
MAHARASHTRA,MUMBAI SUBURBAN,2021-02-07,96,1716,2,1814,0.0
MAHARASHTRA,MUMBAI SUBURBAN,2021-02-08,87,2395,2,2484,0.0
MAHARASHTRA,MUMBAI SUBURBAN,2021-02-09,124,2271,7,2402,0.0
MAHARASHTRA,MUMBAI SUBURBAN,2021-02-10,116,3028,2,3146,0.0
MAHARASHTRA,NAGPUR,2021-02-06,356,3223,27,3606,0.0
MAHARASHTRA,NAGPUR,2021-02-07,208,1529,9,1746,0.0
MAHARASHTRA,NAGPUR,2021-02-08,381,2886,8,3275,0.0
MAHARASHTRA,NAGPUR,2021-02-09,352,3767,15,4134,0.0
MAHARASHTRA,NAGPUR,2021-02-10,427,3319,26,3772,0.0
MAHARASHTRA,NANDED,2021-02-06,16,288,3,307,0.0
MAHARASHTRA,NANDED,2021-02-07,19,197,0,216,0.0
MAHARASHTRA,NANDED,2021-02-08,28,357,1,386,0.0
MAHARASHTRA,NANDED,2021-02-09,6,336,1,343,0.0
MAHARASHTRA,NANDED,2021-02-10,30,530,3,563,0.0
MAHARASHTRA,NANDURBAR,2021-02-06,27,122,0,149,0.0
MAHARASHTRA,NANDURBAR,2021-02-07,12,180,0,192,0.0
MAHARASHTRA,NANDURBAR,2021-02-08,6,362,1,369,0.0
MAHARASHTRA,NANDURBAR,2021-02-09,11,195,0,206,0.0
MAHARASHTRA,NANDURBAR,2021-02-10,8,182,0,190,0.0
MAHARASHTRA,NASHIK,2021-02-06,53,530,0,583,0.0
MAHARASHTRA,NASHIK,2021-02-07,198,1079,4,1281,0.0
MAHARASHTRA,NASHIK,2021-02-08,31,354,2,387,0.0
MAHARASHTRA,NASHIK,2021-02-09,338,1292,8,1638,0.0
MAHARASHTRA,NASHIK,2021-02-10,289,1209,0,1498,0.0
MAHARASHTRA,OSMANABAD,2021-02-06,24,588,4,616,0.0
MAHARASHTRA,OSMANABAD,2021-02-07,6,384,2,392,0.0
MAHARASHTRA,OSMANABAD,2021-02-08,13,476,1,490,0.0
MAHARASHTRA,OSMANABAD,2021-02-09,20,564,0,584,0.0
MAHARASHTRA,OSMANABAD,2021-02-10,5,187,0,192,0.0
MAHARASHTRA,PALGHAR,2021-02-06,37,882,2,921,0.0
MAHARASHTRA,PALGHAR,2021-02-07,40,396,0,436,0.0
MAHARASHTRA,PALGHAR,2021-02-08,33,522,2,557,0.0
MAHARASHTRA,PALGHAR,2021-02-09,56,772,0,828,0.0
MAHARASHTRA,PALGHAR,2021-02-10,31,894,1,926,0.0
MAHARASHTRA,PARBHANI,2021-02-06,5,619,1,625,0.0
MAHARASHTRA,PARBHANI,2021-02-07,9,397,0,406,0.0
MAHARASHTRA,PARBHANI,2021-02-08,10,851,0,861,0.0
MAHARASHTRA,PARBHANI,2021-02-09,27,534,0,561,0.0
MAHARASHTRA,PARBHANI,2021-02-10,8,334,2,344,0.0
MAHARASHTRA,PUNE,2021-02-06,446,5455,81,5982,0.0
MAHARASHTRA,PUNE,2021-02-07,318,2669,10,2997,0.0
MAHARASHTRA,PUNE,2021-02-08,466,3965,70,4501,0.0
MAHARASHTRA,PUNE,2021-02-09,561,4966,83,5610,0.0
MAHARASHTRA,PUNE,2021-02-10,598,5182,54,5834,0.0
MAHARASHTRA,RAIGAD,2021-02-06,75,1014,9,1098,0.0
MAHARASHTRA,RAIGAD,2021-02-07,60,683,2,745,0.0
MAHARASHTRA,RAIGAD,2021-02-08,46,753,7,806,0.0
MAHARASHTRA,RAIGAD,2021-02-09,77,795,0,872,0.0
MAHARASHTRA,RAIGAD,2021-02-10,72,952,4,1028,0.0
MAHARASHTRA,RATNAGIRI,2021-02-06,9,834,2,845,0.0
MAHARASHTRA,RATNAGIRI,2021-02-07,15,565,0,580,0.0
MAHARASHTRA,RATNAGIRI,2021-02-08,6,357,2,365,0.0
MAHARASHTRA,RATNAGIRI,2021-02-09,41,641,0,682,0.0
MAHARASHTRA,RATNAGIRI,2021-02-10,7,378,0,385,0.0
MAHARASHTRA,SANGLI,2021-02-06,28,353,0,381,0.0
MAHARASHTRA,SANGLI,2021-02-07,17,177,0,194,0.0
MAHARASHTRA,SANGLI,2021-02-08,19,439,1,459,0.0
MAHARASHTRA,SANGLI,2021-02-09,21,477,1,499,0.0
MAHARASHTRA,SANGLI,2021-02-10,19,544,0,563,0.0
MAHARASHTRA,SATARA,2021-02-06,129,1010,54,1193,0.0
MAHARASHTRA,SATARA,2021-02-07,67,1123,19,1209,0.0
MAHARASHTRA,SATARA,2021-02-08,64,1636,7,1707,0.0
MAHARASHTRA,SATARA,2021-02-09,62,1253,10,1325,0.0
MAHARASHTRA,SATARA,2021-02-10,95,1279,8,1382,0.0
MAHARASHTRA,SINDHUDURG,2021-02-06,14,402,1,417,0.0
MAHARASHTRA,SINDHUDURG,2021-02-07,4,183,0,187,0.0
MAHARASHTRA,SINDHUDURG,2021-02-08,3,279,0,282,0.0
MAHARASHTRA,SINDHUDURG,2021-02-09,10,258,0,268,0.0
MAHARASHTRA,SINDHUDURG,2021-02-10,10,266,0,276,0.0
MAHARASHTRA,SOLAPUR,2021-02-06,54,1237,4,1295,0.0
MAHARASHTRA,SOLAPUR,2021-02-07,64,989,5,1058,0.0
MAHARASHTRA,SOLAPUR,2021-02-08,48,1112,1,1161,0.0
MAHARASHTRA,SOLAPUR,2021-02-09,83,2127,5,2215,0.0
MAHARASHTRA,SOLAPUR,2021-02-10,51,1519,12,1582,0.0
MAHARASHTRA,THANE,2021-02-06,326,6535,28,6889,0.0
MAHARASHTRA,THANE,2021-02-07,244,4200,4,4448,0.0
MAHARASHTRA,THANE,2021-02-08,304,5370,15,5689,0.0
MAHARASHTRA,THANE,2021-02-09,426,7462,6,7894,0.0
MAHARASHTRA,THANE,2021-02-10,361,7128,16,7505,0.0
MAHARASHTRA,WARDHA,2021-02-06,72,289,11,372,0.0
MAHARASHTRA,WARDHA,2021-02-07,21,124,1,146,0.0
MAHARASHTRA,WARDHA,2021-02-08,85,543,16,644,0.0
MAHARASHTRA,WARDHA,2021-02-09,61,458,8,527,0.0
MAHARASHTRA,WARDHA,2021-02-10,49,363,10,422,0.0
MAHARASHTRA,WASHIM,2021-02-06,16,140,4,160,0.0
MAHARASHTRA,WASHIM,2021-02-07,11,178,1,190,0.0
MAHARASHTRA,WASHIM,2021-02-08,7,100,0,107,0.0
MAHARASHTRA,WASHIM,2021-02-09,11,214,0,225,0.0
MAHARASHTRA,WASHIM,2021-02-10,12,311,0,323,0.0
MAHARASHTRA,YAVATMAL,2021-02-06,70,327,0,397,0.0
MAHARASHTRA,YAVATMAL,2021-02-07,49,149,0,198,0.0
MAHARASHTRA,YAVATMAL,2021-02-08,52,326,2,380,0.0
MAHARASHTRA,YAVATMAL,2021-02-09,68,415,0,483,0.0
MAHARASHTRA,YAVATMAL,2021-02-10,74,468,1,543,0.0
MANIPUR,BISHNUPUR,2021-02-06,0,125,0,125,0.0
MANIPUR,BISHNUPUR,2021-02-07,0,82,0,82,0.0
MANIPUR,BISHNUPUR,2021-02-08,0,89,0,89,0.0
MANIPUR,BISHNUPUR,2021-02-09,0,69,0,69,0.0
MANIPUR,BISHNUPUR,2021-02-10,0,66,0,66,0.0
MANIPUR,CHANDEL,2021-02-06,0,17,0,17,0.0
MANIPUR,CHANDEL,2021-02-07,0,37,0,37,0.0
MANIPUR,CHANDEL,2021-02-08,0,30,0,30,0.0
MANIPUR,CHANDEL,2021-02-09,0,41,0,41,0.0
MANIPUR,CHANDEL,2021-02-10,0,18,0,18,0.0
MANIPUR,CHURACHANDPUR,2021-02-06,5,101,0,106,0.0
MANIPUR,CHURACHANDPUR,2021-02-07,0,68,0,68,0.0
MANIPUR,CHURACHANDPUR,2021-02-08,1,241,0,242,0.0
MANIPUR,CHURACHANDPUR,2021-02-09,1,152,0,153,0.0
MANIPUR,CHURACHANDPUR,2021-02-10,1,150,0,151,0.0
MANIPUR,IMPHAL EAST,2021-02-06,0,210,0,210,0.0
MANIPUR,IMPHAL EAST,2021-02-07,3,201,0,204,0.0
MANIPUR,IMPHAL EAST,2021-02-08,0,193,0,193,0.0
MANIPUR,IMPHAL EAST,2021-02-09,1,274,0,275,0.0
MANIPUR,IMPHAL EAST,2021-02-10,1,188,0,189,0.0
MANIPUR,IMPHAL WEST,2021-02-06,3,591,0,594,0.0
MANIPUR,IMPHAL WEST,2021-02-07,0,315,0,315,0.0
MANIPUR,IMPHAL WEST,2021-02-08,0,518,0,518,0.0
MANIPUR,IMPHAL WEST,2021-02-09,1,566,0,567,0.0
MANIPUR,IMPHAL WEST,2021-02-10,3,581,0,584,0.0
MANIPUR,JIRIBAM,2021-02-06,0,13,1,14,0.0
MANIPUR,JIRIBAM,2021-02-07,0,5,0,5,0.0
MANIPUR,JIRIBAM,2021-02-08,0,8,0,8,0.0
MANIPUR,JIRIBAM,2021-02-09,0,2,0,2,0.0
MANIPUR,JIRIBAM,2021-02-10,0,4,0,4,0.0
MANIPUR,KAKCHING,2021-02-06,5,90,0,95,0.0
MANIPUR,KAKCHING,2021-02-07,5,107,0,112,0.0
MANIPUR,KAKCHING,2021-02-08,3,49,0,52,0.0
MANIPUR,KAKCHING,2021-02-09,5,102,0,107,0.0
MANIPUR,KAKCHING,2021-02-10,0,41,0,41,0.0
MANIPUR,KAMJONG,2021-02-06,0,12,0,12,0.0
MANIPUR,KAMJONG,2021-02-07,0,1,0,1,0.0
MANIPUR,KAMJONG,2021-02-08,0,8,0,8,0.0
MANIPUR,KAMJONG,2021-02-09,0,7,0,7,0.0
MANIPUR,KAMJONG,2021-02-10,0,152,0,152,0.0
MANIPUR,KANGPOKPI,2021-02-06,0,49,0,49,0.0
MANIPUR,KANGPOKPI,2021-02-07,0,22,0,22,0.0
MANIPUR,KANGPOKPI,2021-02-08,0,36,0,36,0.0
MANIPUR,KANGPOKPI,2021-02-09,0,38,0,38,0.0
MANIPUR,KANGPOKPI,2021-02-10,0,46,0,46,0.0
MANIPUR,NONEY,2021-02-06,0,3,0,3,0.0
MANIPUR,NONEY,2021-02-07,0,5,0,5,0.0
MANIPUR,NONEY,2021-02-08,0,5,0,5,0.0
MANIPUR,NONEY,2021-02-09,0,1,0,1,0.0
MANIPUR,NONEY,2021-02-10,0,7,0,7,0.0
MANIPUR,SENAPATI,2021-02-06,0,33,0,33,0.0
MANIPUR,SENAPATI,2021-02-07,1,22,0,23,0.0
MANIPUR,SENAPATI,2021-02-08,1,140,0,141,0.0
MANIPUR,SENAPATI,2021-02-09,1,48,0,49,0.0
MANIPUR,SENAPATI,2021-02-10,1,35,0,36,0.0
MANIPUR,TAMENGLONG,2021-02-06,0,55,0,55,0.0
MANIPUR,TAMENGLONG,2021-02-07,0,25,0,25,0.0
MANIPUR,TAMENGLONG,2021-02-08,0,49,0,49,0.0
MANIPUR,TAMENGLONG,2021-02-09,0,162,0,162,0.0
MANIPUR,TAMENGLONG,2021-02-10,0,105,0,105,0.0
MANIPUR,TENGNOUPAL,2021-02-06,0,4,0,4,0.0
MANIPUR,TENGNOUPAL,2021-02-07,0,2,0,2,0.0
MANIPUR,TENGNOUPAL,2021-02-08,0,4,0,4,0.0
MANIPUR,TENGNOUPAL,2021-02-09,0,4,0,4,0.0
MANIPUR,TENGNOUPAL,2021-02-10,0,4,0,4,0.0
MANIPUR,THOUBAL,2021-02-06,2,108,0,110,0.0
MANIPUR,THOUBAL,2021-02-07,6,153,0,159,0.0
MANIPUR,THOUBAL,2021-02-08,7,107,0,114,0.0
MANIPUR,THOUBAL,2021-02-09,3,164,0,167,0.0
MANIPUR,THOUBAL,2021-02-10,2,153,0,155,0.0
MANIPUR,UKHRUL,2021-02-06,0,89,0,89,0.0
MANIPUR,UKHRUL,2021-02-07,3,232,0,235,0.0
MANIPUR,UKHRUL,2021-02-08,3,58,0,61,0.0
MANIPUR,UKHRUL,2021-02-09,2,323,0,325,0.0
MANIPUR,UKHRUL,2021-02-10,4,212,0,216,0.0
MEGHALAYA,EAST GARO HILLS,2021-02-06,0,12,0,12,0.0
MEGHALAYA,EAST GARO HILLS,2021-02-07,0,9,0,9,0.0
MEGHALAYA,EAST GARO HILLS,2021-02-08,0,25,0,25,0.0
MEGHALAYA,EAST GARO HILLS,2021-02-09,0,25,0,25,0.0
MEGHALAYA,EAST GARO HILLS,2021-02-10,0,18,0,18,0.0
MEGHALAYA,EAST JAINTIA HILLS,2021-02-06,0,29,0,29,0.0
MEGHALAYA,EAST JAINTIA HILLS,2021-02-07,0,8,0,8,0.0
MEGHALAYA,EAST JAINTIA HILLS,2021-02-08,0,134,0,134,0.0
MEGHALAYA,EAST JAINTIA HILLS,2021-02-09,2,131,0,133,0.0
MEGHALAYA,EAST JAINTIA HILLS,2021-02-10,0,44,0,44,0.0
MEGHALAYA,EAST KHASI HILLS,2021-02-06,29,565,0,594,0.0
MEGHALAYA,EAST KHASI HILLS,2021-02-07,2,554,0,556,0.0
MEGHALAYA,EAST KHASI HILLS,2021-02-08,1,764,1,766,0.0
MEGHALAYA,EAST KHASI HILLS,2021-02-09,28,834,0,862,0.0
MEGHALAYA,EAST KHASI HILLS,2021-02-10,7,855,0,862,0.0
MEGHALAYA,NORTH GARO HILLS,2021-02-06,0,2,0,2,0.0
MEGHALAYA,NORTH GARO HILLS,2021-02-07,0,1,0,1,0.0
MEGHALAYA,NORTH GARO HILLS,2021-02-08,0,3,0,3,0.0
MEGHALAYA,NORTH GARO HILLS,2021-02-09,0,3,0,3,0.0
MEGHALAYA,NORTH GARO HILLS,2021-02-10,0,12,0,12,0.0
MEGHALAYA,RI BHOI,2021-02-06,2,51,0,53,0.0
MEGHALAYA,RI BHOI,2021-02-07,0,22,0,22,0.0
MEGHALAYA,RI BHOI,2021-02-08,0,171,0,171,0.0
MEGHALAYA,RI BHOI,2021-02-09,0,130,0,130,0.0
MEGHALAYA,RI BHOI,2021-02-10,0,58,0,58,0.0
MEGHALAYA,SOUTH GARO HILLS,2021-02-06,0,8,0,8,0.0
MEGHALAYA,SOUTH GARO HILLS,2021-02-07,0,8,0,8,0.0
MEGHALAYA,SOUTH GARO HILLS,2021-02-08,0,14,0,14,0.0
MEGHALAYA,SOUTH GARO HILLS,2021-02-09,0,9,0,9,0.0
MEGHALAYA,SOUTH GARO HILLS,2021-02-10,0,9,0,9,0.0
MEGHALAYA,SOUTH WEST GARO HILLS,2021-02-06,0,28,0,28,0.0
MEGHALAYA,SOUTH WEST GARO HILLS,2021-02-08,0,54,0,54,0.0
MEGHALAYA,SOUTH WEST GARO HILLS,2021-02-09,0,19,0,19,0.0
MEGHALAYA,SOUTH WEST GARO HILLS,2021-02-10,0,31,0,31,0.0
MEGHALAYA,SOUTH WEST KHASI HILLS,2021-02-06,0,1,0,1,0.0
MEGHALAYA,SOUTH WEST KHASI HILLS,2021-02-07,0,3,0,3,0.0
MEGHALAYA,SOUTH WEST KHASI HILLS,2021-02-08,0,6,0,6,0.0
MEGHALAYA,SOUTH WEST KHASI HILLS,2021-02-09,0,7,0,7,0.0
MEGHALAYA,SOUTH WEST KHASI HILLS,2021-02-10,0,16,0,16,0.0
MEGHALAYA,WEST GARO HILLS,2021-02-06,0,67,0,67,0.0
MEGHALAYA,WEST GARO HILLS,2021-02-07,0,4,0,4,0.0
MEGHALAYA,WEST GARO HILLS,2021-02-08,0,76,0,76,0.0
MEGHALAYA,WEST GARO HILLS,2021-02-09,0,106,0,106,0.0
MEGHALAYA,WEST GARO HILLS,2021-02-10,0,42,0,42,0.0
MEGHALAYA,WEST JAINTIA HILLS,2021-02-06,12,54,0,66,0.0
MEGHALAYA,WEST JAINTIA HILLS,2021-02-07,4,18,0,22,0.0
MEGHALAYA,WEST JAINTIA HILLS,2021-02-08,3,48,0,51,0.0
MEGHALAYA,WEST JAINTIA HILLS,2021-02-09,8,86,0,94,0.0
MEGHALAYA,WEST JAINTIA HILLS,2021-02-10,0,96,0,96,0.0
MEGHALAYA,WEST KHASI HILLS,2021-02-06,0,27,0,27,0.0
MEGHALAYA,WEST KHASI HILLS,2021-02-07,0,17,0,17,0.0
MEGHALAYA,WEST KHASI HILLS,2021-02-08,0,73,0,73,0.0
MEGHALAYA,WEST KHASI HILLS,2021-02-09,0,99,0,99,0.0
MEGHALAYA,WEST KHASI HILLS,2021-02-10,0,41,0,41,0.0
MIZORAM,AIZAWL,2021-02-06,1,401,0,402,0.0
MIZORAM,AIZAWL,2021-02-07,1,141,0,142,0.0
MIZORAM,AIZAWL,2021-02-08,4,716,0,720,0.0
MIZORAM,AIZAWL,2021-02-09,2,490,0,492,0.0
MIZORAM,AIZAWL,2021-02-10,0,539,0,539,0.0
MIZORAM,CHAMPHAI,2021-02-06,0,9,0,9,0.0
MIZORAM,CHAMPHAI,2021-02-07,0,2,0,2,0.0
MIZORAM,CHAMPHAI,2021-02-08,0,4,0,4,0.0
MIZORAM,CHAMPHAI,2021-02-09,0,3,0,3,0.0
MIZORAM,CHAMPHAI,2021-02-10,0,13,0,13,0.0
MIZORAM,HNAHTHIAL,2021-02-06,0,1,0,1,0.0
MIZORAM,HNAHTHIAL,2021-02-08,0,5,0,5,0.0
MIZORAM,HNAHTHIAL,2021-02-09,0,2,0,2,0.0
MIZORAM,KHAWZAWL,2021-02-06,0,1,0,1,0.0
MIZORAM,KHAWZAWL,2021-02-07,0,2,0,2,0.0
MIZORAM,KHAWZAWL,2021-02-08,0,4,0,4,0.0
MIZORAM,KHAWZAWL,2021-02-09,0,4,0,4,0.0
MIZORAM,KHAWZAWL,2021-02-10,0,18,0,18,0.0
MIZORAM,KOLASIB,2021-02-06,0,238,0,238,0.0
MIZORAM,KOLASIB,2021-02-07,0,196,0,196,0.0
MIZORAM,KOLASIB,2021-02-08,0,179,0,179,0.0
MIZORAM,KOLASIB,2021-02-09,0,207,0,207,0.0
MIZORAM,KOLASIB,2021-02-10,0,195,0,195,0.0
MIZORAM,LAWNGTLAI,2021-02-06,0,2,0,2,0.0
MIZORAM,LAWNGTLAI,2021-02-07,0,1,0,1,0.0
MIZORAM,LAWNGTLAI,2021-02-08,1,59,0,60,0.0
MIZORAM,LAWNGTLAI,2021-02-09,0,14,0,14,0.0
MIZORAM,LAWNGTLAI,2021-02-10,1,6,0,7,0.0
MIZORAM,LUNGLEI,2021-02-06,0,5,0,5,0.0
MIZORAM,LUNGLEI,2021-02-07,0,1,0,1,0.0
MIZORAM,LUNGLEI,2021-02-08,0,53,0,53,0.0
MIZORAM,LUNGLEI,2021-02-09,1,26,0,27,0.0
MIZORAM,LUNGLEI,2021-02-10,1,40,0,41,0.0
MIZORAM,MAMIT,2021-02-06,0,58,0,58,0.0
MIZORAM,MAMIT,2021-02-07,0,37,0,37,0.0
MIZORAM,MAMIT,2021-02-08,0,65,0,65,0.0
MIZORAM,MAMIT,2021-02-09,0,57,0,57,0.0
MIZORAM,MAMIT,2021-02-10,0,75,0,75,0.0
MIZORAM,SAIHA,2021-02-07,0,26,0,26,0.0
MIZORAM,SAIHA,2021-02-08,0,12,0,12,0.0
MIZORAM,SAIHA,2021-02-09,0,6,0,6,0.0
MIZORAM,SAIHA,2021-02-10,0,5,0,5,0.0
MIZORAM,SAITUAL,2021-02-06,0,1,0,1,0.0
MIZORAM,SAITUAL,2021-02-08,0,44,0,44,0.0
MIZORAM,SAITUAL,2021-02-09,0,137,0,137,0.0
MIZORAM,SAITUAL,2021-02-10,0,5,0,5,0.0
MIZORAM,SERCHHIP,2021-02-08,0,24,0,24,0.0
MIZORAM,SERCHHIP,2021-02-09,0,7,0,7,0.0
MIZORAM,SERCHHIP,2021-02-10,0,7,0,7,0.0
NAGALAND,DIMAPUR,2021-02-06,0,88,0,88,0.0
NAGALAND,DIMAPUR,2021-02-07,1,37,0,38,0.0
NAGALAND,DIMAPUR,2021-02-08,1,126,0,127,0.0
NAGALAND,DIMAPUR,2021-02-09,0,118,0,118,0.0
NAGALAND,DIMAPUR,2021-02-10,0,68,0,68,0.0
NAGALAND,KIPHIRE,2021-02-06,0,3,0,3,0.0
NAGALAND,KIPHIRE,2021-02-08,0,8,0,8,0.0
NAGALAND,KOHIMA,2021-02-06,0,10,0,10,0.0
NAGALAND,KOHIMA,2021-02-07,0,3,0,3,0.0
NAGALAND,KOHIMA,2021-02-08,0,5,0,5,0.0
NAGALAND,KOHIMA,2021-02-09,0,10,0,10,0.0
NAGALAND,KOHIMA,2021-02-10,0,28,0,28,0.0
NAGALAND,LONGLENG,2021-02-06,0,9,0,9,0.0
NAGALAND,LONGLENG,2021-02-08,0,2,0,2,0.0
NAGALAND,LONGLENG,2021-02-09,0,6,0,6,0.0
NAGALAND,MOKOKCHUNG,2021-02-06,3,29,0,32,0.0
NAGALAND,MOKOKCHUNG,2021-02-07,0,14,0,14,0.0
NAGALAND,MOKOKCHUNG,2021-02-08,0,14,0,14,0.0
NAGALAND,MOKOKCHUNG,2021-02-09,0,7,0,7,0.0
NAGALAND,MOKOKCHUNG,2021-02-10,0,5,0,5,0.0
NAGALAND,MON,2021-02-06,0,2,0,2,0.0
NAGALAND,MON,2021-02-08,0,4,0,4,0.0
NAGALAND,MON,2021-02-09,0,9,0,9,0.0
NAGALAND,MON,2021-02-10,0,2,0,2,0.0
NAGALAND,PEREN,2021-02-08,0,1,0,1,0.0
NAGALAND,PEREN,2021-02-09,0,1,0,1,0.0
NAGALAND,PEREN,2021-02-10,0,3,0,3,0.0
NAGALAND,PHEK,2021-02-06,0,5,0,5,0.0
NAGALAND,PHEK,2021-02-08,0,5,0,5,0.0
NAGALAND,PHEK,2021-02-09,0,2,0,2,0.0
NAGALAND,PHEK,2021-02-10,0,1,0,1,0.0
NAGALAND,TUENSANG,2021-02-06,0,4,0,4,0.0
NAGALAND,TUENSANG,2021-02-09,0,1,0,1,0.0
NAGALAND,WOKHA,2021-02-06,0,1,0,1,0.0
NAGALAND,WOKHA,2021-02-07,0,1,0,1,0.0
NAGALAND,WOKHA,2021-02-08,0,2,0,2,0.0
NAGALAND,WOKHA,2021-02-09,0,1,0,1,0.0
NAGALAND,WOKHA,2021-02-10,0,4,0,4,0.0
NAGALAND,ZUNHEBOTO,2021-02-06,0,1,0,1,0.0
NAGALAND,ZUNHEBOTO,2021-02-08,0,1,0,1,0.0
NAGALAND,ZUNHEBOTO,2021-02-09,0,4,0,4,0.0
ODISHA,ANUGUL,2021-02-06,8,507,0,515,0.0
ODISHA,ANUGUL,2021-02-07,0,244,0,244,0.0
ODISHA,ANUGUL,2021-02-08,5,528,0,533,0.0
ODISHA,ANUGUL,2021-02-09,5,425,0,430,0.0
ODISHA,ANUGUL,2021-02-10,6,491,0,497,0.0
ODISHA,BALANGIR,2021-02-06,1,882,8,891,0.0
ODISHA,BALANGIR,2021-02-07,1,756,0,757,0.0
ODISHA,BALANGIR,2021-02-08,2,1012,1,1015,0.0
ODISHA,BALANGIR,2021-02-09,3,1107,4,1114,0.0
ODISHA,BALANGIR,2021-02-10,2,1000,2,1004,0.0
ODISHA,BALESHWAR,2021-02-06,5,2856,7,2868,0.0
ODISHA,BALESHWAR,2021-02-07,8,2197,4,2209,0.0
ODISHA,BALESHWAR,2021-02-08,7,3248,0,3255,0.0
ODISHA,BALESHWAR,2021-02-09,1,2677,30,2708,0.0
ODISHA,BALESHWAR,2021-02-10,3,2708,1,2712,0.0
ODISHA,BARGARH,2021-02-06,2,503,0,505,0.0
ODISHA,BARGARH,2021-02-07,1,532,0,533,0.0
ODISHA,BARGARH,2021-02-08,11,410,0,421,0.0
ODISHA,BARGARH,2021-02-09,0,639,0,639,0.0
ODISHA,BARGARH,2021-02-10,1,527,0,528,0.0
ODISHA,BHADRAK,2021-02-06,0,498,1,499,0.0
ODISHA,BHADRAK,2021-02-07,1,336,0,337,0.0
ODISHA,BHADRAK,2021-02-08,2,584,0,586,0.0
ODISHA,BHADRAK,2021-02-09,0,732,0,732,0.0
ODISHA,BHADRAK,2021-02-10,0,714,3,717,0.0
ODISHA,BOUDH,2021-02-06,0,155,0,155,0.0
ODISHA,BOUDH,2021-02-07,0,193,0,193,0.0
ODISHA,BOUDH,2021-02-08,1,409,0,410,0.0
ODISHA,BOUDH,2021-02-09,2,425,0,427,0.0
ODISHA,BOUDH,2021-02-10,0,453,0,453,0.0
ODISHA,CUTTACK,2021-02-06,9,1225,0,1234,0.0
ODISHA,CUTTACK,2021-02-07,13,440,0,453,0.0
ODISHA,CUTTACK,2021-02-08,12,1497,0,1509,0.0
ODISHA,CUTTACK,2021-02-09,10,1566,1,1577,0.0
ODISHA,CUTTACK,2021-02-10,1,1298,0,1299,0.0
ODISHA,DEOGARH,2021-02-06,1,111,0,112,0.0
ODISHA,DEOGARH,2021-02-07,2,117,0,119,0.0
ODISHA,DEOGARH,2021-02-08,1,72,0,73,0.0
ODISHA,DEOGARH,2021-02-09,0,380,0,380,0.0
ODISHA,DEOGARH,2021-02-10,2,186,0,188,0.0
ODISHA,DHENKANAL,2021-02-06,0,515,0,515,0.0
ODISHA,DHENKANAL,2021-02-07,1,407,0,408,0.0
ODISHA,DHENKANAL,2021-02-08,0,571,0,571,0.0
ODISHA,DHENKANAL,2021-02-09,0,535,0,535,0.0
ODISHA,DHENKANAL,2021-02-10,0,335,0,335,0.0
ODISHA,GAJAPATI,2021-02-06,0,332,0,332,0.0
ODISHA,GAJAPATI,2021-02-07,0,189,0,189,0.0
ODISHA,GAJAPATI,2021-02-08,0,175,0,175,0.0
ODISHA,GAJAPATI,2021-02-09,0,367,6,373,0.0
ODISHA,GAJAPATI,2021-02-10,0,248,0,248,0.0
ODISHA,GANJAM,2021-02-06,2,1034,36,1072,0.0
ODISHA,GANJAM,2021-02-07,0,666,0,666,0.0
ODISHA,GANJAM,2021-02-08,0,1539,13,1552,0.0
ODISHA,GANJAM,2021-02-09,1,2790,165,2956,0.0
ODISHA,GANJAM,2021-02-10,2,1276,144,1422,0.0
ODISHA,JAGATSINGHAPUR,2021-02-06,1,440,0,441,0.0
ODISHA,JAGATSINGHAPUR,2021-02-07,0,218,0,218,0.0
ODISHA,JAGATSINGHAPUR,2021-02-08,2,609,0,611,0.0
ODISHA,JAGATSINGHAPUR,2021-02-09,0,868,3,871,0.0
ODISHA,JAGATSINGHAPUR,2021-02-10,0,452,0,452,0.0
ODISHA,JAJAPUR,2021-02-06,1,377,0,378,0.0
ODISHA,JAJAPUR,2021-02-07,2,110,0,112,0.0
ODISHA,JAJAPUR,2021-02-08,6,591,0,597,0.0
ODISHA,JAJAPUR,2021-02-09,2,605,0,607,0.0
ODISHA,JAJAPUR,2021-02-10,0,523,0,523,0.0
ODISHA,JHARSUGUDA,2021-02-06,9,397,0,406,0.0
ODISHA,JHARSUGUDA,2021-02-07,3,225,0,228,0.0
ODISHA,JHARSUGUDA,2021-02-08,5,477,0,482,0.0
ODISHA,JHARSUGUDA,2021-02-09,1,364,5,370,0.0
ODISHA,JHARSUGUDA,2021-02-10,4,358,0,362,0.0
ODISHA,KALAHANDI,2021-02-06,2,140,0,142,0.0
ODISHA,KALAHANDI,2021-02-07,0,435,0,435,0.0
ODISHA,KALAHANDI,2021-02-08,0,187,0,187,0.0
ODISHA,KALAHANDI,2021-02-09,4,113,0,117,0.0
ODISHA,KALAHANDI,2021-02-10,1,461,0,462,0.0
ODISHA,KANDHAMAL,2021-02-06,0,571,0,571,0.0
ODISHA,KANDHAMAL,2021-02-07,3,575,0,578,0.0
ODISHA,KANDHAMAL,2021-02-08,0,501,0,501,0.0
ODISHA,KANDHAMAL,2021-02-09,0,756,0,756,0.0
ODISHA,KANDHAMAL,2021-02-10,0,601,0,601,0.0
ODISHA,KENDRAPARA,2021-02-06,0,973,1,974,0.0
ODISHA,KENDRAPARA,2021-02-07,0,682,0,682,0.0
ODISHA,KENDRAPARA,2021-02-08,1,1003,2,1006,0.0
ODISHA,KENDRAPARA,2021-02-09,0,1059,1,1060,0.0
ODISHA,KENDRAPARA,2021-02-10,0,926,0,926,0.0
ODISHA,KENDUJHAR,2021-02-06,0,573,0,573,0.0
ODISHA,KENDUJHAR,2021-02-07,1,775,0,776,0.0
ODISHA,KENDUJHAR,2021-02-08,4,882,0,886,0.0
ODISHA,KENDUJHAR,2021-02-09,1,925,0,926,0.0
ODISHA,KENDUJHAR,2021-02-10,1,1154,1,1156,0.0
ODISHA,KHORDHA,2021-02-06,15,1401,2,1418,0.0
ODISHA,KHORDHA,2021-02-07,1,916,0,917,0.0
ODISHA,KHORDHA,2021-02-08,11,1851,1,1863,0.0
ODISHA,KHORDHA,2021-02-09,5,1712,2,1719,0.0
ODISHA,KHORDHA,2021-02-10,4,1720,0,1724,0.0
ODISHA,KORAPUT,2021-02-06,1,883,0,884,0.0
ODISHA,KORAPUT,2021-02-07,1,935,0,936,0.0
ODISHA,KORAPUT,2021-02-08,0,1009,0,1009,0.0
ODISHA,KORAPUT,2021-02-09,2,1015,0,1017,0.0
ODISHA,KORAPUT,2021-02-10,0,942,0,942,0.0
ODISHA,MALKANGIRI,2021-02-06,1,262,0,263,0.0
ODISHA,MALKANGIRI,2021-02-07,0,434,1,435,0.0
ODISHA,MALKANGIRI,2021-02-08,0,589,0,589,0.0
ODISHA,MALKANGIRI,2021-02-09,0,517,0,517,0.0
ODISHA,MALKANGIRI,2021-02-10,1,583,0,584,0.0
ODISHA,MAYURBHANJ,2021-02-06,2,1274,0,1276,0.0
ODISHA,MAYURBHANJ,2021-02-07,7,1353,0,1360,0.0
ODISHA,MAYURBHANJ,2021-02-08,7,1278,0,1285,0.0
ODISHA,MAYURBHANJ,2021-02-09,2,1373,0,1375,0.0
ODISHA,MAYURBHANJ,2021-02-10,3,1441,0,1444,0.0
ODISHA,NABARANGPUR,2021-02-06,2,548,0,550,0.0
ODISHA,NABARANGPUR,2021-02-07,0,509,0,509,0.0
ODISHA,NABARANGPUR,2021-02-08,0,740,0,740,0.0
ODISHA,NABARANGPUR,2021-02-09,0,727,2,729,0.0
ODISHA,NABARANGPUR,2021-02-10,0,696,0,696,0.0
ODISHA,NAYAGARH,2021-02-06,0,527,1,528,0.0
ODISHA,NAYAGARH,2021-02-07,0,590,0,590,0.0
ODISHA,NAYAGARH,2021-02-08,0,1034,0,1034,0.0
ODISHA,NAYAGARH,2021-02-09,0,1032,0,1032,0.0
ODISHA,NAYAGARH,2021-02-10,0,380,4,384,0.0
ODISHA,NUAPADA,2021-02-06,1,161,0,162,0.0
ODISHA,NUAPADA,2021-02-07,1,127,0,128,0.0
ODISHA,NUAPADA,2021-02-08,2,93,0,95,0.0
ODISHA,NUAPADA,2021-02-09,2,118,0,120,0.0
ODISHA,NUAPADA,2021-02-10,2,175,0,177,0.0
ODISHA,PURI,2021-02-06,12,772,0,784,0.0
ODISHA,PURI,2021-02-07,4,582,0,586,0.0
ODISHA,PURI,2021-02-08,4,715,0,719,0.0
ODISHA,PURI,2021-02-09,12,642,0,654,0.0
ODISHA,PURI,2021-02-10,5,566,0,571,0.0
ODISHA,RAYAGADA,2021-02-06,4,605,0,609,0.0
ODISHA,RAYAGADA,2021-02-07,0,519,0,519,0.0
ODISHA,RAYAGADA,2021-02-08,3,635,0,638,0.0
ODISHA,RAYAGADA,2021-02-09,2,463,1,466,0.0
ODISHA,RAYAGADA,2021-02-10,0,781,0,781,0.0
ODISHA,SAMBALPUR,2021-02-06,16,372,0,388,0.0
ODISHA,SAMBALPUR,2021-02-07,13,304,0,317,0.0
ODISHA,SAMBALPUR,2021-02-08,17,621,0,638,0.0
ODISHA,SAMBALPUR,2021-02-09,24,673,0,697,0.0
ODISHA,SAMBALPUR,2021-02-10,17,594,0,611,0.0
ODISHA,SONEPUR,2021-02-06,0,286,0,286,0.0
ODISHA,SONEPUR,2021-02-07,0,241,0,241,0.0
ODISHA,SONEPUR,2021-02-08,1,524,0,525,0.0
ODISHA,SONEPUR,2021-02-09,0,439,0,439,0.0
ODISHA,SONEPUR,2021-02-10,0,266,0,266,0.0
ODISHA,SUNDARGARH,2021-02-06,22,872,1,895,0.0
ODISHA,SUNDARGARH,2021-02-07,7,367,0,374,0.0
ODISHA,SUNDARGARH,2021-02-08,12,819,1,832,0.0
ODISHA,SUNDARGARH,2021-02-09,33,980,2,1015,0.0
ODISHA,SUNDARGARH,2021-02-10,8,729,0,737,0.0
PUDUCHERRY,KARAIKAL,2021-02-06,4,479,0,483,0.0
PUDUCHERRY,KARAIKAL,2021-02-07,1,360,0,361,0.0
PUDUCHERRY,KARAIKAL,2021-02-08,7,409,0,416,0.0
PUDUCHERRY,KARAIKAL,2021-02-09,3,619,0,622,0.0
PUDUCHERRY,KARAIKAL,2021-02-10,3,515,0,518,0.0
PUDUCHERRY,MAHE,2021-02-06,7,281,0,288,0.0
PUDUCHERRY,MAHE,2021-02-07,0,180,0,180,0.0
PUDUCHERRY,MAHE,2021-02-08,3,179,0,182,0.0
PUDUCHERRY,MAHE,2021-02-09,2,145,3,150,0.0
PUDUCHERRY,MAHE,2021-02-10,3,336,0,339,0.0
PUDUCHERRY,PONDICHERRY,2021-02-06,20,561,3,584,0.0
PUDUCHERRY,PONDICHERRY,2021-02-07,21,295,0,316,0.0
PUDUCHERRY,PONDICHERRY,2021-02-08,21,559,7,587,0.0
PUDUCHERRY,PONDICHERRY,2021-02-09,21,659,4,684,0.0
PUDUCHERRY,PONDICHERRY,2021-02-10,16,546,3,565,0.0
PUDUCHERRY,YANAM,2021-02-06,0,168,0,168,0.0
PUDUCHERRY,YANAM,2021-02-07,0,170,0,170,0.0
PUDUCHERRY,YANAM,2021-02-08,0,172,0,172,0.0
PUDUCHERRY,YANAM,2021-02-09,0,145,0,145,0.0
PUDUCHERRY,YANAM,2021-02-10,0,106,0,106,0.0
PUNJAB,AMRITSAR,2021-02-06,12,2149,6,2167,0.0
PUNJAB,AMRITSAR,2021-02-07,15,586,6,607,0.0
PUNJAB,AMRITSAR,2021-02-08,10,909,8,927,0.0
PUNJAB,AMRITSAR,2021-02-09,24,1035,8,1067,0.0
PUNJAB,AMRITSAR,2021-02-10,14,1226,11,1251,0.0
PUNJAB,BARNALA,2021-02-06,4,1155,7,1166,0.0
PUNJAB,BARNALA,2021-02-07,2,596,71,669,0.0
PUNJAB,BARNALA,2021-02-08,0,257,8,265,0.0
PUNJAB,BARNALA,2021-02-09,0,181,30,211,0.0
PUNJAB,BARNALA,2021-02-10,2,271,1,274,0.0
PUNJAB,BATHINDA,2021-02-06,11,514,1,526,0.0
PUNJAB,BATHINDA,2021-02-07,7,774,1,782,0.0
PUNJAB,BATHINDA,2021-02-08,5,466,7,478,0.0
PUNJAB,BATHINDA,2021-02-09,9,571,8,588,0.0
PUNJAB,BATHINDA,2021-02-10,8,819,5,832,0.0
PUNJAB,FARIDKOT,2021-02-06,6,248,1,255,0.0
PUNJAB,FARIDKOT,2021-02-07,5,247,1,253,0.0
PUNJAB,FARIDKOT,2021-02-08,8,103,0,111,0.0
PUNJAB,FARIDKOT,2021-02-09,3,220,2,225,0.0
PUNJAB,FARIDKOT,2021-02-10,11,368,5,384,0.0
PUNJAB,FATEHGARH SAHIB,2021-02-06,2,412,0,414,0.0
PUNJAB,FATEHGARH SAHIB,2021-02-07,12,651,1,664,0.0
PUNJAB,FATEHGARH SAHIB,2021-02-08,3,1114,1,1118,0.0
PUNJAB,FATEHGARH SAHIB,2021-02-09,9,145,0,154,0.0
PUNJAB,FATEHGARH SAHIB,2021-02-10,9,452,2,463,0.0
PUNJAB,FAZILKA,2021-02-06,3,291,0,294,0.0
PUNJAB,FAZILKA,2021-02-07,1,287,0,288,0.0
PUNJAB,FAZILKA,2021-02-08,1,169,0,170,0.0
PUNJAB,FAZILKA,2021-02-09,2,164,1,167,0.0
PUNJAB,FAZILKA,2021-02-10,3,181,2,186,0.0
PUNJAB,FIROZEPUR,2021-02-06,2,347,0,349,0.0
PUNJAB,FIROZEPUR,2021-02-07,0,277,0,277,0.0
PUNJAB,FIROZEPUR,2021-02-08,2,89,1,92,0.0
PUNJAB,FIROZEPUR,2021-02-09,0,365,0,365,0.0
PUNJAB,FIROZEPUR,2021-02-10,5,113,1,119,0.0
PUNJAB,GURDASPUR,2021-02-06,2,765,1,768,0.0
PUNJAB,GURDASPUR,2021-02-07,2,988,5,995,0.0
PUNJAB,GURDASPUR,2021-02-08,5,2074,5,2084,0.0
PUNJAB,GURDASPUR,2021-02-09,14,910,3,927,0.0
PUNJAB,GURDASPUR,2021-02-10,17,1584,1,1602,0.0
PUNJAB,HOSHIARPUR,2021-02-06,20,1426,1,1447,0.0
PUNJAB,HOSHIARPUR,2021-02-07,21,1233,0,1254,0.0
PUNJAB,HOSHIARPUR,2021-02-08,17,1177,1,1195,0.0
PUNJAB,HOSHIARPUR,2021-02-09,15,852,4,871,0.0
PUNJAB,HOSHIARPUR,2021-02-10,26,1241,4,1271,0.0
PUNJAB,JALANDHAR,2021-02-06,25,2239,50,2314,0.0
PUNJAB,JALANDHAR,2021-02-07,32,2157,85,2274,0.0
PUNJAB,JALANDHAR,2021-02-08,32,1004,16,1052,0.0
PUNJAB,JALANDHAR,2021-02-09,32,1829,10,1871,0.0
PUNJAB,JALANDHAR,2021-02-10,38,2024,67,2129,0.0
PUNJAB,KAPURTHALA,2021-02-06,14,534,0,548,0.0
PUNJAB,KAPURTHALA,2021-02-07,5,361,4,370,0.0
PUNJAB,KAPURTHALA,2021-02-08,12,613,1,626,0.0
PUNJAB,KAPURTHALA,2021-02-09,11,971,1,983,0.0
PUNJAB,KAPURTHALA,2021-02-10,20,633,5,658,0.0
PUNJAB,LUDHIANA,2021-02-06,47,2305,8,2360,0.0
PUNJAB,LUDHIANA,2021-02-07,36,2454,15,2505,0.0
PUNJAB,LUDHIANA,2021-02-08,26,1818,30,1874,0.0
PUNJAB,LUDHIANA,2021-02-09,52,1611,23,1686,0.0
PUNJAB,LUDHIANA,2021-02-10,61,2675,10,2746,0.0
PUNJAB,MANSA,2021-02-06,0,568,0,568,0.0
PUNJAB,MANSA,2021-02-07,2,646,0,648,0.0
PUNJAB,MANSA,2021-02-08,0,1291,1,1292,0.0
PUNJAB,MANSA,2021-02-09,0,1951,1,1952,0.0
PUNJAB,MANSA,2021-02-10,3,2629,0,2632,0.0
PUNJAB,MOGA,2021-02-06,3,281,29,313,0.0
PUNJAB,MOGA,2021-02-07,3,200,5,208,0.0
PUNJAB,MOGA,2021-02-08,0,213,2,215,0.0
PUNJAB,MOGA,2021-02-09,1,264,3,268,0.0
PUNJAB,MOGA,2021-02-10,8,278,4,290,0.0
PUNJAB,PATHANKOT,2021-02-06,2,142,0,144,0.0
PUNJAB,PATHANKOT,2021-02-07,1,806,2,809,0.0
PUNJAB,PATHANKOT,2021-02-08,4,495,3,502,0.0
PUNJAB,PATHANKOT,2021-02-09,3,526,11,540,0.0
PUNJAB,PATHANKOT,2021-02-10,1,614,3,618,0.0
PUNJAB,PATIALA,2021-02-06,18,1044,0,1062,0.0
PUNJAB,PATIALA,2021-02-07,9,487,0,496,0.0
PUNJAB,PATIALA,2021-02-08,18,1033,0,1051,0.0
PUNJAB,PATIALA,2021-02-09,17,580,1,598,0.0
PUNJAB,PATIALA,2021-02-10,22,2121,1,2144,0.0
PUNJAB,RUPNAGAR,2021-02-06,12,499,0,511,0.0
PUNJAB,RUPNAGAR,2021-02-07,8,453,1,462,0.0
PUNJAB,RUPNAGAR,2021-02-08,3,318,0,321,0.0
PUNJAB,RUPNAGAR,2021-02-09,8,489,1,498,0.0
PUNJAB,RUPNAGAR,2021-02-10,4,521,2,527,0.0
PUNJAB,S.A.S NAGAR,2021-02-06,32,996,6,1034,0.0
PUNJAB,S.A.S NAGAR,2021-02-07,20,383,2,405,0.0
PUNJAB,S.A.S NAGAR,2021-02-08,32,943,2,977,0.0
PUNJAB,S.A.S NAGAR,2021-02-09,36,1139,7,1182,0.0
PUNJAB,S.A.S NAGAR,2021-02-10,39,1049,1,1089,0.0
PUNJAB,SANGRUR,2021-02-06,6,1355,1,1362,0.0
PUNJAB,SANGRUR,2021-02-07,5,1492,13,1510,0.0
PUNJAB,SANGRUR,2021-02-08,8,160,0,168,0.0
PUNJAB,SANGRUR,2021-02-09,4,1032,2,1038,0.0
PUNJAB,SANGRUR,2021-02-10,2,1000,0,1002,0.0
PUNJAB,SHAHID BHAGAT SINGH NAGAR,2021-02-06,45,719,1,765,0.0
PUNJAB,SHAHID BHAGAT SINGH NAGAR,2021-02-07,11,908,0,919,0.0
PUNJAB,SHAHID BHAGAT SINGH NAGAR,2021-02-08,31,128,0,159,0.0
PUNJAB,SHAHID BHAGAT SINGH NAGAR,2021-02-09,47,1057,0,1104,0.0
PUNJAB,SHAHID BHAGAT SINGH NAGAR,2021-02-10,28,1181,0,1209,0.0
PUNJAB,SRI MUKTSAR SAHIB,2021-02-06,2,296,0,298,0.0
PUNJAB,SRI MUKTSAR SAHIB,2021-02-07,0,137,1,138,0.0
PUNJAB,SRI MUKTSAR SAHIB,2021-02-08,1,100,0,101,0.0
PUNJAB,SRI MUKTSAR SAHIB,2021-02-09,1,285,3,289,0.0
PUNJAB,SRI MUKTSAR SAHIB,2021-02-10,3,280,0,283,0.0
PUNJAB,TARN TARAN,2021-02-06,1,336,1,338,0.0
PUNJAB,TARN TARAN,2021-02-07,0,514,0,514,0.0
PUNJAB,TARN TARAN,2021-02-08,1,372,0,373,0.0
PUNJAB,TARN TARAN,2021-02-09,3,1009,0,1012,0.0
PUNJAB,TARN TARAN,2021-02-10,2,392,0,394,0.0
RAJASTHAN,AJMER,2021-02-06,10,59,460,529,0.0
RAJASTHAN,AJMER,2021-02-07,5,43,164,212,0.0
RAJASTHAN,AJMER,2021-02-08,4,54,727,785,0.0
RAJASTHAN,AJMER,2021-02-09,3,67,559,629,0.0
RAJASTHAN,AJMER,2021-02-10,4,54,553,611,0.0
RAJASTHAN,ALWAR,2021-02-06,216,1911,7,2134,0.0
RAJASTHAN,ALWAR,2021-02-07,316,3802,24,4142,0.0
RAJASTHAN,ALWAR,2021-02-08,2,2815,23,2840,0.0
RAJASTHAN,ALWAR,2021-02-09,210,2184,16,2410,0.0
RAJASTHAN,ALWAR,2021-02-10,261,4211,50,4522,0.0
RAJASTHAN,BANSWARA,2021-02-06,2,34,0,36,0.0
RAJASTHAN,BANSWARA,2021-02-07,3,52,0,55,0.0
RAJASTHAN,BANSWARA,2021-02-08,1,73,0,74,0.0
RAJASTHAN,BANSWARA,2021-02-09,0,47,0,47,0.0
RAJASTHAN,BANSWARA,2021-02-10,1,119,0,120,0.0
RAJASTHAN,BARAN,2021-02-06,0,43,0,43,0.0
RAJASTHAN,BARAN,2021-02-07,0,90,0,90,0.0
RAJASTHAN,BARAN,2021-02-08,1,285,0,286,0.0
RAJASTHAN,BARAN,2021-02-09,1,57,0,58,0.0
RAJASTHAN,BARAN,2021-02-10,1,140,0,141,0.0
RAJASTHAN,BARMER,2021-02-06,12,237,0,249,0.0
RAJASTHAN,BARMER,2021-02-07,0,83,0,83,0.0
RAJASTHAN,BARMER,2021-02-08,0,265,2,267,0.0
RAJASTHAN,BARMER,2021-02-09,0,162,1,163,0.0
RAJASTHAN,BARMER,2021-02-10,0,147,3,150,0.0
RAJASTHAN,BHARATPUR,2021-02-06,3,445,0,448,0.0
RAJASTHAN,BHARATPUR,2021-02-07,6,327,6,339,0.0
RAJASTHAN,BHARATPUR,2021-02-08,4,363,2,369,0.0
RAJASTHAN,BHARATPUR,2021-02-09,3,320,6,329,0.0
RAJASTHAN,BHARATPUR,2021-02-10,5,305,7,317,0.0
RAJASTHAN,BHILWARA,2021-02-06,14,279,2,295,0.0
RAJASTHAN,BHILWARA,2021-02-07,13,347,1,361,0.0
RAJASTHAN,BHILWARA,2021-02-08,1,106,3,110,0.0
RAJASTHAN,BHILWARA,2021-02-09,6,287,1,294,0.0
RAJASTHAN,BHILWARA,2021-02-10,13,284,1,298,0.0
RAJASTHAN,BIKANER,2021-02-06,0,1668,2,1670,0.0
RAJASTHAN,BIKANER,2021-02-07,0,592,3,595,0.0
RAJASTHAN,BIKANER,2021-02-08,6,1215,0,1221,0.0
RAJASTHAN,BIKANER,2021-02-09,0,1504,5,1509,0.0
RAJASTHAN,BIKANER,2021-02-10,14,1061,0,1075,0.0
RAJASTHAN,BUNDI,2021-02-06,3,214,1,218,0.0
RAJASTHAN,BUNDI,2021-02-07,0,145,0,145,0.0
RAJASTHAN,BUNDI,2021-02-08,1,261,1,263,0.0
RAJASTHAN,BUNDI,2021-02-09,0,171,0,171,0.0
RAJASTHAN,BUNDI,2021-02-10,0,95,0,95,0.0
RAJASTHAN,CHITTORGARH,2021-02-06,2,980,1,983,0.0
RAJASTHAN,CHITTORGARH,2021-02-07,1,728,0,729,0.0
RAJASTHAN,CHITTORGARH,2021-02-08,5,1181,0,1186,0.0
RAJASTHAN,CHITTORGARH,2021-02-09,0,869,3,872,0.0
RAJASTHAN,CHITTORGARH,2021-02-10,8,700,0,708,0.0
RAJASTHAN,CHURU,2021-02-06,0,338,0,338,0.0
RAJASTHAN,CHURU,2021-02-07,0,294,11,305,0.0
RAJASTHAN,CHURU,2021-02-08,1,78,230,309,0.0
RAJASTHAN,CHURU,2021-02-09,0,379,3,382,0.0
RAJASTHAN,CHURU,2021-02-10,2,370,2,374,0.0
RAJASTHAN,DAUSA,2021-02-06,1,342,5,348,0.0
RAJASTHAN,DAUSA,2021-02-07,1,161,9,171,0.0
RAJASTHAN,DAUSA,2021-02-08,0,369,4,373,0.0
RAJASTHAN,DAUSA,2021-02-09,2,397,11,410,0.0
RAJASTHAN,DAUSA,2021-02-10,1,228,14,243,0.0
RAJASTHAN,DHOLPUR,2021-02-06,7,288,6,301,0.0
RAJASTHAN,DHOLPUR,2021-02-07,2,14,1,17,0.0
RAJASTHAN,DHOLPUR,2021-02-08,2,655,4,661,0.0
RAJASTHAN,DHOLPUR,2021-02-09,16,1104,1,1121,0.0
RAJASTHAN,DHOLPUR,2021-02-10,2,783,5,790,0.0
RAJASTHAN,DUNGARPUR,2021-02-06,2,462,0,464,0.0
RAJASTHAN,DUNGARPUR,2021-02-07,0,186,0,186,0.0
RAJASTHAN,DUNGARPUR,2021-02-08,0,239,0,239,0.0
RAJASTHAN,DUNGARPUR,2021-02-09,2,367,0,369,0.0
RAJASTHAN,DUNGARPUR,2021-02-10,0,150,1,151,0.0
RAJASTHAN,GANGANAGAR,2021-02-06,38,119,1,158,0.0
RAJASTHAN,GANGANAGAR,2021-02-07,9,24,1,34,0.0
RAJASTHAN,GANGANAGAR,2021-02-08,79,147,15,241,0.0
RAJASTHAN,GANGANAGAR,2021-02-09,86,225,3,314,0.0
RAJASTHAN,GANGANAGAR,2021-02-10,49,181,2,232,0.0
RAJASTHAN,HANUMANGARH,2021-02-06,0,683,0,683,0.0
RAJASTHAN,HANUMANGARH,2021-02-07,0,739,0,739,0.0
RAJASTHAN,HANUMANGARH,2021-02-08,1,46,1,48,0.0
RAJASTHAN,HANUMANGARH,2021-02-09,0,917,5,922,0.0
RAJASTHAN,HANUMANGARH,2021-02-10,0,1042,2,1044,0.0
RAJASTHAN,JAIPUR,2021-02-06,26,1871,208,2105,0.0
RAJASTHAN,JAIPUR,2021-02-07,30,1907,267,2204,0.0
RAJASTHAN,JAIPUR,2021-02-08,31,1864,218,2113,0.0
RAJASTHAN,JAIPUR,2021-02-09,64,2918,244,3226,0.0
RAJASTHAN,JAIPUR,2021-02-10,39,2241,263,2543,0.0
RAJASTHAN,JAISALMER,2021-02-06,1,129,0,130,0.0
RAJASTHAN,JAISALMER,2021-02-07,0,136,1,137,0.0
RAJASTHAN,JAISALMER,2021-02-08,0,85,0,85,0.0
RAJASTHAN,JAISALMER,2021-02-09,1,102,0,103,0.0
RAJASTHAN,JAISALMER,2021-02-10,0,115,1,116,0.0
RAJASTHAN,JALORE,2021-02-06,0,781,1,782,0.0
RAJASTHAN,JALORE,2021-02-07,0,625,2,627,0.0
RAJASTHAN,JALORE,2021-02-08,0,701,2,703,0.0
RAJASTHAN,JALORE,2021-02-09,1,965,7,973,0.0
RAJASTHAN,JALORE,2021-02-10,0,674,3,677,0.0
RAJASTHAN,JHALAWAR,2021-02-06,1,479,0,480,0.0
RAJASTHAN,JHALAWAR,2021-02-07,0,538,0,538,0.0
RAJASTHAN,JHALAWAR,2021-02-08,17,1096,10,1123,0.0
RAJASTHAN,JHALAWAR,2021-02-09,4,556,3,563,0.0
RAJASTHAN,JHALAWAR,2021-02-10,4,504,4,512,0.0
RAJASTHAN,JHUNJHUNU,2021-02-06,1,64,1,66,0.0
RAJASTHAN,JHUNJHUNU,2021-02-07,1,75,5,81,0.0
RAJASTHAN,JHUNJHUNU,2021-02-08,0,70,5,75,0.0
RAJASTHAN,JHUNJHUNU,2021-02-09,0,110,4,114,0.0
RAJASTHAN,JHUNJHUNU,2021-02-10,2,110,1,113,0.0
RAJASTHAN,JODHPUR,2021-02-06,12,987,10,1009,0.0
RAJASTHAN,JODHPUR,2021-02-07,21,1356,13,1390,0.0
RAJASTHAN,JODHPUR,2021-02-08,9,687,7,703,0.0
RAJASTHAN,JODHPUR,2021-02-09,5,1034,4,1043,0.0
RAJASTHAN,JODHPUR,2021-02-10,9,1314,7,1330,0.0
RAJASTHAN,KARAULI,2021-02-06,0,23,4,27,0.0
RAJASTHAN,KARAULI,2021-02-07,0,12,4,16,0.0
RAJASTHAN,KARAULI,2021-02-08,0,49,3,52,0.0
RAJASTHAN,KARAULI,2021-02-09,0,60,5,65,0.0
RAJASTHAN,KARAULI,2021-02-10,3,333,3,339,0.0
RAJASTHAN,KOTA,2021-02-06,29,862,2,893,0.0
RAJASTHAN,KOTA,2021-02-07,0,1398,0,1398,0.0
RAJASTHAN,KOTA,2021-02-08,47,720,6,773,0.0
RAJASTHAN,KOTA,2021-02-09,62,600,3,665,0.0
RAJASTHAN,KOTA,2021-02-10,16,827,1,844,0.0
RAJASTHAN,NAGAUR,2021-02-06,1,436,567,1004,0.0
RAJASTHAN,NAGAUR,2021-02-07,0,88,334,422,0.0
RAJASTHAN,NAGAUR,2021-02-08,0,186,276,462,0.0
RAJASTHAN,NAGAUR,2021-02-09,235,146,247,628,0.0
RAJASTHAN,NAGAUR,2021-02-10,423,67,526,1016,0.0
RAJASTHAN,PALI,2021-02-06,0,23,7,30,0.0
RAJASTHAN,PALI,2021-02-07,2,22,18,42,0.0
RAJASTHAN,PALI,2021-02-08,5,314,78,397,0.0
RAJASTHAN,PALI,2021-02-09,3,311,9,323,0.0
RAJASTHAN,PALI,2021-02-10,0,226,2,228,0.0
RAJASTHAN,PRATAPGARH,2021-02-06,0,5,0,5,0.0
RAJASTHAN,PRATAPGARH,2021-02-07,0,4,0,4,0.0
RAJASTHAN,PRATAPGARH,2021-02-08,5,6,0,11,0.0
RAJASTHAN,PRATAPGARH,2021-02-09,0,8,0,8,0.0
RAJASTHAN,PRATAPGARH,2021-02-10,0,7,0,7,0.0
RAJASTHAN,RAJSAMAND,2021-02-06,2,202,2,206,0.0
RAJASTHAN,RAJSAMAND,2021-02-07,0,264,0,264,0.0
RAJASTHAN,RAJSAMAND,2021-02-08,8,320,3,331,0.0
RAJASTHAN,RAJSAMAND,2021-02-09,5,381,3,389,0.0
RAJASTHAN,RAJSAMAND,2021-02-10,5,547,0,552,0.0
RAJASTHAN,SAWAI MADHOPUR,2021-02-06,1,357,8,366,0.0
RAJASTHAN,SAWAI MADHOPUR,2021-02-07,0,127,6,133,0.0
RAJASTHAN,SAWAI MADHOPUR,2021-02-08,1,124,7,132,0.0
RAJASTHAN,SAWAI MADHOPUR,2021-02-09,0,136,16,152,0.0
RAJASTHAN,SAWAI MADHOPUR,2021-02-10,0,185,7,192,0.0
RAJASTHAN,SIKAR,2021-02-06,1,300,5,306,0.0
RAJASTHAN,SIKAR,2021-02-07,0,420,9,429,0.0
RAJASTHAN,SIKAR,2021-02-08,0,503,11,514,0.0
RAJASTHAN,SIKAR,2021-02-09,0,397,8,405,0.0
RAJASTHAN,SIKAR,2021-02-10,1,354,7,362,0.0
RAJASTHAN,SIROHI,2021-02-06,17,262,0,279,0.0
RAJASTHAN,SIROHI,2021-02-07,0,44,2,46,0.0
RAJASTHAN,SIROHI,2021-02-08,0,272,0,272,0.0
RAJASTHAN,SIROHI,2021-02-09,16,334,0,350,0.0
RAJASTHAN,SIROHI,2021-02-10,23,251,0,274,0.0
RAJASTHAN,TONK,2021-02-06,1,224,73,298,0.0
RAJASTHAN,TONK,2021-02-07,1,436,71,508,0.0
RAJASTHAN,TONK,2021-02-08,0,569,37,606,0.0
RAJASTHAN,TONK,2021-02-09,0,421,27,448,0.0
RAJASTHAN,TONK,2021-02-10,1,438,23,462,0.0
RAJASTHAN,UDAIPUR,2021-02-06,44,792,2,838,0.0
RAJASTHAN,UDAIPUR,2021-02-07,46,502,1,549,0.0
RAJASTHAN,UDAIPUR,2021-02-08,35,499,1,535,0.0
RAJASTHAN,UDAIPUR,2021-02-09,37,791,0,828,0.0
RAJASTHAN,UDAIPUR,2021-02-10,22,594,1,617,0.0
SIKKIM,EAST DISTRICT,2021-02-06,3,104,0,107,0.0
SIKKIM,EAST DISTRICT,2021-02-07,0,12,0,12,0.0
SIKKIM,EAST DISTRICT,2021-02-08,0,184,0,184,0.0
SIKKIM,EAST DISTRICT,2021-02-09,2,155,0,157,0.0
SIKKIM,EAST DISTRICT,2021-02-10,2,115,0,117,0.0
SIKKIM,NORTH DISTRICT,2021-02-06,0,6,0,6,0.0
SIKKIM,NORTH DISTRICT,2021-02-08,0,5,0,5,0.0
SIKKIM,NORTH DISTRICT,2021-02-09,0,4,0,4,0.0
SIKKIM,NORTH DISTRICT,2021-02-10,0,3,0,3,0.0
SIKKIM,SOUTH DISTRICT,2021-02-06,0,30,1,31,0.0
SIKKIM,SOUTH DISTRICT,2021-02-07,0,1,0,1,0.0
SIKKIM,SOUTH DISTRICT,2021-02-08,3,17,0,20,0.0
SIKKIM,SOUTH DISTRICT,2021-02-09,0,7,0,7,0.0
SIKKIM,SOUTH DISTRICT,2021-02-10,0,29,0,29,0.0
SIKKIM,WEST DISTRICT,2021-02-07,2,0,0,2,0.0
SIKKIM,WEST DISTRICT,2021-02-08,0,7,0,7,0.0
SIKKIM,WEST DISTRICT,2021-02-09,0,2,0,2,0.0
SIKKIM,WEST DISTRICT,2021-02-10,0,6,0,6,0.0
TAMIL NADU,ARIYALUR,2021-02-06,1,53,0,54,0.0
TAMIL NADU,ARIYALUR,2021-02-07,0,407,1,408,0.0
TAMIL NADU,ARIYALUR,2021-02-08,1,453,0,454,0.0
TAMIL NADU,ARIYALUR,2021-02-09,1,851,0,852,0.0
TAMIL NADU,ARIYALUR,2021-02-10,1,911,0,912,0.0
TAMIL NADU,CHENGALPATTU,2021-02-06,12,2358,0,2370,0.0
TAMIL NADU,CHENGALPATTU,2021-02-07,22,3379,0,3401,0.0
TAMIL NADU,CHENGALPATTU,2021-02-08,24,2281,1,2306,0.0
TAMIL NADU,CHENGALPATTU,2021-02-09,23,3063,0,3086,0.0
TAMIL NADU,CHENGALPATTU,2021-02-10,35,1756,0,1791,0.0
TAMIL NADU,CHENNAI,2021-02-06,172,10825,7,11004,0.0
TAMIL NADU,CHENNAI,2021-02-07,137,9444,6,9587,0.0
TAMIL NADU,CHENNAI,2021-02-08,170,8963,6,9139,0.0
TAMIL NADU,CHENNAI,2021-02-09,199,11392,45,11636,0.0
TAMIL NADU,CHENNAI,2021-02-10,177,12567,11,12755,0.0
TAMIL NADU,COIMBATORE,2021-02-06,67,2897,0,2964,0.0
TAMIL NADU,COIMBATORE,2021-02-07,41,1481,0,1522,0.0
TAMIL NADU,COIMBATORE,2021-02-08,57,1571,1,1629,0.0
TAMIL NADU,COIMBATORE,2021-02-09,60,2265,1,2326,0.0
TAMIL NADU,COIMBATORE,2021-02-10,62,2113,0,2175,0.0
TAMIL NADU,CUDDALORE,2021-02-06,10,1369,1,1380,0.0
TAMIL NADU,CUDDALORE,2021-02-07,2,569,1,572,0.0
TAMIL NADU,CUDDALORE,2021-02-08,7,2209,20,2236,0.0
TAMIL NADU,CUDDALORE,2021-02-09,12,1766,2,1780,0.0
TAMIL NADU,CUDDALORE,2021-02-10,17,1288,0,1305,0.0
TAMIL NADU,DHARMAPURI,2021-02-06,3,549,0,552,0.0
TAMIL NADU,DHARMAPURI,2021-02-07,2,1035,0,1037,0.0
TAMIL NADU,DHARMAPURI,2021-02-08,7,794,0,801,0.0
TAMIL NADU,DHARMAPURI,2021-02-09,8,827,0,835,0.0
TAMIL NADU,DHARMAPURI,2021-02-10,9,673,0,682,0.0
TAMIL NADU,DINDIGUL,2021-02-06,9,572,0,581,0.0
TAMIL NADU,DINDIGUL,2021-02-07,5,568,2,575,0.0
TAMIL NADU,DINDIGUL,2021-02-08,6,438,5,449,0.0
TAMIL NADU,DINDIGUL,2021-02-09,7,587,0,594,0.0
TAMIL NADU,DINDIGUL,2021-02-10,6,440,0,446,0.0
TAMIL NADU,ERODE,2021-02-06,23,2002,0,2025,0.0
TAMIL NADU,ERODE,2021-02-07,18,2208,1,2227,0.0
TAMIL NADU,ERODE,2021-02-08,20,714,0,734,0.0
TAMIL NADU,ERODE,2021-02-09,12,1849,0,1861,0.0
TAMIL NADU,ERODE,2021-02-10,14,1002,0,1016,0.0
TAMIL NADU,KALLAKURICHI,2021-02-06,2,427,0,429,0.0
TAMIL NADU,KALLAKURICHI,2021-02-07,1,573,0,574,0.0
TAMIL NADU,KALLAKURICHI,2021-02-08,2,342,1,345,0.0
TAMIL NADU,KALLAKURICHI,2021-02-09,2,349,0,351,0.0
TAMIL NADU,KALLAKURICHI,2021-02-10,1,253,0,254,0.0
TAMIL NADU,KANCHIPURAM,2021-02-06,21,1933,0,1954,0.0
TAMIL NADU,KANCHIPURAM,2021-02-07,10,2038,0,2048,0.0
TAMIL NADU,KANCHIPURAM,2021-02-08,8,1394,0,1402,0.0
TAMIL NADU,KANCHIPURAM,2021-02-09,13,2009,2,2024,0.0
TAMIL NADU,KANCHIPURAM,2021-02-10,10,1831,1,1842,0.0
TAMIL NADU,KANNIYAKUMARI,2021-02-06,9,1420,2,1431,0.0
TAMIL NADU,KANNIYAKUMARI,2021-02-07,12,1211,2,1225,0.0
TAMIL NADU,KANNIYAKUMARI,2021-02-08,11,1213,3,1227,0.0
TAMIL NADU,KANNIYAKUMARI,2021-02-09,10,1982,7,1999,0.0
TAMIL NADU,KANNIYAKUMARI,2021-02-10,6,1698,3,1707,0.0
TAMIL NADU,KARUR,2021-02-06,1,1112,3,1116,0.0
TAMIL NADU,KARUR,2021-02-07,1,1078,0,1079,0.0
TAMIL NADU,KARUR,2021-02-08,6,832,0,838,0.0
TAMIL NADU,KARUR,2021-02-09,9,1229,0,1238,0.0
TAMIL NADU,KARUR,2021-02-10,3,1068,0,1071,0.0
TAMIL NADU,KRISHNAGIRI,2021-02-06,2,1107,1,1110,0.0
TAMIL NADU,KRISHNAGIRI,2021-02-07,6,335,0,341,0.0
TAMIL NADU,KRISHNAGIRI,2021-02-08,1,1476,1,1478,0.0
TAMIL NADU,KRISHNAGIRI,2021-02-09,0,2172,4,2176,0.0
TAMIL NADU,KRISHNAGIRI,2021-02-10,2,1712,2,1716,0.0
TAMIL NADU,MADURAI,2021-02-06,9,3262,0,3271,0.0
TAMIL NADU,MADURAI,2021-02-07,4,1218,1,1223,0.0
TAMIL NADU,MADURAI,2021-02-08,2,2484,1,2487,0.0
TAMIL NADU,MADURAI,2021-02-09,5,3449,1,3455,0.0
TAMIL NADU,MADURAI,2021-02-10,12,3239,0,3251,0.0
TAMIL NADU,NAGAPATTINAM,2021-02-06,6,700,0,706,0.0
TAMIL NADU,NAGAPATTINAM,2021-02-07,3,314,0,317,0.0
TAMIL NADU,NAGAPATTINAM,2021-02-08,8,267,2,277,0.0
TAMIL NADU,NAGAPATTINAM,2021-02-09,9,393,0,402,0.0
TAMIL NADU,NAGAPATTINAM,2021-02-10,8,350,0,358,0.0
TAMIL NADU,NAMAKKAL,2021-02-06,9,1955,2,1966,0.0
TAMIL NADU,NAMAKKAL,2021-02-07,9,945,0,954,0.0
TAMIL NADU,NAMAKKAL,2021-02-08,15,1364,2,1381,0.0
TAMIL NADU,NAMAKKAL,2021-02-09,4,1435,0,1439,0.0
TAMIL NADU,NAMAKKAL,2021-02-10,9,1637,3,1649,0.0
TAMIL NADU,PERAMBALUR,2021-02-06,0,315,0,315,0.0
TAMIL NADU,PERAMBALUR,2021-02-07,0,396,1,397,0.0
TAMIL NADU,PERAMBALUR,2021-02-08,0,85,0,85,0.0
TAMIL NADU,PERAMBALUR,2021-02-09,2,376,0,378,0.0
TAMIL NADU,PERAMBALUR,2021-02-10,3,201,0,204,0.0
TAMIL NADU,PUDUKKOTTAI,2021-02-06,1,1027,1,1029,0.0
TAMIL NADU,PUDUKKOTTAI,2021-02-07,1,829,1,831,0.0
TAMIL NADU,PUDUKKOTTAI,2021-02-08,5,84,0,89,0.0
TAMIL NADU,PUDUKKOTTAI,2021-02-09,6,771,0,777,0.0
TAMIL NADU,PUDUKKOTTAI,2021-02-10,11,1023,3,1037,0.0
TAMIL NADU,RAMANATHAPURAM,2021-02-06,2,990,0,992,0.0
TAMIL NADU,RAMANATHAPURAM,2021-02-07,2,899,0,901,0.0
TAMIL NADU,RAMANATHAPURAM,2021-02-08,0,651,0,651,0.0
TAMIL NADU,RAMANATHAPURAM,2021-02-09,1,958,0,959,0.0
TAMIL NADU,RAMANATHAPURAM,2021-02-10,1,771,1,773,0.0
TAMIL NADU,RANIPET,2021-02-06,3,484,0,487,0.0
TAMIL NADU,RANIPET,2021-02-07,3,25,0,28,0.0
TAMIL NADU,RANIPET,2021-02-08,1,523,0,524,0.0
TAMIL NADU,RANIPET,2021-02-09,5,839,0,844,0.0
TAMIL NADU,RANIPET,2021-02-10,6,689,0,695,0.0
TAMIL NADU,SALEM,2021-02-06,6,284,0,290,0.0
TAMIL NADU,SALEM,2021-02-07,7,200,1,208,0.0
TAMIL NADU,SALEM,2021-02-08,32,292,0,324,0.0
TAMIL NADU,SALEM,2021-02-09,12,336,0,348,0.0
TAMIL NADU,SALEM,2021-02-10,13,200,0,213,0.0
TAMIL NADU,SIVAGANGA,2021-02-06,4,737,0,741,0.0
TAMIL NADU,SIVAGANGA,2021-02-07,1,302,0,303,0.0
TAMIL NADU,SIVAGANGA,2021-02-08,0,403,0,403,0.0
TAMIL NADU,SIVAGANGA,2021-02-09,6,749,0,755,0.0
TAMIL NADU,SIVAGANGA,2021-02-10,8,575,0,583,0.0
TAMIL NADU,TENKASI,2021-02-06,9,705,1,715,0.0
TAMIL NADU,TENKASI,2021-02-07,0,524,5,529,0.0
TAMIL NADU,TENKASI,2021-02-08,4,455,0,459,0.0
TAMIL NADU,TENKASI,2021-02-09,11,714,0,725,0.0
TAMIL NADU,TENKASI,2021-02-10,4,534,0,538,0.0
TAMIL NADU,THANJAVUR,2021-02-06,32,857,2,891,0.0
TAMIL NADU,THANJAVUR,2021-02-07,11,305,0,316,0.0
TAMIL NADU,THANJAVUR,2021-02-08,13,973,2,988,0.0
TAMIL NADU,THANJAVUR,2021-02-09,11,589,1,601,0.0
TAMIL NADU,THANJAVUR,2021-02-10,19,889,3,911,0.0
TAMIL NADU,THE NILGIRIS,2021-02-06,8,881,0,889,0.0
TAMIL NADU,THE NILGIRIS,2021-02-07,4,899,0,903,0.0
TAMIL NADU,THE NILGIRIS,2021-02-08,5,907,0,912,0.0
TAMIL NADU,THE NILGIRIS,2021-02-09,14,1426,4,1444,0.0
TAMIL NADU,THE NILGIRIS,2021-02-10,5,1322,0,1327,0.0
TAMIL NADU,THENI,2021-02-06,4,632,0,636,0.0
TAMIL NADU,THENI,2021-02-07,3,388,0,391,0.0
TAMIL NADU,THENI,2021-02-08,1,144,0,145,0.0
TAMIL NADU,THENI,2021-02-09,5,351,0,356,0.0
TAMIL NADU,THENI,2021-02-10,4,503,0,507,0.0
TAMIL NADU,THIRUVALLUR,2021-02-06,23,2008,2,2033,0.0
TAMIL NADU,THIRUVALLUR,2021-02-07,16,1500,0,1516,0.0
TAMIL NADU,THIRUVALLUR,2021-02-08,20,1787,3,1810,0.0
TAMIL NADU,THIRUVALLUR,2021-02-09,35,2016,0,2051,0.0
TAMIL NADU,THIRUVALLUR,2021-02-10,17,2146,1,2164,0.0
TAMIL NADU,THIRUVARUR,2021-02-06,8,578,0,586,0.0
TAMIL NADU,THIRUVARUR,2021-02-07,3,183,0,186,0.0
TAMIL NADU,THIRUVARUR,2021-02-08,3,985,0,988,0.0
TAMIL NADU,THIRUVARUR,2021-02-09,11,1053,0,1064,0.0
TAMIL NADU,THIRUVARUR,2021-02-10,5,806,0,811,0.0
TAMIL NADU,TIRUCHIRAPPALLI,2021-02-06,15,1279,1,1295,0.0
TAMIL NADU,TIRUCHIRAPPALLI,2021-02-07,16,1421,10,1447,0.0
TAMIL NADU,TIRUCHIRAPPALLI,2021-02-08,10,1438,2,1450,0.0
TAMIL NADU,TIRUCHIRAPPALLI,2021-02-09,15,1364,1,1380,0.0
TAMIL NADU,TIRUCHIRAPPALLI,2021-02-10,13,1605,3,1621,0.0
TAMIL NADU,TIRUNELVELI,2021-02-06,7,914,1,922,0.0
TAMIL NADU,TIRUNELVELI,2021-02-07,5,332,1,338,0.0
TAMIL NADU,TIRUNELVELI,2021-02-08,10,1101,0,1111,0.0
TAMIL NADU,TIRUNELVELI,2021-02-09,8,1022,2,1032,0.0
TAMIL NADU,TIRUNELVELI,2021-02-10,6,852,0,858,0.0
TAMIL NADU,TIRUPATHUR,2021-02-06,4,2082,10,2096,0.0
TAMIL NADU,TIRUPATHUR,2021-02-07,1,2294,2,2297,0.0
TAMIL NADU,TIRUPATHUR,2021-02-08,4,2745,10,2759,0.0
TAMIL NADU,TIRUPATHUR,2021-02-09,2,2310,1,2313,0.0
TAMIL NADU,TIRUPATHUR,2021-02-10,2,1408,4,1414,0.0
TAMIL NADU,TIRUPPUR,2021-02-06,21,2546,1,2568,0.0
TAMIL NADU,TIRUPPUR,2021-02-07,13,706,0,719,0.0
TAMIL NADU,TIRUPPUR,2021-02-08,14,1223,0,1237,0.0
TAMIL NADU,TIRUPPUR,2021-02-09,20,1961,0,1981,0.0
TAMIL NADU,TIRUPPUR,2021-02-10,15,2059,0,2074,0.0
TAMIL NADU,TIRUVANNAMALAI,2021-02-06,5,633,1,639,0.0
TAMIL NADU,TIRUVANNAMALAI,2021-02-07,2,408,0,410,0.0
TAMIL NADU,TIRUVANNAMALAI,2021-02-08,4,1312,1,1317,0.0
TAMIL NADU,TIRUVANNAMALAI,2021-02-09,3,766,0,769,0.0
TAMIL NADU,TIRUVANNAMALAI,2021-02-10,5,717,1,723,0.0
TAMIL NADU,TUTICORIN,2021-02-06,1,960,0,961,0.0
TAMIL NADU,TUTICORIN,2021-02-07,2,772,0,774,0.0
TAMIL NADU,TUTICORIN,2021-02-08,3,362,0,365,0.0
TAMIL NADU,TUTICORIN,2021-02-09,5,1015,2,1022,0.0
TAMIL NADU,TUTICORIN,2021-02-10,1,836,0,837,0.0
TAMIL NADU,VELLORE,2021-02-06,8,1622,0,1630,0.0
TAMIL NADU,VELLORE,2021-02-07,13,530,0,543,0.0
TAMIL NADU,VELLORE,2021-02-08,7,1326,0,1333,0.0
TAMIL NADU,VELLORE,2021-02-09,13,1689,0,1702,0.0
TAMIL NADU,VELLORE,2021-02-10,15,1783,0,1798,0.0
TAMIL NADU,VILLUPURAM,2021-02-06,4,454,0,458,0.0
TAMIL NADU,VILLUPURAM,2021-02-07,3,1300,0,1303,0.0
TAMIL NADU,VILLUPURAM,2021-02-08,5,875,4,884,0.0
TAMIL NADU,VILLUPURAM,2021-02-09,1,943,0,944,0.0
TAMIL NADU,VILLUPURAM,2021-02-10,2,875,0,877,0.0
TAMIL NADU,VIRUDHUNAGAR,2021-02-06,4,340,0,344,0.0
TAMIL NADU,VIRUDHUNAGAR,2021-02-07,4,128,0,132,0.0
TAMIL NADU,VIRUDHUNAGAR,2021-02-08,4,513,0,517,0.0
TAMIL NADU,VIRUDHUNAGAR,2021-02-09,0,435,0,435,0.0
TAMIL NADU,VIRUDHUNAGAR,2021-02-10,7,907,0,914,0.0
TELANGANA,ADILABAD,2021-02-06,1,360,0,361,0.0
TELANGANA,ADILABAD,2021-02-07,0,234,0,234,0.0
TELANGANA,ADILABAD,2021-02-08,0,317,0,317,0.0
TELANGANA,ADILABAD,2021-02-09,0,197,0,197,0.0
TELANGANA,ADILABAD,2021-02-10,0,314,0,314,0.0
TELANGANA,BHADRADRI KOTHAGUDEM,2021-02-06,0,608,0,608,0.0
TELANGANA,BHADRADRI KOTHAGUDEM,2021-02-07,0,167,0,167,0.0
TELANGANA,BHADRADRI KOTHAGUDEM,2021-02-08,0,750,0,750,0.0
TELANGANA,BHADRADRI KOTHAGUDEM,2021-02-09,0,497,0,497,0.0
TELANGANA,BHADRADRI KOTHAGUDEM,2021-02-10,0,598,0,598,0.0
TELANGANA,HYDERABAD,2021-02-06,16,5677,0,5693,0.0
TELANGANA,HYDERABAD,2021-02-07,12,3337,0,3349,0.0
TELANGANA,HYDERABAD,2021-02-08,7,7170,1,7178,0.0
TELANGANA,HYDERABAD,2021-02-09,34,5340,2,5376,0.0
TELANGANA,HYDERABAD,2021-02-10,23,5975,1,5999,0.0
TELANGANA,JAGITIAL,2021-02-06,0,629,0,629,0.0
TELANGANA,JAGITIAL,2021-02-07,0,283,0,283,0.0
TELANGANA,JAGITIAL,2021-02-08,0,591,0,591,0.0
TELANGANA,JAGITIAL,2021-02-09,0,375,0,375,0.0
TELANGANA,JAGITIAL,2021-02-10,0,455,0,455,0.0
TELANGANA,JANGOAN,2021-02-06,0,543,0,543,0.0
TELANGANA,JANGOAN,2021-02-07,0,256,0,256,0.0
TELANGANA,JANGOAN,2021-02-08,0,600,0,600,0.0
TELANGANA,JANGOAN,2021-02-09,0,424,0,424,0.0
TELANGANA,JANGOAN,2021-02-10,0,419,0,419,0.0
TELANGANA,JAYASHANKAR BHUPALAPALLY,2021-02-06,0,299,0,299,0.0
TELANGANA,JAYASHANKAR BHUPALAPALLY,2021-02-07,0,37,0,37,0.0
TELANGANA,JAYASHANKAR BHUPALAPALLY,2021-02-08,0,355,0,355,0.0
TELANGANA,JAYASHANKAR BHUPALAPALLY,2021-02-09,0,192,0,192,0.0
TELANGANA,JAYASHANKAR BHUPALAPALLY,2021-02-10,0,219,0,219,0.0
TELANGANA,JOGULAMBA GADWAL,2021-02-06,0,532,0,532,0.0
TELANGANA,JOGULAMBA GADWAL,2021-02-07,0,221,0,221,0.0
TELANGANA,JOGULAMBA GADWAL,2021-02-08,0,595,0,595,0.0
TELANGANA,JOGULAMBA GADWAL,2021-02-09,0,467,0,467,0.0
TELANGANA,JOGULAMBA GADWAL,2021-02-10,0,702,0,702,0.0
TELANGANA,KAMAREDDY,2021-02-06,0,458,0,458,0.0
TELANGANA,KAMAREDDY,2021-02-07,0,51,0,51,0.0
TELANGANA,KAMAREDDY,2021-02-08,0,579,0,579,0.0
TELANGANA,KAMAREDDY,2021-02-09,0,320,0,320,0.0
TELANGANA,KAMAREDDY,2021-02-10,0,454,0,454,0.0
TELANGANA,KARIMNAGAR,2021-02-06,6,1178,0,1184,0.0
TELANGANA,KARIMNAGAR,2021-02-07,0,579,0,579,0.0
TELANGANA,KARIMNAGAR,2021-02-08,0,1119,0,1119,0.0
TELANGANA,KARIMNAGAR,2021-02-09,2,722,0,724,0.0
TELANGANA,KARIMNAGAR,2021-02-10,2,1003,0,1005,0.0
TELANGANA,KHAMMAM,2021-02-06,1,965,0,966,0.0
TELANGANA,KHAMMAM,2021-02-07,0,178,0,178,0.0
TELANGANA,KHAMMAM,2021-02-08,0,900,0,900,0.0
TELANGANA,KHAMMAM,2021-02-09,0,460,0,460,0.0
TELANGANA,KHAMMAM,2021-02-10,1,608,0,609,0.0
TELANGANA,KUMURAM BHEEM ASIFABAD,2021-02-06,0,611,0,611,0.0
TELANGANA,KUMURAM BHEEM ASIFABAD,2021-02-07,0,368,0,368,0.0
TELANGANA,KUMURAM BHEEM ASIFABAD,2021-02-08,0,716,0,716,0.0
TELANGANA,KUMURAM BHEEM ASIFABAD,2021-02-09,0,408,0,408,0.0
TELANGANA,KUMURAM BHEEM ASIFABAD,2021-02-10,0,416,0,416,0.0
TELANGANA,MAHABUBABAD,2021-02-06,0,598,0,598,0.0
TELANGANA,MAHABUBABAD,2021-02-07,0,194,0,194,0.0
TELANGANA,MAHABUBABAD,2021-02-08,0,416,0,416,0.0
TELANGANA,MAHABUBABAD,2021-02-09,0,435,0,435,0.0
TELANGANA,MAHABUBABAD,2021-02-10,0,328,0,328,0.0
TELANGANA,MAHABUBNAGAR,2021-02-06,0,687,0,687,0.0
TELANGANA,MAHABUBNAGAR,2021-02-07,1,218,0,219,0.0
TELANGANA,MAHABUBNAGAR,2021-02-08,0,680,0,680,0.0
TELANGANA,MAHABUBNAGAR,2021-02-09,0,480,0,480,0.0
TELANGANA,MAHABUBNAGAR,2021-02-10,0,537,0,537,0.0
TELANGANA,MANCHERIAL,2021-02-06,0,668,0,668,0.0
TELANGANA,MANCHERIAL,2021-02-07,0,279,0,279,0.0
TELANGANA,MANCHERIAL,2021-02-08,0,723,0,723,0.0
TELANGANA,MANCHERIAL,2021-02-09,0,496,0,496,0.0
TELANGANA,MANCHERIAL,2021-02-10,0,508,0,508,0.0
TELANGANA,MEDAK,2021-02-06,1,246,0,247,0.0
TELANGANA,MEDAK,2021-02-07,0,99,0,99,0.0
TELANGANA,MEDAK,2021-02-08,0,351,0,351,0.0
TELANGANA,MEDAK,2021-02-09,1,221,0,222,0.0
TELANGANA,MEDAK,2021-02-10,0,303,0,303,0.0
TELANGANA,MEDCHAL MALKAJGIRI,2021-02-06,0,1418,0,1418,0.0
TELANGANA,MEDCHAL MALKAJGIRI,2021-02-07,0,321,0,321,0.0
TELANGANA,MEDCHAL MALKAJGIRI,2021-02-08,2,1887,0,1889,0.0
TELANGANA,MEDCHAL MALKAJGIRI,2021-02-09,0,1009,0,1009,0.0
TELANGANA,MEDCHAL MALKAJGIRI,2021-02-10,0,1233,0,1233,0.0
TELANGANA,MULUGU,2021-02-06,0,193,0,193,0.0
TELANGANA,MULUGU,2021-02-07,0,58,0,58,0.0
TELANGANA,MULUGU,2021-02-08,0,183,0,183,0.0
TELANGANA,MULUGU,2021-02-09,0,115,0,115,0.0
TELANGANA,MULUGU,2021-02-10,0,158,0,158,0.0
TELANGANA,NAGARKURNOOL,2021-02-06,0,1315,0,1315,0.0
TELANGANA,NAGARKURNOOL,2021-02-07,0,660,0,660,0.0
TELANGANA,NAGARKURNOOL,2021-02-08,0,940,0,940,0.0
TELANGANA,NAGARKURNOOL,2021-02-09,0,715,0,715,0.0
TELANGANA,NAGARKURNOOL,2021-02-10,0,953,0,953,0.0
TELANGANA,NALGONDA,2021-02-06,2,1289,0,1291,0.0
TELANGANA,NALGONDA,2021-02-07,0,58,0,58,0.0
TELANGANA,NALGONDA,2021-02-08,0,1345,0,1345,0.0
TELANGANA,NALGONDA,2021-02-09,1,778,0,779,0.0
TELANGANA,NALGONDA,2021-02-10,0,907,0,907,0.0
TELANGANA,NARAYANPET,2021-02-06,0,474,0,474,0.0
TELANGANA,NARAYANPET,2021-02-07,0,117,0,117,0.0
TELANGANA,NARAYANPET,2021-02-08,0,299,0,299,0.0
TELANGANA,NARAYANPET,2021-02-09,0,132,0,132,0.0
TELANGANA,NARAYANPET,2021-02-10,0,214,0,214,0.0
TELANGANA,NIRMAL,2021-02-06,0,624,0,624,0.0
TELANGANA,NIRMAL,2021-02-07,0,186,0,186,0.0
TELANGANA,NIRMAL,2021-02-08,0,525,0,525,0.0
TELANGANA,NIRMAL,2021-02-09,0,353,0,353,0.0
TELANGANA,NIRMAL,2021-02-10,0,302,0,302,0.0
TELANGANA,NIZAMABAD,2021-02-06,2,913,0,915,0.0
TELANGANA,NIZAMABAD,2021-02-07,0,165,0,165,0.0
TELANGANA,NIZAMABAD,2021-02-08,0,747,0,747,0.0
TELANGANA,NIZAMABAD,2021-02-09,0,515,1,516,0.0
TELANGANA,NIZAMABAD,2021-02-10,1,549,0,550,0.0
TELANGANA,PEDDAPALLI,2021-02-06,0,1064,0,1064,0.0
TELANGANA,PEDDAPALLI,2021-02-07,0,186,0,186,0.0
TELANGANA,PEDDAPALLI,2021-02-08,0,957,0,957,0.0
TELANGANA,PEDDAPALLI,2021-02-09,0,667,0,667,0.0
TELANGANA,PEDDAPALLI,2021-02-10,0,838,0,838,0.0
TELANGANA,RAJANNA SIRCILLA,2021-02-06,0,405,0,405,0.0
TELANGANA,RAJANNA SIRCILLA,2021-02-07,0,63,0,63,0.0
TELANGANA,RAJANNA SIRCILLA,2021-02-08,0,352,0,352,0.0
TELANGANA,RAJANNA SIRCILLA,2021-02-09,0,254,0,254,0.0
TELANGANA,RAJANNA SIRCILLA,2021-02-10,0,386,0,386,0.0
TELANGANA,RANGA REDDY,2021-02-06,6,2241,0,2247,0.0
TELANGANA,RANGA REDDY,2021-02-07,1,1023,2,1026,0.0
TELANGANA,RANGA REDDY,2021-02-08,1,2590,0,2591,0.0
TELANGANA,RANGA REDDY,2021-02-09,8,1682,0,1690,0.0
TELANGANA,RANGA REDDY,2021-02-10,4,2037,0,2041,0.0
TELANGANA,SANGAREDDY,2021-02-06,0,884,0,884,0.0
TELANGANA,SANGAREDDY,2021-02-07,0,413,0,413,0.0
TELANGANA,SANGAREDDY,2021-02-08,3,882,0,885,0.0
TELANGANA,SANGAREDDY,2021-02-09,0,696,0,696,0.0
TELANGANA,SANGAREDDY,2021-02-10,1,723,0,724,0.0
TELANGANA,SIDDIPET,2021-02-06,0,1478,0,1478,0.0
TELANGANA,SIDDIPET,2021-02-07,0,1015,0,1015,0.0
TELANGANA,SIDDIPET,2021-02-08,0,1213,0,1213,0.0
TELANGANA,SIDDIPET,2021-02-09,0,888,0,888,0.0
TELANGANA,SIDDIPET,2021-02-10,0,1202,0,1202,0.0
TELANGANA,SURYAPET,2021-02-06,0,1259,0,1259,0.0
TELANGANA,SURYAPET,2021-02-07,0,443,0,443,0.0
TELANGANA,SURYAPET,2021-02-08,0,1121,0,1121,0.0
TELANGANA,SURYAPET,2021-02-09,0,938,0,938,0.0
TELANGANA,SURYAPET,2021-02-10,0,766,0,766,0.0
TELANGANA,VIKARABAD,2021-02-06,2,593,0,595,0.0
TELANGANA,VIKARABAD,2021-02-07,0,188,0,188,0.0
TELANGANA,VIKARABAD,2021-02-08,0,690,0,690,0.0
TELANGANA,VIKARABAD,2021-02-09,0,347,0,347,0.0
TELANGANA,VIKARABAD,2021-02-10,0,338,0,338,0.0
TELANGANA,WANAPARTHY,2021-02-06,0,400,0,400,0.0
TELANGANA,WANAPARTHY,2021-02-07,0,174,0,174,0.0
TELANGANA,WANAPARTHY,2021-02-08,0,568,0,568,0.0
TELANGANA,WANAPARTHY,2021-02-09,0,310,0,310,0.0
TELANGANA,WANAPARTHY,2021-02-10,0,261,0,261,0.0
TELANGANA,WARANGAL RURAL,2021-02-06,1,422,0,423,0.0
TELANGANA,WARANGAL RURAL,2021-02-07,0,90,0,90,0.0
TELANGANA,WARANGAL RURAL,2021-02-08,0,574,0,574,0.0
TELANGANA,WARANGAL RURAL,2021-02-09,5,300,1,306,0.0
TELANGANA,WARANGAL RURAL,2021-02-10,4,345,0,349,0.0
TELANGANA,WARANGAL URBAN,2021-02-06,2,1546,0,1548,0.0
TELANGANA,WARANGAL URBAN,2021-02-07,0,612,0,612,0.0
TELANGANA,WARANGAL URBAN,2021-02-08,1,1279,0,1280,0.0
TELANGANA,WARANGAL URBAN,2021-02-09,0,1062,0,1062,0.0
TELANGANA,WARANGAL URBAN,2021-02-10,0,1350,0,1350,0.0
TELANGANA,YADADRI BHUVANAGIRI,2021-02-06,0,605,0,605,0.0
TELANGANA,YADADRI BHUVANAGIRI,2021-02-07,0,106,0,106,0.0
TELANGANA,YADADRI BHUVANAGIRI,2021-02-08,0,482,0,482,0.0
TELANGANA,YADADRI BHUVANAGIRI,2021-02-09,0,313,0,313,0.0
TELANGANA,YADADRI BHUVANAGIRI,2021-02-10,0,382,0,382,0.0
TRIPURA,DHALAI,2021-02-06,0,12,0,12,0.0
TRIPURA,DHALAI,2021-02-07,0,2,0,2,0.0
TRIPURA,DHALAI,2021-02-08,0,6,0,6,0.0
TRIPURA,DHALAI,2021-02-09,0,11,0,11,0.0
TRIPURA,DHALAI,2021-02-10,0,44,0,44,0.0
TRIPURA,GOMATI,2021-02-06,0,45,0,45,0.0
TRIPURA,GOMATI,2021-02-07,0,21,0,21,0.0
TRIPURA,GOMATI,2021-02-08,1,25,0,26,0.0
TRIPURA,GOMATI,2021-02-09,0,34,0,34,0.0
TRIPURA,GOMATI,2021-02-10,0,47,0,47,0.0
TRIPURA,KHOWAI,2021-02-06,0,21,0,21,0.0
TRIPURA,KHOWAI,2021-02-07,0,6,0,6,0.0
TRIPURA,KHOWAI,2021-02-08,0,19,0,19,0.0
TRIPURA,KHOWAI,2021-02-09,0,26,0,26,0.0
TRIPURA,KHOWAI,2021-02-10,0,23,0,23,0.0
TRIPURA,NORTH TRIPURA,2021-02-06,0,52,0,52,0.0
TRIPURA,NORTH TRIPURA,2021-02-07,0,33,0,33,0.0
TRIPURA,NORTH TRIPURA,2021-02-08,0,101,0,101,0.0
TRIPURA,NORTH TRIPURA,2021-02-09,1,84,0,85,0.0
TRIPURA,NORTH TRIPURA,2021-02-10,1,71,0,72,0.0
TRIPURA,SEPAHIJALA,2021-02-06,0,57,0,57,0.0
TRIPURA,SEPAHIJALA,2021-02-07,0,47,0,47,0.0
TRIPURA,SEPAHIJALA,2021-02-08,0,24,0,24,0.0
TRIPURA,SEPAHIJALA,2021-02-09,0,107,0,107,0.0
TRIPURA,SEPAHIJALA,2021-02-10,0,30,0,30,0.0
TRIPURA,SOUTH TRIPURA,2021-02-06,1,78,0,79,0.0
TRIPURA,SOUTH TRIPURA,2021-02-07,0,107,0,107,0.0
TRIPURA,SOUTH TRIPURA,2021-02-08,0,37,0,37,0.0
TRIPURA,SOUTH TRIPURA,2021-02-09,0,55,0,55,0.0
TRIPURA,SOUTH TRIPURA,2021-02-10,0,50,0,50,0.0
TRIPURA,UNAKOTI,2021-02-06,0,8,0,8,0.0
TRIPURA,UNAKOTI,2021-02-07,0,1,0,1,0.0
TRIPURA,UNAKOTI,2021-02-08,0,9,0,9,0.0
TRIPURA,UNAKOTI,2021-02-09,0,9,0,9,0.0
TRIPURA,UNAKOTI,2021-02-10,0,2,0,2,0.0
TRIPURA,WEST TRIPURA,2021-02-06,0,154,0,154,0.0
TRIPURA,WEST TRIPURA,2021-02-07,0,92,0,92,0.0
TRIPURA,WEST TRIPURA,2021-02-08,1,181,0,182,0.0
TRIPURA,WEST TRIPURA,2021-02-09,0,173,0,173,0.0
TRIPURA,WEST TRIPURA,2021-02-10,0,203,0,203,0.0
UTTAR PRADESH,AGRA,2021-02-06,2,1925,41,1968,0.0
UTTAR PRADESH,AGRA,2021-02-07,3,1362,4,1369,0.0
UTTAR PRADESH,AGRA,2021-02-08,1,2279,4,2284,0.0
UTTAR PRADESH,AGRA,2021-02-09,2,1499,1,1502,0.0
UTTAR PRADESH,AGRA,2021-02-10,1,2888,1,2890,0.0
UTTAR PRADESH,ALIGARH,2021-02-06,2,2586,5,2593,0.0
UTTAR PRADESH,ALIGARH,2021-02-07,0,2185,4,2189,0.0
UTTAR PRADESH,ALIGARH,2021-02-08,4,2420,1,2425,0.0
UTTAR PRADESH,ALIGARH,2021-02-09,1,2788,6,2795,0.0
UTTAR PRADESH,ALIGARH,2021-02-10,2,2737,3,2742,0.0
UTTAR PRADESH,AMBEDKAR NAGAR,2021-02-06,0,1110,9,1119,0.0
UTTAR PRADESH,AMBEDKAR NAGAR,2021-02-07,0,916,17,933,0.0
UTTAR PRADESH,AMBEDKAR NAGAR,2021-02-08,0,3226,1,3227,0.0
UTTAR PRADESH,AMBEDKAR NAGAR,2021-02-09,0,1302,26,1328,0.0
UTTAR PRADESH,AMBEDKAR NAGAR,2021-02-10,1,1485,18,1504,0.0
UTTAR PRADESH,AMETHI,2021-02-06,0,1245,0,1245,0.0
UTTAR PRADESH,AMETHI,2021-02-07,1,1248,0,1249,0.0
UTTAR PRADESH,AMETHI,2021-02-08,0,750,0,750,0.0
UTTAR PRADESH,AMETHI,2021-02-09,0,1454,0,1454,0.0
UTTAR PRADESH,AMETHI,2021-02-10,0,1114,1,1115,0.0
UTTAR PRADESH,AMROHA,2021-02-06,4,629,0,633,0.0
UTTAR PRADESH,AMROHA,2021-02-07,1,1276,1,1278,0.0
UTTAR PRADESH,AMROHA,2021-02-08,3,800,0,803,0.0
UTTAR PRADESH,AMROHA,2021-02-09,1,1186,0,1187,0.0
UTTAR PRADESH,AMROHA,2021-02-10,9,958,0,967,0.0
UTTAR PRADESH,AURAIYA,2021-02-06,0,776,41,817,0.0
UTTAR PRADESH,AURAIYA,2021-02-07,0,710,30,740,0.0
UTTAR PRADESH,AURAIYA,2021-02-08,0,485,19,504,0.0
UTTAR PRADESH,AURAIYA,2021-02-09,0,825,21,846,0.0
UTTAR PRADESH,AURAIYA,2021-02-10,0,833,10,843,0.0
UTTAR PRADESH,AYODHYA,2021-02-06,1,1289,0,1290,0.0
UTTAR PRADESH,AYODHYA,2021-02-07,1,1218,0,1219,0.0
UTTAR PRADESH,AYODHYA,2021-02-08,3,1593,0,1596,0.0
UTTAR PRADESH,AYODHYA,2021-02-09,3,1659,0,1662,0.0
UTTAR PRADESH,AYODHYA,2021-02-10,0,1825,1,1826,0.0
UTTAR PRADESH,AZAMGARH,2021-02-06,0,1341,1,1342,0.0
UTTAR PRADESH,AZAMGARH,2021-02-07,1,578,0,579,0.0
UTTAR PRADESH,AZAMGARH,2021-02-08,0,860,11,871,0.0
UTTAR PRADESH,AZAMGARH,2021-02-09,2,669,2,673,0.0
UTTAR PRADESH,AZAMGARH,2021-02-10,0,398,0,398,0.0
UTTAR PRADESH,BAGHPAT,2021-02-06,0,536,40,576,0.0
UTTAR PRADESH,BAGHPAT,2021-02-07,0,1254,33,1287,0.0
UTTAR PRADESH,BAGHPAT,2021-02-08,2,1086,116,1204,0.0
UTTAR PRADESH,BAGHPAT,2021-02-09,1,1262,15,1278,0.0
UTTAR PRADESH,BAGHPAT,2021-02-10,2,2016,18,2036,0.0
UTTAR PRADESH,BAHRAICH,2021-02-06,1,1783,74,1858,0.0
UTTAR PRADESH,BAHRAICH,2021-02-07,2,1639,90,1731,0.0
UTTAR PRADESH,BAHRAICH,2021-02-08,0,1805,55,1860,0.0
UTTAR PRADESH,BAHRAICH,2021-02-09,0,1911,42,1953,0.0
UTTAR PRADESH,BAHRAICH,2021-02-10,1,1679,17,1697,0.0
UTTAR PRADESH,BALLIA,2021-02-06,1,721,1,723,0.0
UTTAR PRADESH,BALLIA,2021-02-07,1,383,0,384,0.0
UTTAR PRADESH,BALLIA,2021-02-08,2,509,33,544,0.0
UTTAR PRADESH,BALLIA,2021-02-09,0,543,6,549,0.0
UTTAR PRADESH,BALLIA,2021-02-10,0,582,2,584,0.0
UTTAR PRADESH,BALRAMPUR,2021-02-06,0,892,0,892,0.0
UTTAR PRADESH,BALRAMPUR,2021-02-07,0,1043,0,1043,0.0
UTTAR PRADESH,BALRAMPUR,2021-02-08,0,879,0,879,0.0
UTTAR PRADESH,BALRAMPUR,2021-02-09,2,1061,10,1073,0.0
UTTAR PRADESH,BALRAMPUR,2021-02-10,1,998,22,1021,0.0
UTTAR PRADESH,BANDA,2021-02-06,2,2190,9,2201,0.0
UTTAR PRADESH,BANDA,2021-02-07,0,1877,11,1888,0.0
UTTAR PRADESH,BANDA,2021-02-08,1,1746,21,1768,0.0
UTTAR PRADESH,BANDA,2021-02-09,0,1722,12,1734,0.0
UTTAR PRADESH,BANDA,2021-02-10,0,2108,16,2124,0.0
UTTAR PRADESH,BARABANKI,2021-02-06,2,1849,4,1855,0.0
UTTAR PRADESH,BARABANKI,2021-02-07,0,1350,1,1351,0.0
UTTAR PRADESH,BARABANKI,2021-02-08,0,1231,1,1232,0.0
UTTAR PRADESH,BARABANKI,2021-02-09,1,1550,7,1558,0.0
UTTAR PRADESH,BARABANKI,2021-02-10,2,1535,39,1576,0.0
UTTAR PRADESH,BAREILLY,2021-02-06,5,1751,1,1757,0.0
UTTAR PRADESH,BAREILLY,2021-02-07,5,1542,1,1548,0.0
UTTAR PRADESH,BAREILLY,2021-02-08,0,2855,1,2856,0.0
UTTAR PRADESH,BAREILLY,2021-02-09,13,2827,2,2842,0.0
UTTAR PRADESH,BAREILLY,2021-02-10,15,1702,3,1720,0.0
UTTAR PRADESH,BASTI,2021-02-06,0,966,115,1081,0.0
UTTAR PRADESH,BASTI,2021-02-07,0,987,64,1051,0.0
UTTAR PRADESH,BASTI,2021-02-08,4,916,5,925,0.0
UTTAR PRADESH,BASTI,2021-02-09,7,1108,84,1199,0.0
UTTAR PRADESH,BASTI,2021-02-10,27,1231,61,1319,0.0
UTTAR PRADESH,BHADOHI,2021-02-06,0,1499,1,1500,0.0
UTTAR PRADESH,BHADOHI,2021-02-07,0,1487,3,1490,0.0
UTTAR PRADESH,BHADOHI,2021-02-08,0,1494,3,1497,0.0
UTTAR PRADESH,BHADOHI,2021-02-09,0,1515,3,1518,0.0
UTTAR PRADESH,BHADOHI,2021-02-10,1,1509,2,1512,0.0
UTTAR PRADESH,BIJNOR,2021-02-06,3,1479,0,1482,0.0
UTTAR PRADESH,BIJNOR,2021-02-07,0,1385,0,1385,0.0
UTTAR PRADESH,BIJNOR,2021-02-08,2,1201,0,1203,0.0
UTTAR PRADESH,BIJNOR,2021-02-09,2,1585,0,1587,0.0
UTTAR PRADESH,BIJNOR,2021-02-10,3,1636,1,1640,0.0
UTTAR PRADESH,BUDAUN,2021-02-06,0,1261,18,1279,0.0
UTTAR PRADESH,BUDAUN,2021-02-07,1,1276,15,1292,0.0
UTTAR PRADESH,BUDAUN,2021-02-08,6,2552,15,2573,0.0
UTTAR PRADESH,BUDAUN,2021-02-09,2,2108,21,2131,0.0
UTTAR PRADESH,BUDAUN,2021-02-10,2,956,7,965,0.0
UTTAR PRADESH,BULANDSHAHR,2021-02-06,0,807,1,808,0.0
UTTAR PRADESH,BULANDSHAHR,2021-02-07,2,431,1,434,0.0
UTTAR PRADESH,BULANDSHAHR,2021-02-08,4,3276,11,3291,0.0
UTTAR PRADESH,BULANDSHAHR,2021-02-09,2,1673,8,1683,0.0
UTTAR PRADESH,BULANDSHAHR,2021-02-10,0,572,33,605,0.0
UTTAR PRADESH,CHANDAULI,2021-02-06,0,1187,37,1224,0.0
UTTAR PRADESH,CHANDAULI,2021-02-07,1,1168,26,1195,0.0
UTTAR PRADESH,CHANDAULI,2021-02-08,0,1066,35,1101,0.0
UTTAR PRADESH,CHANDAULI,2021-02-09,3,1219,86,1308,0.0
UTTAR PRADESH,CHANDAULI,2021-02-10,1,1131,5,1137,0.0
UTTAR PRADESH,CHITRAKOOT,2021-02-06,1,1837,0,1838,0.0
UTTAR PRADESH,CHITRAKOOT,2021-02-07,0,582,10,592,0.0
UTTAR PRADESH,CHITRAKOOT,2021-02-08,0,1331,15,1346,0.0
UTTAR PRADESH,CHITRAKOOT,2021-02-09,0,1122,2,1124,0.0
UTTAR PRADESH,CHITRAKOOT,2021-02-10,0,1133,0,1133,0.0
UTTAR PRADESH,DEORIA,2021-02-06,1,425,39,465,0.0
UTTAR PRADESH,DEORIA,2021-02-07,3,540,43,586,0.0
UTTAR PRADESH,DEORIA,2021-02-08,3,504,24,531,0.0
UTTAR PRADESH,DEORIA,2021-02-09,0,1149,25,1174,0.0
UTTAR PRADESH,DEORIA,2021-02-10,2,1203,97,1302,0.0
UTTAR PRADESH,ETAH,2021-02-06,1,1050,0,1051,0.0
UTTAR PRADESH,ETAH,2021-02-07,0,1463,5,1468,0.0
UTTAR PRADESH,ETAH,2021-02-08,0,745,1,746,0.0
UTTAR PRADESH,ETAH,2021-02-09,0,1616,2,1618,0.0
UTTAR PRADESH,ETAH,2021-02-10,0,935,2,937,0.0
UTTAR PRADESH,ETAWAH,2021-02-06,1,1012,102,1115,0.0
UTTAR PRADESH,ETAWAH,2021-02-07,0,695,85,780,0.0
UTTAR PRADESH,ETAWAH,2021-02-08,0,1834,41,1875,0.0
UTTAR PRADESH,ETAWAH,2021-02-09,2,682,99,783,0.0
UTTAR PRADESH,ETAWAH,2021-02-10,2,2932,201,3135,0.0
UTTAR PRADESH,FARRUKHABAD,2021-02-06,0,500,41,541,0.0
UTTAR PRADESH,FARRUKHABAD,2021-02-07,1,373,54,428,0.0
UTTAR PRADESH,FARRUKHABAD,2021-02-08,0,649,40,689,0.0
UTTAR PRADESH,FARRUKHABAD,2021-02-09,1,962,70,1033,0.0
UTTAR PRADESH,FARRUKHABAD,2021-02-10,0,824,27,851,0.0
UTTAR PRADESH,FATEHPUR,2021-02-06,1,876,148,1025,0.0
UTTAR PRADESH,FATEHPUR,2021-02-07,0,820,204,1024,0.0
UTTAR PRADESH,FATEHPUR,2021-02-08,0,802,79,881,0.0
UTTAR PRADESH,FATEHPUR,2021-02-09,0,1469,37,1506,0.0
UTTAR PRADESH,FATEHPUR,2021-02-10,1,1293,193,1487,0.0
UTTAR PRADESH,FIROZABAD,2021-02-06,1,1499,2,1502,0.0
UTTAR PRADESH,FIROZABAD,2021-02-07,0,2730,7,2737,0.0
UTTAR PRADESH,FIROZABAD,2021-02-08,0,2138,0,2138,0.0
UTTAR PRADESH,FIROZABAD,2021-02-09,4,2912,6,2922,0.0
UTTAR PRADESH,FIROZABAD,2021-02-10,7,1238,41,1286,0.0
UTTAR PRADESH,GAUTAM BUDDHA NAGAR,2021-02-06,20,2870,63,2953,0.0
UTTAR PRADESH,GAUTAM BUDDHA NAGAR,2021-02-07,11,1684,67,1762,0.0
UTTAR PRADESH,GAUTAM BUDDHA NAGAR,2021-02-08,11,2361,8,2380,0.0
UTTAR PRADESH,GAUTAM BUDDHA NAGAR,2021-02-09,26,2573,85,2684,0.0
UTTAR PRADESH,GAUTAM BUDDHA NAGAR,2021-02-10,21,2811,3,2835,0.0
UTTAR PRADESH,GHAZIABAD,2021-02-06,26,2153,15,2194,0.0
UTTAR PRADESH,GHAZIABAD,2021-02-07,8,961,2,971,0.0
UTTAR PRADESH,GHAZIABAD,2021-02-08,19,3103,203,3325,0.0
UTTAR PRADESH,GHAZIABAD,2021-02-09,28,2874,10,2912,0.0
UTTAR PRADESH,GHAZIABAD,2021-02-10,20,2952,27,2999,0.0
UTTAR PRADESH,GHAZIPUR,2021-02-06,1,909,0,910,0.0
UTTAR PRADESH,GHAZIPUR,2021-02-07,1,472,10,483,0.0
UTTAR PRADESH,GHAZIPUR,2021-02-08,0,384,16,400,0.0
UTTAR PRADESH,GHAZIPUR,2021-02-09,2,999,39,1040,0.0
UTTAR PRADESH,GHAZIPUR,2021-02-10,0,1088,19,1107,0.0
UTTAR PRADESH,GONDA,2021-02-06,0,1253,0,1253,0.0
UTTAR PRADESH,GONDA,2021-02-07,0,1169,0,1169,0.0
UTTAR PRADESH,GONDA,2021-02-08,2,1204,0,1206,0.0
UTTAR PRADESH,GONDA,2021-02-09,1,1794,10,1805,0.0
UTTAR PRADESH,GONDA,2021-02-10,0,1980,1,1981,0.0
UTTAR PRADESH,GORAKHPUR,2021-02-06,3,2759,246,3008,0.0
UTTAR PRADESH,GORAKHPUR,2021-02-07,3,2546,130,2679,0.0
UTTAR PRADESH,GORAKHPUR,2021-02-08,2,1531,83,1616,0.0
UTTAR PRADESH,GORAKHPUR,2021-02-09,4,3214,104,3322,0.0
UTTAR PRADESH,GORAKHPUR,2021-02-10,0,2596,30,2626,0.0
UTTAR PRADESH,HAMIRPUR,2021-02-06,0,786,3,789,0.0
UTTAR PRADESH,HAMIRPUR,2021-02-07,3,1201,1,1205,0.0
UTTAR PRADESH,HAMIRPUR,2021-02-08,0,757,2,759,0.0
UTTAR PRADESH,HAMIRPUR,2021-02-09,0,1385,1,1386,0.0
UTTAR PRADESH,HAMIRPUR,2021-02-10,1,626,106,733,0.0
UTTAR PRADESH,HAPUR,2021-02-06,0,774,78,852,0.0
UTTAR PRADESH,HAPUR,2021-02-07,1,969,16,986,0.0
UTTAR PRADESH,HAPUR,2021-02-08,2,2328,10,2340,0.0
UTTAR PRADESH,HAPUR,2021-02-09,11,788,70,869,0.0
UTTAR PRADESH,HAPUR,2021-02-10,3,252,8,263,0.0
UTTAR PRADESH,HARDOI,2021-02-06,1,1696,7,1704,0.0
UTTAR PRADESH,HARDOI,2021-02-07,0,1117,1,1118,0.0
UTTAR PRADESH,HARDOI,2021-02-08,1,1259,5,1265,0.0
UTTAR PRADESH,HARDOI,2021-02-09,1,1675,1,1677,0.0
UTTAR PRADESH,HARDOI,2021-02-10,3,1552,72,1627,0.0
UTTAR PRADESH,HATHRAS,2021-02-06,0,1214,0,1214,0.0
UTTAR PRADESH,HATHRAS,2021-02-07,0,1069,0,1069,0.0
UTTAR PRADESH,HATHRAS,2021-02-08,0,1315,0,1315,0.0
UTTAR PRADESH,HATHRAS,2021-02-09,0,833,0,833,0.0
UTTAR PRADESH,HATHRAS,2021-02-10,0,725,0,725,0.0
UTTAR PRADESH,JALAUN,2021-02-06,1,1097,0,1098,0.0
UTTAR PRADESH,JALAUN,2021-02-07,0,658,1,659,0.0
UTTAR PRADESH,JALAUN,2021-02-08,0,978,1,979,0.0
UTTAR PRADESH,JALAUN,2021-02-09,0,1808,5,1813,0.0
UTTAR PRADESH,JALAUN,2021-02-10,0,1495,3,1498,0.0
UTTAR PRADESH,JAUNPUR,2021-02-06,2,600,70,672,0.0
UTTAR PRADESH,JAUNPUR,2021-02-07,0,1458,1,1459,0.0
UTTAR PRADESH,JAUNPUR,2021-02-08,1,896,16,913,0.0
UTTAR PRADESH,JAUNPUR,2021-02-09,2,1297,2,1301,0.0
UTTAR PRADESH,JAUNPUR,2021-02-10,0,1431,2,1433,0.0
UTTAR PRADESH,JHANSI,2021-02-06,2,2127,4,2133,0.0
UTTAR PRADESH,JHANSI,2021-02-07,1,2381,1,2383,0.0
UTTAR PRADESH,JHANSI,2021-02-08,0,2468,17,2485,0.0
UTTAR PRADESH,JHANSI,2021-02-09,4,2623,1,2628,0.0
UTTAR PRADESH,JHANSI,2021-02-10,5,2759,3,2767,0.0
UTTAR PRADESH,KANNAUJ,2021-02-06,0,1591,1,1592,0.0
UTTAR PRADESH,KANNAUJ,2021-02-07,0,1170,1,1171,0.0
UTTAR PRADESH,KANNAUJ,2021-02-08,0,1642,0,1642,0.0
UTTAR PRADESH,KANNAUJ,2021-02-09,0,2054,0,2054,0.0
UTTAR PRADESH,KANNAUJ,2021-02-10,0,1530,0,1530,0.0
UTTAR PRADESH,KANPUR DEHAT,2021-02-06,0,854,3,857,0.0
UTTAR PRADESH,KANPUR DEHAT,2021-02-07,0,848,0,848,0.0
UTTAR PRADESH,KANPUR DEHAT,2021-02-08,0,1591,3,1594,0.0
UTTAR PRADESH,KANPUR DEHAT,2021-02-09,0,1226,88,1314,0.0
UTTAR PRADESH,KANPUR DEHAT,2021-02-10,0,1100,67,1167,0.0
UTTAR PRADESH,KANPUR NAGAR,2021-02-06,8,2568,2,2578,0.0
UTTAR PRADESH,KANPUR NAGAR,2021-02-07,5,2352,9,2366,0.0
UTTAR PRADESH,KANPUR NAGAR,2021-02-08,10,2007,2,2019,0.0
UTTAR PRADESH,KANPUR NAGAR,2021-02-09,11,2800,1,2812,0.0
UTTAR PRADESH,KANPUR NAGAR,2021-02-10,5,2707,7,2719,0.0
UTTAR PRADESH,KASGANJ,2021-02-06,0,3286,3,3289,0.0
UTTAR PRADESH,KASGANJ,2021-02-07,1,959,12,972,0.0
UTTAR PRADESH,KASGANJ,2021-02-08,0,1886,4,1890,0.0
UTTAR PRADESH,KASGANJ,2021-02-09,0,2405,14,2419,0.0
UTTAR PRADESH,KASGANJ,2021-02-10,1,1455,6,1462,0.0
UTTAR PRADESH,KAUSHAMBI,2021-02-06,0,1399,0,1399,0.0
UTTAR PRADESH,KAUSHAMBI,2021-02-07,0,3577,0,3577,0.0
UTTAR PRADESH,KAUSHAMBI,2021-02-08,0,1316,0,1316,0.0
UTTAR PRADESH,KAUSHAMBI,2021-02-09,0,1231,0,1231,0.0
UTTAR PRADESH,KAUSHAMBI,2021-02-10,0,1317,0,1317,0.0
UTTAR PRADESH,KHERI,2021-02-06,0,1606,69,1675,0.0
UTTAR PRADESH,KHERI,2021-02-07,1,1100,25,1126,0.0
UTTAR PRADESH,KHERI,2021-02-08,0,1511,7,1518,0.0
UTTAR PRADESH,KHERI,2021-02-09,1,1953,27,1981,0.0
UTTAR PRADESH,KHERI,2021-02-10,0,1797,6,1803,0.0
UTTAR PRADESH,KUSHI NAGAR,2021-02-06,0,852,59,911,0.0
UTTAR PRADESH,KUSHI NAGAR,2021-02-07,0,717,68,785,0.0
UTTAR PRADESH,KUSHI NAGAR,2021-02-08,1,901,3,905,0.0
UTTAR PRADESH,KUSHI NAGAR,2021-02-09,1,1139,2,1142,0.0
UTTAR PRADESH,KUSHI NAGAR,2021-02-10,3,954,13,970,0.0
UTTAR PRADESH,LALITPUR,2021-02-06,2,1512,9,1523,0.0
UTTAR PRADESH,LALITPUR,2021-02-07,0,544,0,544,0.0
UTTAR PRADESH,LALITPUR,2021-02-08,2,2058,15,2075,0.0
UTTAR PRADESH,LALITPUR,2021-02-09,2,1090,3,1095,0.0
UTTAR PRADESH,LALITPUR,2021-02-10,2,1867,4,1873,0.0
UTTAR PRADESH,LUCKNOW,2021-02-06,28,6097,135,6260,0.0
UTTAR PRADESH,LUCKNOW,2021-02-07,20,5814,154,5988,0.0
UTTAR PRADESH,LUCKNOW,2021-02-08,21,5590,157,5768,0.0
UTTAR PRADESH,LUCKNOW,2021-02-09,29,7144,68,7241,0.0
UTTAR PRADESH,LUCKNOW,2021-02-10,38,6822,157,7017,0.0
UTTAR PRADESH,MAHARAJGANJ,2021-02-06,1,1491,25,1517,0.0
UTTAR PRADESH,MAHARAJGANJ,2021-02-07,0,749,83,832,0.0
UTTAR PRADESH,MAHARAJGANJ,2021-02-08,0,430,0,430,0.0
UTTAR PRADESH,MAHARAJGANJ,2021-02-09,0,1236,124,1360,0.0
UTTAR PRADESH,MAHARAJGANJ,2021-02-10,0,1230,82,1312,0.0
UTTAR PRADESH,MAHOBA,2021-02-06,0,1338,10,1348,0.0
UTTAR PRADESH,MAHOBA,2021-02-07,0,454,90,544,0.0
UTTAR PRADESH,MAHOBA,2021-02-08,0,365,39,404,0.0
UTTAR PRADESH,MAHOBA,2021-02-09,0,768,14,782,0.0
UTTAR PRADESH,MAHOBA,2021-02-10,0,680,26,706,0.0
UTTAR PRADESH,MAINPURI,2021-02-06,1,1669,0,1670,0.0
UTTAR PRADESH,MAINPURI,2021-02-07,1,1326,0,1327,0.0
UTTAR PRADESH,MAINPURI,2021-02-08,2,1526,0,1528,0.0
UTTAR PRADESH,MAINPURI,2021-02-09,1,1694,1,1696,0.0
UTTAR PRADESH,MAINPURI,2021-02-10,5,1767,0,1772,0.0
UTTAR PRADESH,MATHURA,2021-02-06,2,1631,2,1635,0.0
UTTAR PRADESH,MATHURA,2021-02-07,0,1992,2,1994,0.0
UTTAR PRADESH,MATHURA,2021-02-08,1,1310,0,1311,0.0
UTTAR PRADESH,MATHURA,2021-02-09,1,1727,6,1734,0.0
UTTAR PRADESH,MATHURA,2021-02-10,2,2382,6,2390,0.0
UTTAR PRADESH,MAU,2021-02-06,0,849,4,853,0.0
UTTAR PRADESH,MAU,2021-02-07,0,1500,17,1517,0.0
UTTAR PRADESH,MAU,2021-02-08,1,1070,4,1075,0.0
UTTAR PRADESH,MAU,2021-02-09,1,1281,2,1284,0.0
UTTAR PRADESH,MAU,2021-02-10,0,1217,6,1223,0.0
UTTAR PRADESH,MEERUT,2021-02-06,3,3817,105,3925,0.0
UTTAR PRADESH,MEERUT,2021-02-07,6,3134,0,3140,0.0
UTTAR PRADESH,MEERUT,2021-02-08,24,2721,11,2756,0.0
UTTAR PRADESH,MEERUT,2021-02-09,20,3339,44,3403,0.0
UTTAR PRADESH,MEERUT,2021-02-10,5,4175,28,4208,0.0
UTTAR PRADESH,MIRZAPUR,2021-02-06,0,1483,0,1483,0.0
UTTAR PRADESH,MIRZAPUR,2021-02-07,0,2154,0,2154,0.0
UTTAR PRADESH,MIRZAPUR,2021-02-08,1,1445,9,1455,0.0
UTTAR PRADESH,MIRZAPUR,2021-02-09,4,1541,3,1548,0.0
UTTAR PRADESH,MIRZAPUR,2021-02-10,1,1455,0,1456,0.0
UTTAR PRADESH,MORADABAD,2021-02-06,1,1401,0,1402,0.0
UTTAR PRADESH,MORADABAD,2021-02-07,1,2872,1,2874,0.0
UTTAR PRADESH,MORADABAD,2021-02-08,6,2116,1,2123,0.0
UTTAR PRADESH,MORADABAD,2021-02-09,3,1263,0,1266,0.0
UTTAR PRADESH,MORADABAD,2021-02-10,4,3137,12,3153,0.0
UTTAR PRADESH,MUZAFFARNAGAR,2021-02-06,7,1522,2,1531,0.0
UTTAR PRADESH,MUZAFFARNAGAR,2021-02-07,2,901,0,903,0.0
UTTAR PRADESH,MUZAFFARNAGAR,2021-02-08,9,802,3,814,0.0
UTTAR PRADESH,MUZAFFARNAGAR,2021-02-09,5,1987,2,1994,0.0
UTTAR PRADESH,MUZAFFARNAGAR,2021-02-10,3,1632,0,1635,0.0
UTTAR PRADESH,PILIBHIT,2021-02-06,1,1681,0,1682,0.0
UTTAR PRADESH,PILIBHIT,2021-02-07,0,1017,4,1021,0.0
UTTAR PRADESH,PILIBHIT,2021-02-08,1,1606,0,1607,0.0
UTTAR PRADESH,PILIBHIT,2021-02-09,1,1546,62,1609,0.0
UTTAR PRADESH,PILIBHIT,2021-02-10,0,1339,44,1383,0.0
UTTAR PRADESH,PRATAPGARH,2021-02-06,1,1357,123,1481,0.0
UTTAR PRADESH,PRATAPGARH,2021-02-07,0,1678,16,1694,0.0
UTTAR PRADESH,PRATAPGARH,2021-02-08,0,1506,150,1656,0.0
UTTAR PRADESH,PRATAPGARH,2021-02-09,1,3737,59,3797,0.0
UTTAR PRADESH,PRATAPGARH,2021-02-10,1,1896,95,1992,0.0
UTTAR PRADESH,PRAYAGRAJ,2021-02-06,10,3251,4,3265,0.0
UTTAR PRADESH,PRAYAGRAJ,2021-02-07,1,2361,1,2363,0.0
UTTAR PRADESH,PRAYAGRAJ,2021-02-08,6,5472,31,5509,0.0
UTTAR PRADESH,PRAYAGRAJ,2021-02-09,3,4651,4,4658,0.0
UTTAR PRADESH,PRAYAGRAJ,2021-02-10,7,4582,0,4589,0.0
UTTAR PRADESH,RAE BARELI,2021-02-06,1,2306,24,2331,0.0
UTTAR PRADESH,RAE BARELI,2021-02-07,0,1674,0,1674,0.0
UTTAR PRADESH,RAE BARELI,2021-02-08,3,1841,8,1852,0.0
UTTAR PRADESH,RAE BARELI,2021-02-09,1,2083,0,2084,0.0
UTTAR PRADESH,RAE BARELI,2021-02-10,1,1848,8,1857,0.0
UTTAR PRADESH,RAMPUR,2021-02-06,1,1375,0,1376,0.0
UTTAR PRADESH,RAMPUR,2021-02-07,0,1417,11,1428,0.0
UTTAR PRADESH,RAMPUR,2021-02-08,0,1447,19,1466,0.0
UTTAR PRADESH,RAMPUR,2021-02-09,1,1470,12,1483,0.0
UTTAR PRADESH,RAMPUR,2021-02-10,1,1506,10,1517,0.0
UTTAR PRADESH,SAHARANPUR,2021-02-06,4,3097,10,3111,0.0
UTTAR PRADESH,SAHARANPUR,2021-02-07,3,2528,36,2567,0.0
UTTAR PRADESH,SAHARANPUR,2021-02-08,3,2266,73,2342,0.0
UTTAR PRADESH,SAHARANPUR,2021-02-09,5,2832,37,2874,0.0
UTTAR PRADESH,SAHARANPUR,2021-02-10,3,2916,11,2930,0.0
UTTAR PRADESH,SAMBHAL,2021-02-06,1,1559,0,1560,0.0
UTTAR PRADESH,SAMBHAL,2021-02-07,0,1508,80,1588,0.0
UTTAR PRADESH,SAMBHAL,2021-02-08,0,1186,61,1247,0.0
UTTAR PRADESH,SAMBHAL,2021-02-09,0,1725,111,1836,0.0
UTTAR PRADESH,SAMBHAL,2021-02-10,0,1374,10,1384,0.0
UTTAR PRADESH,SANT KABEER NAGAR,2021-02-06,0,1441,0,1441,0.0
UTTAR PRADESH,SANT KABEER NAGAR,2021-02-07,1,1354,0,1355,0.0
UTTAR PRADESH,SANT KABEER NAGAR,2021-02-08,0,1408,0,1408,0.0
UTTAR PRADESH,SANT KABEER NAGAR,2021-02-09,0,1165,0,1165,0.0
UTTAR PRADESH,SANT KABEER NAGAR,2021-02-10,6,955,0,961,0.0
UTTAR PRADESH,SHAHJAHANPUR,2021-02-06,3,1109,30,1142,0.0
UTTAR PRADESH,SHAHJAHANPUR,2021-02-07,1,1279,3,1283,0.0
UTTAR PRADESH,SHAHJAHANPUR,2021-02-08,4,2067,0,2071,0.0
UTTAR PRADESH,SHAHJAHANPUR,2021-02-09,0,1418,10,1428,0.0
UTTAR PRADESH,SHAHJAHANPUR,2021-02-10,0,1137,1,1138,0.0
UTTAR PRADESH,SHAMLI,2021-02-06,1,866,0,867,0.0
UTTAR PRADESH,SHAMLI,2021-02-07,0,1115,0,1115,0.0
UTTAR PRADESH,SHAMLI,2021-02-08,0,890,0,890,0.0
UTTAR PRADESH,SHAMLI,2021-02-09,1,1217,0,1218,0.0
UTTAR PRADESH,SHAMLI,2021-02-10,0,1227,7,1234,0.0
UTTAR PRADESH,SHRAVASTI,2021-02-06,0,800,33,833,0.0
UTTAR PRADESH,SHRAVASTI,2021-02-07,0,725,0,725,0.0
UTTAR PRADESH,SHRAVASTI,2021-02-08,0,639,0,639,0.0
UTTAR PRADESH,SHRAVASTI,2021-02-09,1,854,0,855,0.0
UTTAR PRADESH,SHRAVASTI,2021-02-10,0,763,0,763,0.0
UTTAR PRADESH,SIDDHARTH NAGAR,2021-02-06,0,1354,0,1354,0.0
UTTAR PRADESH,SIDDHARTH NAGAR,2021-02-07,0,622,54,676,0.0
UTTAR PRADESH,SIDDHARTH NAGAR,2021-02-08,0,629,0,629,0.0
UTTAR PRADESH,SIDDHARTH NAGAR,2021-02-09,0,1040,0,1040,0.0
UTTAR PRADESH,SIDDHARTH NAGAR,2021-02-10,1,1280,66,1347,0.0
UTTAR PRADESH,SITAPUR,2021-02-06,0,1385,19,1404,0.0
UTTAR PRADESH,SITAPUR,2021-02-07,1,1183,33,1217,0.0
UTTAR PRADESH,SITAPUR,2021-02-08,1,1261,8,1270,0.0
UTTAR PRADESH,SITAPUR,2021-02-09,2,1269,25,1296,0.0
UTTAR PRADESH,SITAPUR,2021-02-10,0,1801,39,1840,0.0
UTTAR PRADESH,SONBHADRA,2021-02-06,2,1924,15,1941,0.0
UTTAR PRADESH,SONBHADRA,2021-02-07,0,1330,1,1331,0.0
UTTAR PRADESH,SONBHADRA,2021-02-08,6,1028,8,1042,0.0
UTTAR PRADESH,SONBHADRA,2021-02-09,1,1257,5,1263,0.0
UTTAR PRADESH,SONBHADRA,2021-02-10,3,1825,0,1828,0.0
UTTAR PRADESH,SULTANPUR,2021-02-06,4,736,4,744,0.0
UTTAR PRADESH,SULTANPUR,2021-02-07,1,760,9,770,0.0
UTTAR PRADESH,SULTANPUR,2021-02-08,2,159,1,162,0.0
UTTAR PRADESH,SULTANPUR,2021-02-09,2,906,4,912,0.0
UTTAR PRADESH,SULTANPUR,2021-02-10,0,834,3,837,0.0
UTTAR PRADESH,UNNAO,2021-02-06,0,1692,26,1718,0.0
UTTAR PRADESH,UNNAO,2021-02-07,2,858,33,893,0.0
UTTAR PRADESH,UNNAO,2021-02-08,1,2797,85,2883,0.0
UTTAR PRADESH,UNNAO,2021-02-09,0,2056,46,2102,0.0
UTTAR PRADESH,UNNAO,2021-02-10,0,1884,6,1890,0.0
UTTAR PRADESH,VARANASI,2021-02-06,13,2515,75,2603,0.0
UTTAR PRADESH,VARANASI,2021-02-07,4,2438,91,2533,0.0
UTTAR PRADESH,VARANASI,2021-02-08,9,1994,143,2146,0.0
UTTAR PRADESH,VARANASI,2021-02-09,5,2879,86,2970,0.0
UTTAR PRADESH,VARANASI,2021-02-10,4,2626,33,2663,0.0
UTTARAKHAND,ALMORA,2021-02-06,0,139,0,139,0.0
UTTARAKHAND,ALMORA,2021-02-07,0,10,0,10,0.0
UTTARAKHAND,ALMORA,2021-02-08,0,138,0,138,0.0
UTTARAKHAND,ALMORA,2021-02-09,0,139,0,139,0.0
UTTARAKHAND,ALMORA,2021-02-10,2,177,0,179,0.0
UTTARAKHAND,BAGESHWAR,2021-02-06,0,155,0,155,0.0
UTTARAKHAND,BAGESHWAR,2021-02-07,0,5,0,5,0.0
UTTARAKHAND,BAGESHWAR,2021-02-08,2,34,0,36,0.0
UTTARAKHAND,BAGESHWAR,2021-02-09,0,223,0,223,0.0
UTTARAKHAND,BAGESHWAR,2021-02-10,1,238,0,239,0.0
UTTARAKHAND,CHAMOLI,2021-02-06,0,168,11,179,0.0
UTTARAKHAND,CHAMOLI,2021-02-07,0,171,0,171,0.0
UTTARAKHAND,CHAMOLI,2021-02-08,0,24,0,24,0.0
UTTARAKHAND,CHAMOLI,2021-02-09,7,134,0,141,0.0
UTTARAKHAND,CHAMOLI,2021-02-10,2,62,0,64,0.0
UTTARAKHAND,CHAMPAWAT,2021-02-06,0,169,2,171,0.0
UTTARAKHAND,CHAMPAWAT,2021-02-07,0,18,0,18,0.0
UTTARAKHAND,CHAMPAWAT,2021-02-08,1,115,0,116,0.0
UTTARAKHAND,CHAMPAWAT,2021-02-09,0,182,0,182,0.0
UTTARAKHAND,CHAMPAWAT,2021-02-10,0,78,0,78,0.0
UTTARAKHAND,DEHRADUN,2021-02-06,11,1229,3,1243,0.0
UTTARAKHAND,DEHRADUN,2021-02-07,21,994,5,1020,0.0
UTTARAKHAND,DEHRADUN,2021-02-08,32,1856,3,1891,0.0
UTTARAKHAND,DEHRADUN,2021-02-09,25,1512,3,1540,0.0
UTTARAKHAND,DEHRADUN,2021-02-10,16,1779,1,1796,0.0
UTTARAKHAND,HARIDWAR,2021-02-06,11,3171,15,3197,0.0
UTTARAKHAND,HARIDWAR,2021-02-07,11,1144,4,1159,0.0
UTTARAKHAND,HARIDWAR,2021-02-08,6,1010,0,1016,0.0
UTTARAKHAND,HARIDWAR,2021-02-09,3,1854,1,1858,0.0
UTTARAKHAND,HARIDWAR,2021-02-10,6,2427,9,2442,0.0
UTTARAKHAND,NAINITAL,2021-02-06,3,1236,1,1240,0.0
UTTARAKHAND,NAINITAL,2021-02-07,6,446,0,452,0.0
UTTARAKHAND,NAINITAL,2021-02-08,19,578,3,600,0.0
UTTARAKHAND,NAINITAL,2021-02-09,1,984,1,986,0.0
UTTARAKHAND,NAINITAL,2021-02-10,10,773,1,784,0.0
UTTARAKHAND,PAURI GARHWAL,2021-02-06,4,573,15,592,0.0
UTTARAKHAND,PAURI GARHWAL,2021-02-07,3,370,41,414,0.0
UTTARAKHAND,PAURI GARHWAL,2021-02-08,1,381,2,384,0.0
UTTARAKHAND,PAURI GARHWAL,2021-02-09,2,433,12,447,0.0
UTTARAKHAND,PAURI GARHWAL,2021-02-10,0,440,2,442,0.0
UTTARAKHAND,PITHORAGARH,2021-02-06,0,248,0,248,0.0
UTTARAKHAND,PITHORAGARH,2021-02-07,0,7,0,7,0.0
UTTARAKHAND,PITHORAGARH,2021-02-08,0,257,0,257,0.0
UTTARAKHAND,PITHORAGARH,2021-02-09,0,190,0,190,0.0
UTTARAKHAND,PITHORAGARH,2021-02-10,0,214,0,214,0.0
UTTARAKHAND,RUDRA PRAYAG,2021-02-06,0,43,2,45,0.0
UTTARAKHAND,RUDRA PRAYAG,2021-02-07,1,47,2,50,0.0
UTTARAKHAND,RUDRA PRAYAG,2021-02-08,0,42,0,42,0.0
UTTARAKHAND,RUDRA PRAYAG,2021-02-09,0,76,2,78,0.0
UTTARAKHAND,RUDRA PRAYAG,2021-02-10,0,107,7,114,0.0
UTTARAKHAND,TEHRI GARHWAL,2021-02-06,1,100,2,103,0.0
UTTARAKHAND,TEHRI GARHWAL,2021-02-07,3,252,3,258,0.0
UTTARAKHAND,TEHRI GARHWAL,2021-02-08,0,116,0,116,0.0
UTTARAKHAND,TEHRI GARHWAL,2021-02-09,0,308,1,309,0.0
UTTARAKHAND,TEHRI GARHWAL,2021-02-10,2,302,0,304,0.0
UTTARAKHAND,UDAM SINGH NAGAR,2021-02-06,2,1168,228,1398,0.0
UTTARAKHAND,UDAM SINGH NAGAR,2021-02-07,2,853,23,878,0.0
UTTARAKHAND,UDAM SINGH NAGAR,2021-02-08,1,870,191,1062,0.0
UTTARAKHAND,UDAM SINGH NAGAR,2021-02-09,9,1389,49,1447,0.0
UTTARAKHAND,UDAM SINGH NAGAR,2021-02-10,1,987,100,1088,0.0
UTTARAKHAND,UTTAR KASHI,2021-02-06,0,186,2,188,0.0
UTTARAKHAND,UTTAR KASHI,2021-02-07,0,181,0,181,0.0
UTTARAKHAND,UTTAR KASHI,2021-02-08,0,261,4,265,0.0
UTTARAKHAND,UTTAR KASHI,2021-02-09,0,205,0,205,0.0
UTTARAKHAND,UTTAR KASHI,2021-02-10,0,173,1,174,0.0
WEST BENGAL,24 PARAGANAS NORTH,2021-02-06,44,3948,20,4012,0.0
WEST BENGAL,24 PARAGANAS NORTH,2021-02-07,38,2374,17,2429,0.0
WEST BENGAL,24 PARAGANAS NORTH,2021-02-08,27,2768,17,2812,0.0
WEST BENGAL,24 PARAGANAS NORTH,2021-02-09,60,3425,42,3527,0.0
WEST BENGAL,24 PARAGANAS NORTH,2021-02-10,66,3529,7,3602,0.0
WEST BENGAL,24 PARAGANAS SOUTH,2021-02-06,8,2919,2,2929,0.0
WEST BENGAL,24 PARAGANAS SOUTH,2021-02-07,3,3094,8,3105,0.0
WEST BENGAL,24 PARAGANAS SOUTH,2021-02-08,8,2830,2,2840,0.0
WEST BENGAL,24 PARAGANAS SOUTH,2021-02-09,8,3031,13,3052,0.0
WEST BENGAL,24 PARAGANAS SOUTH,2021-02-10,6,2894,6,2906,0.0
WEST BENGAL,ALIPURDUAR,2021-02-06,0,442,9,451,0.0
WEST BENGAL,ALIPURDUAR,2021-02-07,0,363,36,399,0.0
WEST BENGAL,ALIPURDUAR,2021-02-08,1,453,0,454,0.0
WEST BENGAL,ALIPURDUAR,2021-02-09,0,113,0,113,0.0
WEST BENGAL,ALIPURDUAR,2021-02-10,0,143,0,143,0.0
WEST BENGAL,BANKURA,2021-02-06,5,420,0,425,0.0
WEST BENGAL,BANKURA,2021-02-07,3,377,0,380,0.0
WEST BENGAL,BANKURA,2021-02-08,4,333,4,341,0.0
WEST BENGAL,BANKURA,2021-02-09,4,485,3,492,0.0
WEST BENGAL,BANKURA,2021-02-10,5,624,1,630,0.0
WEST BENGAL,BIRBHUM,2021-02-06,4,721,4,729,0.0
WEST BENGAL,BIRBHUM,2021-02-07,2,499,4,505,0.0
WEST BENGAL,BIRBHUM,2021-02-08,4,722,6,732,0.0
WEST BENGAL,BIRBHUM,2021-02-09,2,886,6,894,0.0
WEST BENGAL,BIRBHUM,2021-02-10,1,990,8,999,0.0
WEST BENGAL,COOCHBEHAR,2021-02-06,0,1604,0,1604,0.0
WEST BENGAL,COOCHBEHAR,2021-02-07,2,1513,0,1515,0.0
WEST BENGAL,COOCHBEHAR,2021-02-08,0,1521,0,1521,0.0
WEST BENGAL,COOCHBEHAR,2021-02-09,1,929,0,930,0.0
WEST BENGAL,COOCHBEHAR,2021-02-10,1,1035,0,1036,0.0
WEST BENGAL,DARJEELING,2021-02-06,7,755,4,766,0.0
WEST BENGAL,DARJEELING,2021-02-07,4,299,1,304,0.0
WEST BENGAL,DARJEELING,2021-02-08,12,416,0,428,0.0
WEST BENGAL,DARJEELING,2021-02-09,8,570,0,578,0.0
WEST BENGAL,DARJEELING,2021-02-10,8,717,8,733,0.0
WEST BENGAL,DINAJPUR DAKSHIN,2021-02-06,0,716,0,716,0.0
WEST BENGAL,DINAJPUR DAKSHIN,2021-02-07,5,814,7,826,0.0
WEST BENGAL,DINAJPUR DAKSHIN,2021-02-08,1,570,7,578,0.0
WEST BENGAL,DINAJPUR DAKSHIN,2021-02-09,1,689,2,692,0.0
WEST BENGAL,DINAJPUR DAKSHIN,2021-02-10,2,684,0,686,0.0
WEST BENGAL,DINAJPUR UTTAR,2021-02-06,2,213,0,215,0.0
WEST BENGAL,DINAJPUR UTTAR,2021-02-07,3,235,0,238,0.0
WEST BENGAL,DINAJPUR UTTAR,2021-02-08,1,205,0,206,0.0
WEST BENGAL,DINAJPUR UTTAR,2021-02-09,3,454,3,460,0.0
WEST BENGAL,DINAJPUR UTTAR,2021-02-10,1,194,0,195,0.0
WEST BENGAL,HOOGHLY,2021-02-06,13,761,16,790,0.0
WEST BENGAL,HOOGHLY,2021-02-07,4,356,1,361,0.0
WEST BENGAL,HOOGHLY,2021-02-08,8,818,53,879,0.0
WEST BENGAL,HOOGHLY,2021-02-09,13,717,9,739,0.0
WEST BENGAL,HOOGHLY,2021-02-10,14,517,26,557,0.0
WEST BENGAL,HOWRAH,2021-02-06,12,864,91,967,0.0
WEST BENGAL,HOWRAH,2021-02-07,3,794,50,847,0.0
WEST BENGAL,HOWRAH,2021-02-08,12,1034,148,1194,0.0
WEST BENGAL,HOWRAH,2021-02-09,8,1110,72,1190,0.0
WEST BENGAL,HOWRAH,2021-02-10,5,979,85,1069,0.0
WEST BENGAL,JALPAIGURI,2021-02-06,9,480,0,489,0.0
WEST BENGAL,JALPAIGURI,2021-02-07,0,71,0,71,0.0
WEST BENGAL,JALPAIGURI,2021-02-08,1,482,0,483,0.0
WEST BENGAL,JALPAIGURI,2021-02-09,2,384,0,386,0.0
WEST BENGAL,JALPAIGURI,2021-02-10,3,218,0,221,0.0
WEST BENGAL,JHARGRAM,2021-02-06,0,16,0,16,0.0
WEST BENGAL,JHARGRAM,2021-02-07,0,6,0,6,0.0
WEST BENGAL,JHARGRAM,2021-02-08,0,95,0,95,0.0
WEST BENGAL,JHARGRAM,2021-02-09,0,33,0,33,0.0
WEST BENGAL,JHARGRAM,2021-02-10,0,39,1,40,0.0
WEST BENGAL,KALIMPONG,2021-02-06,1,82,0,83,0.0
WEST BENGAL,KALIMPONG,2021-02-07,1,149,0,150,0.0
WEST BENGAL,KALIMPONG,2021-02-08,0,143,0,143,0.0
WEST BENGAL,KALIMPONG,2021-02-09,0,37,0,37,0.0
WEST BENGAL,KALIMPONG,2021-02-10,0,109,0,109,0.0
WEST BENGAL,KOLKATA,2021-02-06,73,2805,14,2892,0.0
WEST BENGAL,KOLKATA,2021-02-07,47,1856,11,1914,0.0
WEST BENGAL,KOLKATA,2021-02-08,63,2790,20,2873,0.0
WEST BENGAL,KOLKATA,2021-02-09,68,2739,35,2842,0.0
WEST BENGAL,KOLKATA,2021-02-10,93,3126,8,3227,0.0
WEST BENGAL,MALDAH,2021-02-06,2,325,0,327,0.0
WEST BENGAL,MALDAH,2021-02-07,1,64,12,77,0.0
WEST BENGAL,MALDAH,2021-02-08,1,674,4,679,0.0
WEST BENGAL,MALDAH,2021-02-09,0,698,0,698,0.0
WEST BENGAL,MALDAH,2021-02-10,0,441,2,443,0.0
WEST BENGAL,MEDINIPUR EAST,2021-02-06,8,833,3,844,0.0
WEST BENGAL,MEDINIPUR EAST,2021-02-07,4,563,7,574,0.0
WEST BENGAL,MEDINIPUR EAST,2021-02-08,2,696,0,698,0.0
WEST BENGAL,MEDINIPUR EAST,2021-02-09,2,737,12,751,0.0
WEST BENGAL,MEDINIPUR EAST,2021-02-10,4,821,1,826,0.0
WEST BENGAL,MEDINIPUR WEST,2021-02-06,3,354,1,358,0.0
WEST BENGAL,MEDINIPUR WEST,2021-02-07,5,330,5,340,0.0
WEST BENGAL,MEDINIPUR WEST,2021-02-08,1,400,0,401,0.0
WEST BENGAL,MEDINIPUR WEST,2021-02-09,1,278,12,291,0.0
WEST BENGAL,MEDINIPUR WEST,2021-02-10,8,377,1,386,0.0
WEST BENGAL,MURSHIDABAD,2021-02-06,0,1474,1,1475,0.0
WEST BENGAL,MURSHIDABAD,2021-02-07,0,1087,3,1090,0.0
WEST BENGAL,MURSHIDABAD,2021-02-08,2,983,1,986,0.0
WEST BENGAL,MURSHIDABAD,2021-02-09,2,1512,4,1518,0.0
WEST BENGAL,MURSHIDABAD,2021-02-10,1,934,20,955,0.0
WEST BENGAL,NADIA,2021-02-06,8,723,11,742,0.0
WEST BENGAL,NADIA,2021-02-07,4,451,8,463,0.0
WEST BENGAL,NADIA,2021-02-08,5,522,12,539,0.0
WEST BENGAL,NADIA,2021-02-09,9,518,26,553,0.0
WEST BENGAL,NADIA,2021-02-10,2,589,14,605,0.0
WEST BENGAL,PASCHIM BARDHAMAN,2021-02-06,9,650,3,662,0.0
WEST BENGAL,PASCHIM BARDHAMAN,2021-02-07,1,664,0,665,0.0
WEST BENGAL,PASCHIM BARDHAMAN,2021-02-08,7,442,2,451,0.0
WEST BENGAL,PASCHIM BARDHAMAN,2021-02-09,7,613,1,621,0.0
WEST BENGAL,PASCHIM BARDHAMAN,2021-02-10,5,888,5,898,0.0
WEST BENGAL,PURBA BARDHAMAN,2021-02-06,3,784,1,788,0.0
WEST BENGAL,PURBA BARDHAMAN,2021-02-07,6,583,0,589,0.0
WEST BENGAL,PURBA BARDHAMAN,2021-02-08,1,983,0,984,0.0
WEST BENGAL,PURBA BARDHAMAN,2021-02-09,4,847,0,851,0.0
WEST BENGAL,PURBA BARDHAMAN,2021-02-10,4,885,1,890,0.0
WEST BENGAL,PURULIA,2021-02-06,1,422,0,423,0.0
WEST BENGAL,PURULIA,2021-02-07,0,263,1,264,0.0
WEST BENGAL,PURULIA,2021-02-08,2,316,0,318,0.0
WEST BENGAL,PURULIA,2021-02-09,5,412,0,417,0.0
WEST BENGAL,PURULIA,2021-02-10,2,800,0,802,0.0
ANDAMAN AND NICOBAR ISLANDS,NICOBARS,2021-02-11,0,9,0,9,
ANDAMAN AND NICOBAR ISLANDS,NICOBARS,2021-02-12,0,25,1,26,
ANDAMAN AND NICOBAR ISLANDS,NICOBARS,2021-02-13,0,17,0,17,
ANDAMAN AND NICOBAR ISLANDS,NICOBARS,2021-02-14,0,4,0,4,
ANDAMAN AND NICOBAR ISLANDS,NICOBARS,2021-02-15,0,5,0,5,
ANDAMAN AND NICOBAR ISLANDS,NORTH AND MIDDLE ANDAMAN,2021-02-11,1,10,0,11,
ANDAMAN AND NICOBAR ISLANDS,NORTH AND MIDDLE ANDAMAN,2021-02-12,0,14,1,15,
ANDAMAN AND NICOBAR ISLANDS,NORTH AND MIDDLE ANDAMAN,2021-02-13,0,6,0,6,
ANDAMAN AND NICOBAR ISLANDS,NORTH AND MIDDLE ANDAMAN,2021-02-14,0,12,0,12,
ANDAMAN AND NICOBAR ISLANDS,NORTH AND MIDDLE ANDAMAN,2021-02-15,0,29,0,29,
ANDAMAN AND NICOBAR ISLANDS,SOUTH ANDAMANS,2021-02-11,15,733,1,749,
ANDAMAN AND NICOBAR ISLANDS,SOUTH ANDAMANS,2021-02-12,1,447,1,449,
ANDAMAN AND NICOBAR ISLANDS,SOUTH ANDAMANS,2021-02-13,10,340,0,350,
ANDAMAN AND NICOBAR ISLANDS,SOUTH ANDAMANS,2021-02-14,2,84,0,86,
ANDAMAN AND NICOBAR ISLANDS,SOUTH ANDAMANS,2021-02-15,1,803,0,804,
ANDHRA PRADESH,ANANTAPUR,2021-02-11,7,3615,1,3623,
ANDHRA PRADESH,ANANTAPUR,2021-02-12,2,2070,0,2072,
ANDHRA PRADESH,ANANTAPUR,2021-02-13,0,43,1,44,
ANDHRA PRADESH,ANANTAPUR,2021-02-14,1,27,1,29,
ANDHRA PRADESH,ANANTAPUR,2021-02-15,0,27,0,27,
ANDHRA PRADESH,CHITTOOR,2021-02-11,26,3223,0,3249,
ANDHRA PRADESH,CHITTOOR,2021-02-12,6,2331,0,2337,
ANDHRA PRADESH,CHITTOOR,2021-02-13,1,66,1,68,
ANDHRA PRADESH,CHITTOOR,2021-02-14,0,30,0,30,
ANDHRA PRADESH,CHITTOOR,2021-02-15,1,91,0,92,
ANDHRA PRADESH,EAST GODAVARI,2021-02-11,7,3229,0,3236,
ANDHRA PRADESH,EAST GODAVARI,2021-02-12,7,2958,0,2965,
ANDHRA PRADESH,EAST GODAVARI,2021-02-13,0,10,0,10,
ANDHRA PRADESH,EAST GODAVARI,2021-02-14,0,17,0,17,
ANDHRA PRADESH,EAST GODAVARI,2021-02-15,0,16,0,16,
ANDHRA PRADESH,GUNTUR,2021-02-11,9,1328,0,1337,
ANDHRA PRADESH,GUNTUR,2021-02-12,1,938,0,939,
ANDHRA PRADESH,GUNTUR,2021-02-13,0,11,0,11,
ANDHRA PRADESH,GUNTUR,2021-02-14,0,3,0,3,
ANDHRA PRADESH,GUNTUR,2021-02-15,0,15,0,15,
ANDHRA PRADESH,KRISHNA,2021-02-11,9,750,0,759,
ANDHRA PRADESH,KRISHNA,2021-02-12,6,597,0,603,
ANDHRA PRADESH,KRISHNA,2021-02-13,0,4,0,4,
ANDHRA PRADESH,KRISHNA,2021-02-14,0,8,0,8,
ANDHRA PRADESH,KRISHNA,2021-02-15,0,15,0,15,
ANDHRA PRADESH,KURNOOL,2021-02-11,3,1918,0,1921,
ANDHRA PRADESH,KURNOOL,2021-02-12,1,1700,0,1701,
ANDHRA PRADESH,KURNOOL,2021-02-13,1,6,0,7,
ANDHRA PRADESH,KURNOOL,2021-02-14,0,6,0,6,
ANDHRA PRADESH,KURNOOL,2021-02-15,0,7,0,7,
ANDHRA PRADESH,PRAKASAM,2021-02-11,8,4614,0,4622,
ANDHRA PRADESH,PRAKASAM,2021-02-12,2,2426,0,2428,
ANDHRA PRADESH,PRAKASAM,2021-02-13,0,7,0,7,
ANDHRA PRADESH,PRAKASAM,2021-02-14,0,1,0,1,
ANDHRA PRADESH,PRAKASAM,2021-02-15,0,6,0,6,
ANDHRA PRADESH,SPSR NELLORE,2021-02-11,9,2153,0,2162,
ANDHRA PRADESH,SPSR NELLORE,2021-02-12,0,2915,0,2915,
ANDHRA PRADESH,SPSR NELLORE,2021-02-13,0,13,0,13,
ANDHRA PRADESH,SPSR NELLORE,2021-02-14,0,6,0,6,
ANDHRA PRADESH,SPSR NELLORE,2021-02-15,1,20,0,21,
ANDHRA PRADESH,SRIKAKULAM,2021-02-11,3,1858,0,1861,
ANDHRA PRADESH,SRIKAKULAM,2021-02-12,2,1508,0,1510,
ANDHRA PRADESH,SRIKAKULAM,2021-02-13,0,9,0,9,
ANDHRA PRADESH,SRIKAKULAM,2021-02-14,0,5,0,5,
ANDHRA PRADESH,SRIKAKULAM,2021-02-15,0,12,0,12,
ANDHRA PRADESH,VISAKHAPATANAM,2021-02-11,25,1952,0,1977,
ANDHRA PRADESH,VISAKHAPATANAM,2021-02-12,6,1480,0,1486,
ANDHRA PRADESH,VISAKHAPATANAM,2021-02-13,2,98,0,100,
ANDHRA PRADESH,VISAKHAPATANAM,2021-02-14,1,45,0,46,
ANDHRA PRADESH,VISAKHAPATANAM,2021-02-15,1,120,0,121,
ANDHRA PRADESH,VIZIANAGARAM,2021-02-11,0,1647,0,1647,
ANDHRA PRADESH,VIZIANAGARAM,2021-02-12,0,147,0,147,
ANDHRA PRADESH,VIZIANAGARAM,2021-02-13,0,5,0,5,
ANDHRA PRADESH,VIZIANAGARAM,2021-02-14,0,3,0,3,
ANDHRA PRADESH,VIZIANAGARAM,2021-02-15,0,7,0,7,
ANDHRA PRADESH,WEST GODAVARI,2021-02-11,15,1392,0,1407,
ANDHRA PRADESH,WEST GODAVARI,2021-02-12,11,1369,0,1380,
ANDHRA PRADESH,WEST GODAVARI,2021-02-13,0,14,0,14,
ANDHRA PRADESH,WEST GODAVARI,2021-02-14,0,4,0,4,
ANDHRA PRADESH,WEST GODAVARI,2021-02-15,0,8,0,8,
ANDHRA PRADESH,Y.S.R.,2021-02-11,4,2994,0,2998,
ANDHRA PRADESH,Y.S.R.,2021-02-12,6,2131,0,2137,
ANDHRA PRADESH,Y.S.R.,2021-02-13,0,12,0,12,
ANDHRA PRADESH,Y.S.R.,2021-02-14,0,7,0,7,
ANDHRA PRADESH,Y.S.R.,2021-02-15,0,7,0,7,
ARUNACHAL PRADESH,ANJAW,2021-02-11,0,1,0,1,
ARUNACHAL PRADESH,ANJAW,2021-02-13,0,5,0,5,
ARUNACHAL PRADESH,ANJAW,2021-02-14,0,3,0,3,
ARUNACHAL PRADESH,ANJAW,2021-02-15,0,2,0,2,
ARUNACHAL PRADESH,CHANGLANG,2021-02-13,0,1,0,1,
ARUNACHAL PRADESH,CHANGLANG,2021-02-14,0,1,0,1,
ARUNACHAL PRADESH,CHANGLANG,2021-02-15,2,3,0,5,
ARUNACHAL PRADESH,DIBANG VALLEY,2021-02-14,0,1,0,1,
ARUNACHAL PRADESH,EAST SIANG,2021-02-11,0,44,0,44,
ARUNACHAL PRADESH,EAST SIANG,2021-02-12,0,36,0,36,
ARUNACHAL PRADESH,EAST SIANG,2021-02-13,0,36,0,36,
ARUNACHAL PRADESH,EAST SIANG,2021-02-14,0,2,0,2,
ARUNACHAL PRADESH,EAST SIANG,2021-02-15,0,87,0,87,
ARUNACHAL PRADESH,KURUNG KUMEY,2021-02-13,0,1,0,1,
ARUNACHAL PRADESH,LEPARADA,2021-02-11,3,4,0,7,
ARUNACHAL PRADESH,LOHIT,2021-02-13,0,1,0,1,
ARUNACHAL PRADESH,LOHIT,2021-02-15,0,1,0,1,
ARUNACHAL PRADESH,LONGDING,2021-02-12,0,1,0,1,
ARUNACHAL PRADESH,LONGDING,2021-02-15,0,3,0,3,
ARUNACHAL PRADESH,LOWER DIBANG VALLEY,2021-02-15,0,1,0,1,
ARUNACHAL PRADESH,LOWER SIANG,2021-02-11,0,5,0,5,
ARUNACHAL PRADESH,LOWER SIANG,2021-02-12,0,6,0,6,
ARUNACHAL PRADESH,LOWER SIANG,2021-02-13,0,20,0,20,
ARUNACHAL PRADESH,LOWER SIANG,2021-02-14,0,13,0,13,
ARUNACHAL PRADESH,LOWER SIANG,2021-02-15,0,23,0,23,
ARUNACHAL PRADESH,LOWER SUBANSIRI,2021-02-11,0,55,0,55,
ARUNACHAL PRADESH,LOWER SUBANSIRI,2021-02-12,0,2,0,2,
ARUNACHAL PRADESH,LOWER SUBANSIRI,2021-02-13,0,1,0,1,
ARUNACHAL PRADESH,LOWER SUBANSIRI,2021-02-15,0,33,0,33,
ARUNACHAL PRADESH,NAMSAI,2021-02-11,1,1,0,2,
ARUNACHAL PRADESH,NAMSAI,2021-02-12,0,2,0,2,
ARUNACHAL PRADESH,NAMSAI,2021-02-13,0,8,0,8,
ARUNACHAL PRADESH,NAMSAI,2021-02-15,0,1,0,1,
ARUNACHAL PRADESH,PAPUM PARE,2021-02-11,0,17,0,17,
ARUNACHAL PRADESH,PAPUM PARE,2021-02-12,0,28,0,28,
ARUNACHAL PRADESH,PAPUM PARE,2021-02-13,0,29,0,29,
ARUNACHAL PRADESH,PAPUM PARE,2021-02-15,1,12,0,13,
ARUNACHAL PRADESH,SIANG,2021-02-11,0,2,0,2,
ARUNACHAL PRADESH,TAWANG,2021-02-11,0,1,0,1,
ARUNACHAL PRADESH,TAWANG,2021-02-12,0,1,0,1,
ARUNACHAL PRADESH,TAWANG,2021-02-15,0,1,0,1,
ARUNACHAL PRADESH,TIRAP,2021-02-12,0,3,0,3,
ARUNACHAL PRADESH,TIRAP,2021-02-15,0,1,0,1,
ARUNACHAL PRADESH,UPPER SIANG,2021-02-15,0,1,0,1,
ARUNACHAL PRADESH,UPPER SUBANSIRI,2021-02-11,0,1,0,1,
ARUNACHAL PRADESH,UPPER SUBANSIRI,2021-02-13,0,1,0,1,
ARUNACHAL PRADESH,WEST KAMENG,2021-02-11,0,215,0,215,
ARUNACHAL PRADESH,WEST KAMENG,2021-02-12,0,172,0,172,
ARUNACHAL PRADESH,WEST KAMENG,2021-02-13,0,100,0,100,
ARUNACHAL PRADESH,WEST KAMENG,2021-02-15,0,78,0,78,
ARUNACHAL PRADESH,WEST SIANG,2021-02-11,0,3,0,3,
ARUNACHAL PRADESH,WEST SIANG,2021-02-12,0,17,0,17,
ARUNACHAL PRADESH,WEST SIANG,2021-02-15,0,9,0,9,
ASSAM,BAKSA,2021-02-11,0,53,0,53,
ASSAM,BAKSA,2021-02-12,0,51,0,51,
ASSAM,BAKSA,2021-02-13,0,24,0,24,
ASSAM,BAKSA,2021-02-15,0,22,0,22,
ASSAM,BARPETA,2021-02-11,0,153,1,154,
ASSAM,BARPETA,2021-02-12,0,164,0,164,
ASSAM,BARPETA,2021-02-13,0,156,0,156,
ASSAM,BARPETA,2021-02-14,0,11,0,11,
ASSAM,BARPETA,2021-02-15,0,265,0,265,
ASSAM,BISWANATH,2021-02-11,0,36,0,36,
ASSAM,BISWANATH,2021-02-12,0,27,0,27,
ASSAM,BISWANATH,2021-02-13,0,46,0,46,
ASSAM,BISWANATH,2021-02-14,0,4,0,4,
ASSAM,BISWANATH,2021-02-15,0,47,0,47,
ASSAM,BONGAIGAON,2021-02-11,0,210,0,210,
ASSAM,BONGAIGAON,2021-02-12,0,192,0,192,
ASSAM,BONGAIGAON,2021-02-13,0,131,0,131,
ASSAM,BONGAIGAON,2021-02-14,0,13,0,13,
ASSAM,BONGAIGAON,2021-02-15,0,257,0,257,
ASSAM,CACHAR,2021-02-11,1,217,116,334,
ASSAM,CACHAR,2021-02-12,0,236,9,245,
ASSAM,CACHAR,2021-02-13,0,211,25,236,
ASSAM,CACHAR,2021-02-14,1,43,0,44,
ASSAM,CACHAR,2021-02-15,0,184,5,189,
ASSAM,CHARAIDEO,2021-02-11,0,143,0,143,
ASSAM,CHARAIDEO,2021-02-12,0,138,0,138,
ASSAM,CHARAIDEO,2021-02-13,0,116,0,116,
ASSAM,CHARAIDEO,2021-02-14,0,32,0,32,
ASSAM,CHARAIDEO,2021-02-15,0,115,0,115,
ASSAM,CHIRANG,2021-02-11,0,66,0,66,
ASSAM,CHIRANG,2021-02-12,0,62,0,62,
ASSAM,CHIRANG,2021-02-13,0,54,0,54,
ASSAM,CHIRANG,2021-02-14,0,1,0,1,
ASSAM,CHIRANG,2021-02-15,1,113,0,114,
ASSAM,DARRANG,2021-02-11,0,367,0,367,
ASSAM,DARRANG,2021-02-12,1,353,0,354,
ASSAM,DARRANG,2021-02-13,0,335,0,335,
ASSAM,DARRANG,2021-02-14,0,92,0,92,
ASSAM,DARRANG,2021-02-15,0,411,0,411,
ASSAM,DHEMAJI,2021-02-11,0,56,0,56,
ASSAM,DHEMAJI,2021-02-12,0,43,0,43,
ASSAM,DHEMAJI,2021-02-13,0,72,0,72,
ASSAM,DHEMAJI,2021-02-14,0,25,0,25,
ASSAM,DHEMAJI,2021-02-15,0,45,0,45,
ASSAM,DHUBRI,2021-02-11,0,280,0,280,
ASSAM,DHUBRI,2021-02-12,0,307,0,307,
ASSAM,DHUBRI,2021-02-13,0,163,0,163,
ASSAM,DHUBRI,2021-02-14,0,30,0,30,
ASSAM,DHUBRI,2021-02-15,1,257,0,258,
ASSAM,DIBRUGARH,2021-02-11,1,452,0,453,
ASSAM,DIBRUGARH,2021-02-12,0,460,0,460,
ASSAM,DIBRUGARH,2021-02-13,3,288,0,291,
ASSAM,DIBRUGARH,2021-02-14,0,252,0,252,
ASSAM,DIBRUGARH,2021-02-15,3,375,0,378,
ASSAM,DIMA HASAO,2021-02-11,0,71,1,72,
ASSAM,DIMA HASAO,2021-02-12,0,105,0,105,
ASSAM,DIMA HASAO,2021-02-13,0,11,0,11,
ASSAM,DIMA HASAO,2021-02-14,0,30,0,30,
ASSAM,DIMA HASAO,2021-02-15,0,40,0,40,
ASSAM,GOALPARA,2021-02-11,0,351,0,351,
ASSAM,GOALPARA,2021-02-12,0,282,0,282,
ASSAM,GOALPARA,2021-02-13,0,178,0,178,
ASSAM,GOALPARA,2021-02-14,0,125,0,125,
ASSAM,GOALPARA,2021-02-15,0,289,0,289,
ASSAM,GOLAGHAT,2021-02-11,0,197,0,197,
ASSAM,GOLAGHAT,2021-02-12,1,339,0,340,
ASSAM,GOLAGHAT,2021-02-13,0,333,0,333,
ASSAM,GOLAGHAT,2021-02-14,0,18,0,18,
ASSAM,GOLAGHAT,2021-02-15,0,132,0,132,
ASSAM,HAILAKANDI,2021-02-11,0,129,9,138,
ASSAM,HAILAKANDI,2021-02-12,0,164,27,191,
ASSAM,HAILAKANDI,2021-02-13,0,133,1,134,
ASSAM,HAILAKANDI,2021-02-14,0,60,0,60,
ASSAM,HAILAKANDI,2021-02-15,0,272,18,290,
ASSAM,HOJAI,2021-02-11,0,106,0,106,
ASSAM,HOJAI,2021-02-12,0,141,0,141,
ASSAM,HOJAI,2021-02-13,0,62,0,62,
ASSAM,HOJAI,2021-02-14,0,16,0,16,
ASSAM,HOJAI,2021-02-15,0,163,0,163,
ASSAM,JORHAT,2021-02-11,0,417,0,417,
ASSAM,JORHAT,2021-02-12,0,330,0,330,
ASSAM,JORHAT,2021-02-13,0,267,0,267,
ASSAM,JORHAT,2021-02-14,0,125,0,125,
ASSAM,JORHAT,2021-02-15,1,692,0,693,
ASSAM,KAMRUP,2021-02-11,0,515,0,515,
ASSAM,KAMRUP,2021-02-12,1,629,0,630,
ASSAM,KAMRUP,2021-02-13,2,741,0,743,
ASSAM,KAMRUP,2021-02-14,0,225,0,225,
ASSAM,KAMRUP,2021-02-15,0,736,0,736,
ASSAM,KAMRUP METRO,2021-02-11,2,1791,0,1793,
ASSAM,KAMRUP METRO,2021-02-12,3,1498,0,1501,
ASSAM,KAMRUP METRO,2021-02-13,4,1219,5,1228,
ASSAM,KAMRUP METRO,2021-02-14,2,770,0,772,
ASSAM,KAMRUP METRO,2021-02-15,10,1391,2,1403,
ASSAM,KARBI ANGLONG,2021-02-11,0,50,0,50,
ASSAM,KARBI ANGLONG,2021-02-12,0,25,0,25,
ASSAM,KARBI ANGLONG,2021-02-13,0,45,0,45,
ASSAM,KARBI ANGLONG,2021-02-14,0,9,0,9,
ASSAM,KARBI ANGLONG,2021-02-15,0,30,0,30,
ASSAM,KARIMGANJ,2021-02-11,0,281,2,283,
ASSAM,KARIMGANJ,2021-02-12,0,299,3,302,
ASSAM,KARIMGANJ,2021-02-13,0,192,9,201,
ASSAM,KARIMGANJ,2021-02-14,2,96,0,98,
ASSAM,KARIMGANJ,2021-02-15,0,370,2,372,
ASSAM,KOKRAJHAR,2021-02-11,4,19,0,23,
ASSAM,KOKRAJHAR,2021-02-12,0,14,0,14,
ASSAM,KOKRAJHAR,2021-02-13,0,19,0,19,
ASSAM,KOKRAJHAR,2021-02-14,0,3,0,3,
ASSAM,KOKRAJHAR,2021-02-15,0,48,0,48,
ASSAM,LAKHIMPUR,2021-02-11,3,767,0,770,
ASSAM,LAKHIMPUR,2021-02-12,0,359,0,359,
ASSAM,LAKHIMPUR,2021-02-13,0,150,0,150,
ASSAM,LAKHIMPUR,2021-02-14,0,114,0,114,
ASSAM,LAKHIMPUR,2021-02-15,0,218,0,218,
ASSAM,MAJULI,2021-02-11,0,34,0,34,
ASSAM,MAJULI,2021-02-12,0,11,0,11,
ASSAM,MAJULI,2021-02-13,0,5,0,5,
ASSAM,MAJULI,2021-02-14,0,3,0,3,
ASSAM,MAJULI,2021-02-15,0,13,0,13,
ASSAM,MARIGAON,2021-02-11,0,63,0,63,
ASSAM,MARIGAON,2021-02-12,0,59,0,59,
ASSAM,MARIGAON,2021-02-13,0,128,0,128,
ASSAM,MARIGAON,2021-02-14,0,74,0,74,
ASSAM,MARIGAON,2021-02-15,0,121,0,121,
ASSAM,NAGAON,2021-02-11,0,283,0,283,
ASSAM,NAGAON,2021-02-12,0,247,0,247,
ASSAM,NAGAON,2021-02-13,0,243,0,243,
ASSAM,NAGAON,2021-02-14,2,78,0,80,
ASSAM,NAGAON,2021-02-15,0,378,0,378,
ASSAM,NALBARI,2021-02-11,0,77,0,77,
ASSAM,NALBARI,2021-02-12,0,82,0,82,
ASSAM,NALBARI,2021-02-13,0,21,0,21,
ASSAM,NALBARI,2021-02-14,0,14,0,14,
ASSAM,NALBARI,2021-02-15,0,39,0,39,
ASSAM,SIVASAGAR,2021-02-11,0,519,0,519,
ASSAM,SIVASAGAR,2021-02-12,0,198,0,198,
ASSAM,SIVASAGAR,2021-02-13,0,116,0,116,
ASSAM,SIVASAGAR,2021-02-14,0,14,0,14,
ASSAM,SIVASAGAR,2021-02-15,0,175,0,175,
ASSAM,SONITPUR,2021-02-11,1,209,0,210,
ASSAM,SONITPUR,2021-02-12,1,203,0,204,
ASSAM,SONITPUR,2021-02-13,1,262,0,263,
ASSAM,SONITPUR,2021-02-14,0,63,0,63,
ASSAM,SONITPUR,2021-02-15,1,235,0,236,
ASSAM,SOUTH SALMARA MANCACHAR,2021-02-11,0,14,0,14,
ASSAM,SOUTH SALMARA MANCACHAR,2021-02-12,0,28,0,28,
ASSAM,SOUTH SALMARA MANCACHAR,2021-02-13,0,31,0,31,
ASSAM,SOUTH SALMARA MANCACHAR,2021-02-14,0,3,0,3,
ASSAM,SOUTH SALMARA MANCACHAR,2021-02-15,0,40,0,40,
ASSAM,TINSUKIA,2021-02-11,0,300,0,300,
ASSAM,TINSUKIA,2021-02-12,1,211,0,212,
ASSAM,TINSUKIA,2021-02-13,0,172,0,172,
ASSAM,TINSUKIA,2021-02-14,0,117,0,117,
ASSAM,TINSUKIA,2021-02-15,1,66,0,67,
ASSAM,UDALGURI,2021-02-11,0,10,0,10,
ASSAM,UDALGURI,2021-02-12,0,10,0,10,
ASSAM,UDALGURI,2021-02-13,0,5,0,5,
ASSAM,UDALGURI,2021-02-14,0,6,0,6,
ASSAM,UDALGURI,2021-02-15,0,7,0,7,
ASSAM,WEST KARBI ANGLONG,2021-02-11,0,42,0,42,
ASSAM,WEST KARBI ANGLONG,2021-02-12,0,19,0,19,
ASSAM,WEST KARBI ANGLONG,2021-02-13,0,30,0,30,
ASSAM,WEST KARBI ANGLONG,2021-02-14,0,16,0,16,
ASSAM,WEST KARBI ANGLONG,2021-02-15,0,31,0,31,
BIHAR,ARARIA,2021-02-11,0,388,10,398,
BIHAR,ARARIA,2021-02-12,0,963,7,970,
BIHAR,ARARIA,2021-02-13,2,1093,0,1095,
BIHAR,ARARIA,2021-02-14,0,1811,0,1811,
BIHAR,ARARIA,2021-02-15,3,1893,1,1897,
BIHAR,ARWAL,2021-02-11,0,1137,1,1138,
BIHAR,ARWAL,2021-02-12,0,1297,0,1297,
BIHAR,ARWAL,2021-02-13,1,993,4,998,
BIHAR,ARWAL,2021-02-14,0,273,0,273,
BIHAR,ARWAL,2021-02-15,1,365,2,368,
BIHAR,AURANGABAD,2021-02-11,1,1093,0,1094,
BIHAR,AURANGABAD,2021-02-12,2,320,0,322,
BIHAR,AURANGABAD,2021-02-13,0,261,0,261,
BIHAR,AURANGABAD,2021-02-14,0,3,0,3,
BIHAR,AURANGABAD,2021-02-15,1,950,1,952,
BIHAR,BANKA,2021-02-11,0,2044,0,2044,
BIHAR,BANKA,2021-02-12,3,1640,5,1648,
BIHAR,BANKA,2021-02-13,1,1174,99,1274,
BIHAR,BANKA,2021-02-14,5,1035,183,1223,
BIHAR,BANKA,2021-02-15,0,675,47,722,
BIHAR,BEGUSARAI,2021-02-11,4,4665,1,4670,
BIHAR,BEGUSARAI,2021-02-12,3,4862,0,4865,
BIHAR,BEGUSARAI,2021-02-13,2,6407,0,6409,
BIHAR,BEGUSARAI,2021-02-14,1,2423,0,2424,
BIHAR,BEGUSARAI,2021-02-15,3,2298,0,2301,
BIHAR,BHAGALPUR,2021-02-11,4,2383,81,2468,
BIHAR,BHAGALPUR,2021-02-12,0,2287,408,2695,
BIHAR,BHAGALPUR,2021-02-13,1,1830,21,1852,
BIHAR,BHAGALPUR,2021-02-14,2,1768,35,1805,
BIHAR,BHAGALPUR,2021-02-15,0,1191,245,1436,
BIHAR,BHOJPUR,2021-02-11,0,623,0,623,
BIHAR,BHOJPUR,2021-02-12,1,611,20,632,
BIHAR,BHOJPUR,2021-02-13,2,595,290,887,
BIHAR,BHOJPUR,2021-02-14,0,312,7,319,
BIHAR,BHOJPUR,2021-02-15,0,510,27,537,
BIHAR,BUXAR,2021-02-11,0,728,9,737,
BIHAR,BUXAR,2021-02-12,0,497,5,502,
BIHAR,BUXAR,2021-02-13,0,1079,0,1079,
BIHAR,BUXAR,2021-02-14,0,218,0,218,
BIHAR,BUXAR,2021-02-15,0,344,0,344,
BIHAR,DARBHANGA,2021-02-11,2,1836,1,1839,
BIHAR,DARBHANGA,2021-02-12,3,1768,157,1928,
BIHAR,DARBHANGA,2021-02-13,1,1528,0,1529,
BIHAR,DARBHANGA,2021-02-14,2,1045,1,1048,
BIHAR,DARBHANGA,2021-02-15,2,425,0,427,
BIHAR,GAYA,2021-02-11,7,3543,98,3648,
BIHAR,GAYA,2021-02-12,3,2800,56,2859,
BIHAR,GAYA,2021-02-13,2,1860,8,1870,
BIHAR,GAYA,2021-02-14,2,1502,0,1504,
BIHAR,GAYA,2021-02-15,3,1658,16,1677,
BIHAR,GOPALGANJ,2021-02-11,2,375,0,377,
BIHAR,GOPALGANJ,2021-02-12,2,1145,2,1149,
BIHAR,GOPALGANJ,2021-02-13,2,1202,41,1245,
BIHAR,GOPALGANJ,2021-02-14,0,945,5,950,
BIHAR,GOPALGANJ,2021-02-15,3,471,7,481,
BIHAR,JAMUI,2021-02-11,1,712,0,713,
BIHAR,JAMUI,2021-02-12,0,703,0,703,
BIHAR,JAMUI,2021-02-13,0,552,0,552,
BIHAR,JAMUI,2021-02-14,0,272,0,272,
BIHAR,JAMUI,2021-02-15,0,264,34,298,
BIHAR,JEHANABAD,2021-02-11,0,768,56,824,
BIHAR,JEHANABAD,2021-02-12,0,1083,5,1088,
BIHAR,JEHANABAD,2021-02-13,5,421,42,468,
BIHAR,JEHANABAD,2021-02-14,0,635,0,635,
BIHAR,JEHANABAD,2021-02-15,0,534,25,559,
BIHAR,KAIMUR (BHABUA),2021-02-11,2,1608,0,1610,
BIHAR,KAIMUR (BHABUA),2021-02-12,0,2282,0,2282,
BIHAR,KAIMUR (BHABUA),2021-02-13,2,1007,0,1009,
BIHAR,KAIMUR (BHABUA),2021-02-14,0,1330,0,1330,
BIHAR,KAIMUR (BHABUA),2021-02-15,1,1300,0,1301,
BIHAR,KATIHAR,2021-02-11,1,855,0,856,
BIHAR,KATIHAR,2021-02-12,0,996,0,996,
BIHAR,KATIHAR,2021-02-13,4,992,0,996,
BIHAR,KATIHAR,2021-02-14,0,517,0,517,
BIHAR,KATIHAR,2021-02-15,1,775,0,776,
BIHAR,KHAGARIA,2021-02-11,0,987,1,988,
BIHAR,KHAGARIA,2021-02-12,0,1062,4,1066,
BIHAR,KHAGARIA,2021-02-13,0,987,0,987,
BIHAR,KHAGARIA,2021-02-14,0,1105,0,1105,
BIHAR,KHAGARIA,2021-02-15,0,616,0,616,
BIHAR,KISHANGANJ,2021-02-11,2,725,5,732,
BIHAR,KISHANGANJ,2021-02-12,1,1814,0,1815,
BIHAR,KISHANGANJ,2021-02-13,0,415,0,415,
BIHAR,KISHANGANJ,2021-02-14,1,1101,0,1102,
BIHAR,KISHANGANJ,2021-02-15,0,1235,0,1235,
BIHAR,LAKHISARAI,2021-02-11,0,435,0,435,
BIHAR,LAKHISARAI,2021-02-12,0,433,2,435,
BIHAR,LAKHISARAI,2021-02-13,3,1904,2,1909,
BIHAR,LAKHISARAI,2021-02-14,1,1283,12,1296,
BIHAR,LAKHISARAI,2021-02-15,3,320,0,323,
BIHAR,MADHEPURA,2021-02-11,1,1454,0,1455,
BIHAR,MADHEPURA,2021-02-12,1,1176,0,1177,
BIHAR,MADHEPURA,2021-02-13,0,1247,0,1247,
BIHAR,MADHEPURA,2021-02-14,0,1018,0,1018,
BIHAR,MADHEPURA,2021-02-15,0,974,19,993,
BIHAR,MADHUBANI,2021-02-11,5,1084,7,1096,
BIHAR,MADHUBANI,2021-02-12,1,1610,9,1620,
BIHAR,MADHUBANI,2021-02-13,0,1198,6,1204,
BIHAR,MADHUBANI,2021-02-14,0,1065,10,1075,
BIHAR,MADHUBANI,2021-02-15,2,1379,13,1394,
BIHAR,MUNGER,2021-02-11,0,1026,20,1046,
BIHAR,MUNGER,2021-02-12,0,911,32,943,
BIHAR,MUNGER,2021-02-13,1,1636,7,1644,
BIHAR,MUNGER,2021-02-14,1,1447,0,1448,
BIHAR,MUNGER,2021-02-15,2,2103,26,2131,
BIHAR,MUZAFFARPUR,2021-02-11,1,2006,0,2007,
BIHAR,MUZAFFARPUR,2021-02-12,6,2984,0,2990,
BIHAR,MUZAFFARPUR,2021-02-13,0,2147,1,2148,
BIHAR,MUZAFFARPUR,2021-02-14,0,1454,0,1454,
BIHAR,MUZAFFARPUR,2021-02-15,0,757,0,757,
BIHAR,NALANDA,2021-02-11,0,2522,2,2524,
BIHAR,NALANDA,2021-02-12,2,2707,0,2709,
BIHAR,NALANDA,2021-02-13,1,2524,2,2527,
BIHAR,NALANDA,2021-02-14,2,2169,2,2173,
BIHAR,NALANDA,2021-02-15,1,2542,0,2543,
BIHAR,NAWADA,2021-02-11,0,390,0,390,
BIHAR,NAWADA,2021-02-12,0,1788,0,1788,
BIHAR,NAWADA,2021-02-13,0,405,0,405,
BIHAR,NAWADA,2021-02-14,4,667,0,671,
BIHAR,NAWADA,2021-02-15,2,1817,0,1819,
BIHAR,PASHCHIM CHAMPARAN,2021-02-11,0,2250,0,2250,
BIHAR,PASHCHIM CHAMPARAN,2021-02-12,2,1673,1,1676,
BIHAR,PASHCHIM CHAMPARAN,2021-02-13,0,661,0,661,
BIHAR,PASHCHIM CHAMPARAN,2021-02-14,1,728,0,729,
BIHAR,PASHCHIM CHAMPARAN,2021-02-15,0,1706,0,1706,
BIHAR,PATNA,2021-02-11,34,3628,5,3667,
BIHAR,PATNA,2021-02-12,26,3095,2,3123,
BIHAR,PATNA,2021-02-13,26,2735,2,2763,
BIHAR,PATNA,2021-02-14,20,2000,4,2024,
BIHAR,PATNA,2021-02-15,29,3205,10,3244,
BIHAR,PURBI CHAMPARAN,2021-02-11,1,2095,0,2096,
BIHAR,PURBI CHAMPARAN,2021-02-12,1,2206,2,2209,
BIHAR,PURBI CHAMPARAN,2021-02-13,0,1296,1,1297,
BIHAR,PURBI CHAMPARAN,2021-02-14,0,1877,0,1877,
BIHAR,PURBI CHAMPARAN,2021-02-15,0,1287,1,1288,
BIHAR,PURNIA,2021-02-11,1,1061,0,1062,
BIHAR,PURNIA,2021-02-12,0,1031,334,1365,
BIHAR,PURNIA,2021-02-13,0,1047,0,1047,
BIHAR,PURNIA,2021-02-14,0,510,0,510,
BIHAR,PURNIA,2021-02-15,2,722,0,724,
BIHAR,ROHTAS,2021-02-11,2,1423,53,1478,
BIHAR,ROHTAS,2021-02-12,0,1660,4,1664,
BIHAR,ROHTAS,2021-02-13,1,1398,66,1465,
BIHAR,ROHTAS,2021-02-14,0,1023,0,1023,
BIHAR,ROHTAS,2021-02-15,2,1238,116,1356,
BIHAR,SAHARSA,2021-02-11,4,488,0,492,
BIHAR,SAHARSA,2021-02-12,1,1505,0,1506,
BIHAR,SAHARSA,2021-02-13,0,313,0,313,
BIHAR,SAHARSA,2021-02-14,0,317,0,317,
BIHAR,SAHARSA,2021-02-15,0,156,0,156,
BIHAR,SAMASTIPUR,2021-02-11,2,1877,16,1895,
BIHAR,SAMASTIPUR,2021-02-12,3,2587,64,2654,
BIHAR,SAMASTIPUR,2021-02-13,1,1786,18,1805,
BIHAR,SAMASTIPUR,2021-02-14,0,1525,13,1538,
BIHAR,SAMASTIPUR,2021-02-15,0,960,17,977,
BIHAR,SARAN,2021-02-11,4,1855,0,1859,
BIHAR,SARAN,2021-02-12,1,1334,1,1336,
BIHAR,SARAN,2021-02-13,1,1689,1,1691,
BIHAR,SARAN,2021-02-14,1,804,1,806,
BIHAR,SARAN,2021-02-15,4,1653,5,1662,
BIHAR,SHEIKHPURA,2021-02-11,0,95,6,101,
BIHAR,SHEIKHPURA,2021-02-12,0,298,11,309,
BIHAR,SHEIKHPURA,2021-02-13,0,407,5,412,
BIHAR,SHEIKHPURA,2021-02-14,0,285,0,285,
BIHAR,SHEIKHPURA,2021-02-15,0,283,19,302,
BIHAR,SHEOHAR,2021-02-11,3,916,0,919,
BIHAR,SHEOHAR,2021-02-12,0,634,0,634,
BIHAR,SHEOHAR,2021-02-13,0,679,0,679,
BIHAR,SHEOHAR,2021-02-14,0,109,0,109,
BIHAR,SHEOHAR,2021-02-15,0,268,0,268,
BIHAR,SITAMARHI,2021-02-11,0,467,0,467,
BIHAR,SITAMARHI,2021-02-12,0,688,0,688,
BIHAR,SITAMARHI,2021-02-13,2,929,0,931,
BIHAR,SITAMARHI,2021-02-14,1,1197,0,1198,
BIHAR,SITAMARHI,2021-02-15,0,677,1,678,
BIHAR,SIWAN,2021-02-11,2,1454,1,1457,
BIHAR,SIWAN,2021-02-12,0,1768,0,1768,
BIHAR,SIWAN,2021-02-13,1,1876,0,1877,
BIHAR,SIWAN,2021-02-14,0,1737,7,1744,
BIHAR,SIWAN,2021-02-15,1,1972,0,1973,
BIHAR,SUPAUL,2021-02-11,0,1159,18,1177,
BIHAR,SUPAUL,2021-02-12,0,1675,0,1675,
BIHAR,SUPAUL,2021-02-13,0,2636,34,2670,
BIHAR,SUPAUL,2021-02-14,0,1266,0,1266,
BIHAR,SUPAUL,2021-02-15,0,1648,3,1651,
BIHAR,VAISHALI,2021-02-11,1,2862,0,2863,
BIHAR,VAISHALI,2021-02-12,3,3378,1,3382,
BIHAR,VAISHALI,2021-02-13,1,1923,0,1924,
BIHAR,VAISHALI,2021-02-14,1,1504,101,1606,
BIHAR,VAISHALI,2021-02-15,1,2432,28,2461,
CHANDIGARH,CHANDIGARH,2021-02-11,16,1388,7,1411,
CHANDIGARH,CHANDIGARH,2021-02-12,17,1318,2,1337,
CHANDIGARH,CHANDIGARH,2021-02-13,24,1453,2,1479,
CHANDIGARH,CHANDIGARH,2021-02-14,24,445,10,479,
CHANDIGARH,CHANDIGARH,2021-02-15,34,1244,4,1282,
CHHATTISGARH,BALOD,2021-02-11,4,1142,0,1146,
CHHATTISGARH,BALOD,2021-02-12,2,1054,2,1058,
CHHATTISGARH,BALOD,2021-02-13,8,908,0,916,
CHHATTISGARH,BALOD,2021-02-14,1,725,2,728,
CHHATTISGARH,BALOD,2021-02-15,2,860,0,862,
CHHATTISGARH,BALODA BAZAR,2021-02-11,5,666,7,678,
CHHATTISGARH,BALODA BAZAR,2021-02-12,9,750,5,764,
CHHATTISGARH,BALODA BAZAR,2021-02-13,14,438,1,453,
CHHATTISGARH,BALODA BAZAR,2021-02-14,1,291,0,292,
CHHATTISGARH,BALODA BAZAR,2021-02-15,10,581,5,596,
CHHATTISGARH,BALRAMPUR,2021-02-11,0,317,0,317,
CHHATTISGARH,BALRAMPUR,2021-02-12,1,240,1,242,
CHHATTISGARH,BALRAMPUR,2021-02-13,0,301,1,302,
CHHATTISGARH,BALRAMPUR,2021-02-14,0,38,0,38,
CHHATTISGARH,BALRAMPUR,2021-02-15,0,404,1,405,
CHHATTISGARH,BASTAR,2021-02-11,9,1179,0,1188,
CHHATTISGARH,BASTAR,2021-02-12,7,1321,0,1328,
CHHATTISGARH,BASTAR,2021-02-13,6,1244,0,1250,
CHHATTISGARH,BASTAR,2021-02-14,3,882,0,885,
CHHATTISGARH,BASTAR,2021-02-15,5,1061,0,1066,
CHHATTISGARH,BEMETARA,2021-02-11,0,705,0,705,
CHHATTISGARH,BEMETARA,2021-02-12,8,466,0,474,
CHHATTISGARH,BEMETARA,2021-02-13,4,522,0,526,
CHHATTISGARH,BEMETARA,2021-02-14,3,370,2,375,
CHHATTISGARH,BEMETARA,2021-02-15,3,568,0,571,
CHHATTISGARH,BIJAPUR,2021-02-11,0,70,0,70,
CHHATTISGARH,BIJAPUR,2021-02-12,0,366,0,366,
CHHATTISGARH,BIJAPUR,2021-02-13,0,163,0,163,
CHHATTISGARH,BIJAPUR,2021-02-14,0,151,0,151,
CHHATTISGARH,BIJAPUR,2021-02-15,0,43,0,43,
CHHATTISGARH,BILASPUR,2021-02-11,16,804,20,840,
CHHATTISGARH,BILASPUR,2021-02-12,17,765,37,819,
CHHATTISGARH,BILASPUR,2021-02-13,28,641,12,681,
CHHATTISGARH,BILASPUR,2021-02-14,10,564,7,581,
CHHATTISGARH,BILASPUR,2021-02-15,7,897,0,904,
CHHATTISGARH,DANTEWADA,2021-02-11,0,165,0,165,
CHHATTISGARH,DANTEWADA,2021-02-12,0,326,0,326,
CHHATTISGARH,DANTEWADA,2021-02-13,0,290,0,290,
CHHATTISGARH,DANTEWADA,2021-02-14,0,408,0,408,
CHHATTISGARH,DANTEWADA,2021-02-15,1,158,0,159,
CHHATTISGARH,DHAMTARI,2021-02-11,6,634,21,661,
CHHATTISGARH,DHAMTARI,2021-02-12,3,581,35,619,
CHHATTISGARH,DHAMTARI,2021-02-13,2,493,16,511,
CHHATTISGARH,DHAMTARI,2021-02-14,4,64,28,96,
CHHATTISGARH,DHAMTARI,2021-02-15,3,484,15,502,
CHHATTISGARH,DURG,2021-02-11,39,1255,2,1296,
CHHATTISGARH,DURG,2021-02-12,45,1078,1,1124,
CHHATTISGARH,DURG,2021-02-13,45,869,0,914,
CHHATTISGARH,DURG,2021-02-14,64,829,1,894,
CHHATTISGARH,DURG,2021-02-15,60,959,1,1020,
CHHATTISGARH,GARIYABAND,2021-02-11,15,316,2,333,
CHHATTISGARH,GARIYABAND,2021-02-12,6,259,13,278,
CHHATTISGARH,GARIYABAND,2021-02-13,2,293,5,300,
CHHATTISGARH,GARIYABAND,2021-02-14,2,86,7,95,
CHHATTISGARH,GARIYABAND,2021-02-15,4,243,3,250,
CHHATTISGARH,GAURELLA PENDRA MARWAHI,2021-02-11,1,238,1,240,
CHHATTISGARH,GAURELLA PENDRA MARWAHI,2021-02-12,0,286,8,294,
CHHATTISGARH,GAURELLA PENDRA MARWAHI,2021-02-13,0,144,1,145,
CHHATTISGARH,GAURELLA PENDRA MARWAHI,2021-02-14,0,289,0,289,
CHHATTISGARH,GAURELLA PENDRA MARWAHI,2021-02-15,0,48,0,48,
CHHATTISGARH,JANJGIR CHAMPA,2021-02-11,3,1514,0,1517,
CHHATTISGARH,JANJGIR CHAMPA,2021-02-12,4,1432,0,1436,
CHHATTISGARH,JANJGIR CHAMPA,2021-02-13,4,1156,0,1160,
CHHATTISGARH,JANJGIR CHAMPA,2021-02-14,1,756,0,757,
CHHATTISGARH,JANJGIR CHAMPA,2021-02-15,3,1356,0,1359,
CHHATTISGARH,JASHPUR,2021-02-11,10,479,1,490,
CHHATTISGARH,JASHPUR,2021-02-12,8,518,0,526,
CHHATTISGARH,JASHPUR,2021-02-13,5,108,0,113,
CHHATTISGARH,JASHPUR,2021-02-14,1,9,0,10,
CHHATTISGARH,JASHPUR,2021-02-15,17,325,0,342,
CHHATTISGARH,KABIRDHAM,2021-02-11,2,137,0,139,
CHHATTISGARH,KABIRDHAM,2021-02-12,2,503,3,508,
CHHATTISGARH,KABIRDHAM,2021-02-13,2,153,1,156,
CHHATTISGARH,KABIRDHAM,2021-02-14,2,400,0,402,
CHHATTISGARH,KABIRDHAM,2021-02-15,1,94,10,105,
CHHATTISGARH,KANKER,2021-02-11,5,728,0,733,
CHHATTISGARH,KANKER,2021-02-12,1,325,0,326,
CHHATTISGARH,KANKER,2021-02-13,4,483,1,488,
CHHATTISGARH,KANKER,2021-02-14,3,388,0,391,
CHHATTISGARH,KANKER,2021-02-15,9,430,0,439,
CHHATTISGARH,KONDAGAON,2021-02-11,0,1407,0,1407,
CHHATTISGARH,KONDAGAON,2021-02-12,0,1041,0,1041,
CHHATTISGARH,KONDAGAON,2021-02-13,2,1030,0,1032,
CHHATTISGARH,KONDAGAON,2021-02-14,0,492,0,492,
CHHATTISGARH,KONDAGAON,2021-02-15,1,1014,0,1015,
CHHATTISGARH,KORBA,2021-02-11,14,1112,0,1126,
CHHATTISGARH,KORBA,2021-02-12,3,834,0,837,
CHHATTISGARH,KORBA,2021-02-13,3,781,0,784,
CHHATTISGARH,KORBA,2021-02-14,8,535,0,543,
CHHATTISGARH,KORBA,2021-02-15,11,802,0,813,
CHHATTISGARH,KOREA,2021-02-11,11,629,3,643,
CHHATTISGARH,KOREA,2021-02-12,7,629,3,639,
CHHATTISGARH,KOREA,2021-02-13,2,375,0,377,
CHHATTISGARH,KOREA,2021-02-14,3,159,0,162,
CHHATTISGARH,KOREA,2021-02-15,1,371,0,372,
CHHATTISGARH,MAHASAMUND,2021-02-11,9,1096,21,1126,
CHHATTISGARH,MAHASAMUND,2021-02-12,4,1377,7,1388,
CHHATTISGARH,MAHASAMUND,2021-02-13,18,1408,2,1428,
CHHATTISGARH,MAHASAMUND,2021-02-14,5,570,3,578,
CHHATTISGARH,MAHASAMUND,2021-02-15,8,1507,4,1519,
CHHATTISGARH,MUNGELI,2021-02-11,4,391,1,396,
CHHATTISGARH,MUNGELI,2021-02-12,3,424,10,437,
CHHATTISGARH,MUNGELI,2021-02-13,0,552,0,552,
CHHATTISGARH,MUNGELI,2021-02-14,0,202,1,203,
CHHATTISGARH,MUNGELI,2021-02-15,1,638,0,639,
CHHATTISGARH,NARAYANPUR,2021-02-11,0,133,0,133,
CHHATTISGARH,NARAYANPUR,2021-02-12,0,296,0,296,
CHHATTISGARH,NARAYANPUR,2021-02-13,0,252,0,252,
CHHATTISGARH,NARAYANPUR,2021-02-14,0,65,0,65,
CHHATTISGARH,NARAYANPUR,2021-02-15,1,223,0,224,
CHHATTISGARH,RAIGARH,2021-02-11,18,845,2,865,
CHHATTISGARH,RAIGARH,2021-02-12,9,1090,2,1101,
CHHATTISGARH,RAIGARH,2021-02-13,22,898,4,924,
CHHATTISGARH,RAIGARH,2021-02-14,9,566,1,576,
CHHATTISGARH,RAIGARH,2021-02-15,10,727,2,739,
CHHATTISGARH,RAIPUR,2021-02-11,100,2408,32,2540,
CHHATTISGARH,RAIPUR,2021-02-12,81,2297,33,2411,
CHHATTISGARH,RAIPUR,2021-02-13,59,2161,16,2236,
CHHATTISGARH,RAIPUR,2021-02-14,73,1590,14,1677,
CHHATTISGARH,RAIPUR,2021-02-15,111,2370,8,2489,
CHHATTISGARH,RAJNANDGAON,2021-02-11,7,937,0,944,
CHHATTISGARH,RAJNANDGAON,2021-02-12,4,875,0,879,
CHHATTISGARH,RAJNANDGAON,2021-02-13,5,623,36,664,
CHHATTISGARH,RAJNANDGAON,2021-02-14,9,396,13,418,
CHHATTISGARH,RAJNANDGAON,2021-02-15,10,665,3,678,
CHHATTISGARH,SUKMA,2021-02-11,0,32,0,32,
CHHATTISGARH,SUKMA,2021-02-12,0,425,0,425,
CHHATTISGARH,SUKMA,2021-02-13,0,141,0,141,
CHHATTISGARH,SUKMA,2021-02-14,0,26,0,26,
CHHATTISGARH,SUKMA,2021-02-15,2,138,0,140,
CHHATTISGARH,SURAJPUR,2021-02-11,10,768,0,778,
CHHATTISGARH,SURAJPUR,2021-02-12,3,888,1,892,
CHHATTISGARH,SURAJPUR,2021-02-13,9,987,3,999,
CHHATTISGARH,SURAJPUR,2021-02-14,6,624,0,630,
CHHATTISGARH,SURAJPUR,2021-02-15,5,821,0,826,
CHHATTISGARH,SURGUJA,2021-02-11,9,414,1,424,
CHHATTISGARH,SURGUJA,2021-02-12,12,706,0,718,
CHHATTISGARH,SURGUJA,2021-02-13,10,434,0,444,
CHHATTISGARH,SURGUJA,2021-02-14,12,221,0,233,
CHHATTISGARH,SURGUJA,2021-02-15,14,435,0,449,
DADRA AND NAGAR HAVELI,DADRA AND NAGAR HAVELI,2021-02-11,0,532,0,532,
DADRA AND NAGAR HAVELI,DADRA AND NAGAR HAVELI,2021-02-12,0,342,0,342,
DADRA AND NAGAR HAVELI,DADRA AND NAGAR HAVELI,2021-02-13,0,174,0,174,
DADRA AND NAGAR HAVELI,DADRA AND NAGAR HAVELI,2021-02-14,1,70,0,71,
DADRA AND NAGAR HAVELI,DADRA AND NAGAR HAVELI,2021-02-15,0,164,0,164,
DAMAN AND DIU,DAMAN,2021-02-11,0,55,0,55,
DAMAN AND DIU,DAMAN,2021-02-12,2,79,0,81,
DAMAN AND DIU,DAMAN,2021-02-13,0,64,0,64,
DAMAN AND DIU,DAMAN,2021-02-14,1,94,0,95,
DAMAN AND DIU,DAMAN,2021-02-15,0,34,0,34,
DAMAN AND DIU,DIU,2021-02-11,1,72,0,73,
DAMAN AND DIU,DIU,2021-02-12,0,44,0,44,
DAMAN AND DIU,DIU,2021-02-13,0,80,0,80,
DAMAN AND DIU,DIU,2021-02-14,0,48,0,48,
DAMAN AND DIU,DIU,2021-02-15,0,8,0,8,
DELHI,CENTRAL,2021-02-11,12,5142,29,5183,
DELHI,CENTRAL,2021-02-12,11,4643,8,4662,
DELHI,CENTRAL,2021-02-13,9,4639,23,4671,
DELHI,CENTRAL,2021-02-14,4,2729,5,2738,
DELHI,CENTRAL,2021-02-15,7,5134,20,5161,
DELHI,EAST,2021-02-11,10,3904,2,3916,
DELHI,EAST,2021-02-12,27,3622,1,3650,
DELHI,EAST,2021-02-13,17,3592,4,3613,
DELHI,EAST,2021-02-14,6,1446,0,1452,
DELHI,EAST,2021-02-15,10,3078,4,3092,
DELHI,NEW DELHI,2021-02-11,16,6066,17,6099,
DELHI,NEW DELHI,2021-02-12,22,5367,8,5397,
DELHI,NEW DELHI,2021-02-13,19,5635,33,5687,
DELHI,NEW DELHI,2021-02-14,21,4371,5,4397,
DELHI,NEW DELHI,2021-02-15,19,5696,20,5735,
DELHI,NORTH,2021-02-11,9,8038,100,8147,
DELHI,NORTH,2021-02-12,3,6900,9,6912,
DELHI,NORTH,2021-02-13,8,6629,60,6697,
DELHI,NORTH,2021-02-14,5,5309,7,5321,
DELHI,NORTH,2021-02-15,8,7313,21,7342,
DELHI,NORTH EAST,2021-02-11,0,4836,10,4846,
DELHI,NORTH EAST,2021-02-12,3,4835,14,4852,
DELHI,NORTH EAST,2021-02-13,2,4637,12,4651,
DELHI,NORTH EAST,2021-02-14,6,2514,0,2520,
DELHI,NORTH EAST,2021-02-15,1,5617,11,5629,
DELHI,NORTH WEST,2021-02-11,17,5071,6,5094,
DELHI,NORTH WEST,2021-02-12,7,4669,6,4682,
DELHI,NORTH WEST,2021-02-13,14,4567,13,4594,
DELHI,NORTH WEST,2021-02-14,16,2980,5,3001,
DELHI,NORTH WEST,2021-02-15,18,4258,64,4340,
DELHI,SHAHDARA,2021-02-11,4,6965,3,6972,
DELHI,SHAHDARA,2021-02-12,4,6254,4,6262,
DELHI,SHAHDARA,2021-02-13,7,5422,16,5445,
DELHI,SHAHDARA,2021-02-14,0,3610,2,3612,
DELHI,SHAHDARA,2021-02-15,4,5641,4,5649,
DELHI,SOUTH,2021-02-11,38,4691,14,4743,
DELHI,SOUTH,2021-02-12,32,6965,97,7094,
DELHI,SOUTH,2021-02-13,38,5784,32,5854,
DELHI,SOUTH,2021-02-14,42,4037,4,4083,
DELHI,SOUTH,2021-02-15,23,5065,21,5109,
DELHI,SOUTH EAST,2021-02-11,6,4521,1,4528,
DELHI,SOUTH EAST,2021-02-12,6,4794,0,4800,
DELHI,SOUTH EAST,2021-02-13,9,3887,2,3898,
DELHI,SOUTH EAST,2021-02-14,2,2723,3,2728,
DELHI,SOUTH EAST,2021-02-15,4,3554,0,3558,
DELHI,SOUTH WEST,2021-02-11,23,4171,20,4214,
DELHI,SOUTH WEST,2021-02-12,17,3896,4,3917,
DELHI,SOUTH WEST,2021-02-13,32,3473,1,3506,
DELHI,SOUTH WEST,2021-02-14,20,1978,2,2000,
DELHI,SOUTH WEST,2021-02-15,14,2575,2,2591,
DELHI,WEST,2021-02-11,26,9350,5,9381,
DELHI,WEST,2021-02-12,20,8773,0,8793,
DELHI,WEST,2021-02-13,7,8398,4,8409,
DELHI,WEST,2021-02-14,28,7171,1,7200,
DELHI,WEST,2021-02-15,8,8663,1,8672,
GOA,NORTH GOA,2021-02-11,27,866,1,894,
GOA,NORTH GOA,2021-02-12,24,719,1,744,
GOA,NORTH GOA,2021-02-13,28,675,0,703,
GOA,NORTH GOA,2021-02-14,15,431,2,448,
GOA,NORTH GOA,2021-02-15,15,556,0,571,
GOA,SOUTH GOA,2021-02-11,16,773,0,789,
GOA,SOUTH GOA,2021-02-12,33,811,0,844,
GOA,SOUTH GOA,2021-02-13,32,632,0,664,
GOA,SOUTH GOA,2021-02-14,18,319,1,338,
GOA,SOUTH GOA,2021-02-15,22,803,0,825,
GUJARAT,AHMADABAD,2021-02-11,61,3941,44,4046,
GUJARAT,AHMADABAD,2021-02-12,91,3305,81,3477,
GUJARAT,AHMADABAD,2021-02-13,108,3413,52,3573,
GUJARAT,AHMADABAD,2021-02-14,153,1203,1,1357,
GUJARAT,AHMADABAD,2021-02-15,209,3745,65,4019,
GUJARAT,AMRELI,2021-02-11,0,477,0,477,
GUJARAT,AMRELI,2021-02-12,3,294,10,307,
GUJARAT,AMRELI,2021-02-13,1,303,0,304,
GUJARAT,AMRELI,2021-02-14,0,10,0,10,
GUJARAT,AMRELI,2021-02-15,5,449,10,464,
GUJARAT,ANAND,2021-02-11,8,259,14,281,
GUJARAT,ANAND,2021-02-12,18,264,0,282,
GUJARAT,ANAND,2021-02-13,17,284,1,302,
GUJARAT,ANAND,2021-02-14,2,53,0,55,
GUJARAT,ANAND,2021-02-15,5,266,6,277,
GUJARAT,ARVALLI,2021-02-11,1,259,2,262,
GUJARAT,ARVALLI,2021-02-12,2,250,0,252,
GUJARAT,ARVALLI,2021-02-13,1,236,0,237,
GUJARAT,ARVALLI,2021-02-14,1,22,1,24,
GUJARAT,ARVALLI,2021-02-15,0,298,3,301,
GUJARAT,BANAS KANTHA,2021-02-11,1,232,0,233,
GUJARAT,BANAS KANTHA,2021-02-12,1,366,0,367,
GUJARAT,BANAS KANTHA,2021-02-13,0,294,0,294,
GUJARAT,BANAS KANTHA,2021-02-14,1,9,0,10,
GUJARAT,BANAS KANTHA,2021-02-15,0,280,0,280,
GUJARAT,BHARUCH,2021-02-11,2,457,3,462,
GUJARAT,BHARUCH,2021-02-12,0,460,3,463,
GUJARAT,BHARUCH,2021-02-13,3,352,2,357,
GUJARAT,BHARUCH,2021-02-14,3,135,0,138,
GUJARAT,BHARUCH,2021-02-15,4,404,0,408,
GUJARAT,BHAVNAGAR,2021-02-11,4,621,0,625,
GUJARAT,BHAVNAGAR,2021-02-12,6,671,0,677,
GUJARAT,BHAVNAGAR,2021-02-13,7,662,0,669,
GUJARAT,BHAVNAGAR,2021-02-14,6,301,0,307,
GUJARAT,BHAVNAGAR,2021-02-15,3,481,0,484,
GUJARAT,BOTAD,2021-02-11,0,167,0,167,
GUJARAT,BOTAD,2021-02-12,1,200,0,201,
GUJARAT,BOTAD,2021-02-13,0,148,0,148,
GUJARAT,BOTAD,2021-02-14,0,79,0,79,
GUJARAT,BOTAD,2021-02-15,0,207,0,207,
GUJARAT,CHHOTAUDEPUR,2021-02-11,0,131,0,131,
GUJARAT,CHHOTAUDEPUR,2021-02-12,1,116,0,117,
GUJARAT,CHHOTAUDEPUR,2021-02-13,0,56,0,56,
GUJARAT,CHHOTAUDEPUR,2021-02-14,1,41,0,42,
GUJARAT,CHHOTAUDEPUR,2021-02-15,0,230,0,230,
GUJARAT,DANG,2021-02-11,0,51,0,51,
GUJARAT,DANG,2021-02-12,0,23,0,23,
GUJARAT,DANG,2021-02-13,0,42,0,42,
GUJARAT,DANG,2021-02-14,0,1,0,1,
GUJARAT,DANG,2021-02-15,0,37,0,37,
GUJARAT,DEVBHUMI DWARKA,2021-02-11,4,160,0,164,
GUJARAT,DEVBHUMI DWARKA,2021-02-12,6,211,0,217,
GUJARAT,DEVBHUMI DWARKA,2021-02-13,3,102,0,105,
GUJARAT,DEVBHUMI DWARKA,2021-02-14,4,126,1,131,
GUJARAT,DEVBHUMI DWARKA,2021-02-15,3,125,1,129,
GUJARAT,DOHAD,2021-02-11,4,466,0,470,
GUJARAT,DOHAD,2021-02-12,2,350,0,352,
GUJARAT,DOHAD,2021-02-13,3,346,0,349,
GUJARAT,DOHAD,2021-02-14,3,251,0,254,
GUJARAT,DOHAD,2021-02-15,1,428,1,430,
GUJARAT,GANDHINAGAR,2021-02-11,7,583,1,591,
GUJARAT,GANDHINAGAR,2021-02-12,17,677,2,696,
GUJARAT,GANDHINAGAR,2021-02-13,7,549,4,560,
GUJARAT,GANDHINAGAR,2021-02-14,12,246,0,258,
GUJARAT,GANDHINAGAR,2021-02-15,9,613,2,624,
GUJARAT,GIR SOMNATH,2021-02-11,9,434,0,443,
GUJARAT,GIR SOMNATH,2021-02-12,4,384,0,388,
GUJARAT,GIR SOMNATH,2021-02-13,6,175,1,182,
GUJARAT,GIR SOMNATH,2021-02-14,12,58,0,70,
GUJARAT,GIR SOMNATH,2021-02-15,10,342,0,352,
GUJARAT,JAMNAGAR,2021-02-11,10,1035,1,1046,
GUJARAT,JAMNAGAR,2021-02-12,7,936,0,943,
GUJARAT,JAMNAGAR,2021-02-13,3,721,4,728,
GUJARAT,JAMNAGAR,2021-02-14,9,320,0,329,
GUJARAT,JAMNAGAR,2021-02-15,19,847,1,867,
GUJARAT,JUNAGADH,2021-02-11,0,585,0,585,
GUJARAT,JUNAGADH,2021-02-12,3,548,1,552,
GUJARAT,JUNAGADH,2021-02-13,4,695,0,699,
GUJARAT,JUNAGADH,2021-02-14,2,205,0,207,
GUJARAT,JUNAGADH,2021-02-15,9,480,0,489,
GUJARAT,KACHCHH,2021-02-11,22,369,8,399,
GUJARAT,KACHCHH,2021-02-12,19,544,42,605,
GUJARAT,KACHCHH,2021-02-13,19,412,22,453,
GUJARAT,KACHCHH,2021-02-14,12,347,0,359,
GUJARAT,KACHCHH,2021-02-15,17,455,2,474,
GUJARAT,KHEDA,2021-02-11,22,628,2,652,
GUJARAT,KHEDA,2021-02-12,6,527,4,537,
GUJARAT,KHEDA,2021-02-13,7,328,1,336,
GUJARAT,KHEDA,2021-02-14,5,75,0,80,
GUJARAT,KHEDA,2021-02-15,2,278,2,282,
GUJARAT,MAHESANA,2021-02-11,2,438,1,441,
GUJARAT,MAHESANA,2021-02-12,2,394,2,398,
GUJARAT,MAHESANA,2021-02-13,5,273,0,278,
GUJARAT,MAHESANA,2021-02-14,0,138,0,138,
GUJARAT,MAHESANA,2021-02-15,0,273,1,274,
GUJARAT,MAHISAGAR,2021-02-11,6,310,0,316,
GUJARAT,MAHISAGAR,2021-02-12,3,366,11,380,
GUJARAT,MAHISAGAR,2021-02-13,4,357,7,368,
GUJARAT,MAHISAGAR,2021-02-14,2,143,0,145,
GUJARAT,MAHISAGAR,2021-02-15,2,147,0,149,
GUJARAT,MORBI,2021-02-11,1,389,4,394,
GUJARAT,MORBI,2021-02-12,5,277,20,302,
GUJARAT,MORBI,2021-02-13,2,262,9,273,
GUJARAT,MORBI,2021-02-14,2,72,18,92,
GUJARAT,MORBI,2021-02-15,3,255,0,258,
GUJARAT,NARMADA,2021-02-11,0,24,0,24,
GUJARAT,NARMADA,2021-02-12,1,17,2,20,
GUJARAT,NARMADA,2021-02-13,2,38,0,40,
GUJARAT,NARMADA,2021-02-14,5,50,0,55,
GUJARAT,NARMADA,2021-02-15,0,45,0,45,
GUJARAT,NAVSARI,2021-02-11,2,211,6,219,
GUJARAT,NAVSARI,2021-02-12,3,269,0,272,
GUJARAT,NAVSARI,2021-02-13,1,190,0,191,
GUJARAT,NAVSARI,2021-02-14,1,151,1,153,
GUJARAT,NAVSARI,2021-02-15,2,298,0,300,
GUJARAT,PANCH MAHALS,2021-02-11,3,377,0,380,
GUJARAT,PANCH MAHALS,2021-02-12,7,281,0,288,
GUJARAT,PANCH MAHALS,2021-02-13,5,287,0,292,
GUJARAT,PANCH MAHALS,2021-02-14,2,171,1,174,
GUJARAT,PANCH MAHALS,2021-02-15,3,98,0,101,
GUJARAT,PATAN,2021-02-11,1,395,2,398,
GUJARAT,PATAN,2021-02-12,0,587,0,587,
GUJARAT,PATAN,2021-02-13,2,528,0,530,
GUJARAT,PATAN,2021-02-14,1,288,0,289,
GUJARAT,PATAN,2021-02-15,1,573,3,577,
GUJARAT,PORBANDAR,2021-02-11,0,469,0,469,
GUJARAT,PORBANDAR,2021-02-12,0,910,0,910,
GUJARAT,PORBANDAR,2021-02-13,0,746,0,746,
GUJARAT,PORBANDAR,2021-02-14,1,225,0,226,
GUJARAT,PORBANDAR,2021-02-15,1,524,0,525,
GUJARAT,RAJKOT,2021-02-11,33,1388,21,1442,
GUJARAT,RAJKOT,2021-02-12,57,1407,10,1474,
GUJARAT,RAJKOT,2021-02-13,41,1220,7,1268,
GUJARAT,RAJKOT,2021-02-14,14,343,36,393,
GUJARAT,RAJKOT,2021-02-15,26,1403,16,1445,
GUJARAT,SABAR KANTHA,2021-02-11,0,143,23,166,
GUJARAT,SABAR KANTHA,2021-02-12,7,135,3,145,
GUJARAT,SABAR KANTHA,2021-02-13,3,89,16,108,
GUJARAT,SABAR KANTHA,2021-02-14,3,28,2,33,
GUJARAT,SABAR KANTHA,2021-02-15,3,140,11,154,
GUJARAT,SURAT,2021-02-11,28,1452,12,1492,
GUJARAT,SURAT,2021-02-12,37,1777,7,1821,
GUJARAT,SURAT,2021-02-13,35,1529,5,1569,
GUJARAT,SURAT,2021-02-14,21,468,1,490,
GUJARAT,SURAT,2021-02-15,44,1699,2,1745,
GUJARAT,SURENDRANAGAR,2021-02-11,0,584,0,584,
GUJARAT,SURENDRANAGAR,2021-02-12,2,675,0,677,
GUJARAT,SURENDRANAGAR,2021-02-13,1,508,1,510,
GUJARAT,SURENDRANAGAR,2021-02-14,0,135,0,135,
GUJARAT,SURENDRANAGAR,2021-02-15,0,679,0,679,
GUJARAT,TAPI,2021-02-11,2,522,2,526,
GUJARAT,TAPI,2021-02-12,0,378,0,378,
GUJARAT,TAPI,2021-02-13,2,308,0,310,
GUJARAT,TAPI,2021-02-14,1,119,1,121,
GUJARAT,TAPI,2021-02-15,5,294,0,299,
GUJARAT,VADODARA,2021-02-11,44,1713,49,1806,
GUJARAT,VADODARA,2021-02-12,51,1474,33,1558,
GUJARAT,VADODARA,2021-02-13,34,1266,36,1336,
GUJARAT,VADODARA,2021-02-14,34,444,15,493,
GUJARAT,VADODARA,2021-02-15,48,1139,32,1219,
GUJARAT,VALSAD,2021-02-11,1,410,0,411,
GUJARAT,VALSAD,2021-02-12,0,306,0,306,
GUJARAT,VALSAD,2021-02-13,1,310,17,328,
GUJARAT,VALSAD,2021-02-14,3,181,0,184,
GUJARAT,VALSAD,2021-02-15,1,368,0,369,
HARYANA,AMBALA,2021-02-11,7,1527,35,1569,
HARYANA,AMBALA,2021-02-12,19,1741,174,1934,
HARYANA,AMBALA,2021-02-13,20,887,23,930,
HARYANA,AMBALA,2021-02-14,8,162,2,172,
HARYANA,AMBALA,2021-02-15,13,817,18,848,
HARYANA,BHIWANI,2021-02-11,3,401,1,405,
HARYANA,BHIWANI,2021-02-12,0,649,0,649,
HARYANA,BHIWANI,2021-02-13,3,866,0,869,
HARYANA,BHIWANI,2021-02-14,0,650,0,650,
HARYANA,BHIWANI,2021-02-15,2,537,0,539,
HARYANA,CHARKI DADRI,2021-02-11,0,592,0,592,
HARYANA,CHARKI DADRI,2021-02-12,0,363,0,363,
HARYANA,CHARKI DADRI,2021-02-13,0,672,1,673,
HARYANA,CHARKI DADRI,2021-02-14,1,404,0,405,
HARYANA,CHARKI DADRI,2021-02-15,0,281,0,281,
HARYANA,FARIDABAD,2021-02-11,10,1177,2,1189,
HARYANA,FARIDABAD,2021-02-12,5,1981,13,1999,
HARYANA,FARIDABAD,2021-02-13,8,1526,16,1550,
HARYANA,FARIDABAD,2021-02-14,8,639,89,736,
HARYANA,FARIDABAD,2021-02-15,11,1056,3,1070,
HARYANA,FATEHABAD,2021-02-11,2,678,2,682,
HARYANA,FATEHABAD,2021-02-12,2,512,9,523,
HARYANA,FATEHABAD,2021-02-13,0,170,14,184,
HARYANA,FATEHABAD,2021-02-14,0,22,2,24,
HARYANA,FATEHABAD,2021-02-15,1,220,1,222,
HARYANA,GURUGRAM,2021-02-11,40,2998,6,3044,
HARYANA,GURUGRAM,2021-02-12,34,3659,3,3696,
HARYANA,GURUGRAM,2021-02-13,35,2868,5,2908,
HARYANA,GURUGRAM,2021-02-14,44,2553,4,2601,
HARYANA,GURUGRAM,2021-02-15,43,2848,8,2899,
HARYANA,HISAR,2021-02-11,1,1588,1,1590,
HARYANA,HISAR,2021-02-12,2,1365,1,1368,
HARYANA,HISAR,2021-02-13,3,827,0,830,
HARYANA,HISAR,2021-02-14,1,476,4,481,
HARYANA,HISAR,2021-02-15,2,1709,1,1712,
HARYANA,JHAJJAR,2021-02-11,0,1263,0,1263,
HARYANA,JHAJJAR,2021-02-12,0,1232,1,1233,
HARYANA,JHAJJAR,2021-02-13,0,2083,0,2083,
HARYANA,JHAJJAR,2021-02-14,0,1386,0,1386,
HARYANA,JHAJJAR,2021-02-15,1,933,2,936,
HARYANA,JIND,2021-02-11,5,596,1,602,
HARYANA,JIND,2021-02-12,3,311,0,314,
HARYANA,JIND,2021-02-13,2,270,3,275,
HARYANA,JIND,2021-02-14,0,282,0,282,
HARYANA,JIND,2021-02-15,1,237,0,238,
HARYANA,KAITHAL,2021-02-11,2,590,5,597,
HARYANA,KAITHAL,2021-02-12,2,368,1,371,
HARYANA,KAITHAL,2021-02-13,2,409,9,420,
HARYANA,KAITHAL,2021-02-14,1,33,0,34,
HARYANA,KAITHAL,2021-02-15,6,259,0,265,
HARYANA,KARNAL,2021-02-11,5,957,3,965,
HARYANA,KARNAL,2021-02-12,19,1422,2,1443,
HARYANA,KARNAL,2021-02-13,9,1942,5,1956,
HARYANA,KARNAL,2021-02-14,4,164,1,169,
HARYANA,KARNAL,2021-02-15,15,966,2,983,
HARYANA,KURUKSHETRA,2021-02-11,5,1619,7,1631,
HARYANA,KURUKSHETRA,2021-02-12,4,1055,46,1105,
HARYANA,KURUKSHETRA,2021-02-13,9,1435,8,1452,
HARYANA,KURUKSHETRA,2021-02-14,6,862,3,871,
HARYANA,KURUKSHETRA,2021-02-15,8,977,2,987,
HARYANA,MAHENDRAGARH,2021-02-11,0,260,2,262,
HARYANA,MAHENDRAGARH,2021-02-12,1,47,1,49,
HARYANA,MAHENDRAGARH,2021-02-13,0,403,0,403,
HARYANA,MAHENDRAGARH,2021-02-14,0,179,0,179,
HARYANA,MAHENDRAGARH,2021-02-15,0,470,0,470,
HARYANA,NUH,2021-02-11,0,550,1,551,
HARYANA,NUH,2021-02-12,0,434,0,434,
HARYANA,NUH,2021-02-13,0,347,0,347,
HARYANA,NUH,2021-02-14,0,51,0,51,
HARYANA,NUH,2021-02-15,0,660,0,660,
HARYANA,PALWAL,2021-02-11,0,195,0,195,
HARYANA,PALWAL,2021-02-12,1,327,0,328,
HARYANA,PALWAL,2021-02-13,1,523,0,524,
HARYANA,PALWAL,2021-02-14,1,19,0,20,
HARYANA,PALWAL,2021-02-15,0,41,0,41,
HARYANA,PANCHKULA,2021-02-11,10,708,13,731,
HARYANA,PANCHKULA,2021-02-12,27,679,17,723,
HARYANA,PANCHKULA,2021-02-13,25,694,6,725,
HARYANA,PANCHKULA,2021-02-14,6,176,4,186,
HARYANA,PANCHKULA,2021-02-15,18,753,5,776,
HARYANA,PANIPAT,2021-02-11,2,559,1,562,
HARYANA,PANIPAT,2021-02-12,6,451,1,458,
HARYANA,PANIPAT,2021-02-13,9,578,1,588,
HARYANA,PANIPAT,2021-02-14,10,116,0,126,
HARYANA,PANIPAT,2021-02-15,13,661,0,674,
HARYANA,REWARI,2021-02-11,2,539,8,549,
HARYANA,REWARI,2021-02-12,0,718,8,726,
HARYANA,REWARI,2021-02-13,1,532,2,535,
HARYANA,REWARI,2021-02-14,0,307,0,307,
HARYANA,REWARI,2021-02-15,0,564,1,565,
HARYANA,ROHTAK,2021-02-11,3,793,0,796,
HARYANA,ROHTAK,2021-02-12,5,1042,1,1048,
HARYANA,ROHTAK,2021-02-13,7,361,0,368,
HARYANA,ROHTAK,2021-02-14,4,575,1,580,
HARYANA,ROHTAK,2021-02-15,3,456,0,459,
HARYANA,SIRSA,2021-02-11,2,1045,20,1067,
HARYANA,SIRSA,2021-02-12,4,1258,17,1279,
HARYANA,SIRSA,2021-02-13,1,665,4,670,
HARYANA,SIRSA,2021-02-14,2,610,21,633,
HARYANA,SIRSA,2021-02-15,0,984,5,989,
HARYANA,SONIPAT,2021-02-11,2,1341,0,1343,
HARYANA,SONIPAT,2021-02-12,0,1422,0,1422,
HARYANA,SONIPAT,2021-02-13,2,1567,0,1569,
HARYANA,SONIPAT,2021-02-14,3,667,0,670,
HARYANA,SONIPAT,2021-02-15,3,830,1,834,
HARYANA,YAMUNANAGAR,2021-02-11,28,1074,9,1111,
HARYANA,YAMUNANAGAR,2021-02-12,7,1063,0,1070,
HARYANA,YAMUNANAGAR,2021-02-13,1,736,1,738,
HARYANA,YAMUNANAGAR,2021-02-14,8,364,0,372,
HARYANA,YAMUNANAGAR,2021-02-15,12,912,3,927,
HIMACHAL PRADESH,BILASPUR,2021-02-11,5,1009,1,1015,
HIMACHAL PRADESH,BILASPUR,2021-02-12,5,788,2,795,
HIMACHAL PRADESH,BILASPUR,2021-02-13,1,383,0,384,
HIMACHAL PRADESH,BILASPUR,2021-02-14,0,84,0,84,
HIMACHAL PRADESH,BILASPUR,2021-02-15,0,541,0,541,
HIMACHAL PRADESH,CHAMBA,2021-02-11,1,363,1,365,
HIMACHAL PRADESH,CHAMBA,2021-02-12,0,745,3,748,
HIMACHAL PRADESH,CHAMBA,2021-02-13,3,772,5,780,
HIMACHAL PRADESH,CHAMBA,2021-02-14,1,232,3,236,
HIMACHAL PRADESH,CHAMBA,2021-02-15,0,321,1,322,
HIMACHAL PRADESH,HAMIRPUR,2021-02-11,2,434,2,438,
HIMACHAL PRADESH,HAMIRPUR,2021-02-12,1,337,1,339,
HIMACHAL PRADESH,HAMIRPUR,2021-02-13,0,373,1,374,
HIMACHAL PRADESH,HAMIRPUR,2021-02-14,2,266,1,269,
HIMACHAL PRADESH,HAMIRPUR,2021-02-15,0,120,0,120,
HIMACHAL PRADESH,KANGRA,2021-02-11,6,1162,1,1169,
HIMACHAL PRADESH,KANGRA,2021-02-12,2,1873,2,1877,
HIMACHAL PRADESH,KANGRA,2021-02-13,8,2439,0,2447,
HIMACHAL PRADESH,KANGRA,2021-02-14,1,1711,2,1714,
HIMACHAL PRADESH,KANGRA,2021-02-15,10,3127,2,3139,
HIMACHAL PRADESH,KINNAUR,2021-02-11,1,63,0,64,
HIMACHAL PRADESH,KINNAUR,2021-02-12,0,12,0,12,
HIMACHAL PRADESH,KINNAUR,2021-02-13,0,7,0,7,
HIMACHAL PRADESH,KINNAUR,2021-02-14,1,2,0,3,
HIMACHAL PRADESH,KINNAUR,2021-02-15,1,15,0,16,
HIMACHAL PRADESH,KULLU,2021-02-11,2,445,7,454,
HIMACHAL PRADESH,KULLU,2021-02-12,1,316,1,318,
HIMACHAL PRADESH,KULLU,2021-02-13,2,139,1,142,
HIMACHAL PRADESH,KULLU,2021-02-14,0,135,7,142,
HIMACHAL PRADESH,KULLU,2021-02-15,0,216,0,216,
HIMACHAL PRADESH,LAHUL AND SPITI,2021-02-11,0,1,0,1,
HIMACHAL PRADESH,LAHUL AND SPITI,2021-02-13,0,1,0,1,
HIMACHAL PRADESH,LAHUL AND SPITI,2021-02-14,0,2,0,2,
HIMACHAL PRADESH,MANDI,2021-02-11,9,851,29,889,
HIMACHAL PRADESH,MANDI,2021-02-12,21,1146,23,1190,
HIMACHAL PRADESH,MANDI,2021-02-13,6,553,12,571,
HIMACHAL PRADESH,MANDI,2021-02-14,1,116,3,120,
HIMACHAL PRADESH,MANDI,2021-02-15,4,519,0,523,
HIMACHAL PRADESH,SHIMLA,2021-02-11,2,538,3,543,
HIMACHAL PRADESH,SHIMLA,2021-02-12,8,449,10,467,
HIMACHAL PRADESH,SHIMLA,2021-02-13,7,457,8,472,
HIMACHAL PRADESH,SHIMLA,2021-02-14,1,144,4,149,
HIMACHAL PRADESH,SHIMLA,2021-02-15,1,459,1,461,
HIMACHAL PRADESH,SIRMAUR,2021-02-11,2,370,0,372,
HIMACHAL PRADESH,SIRMAUR,2021-02-12,5,655,0,660,
HIMACHAL PRADESH,SIRMAUR,2021-02-13,8,763,1,772,
HIMACHAL PRADESH,SIRMAUR,2021-02-14,2,108,0,110,
HIMACHAL PRADESH,SIRMAUR,2021-02-15,2,413,1,416,
HIMACHAL PRADESH,SOLAN,2021-02-11,1,614,0,615,
HIMACHAL PRADESH,SOLAN,2021-02-12,5,380,0,385,
HIMACHAL PRADESH,SOLAN,2021-02-13,1,613,1,615,
HIMACHAL PRADESH,SOLAN,2021-02-14,3,271,0,274,
HIMACHAL PRADESH,SOLAN,2021-02-15,0,203,0,203,
HIMACHAL PRADESH,UNA,2021-02-11,23,534,8,565,
HIMACHAL PRADESH,UNA,2021-02-12,4,406,0,410,
HIMACHAL PRADESH,UNA,2021-02-13,6,402,0,408,
HIMACHAL PRADESH,UNA,2021-02-14,1,110,0,111,
HIMACHAL PRADESH,UNA,2021-02-15,11,337,0,348,
INDIA,INDIA,2021-02-11,2,6,0,8,
INDIA,INDIA,2021-02-12,2,2,0,4,
INDIA,INDIA,2021-02-13,1,1,0,2,
INDIA,INDIA,2021-02-14,6,2,0,8,
INDIA,INDIA,2021-02-15,1,0,0,1,
JAMMU AND KASHMIR,ANANTNAG,2021-02-11,11,337,1,349,
JAMMU AND KASHMIR,ANANTNAG,2021-02-12,4,401,0,405,
JAMMU AND KASHMIR,ANANTNAG,2021-02-13,6,412,0,418,
JAMMU AND KASHMIR,ANANTNAG,2021-02-14,3,145,0,148,
JAMMU AND KASHMIR,ANANTNAG,2021-02-15,12,320,0,332,
JAMMU AND KASHMIR,BANDIPORA,2021-02-11,1,57,2,60,
JAMMU AND KASHMIR,BANDIPORA,2021-02-12,0,26,0,26,
JAMMU AND KASHMIR,BANDIPORA,2021-02-13,0,41,0,41,
JAMMU AND KASHMIR,BANDIPORA,2021-02-14,0,6,0,6,
JAMMU AND KASHMIR,BANDIPORA,2021-02-15,0,109,0,109,
JAMMU AND KASHMIR,BARAMULLA,2021-02-11,4,216,0,220,
JAMMU AND KASHMIR,BARAMULLA,2021-02-12,1,313,0,314,
JAMMU AND KASHMIR,BARAMULLA,2021-02-13,2,396,0,398,
JAMMU AND KASHMIR,BARAMULLA,2021-02-14,3,86,0,89,
JAMMU AND KASHMIR,BARAMULLA,2021-02-15,5,404,0,409,
JAMMU AND KASHMIR,BUDGAM,2021-02-11,4,616,0,620,
JAMMU AND KASHMIR,BUDGAM,2021-02-12,2,588,0,590,
JAMMU AND KASHMIR,BUDGAM,2021-02-13,4,628,1,633,
JAMMU AND KASHMIR,BUDGAM,2021-02-14,1,272,0,273,
JAMMU AND KASHMIR,BUDGAM,2021-02-15,6,858,0,864,
JAMMU AND KASHMIR,DODA,2021-02-11,2,45,0,47,
JAMMU AND KASHMIR,DODA,2021-02-12,0,12,0,12,
JAMMU AND KASHMIR,DODA,2021-02-13,0,12,0,12,
JAMMU AND KASHMIR,DODA,2021-02-14,1,20,0,21,
JAMMU AND KASHMIR,DODA,2021-02-15,2,35,0,37,
JAMMU AND KASHMIR,GANDERBAL,2021-02-11,1,101,0,102,
JAMMU AND KASHMIR,GANDERBAL,2021-02-12,1,179,0,180,
JAMMU AND KASHMIR,GANDERBAL,2021-02-13,1,119,0,120,
JAMMU AND KASHMIR,GANDERBAL,2021-02-14,0,77,0,77,
JAMMU AND KASHMIR,GANDERBAL,2021-02-15,10,148,0,158,
JAMMU AND KASHMIR,JAMMU,2021-02-11,7,476,0,483,
JAMMU AND KASHMIR,JAMMU,2021-02-12,22,596,1,619,
JAMMU AND KASHMIR,JAMMU,2021-02-13,11,530,1,542,
JAMMU AND KASHMIR,JAMMU,2021-02-14,6,400,0,406,
JAMMU AND KASHMIR,JAMMU,2021-02-15,4,493,0,497,
JAMMU AND KASHMIR,KATHUA,2021-02-11,0,75,0,75,
JAMMU AND KASHMIR,KATHUA,2021-02-12,4,155,0,159,
JAMMU AND KASHMIR,KATHUA,2021-02-13,0,84,0,84,
JAMMU AND KASHMIR,KATHUA,2021-02-14,0,31,0,31,
JAMMU AND KASHMIR,KATHUA,2021-02-15,0,160,0,160,
JAMMU AND KASHMIR,KISHTWAR,2021-02-11,2,125,0,127,
JAMMU AND KASHMIR,KISHTWAR,2021-02-12,1,73,0,74,
JAMMU AND KASHMIR,KISHTWAR,2021-02-13,0,41,0,41,
JAMMU AND KASHMIR,KISHTWAR,2021-02-14,0,30,0,30,
JAMMU AND KASHMIR,KISHTWAR,2021-02-15,6,61,0,67,
JAMMU AND KASHMIR,KULGAM,2021-02-11,0,229,0,229,
JAMMU AND KASHMIR,KULGAM,2021-02-12,1,160,0,161,
JAMMU AND KASHMIR,KULGAM,2021-02-13,0,165,0,165,
JAMMU AND KASHMIR,KULGAM,2021-02-14,0,10,0,10,
JAMMU AND KASHMIR,KULGAM,2021-02-15,2,147,0,149,
JAMMU AND KASHMIR,KUPWARA,2021-02-11,0,33,0,33,
JAMMU AND KASHMIR,KUPWARA,2021-02-12,0,46,0,46,
JAMMU AND KASHMIR,KUPWARA,2021-02-13,1,206,0,207,
JAMMU AND KASHMIR,KUPWARA,2021-02-14,2,6,0,8,
JAMMU AND KASHMIR,KUPWARA,2021-02-15,4,60,0,64,
JAMMU AND KASHMIR,POONCH,2021-02-11,5,200,0,205,
JAMMU AND KASHMIR,POONCH,2021-02-12,8,295,0,303,
JAMMU AND KASHMIR,POONCH,2021-02-13,0,234,0,234,
JAMMU AND KASHMIR,POONCH,2021-02-14,0,162,0,162,
JAMMU AND KASHMIR,POONCH,2021-02-15,1,330,0,331,
JAMMU AND KASHMIR,PULWAMA,2021-02-11,4,436,1,441,
JAMMU AND KASHMIR,PULWAMA,2021-02-12,5,396,0,401,
JAMMU AND KASHMIR,PULWAMA,2021-02-13,5,362,1,368,
JAMMU AND KASHMIR,PULWAMA,2021-02-14,3,153,0,156,
JAMMU AND KASHMIR,PULWAMA,2021-02-15,10,521,0,531,
JAMMU AND KASHMIR,RAJOURI,2021-02-11,1,76,0,77,
JAMMU AND KASHMIR,RAJOURI,2021-02-12,0,172,0,172,
JAMMU AND KASHMIR,RAJOURI,2021-02-13,0,180,0,180,
JAMMU AND KASHMIR,RAJOURI,2021-02-14,0,29,0,29,
JAMMU AND KASHMIR,RAJOURI,2021-02-15,0,176,0,176,
JAMMU AND KASHMIR,RAMBAN,2021-02-11,3,137,0,140,
JAMMU AND KASHMIR,RAMBAN,2021-02-12,0,194,4,198,
JAMMU AND KASHMIR,RAMBAN,2021-02-13,0,204,0,204,
JAMMU AND KASHMIR,RAMBAN,2021-02-14,3,98,0,101,
JAMMU AND KASHMIR,RAMBAN,2021-02-15,0,79,0,79,
JAMMU AND KASHMIR,REASI,2021-02-11,4,141,0,145,
JAMMU AND KASHMIR,REASI,2021-02-12,3,113,1,117,
JAMMU AND KASHMIR,REASI,2021-02-13,1,107,0,108,
JAMMU AND KASHMIR,REASI,2021-02-14,0,45,0,45,
JAMMU AND KASHMIR,REASI,2021-02-15,1,116,0,117,
JAMMU AND KASHMIR,SAMBA,2021-02-11,0,116,0,116,
JAMMU AND KASHMIR,SAMBA,2021-02-12,0,190,0,190,
JAMMU AND KASHMIR,SAMBA,2021-02-13,1,15,0,16,
JAMMU AND KASHMIR,SAMBA,2021-02-14,0,109,0,109,
JAMMU AND KASHMIR,SAMBA,2021-02-15,0,155,0,155,
JAMMU AND KASHMIR,SHOPIAN,2021-02-11,1,55,0,56,
JAMMU AND KASHMIR,SHOPIAN,2021-02-12,2,210,0,212,
JAMMU AND KASHMIR,SHOPIAN,2021-02-13,0,282,0,282,
JAMMU AND KASHMIR,SHOPIAN,2021-02-14,0,95,0,95,
JAMMU AND KASHMIR,SHOPIAN,2021-02-15,3,298,0,301,
JAMMU AND KASHMIR,SRINAGAR,2021-02-11,35,3463,3,3501,
JAMMU AND KASHMIR,SRINAGAR,2021-02-12,40,3017,3,3060,
JAMMU AND KASHMIR,SRINAGAR,2021-02-13,63,3707,8,3778,
JAMMU AND KASHMIR,SRINAGAR,2021-02-14,27,2013,0,2040,
JAMMU AND KASHMIR,SRINAGAR,2021-02-15,53,3446,2,3501,
JAMMU AND KASHMIR,UDHAMPUR,2021-02-11,2,537,0,539,
JAMMU AND KASHMIR,UDHAMPUR,2021-02-12,6,237,0,243,
JAMMU AND KASHMIR,UDHAMPUR,2021-02-13,3,402,0,405,
JAMMU AND KASHMIR,UDHAMPUR,2021-02-14,0,67,0,67,
JAMMU AND KASHMIR,UDHAMPUR,2021-02-15,1,1164,0,1165,
JHARKHAND,BOKARO,2021-02-11,2,582,5,589,
JHARKHAND,BOKARO,2021-02-12,0,371,0,371,
JHARKHAND,BOKARO,2021-02-13,0,458,2,460,
JHARKHAND,BOKARO,2021-02-14,0,101,3,104,
JHARKHAND,BOKARO,2021-02-15,1,478,3,482,
JHARKHAND,CHATRA,2021-02-11,0,25,0,25,
JHARKHAND,CHATRA,2021-02-12,0,323,0,323,
JHARKHAND,CHATRA,2021-02-13,0,222,0,222,
JHARKHAND,CHATRA,2021-02-14,0,591,0,591,
JHARKHAND,CHATRA,2021-02-15,0,208,0,208,
JHARKHAND,DEOGHAR,2021-02-11,1,551,0,552,
JHARKHAND,DEOGHAR,2021-02-12,1,750,3,754,
JHARKHAND,DEOGHAR,2021-02-13,4,1036,1,1041,
JHARKHAND,DEOGHAR,2021-02-14,0,1051,122,1173,
JHARKHAND,DEOGHAR,2021-02-15,1,743,375,1119,
JHARKHAND,DHANBAD,2021-02-11,22,1024,0,1046,
JHARKHAND,DHANBAD,2021-02-12,4,2898,2,2904,
JHARKHAND,DHANBAD,2021-02-13,2,482,0,484,
JHARKHAND,DHANBAD,2021-02-14,0,183,0,183,
JHARKHAND,DHANBAD,2021-02-15,1,273,0,274,
JHARKHAND,DUMKA,2021-02-11,0,179,0,179,
JHARKHAND,DUMKA,2021-02-12,2,177,0,179,
JHARKHAND,DUMKA,2021-02-13,1,278,0,279,
JHARKHAND,DUMKA,2021-02-14,4,198,79,281,
JHARKHAND,DUMKA,2021-02-15,1,222,201,424,
JHARKHAND,EAST SINGHBUM,2021-02-11,13,2377,1,2391,
JHARKHAND,EAST SINGHBUM,2021-02-12,9,2095,3,2107,
JHARKHAND,EAST SINGHBUM,2021-02-13,10,2577,0,2587,
JHARKHAND,EAST SINGHBUM,2021-02-14,13,2041,1,2055,
JHARKHAND,EAST SINGHBUM,2021-02-15,9,3465,0,3474,
JHARKHAND,GARHWA,2021-02-11,0,631,0,631,
JHARKHAND,GARHWA,2021-02-12,0,260,3,263,
JHARKHAND,GARHWA,2021-02-13,0,148,1,149,
JHARKHAND,GARHWA,2021-02-14,0,18,0,18,
JHARKHAND,GARHWA,2021-02-15,0,96,0,96,
JHARKHAND,GIRIDIH,2021-02-11,0,711,0,711,
JHARKHAND,GIRIDIH,2021-02-12,0,712,0,712,
JHARKHAND,GIRIDIH,2021-02-13,2,1787,0,1789,
JHARKHAND,GIRIDIH,2021-02-14,1,6197,1,6199,
JHARKHAND,GIRIDIH,2021-02-15,3,1124,0,1127,
JHARKHAND,GODDA,2021-02-11,0,358,0,358,
JHARKHAND,GODDA,2021-02-12,0,240,0,240,
JHARKHAND,GODDA,2021-02-13,0,171,0,171,
JHARKHAND,GODDA,2021-02-14,0,170,87,257,
JHARKHAND,GODDA,2021-02-15,0,102,137,239,
JHARKHAND,GUMLA,2021-02-11,0,1975,0,1975,
JHARKHAND,GUMLA,2021-02-12,34,2324,0,2358,
JHARKHAND,GUMLA,2021-02-13,1,2358,0,2359,
JHARKHAND,GUMLA,2021-02-14,4,3631,0,3635,
JHARKHAND,GUMLA,2021-02-15,8,3415,0,3423,
JHARKHAND,HAZARIBAGH,2021-02-11,1,467,0,468,
JHARKHAND,HAZARIBAGH,2021-02-12,1,765,0,766,
JHARKHAND,HAZARIBAGH,2021-02-13,0,464,0,464,
JHARKHAND,HAZARIBAGH,2021-02-14,0,9,0,9,
JHARKHAND,HAZARIBAGH,2021-02-15,0,269,0,269,
JHARKHAND,JAMTARA,2021-02-11,2,887,0,889,
JHARKHAND,JAMTARA,2021-02-12,1,523,0,524,
JHARKHAND,JAMTARA,2021-02-13,0,196,0,196,
JHARKHAND,JAMTARA,2021-02-14,0,162,0,162,
JHARKHAND,JAMTARA,2021-02-15,0,240,1,241,
JHARKHAND,KHUNTI,2021-02-11,1,423,0,424,
JHARKHAND,KHUNTI,2021-02-12,2,474,0,476,
JHARKHAND,KHUNTI,2021-02-13,0,241,0,241,
JHARKHAND,KHUNTI,2021-02-14,0,2,0,2,
JHARKHAND,KHUNTI,2021-02-15,0,284,8,292,
JHARKHAND,KODERMA,2021-02-11,9,964,1,974,
JHARKHAND,KODERMA,2021-02-12,0,251,0,251,
JHARKHAND,KODERMA,2021-02-13,1,150,0,151,
JHARKHAND,KODERMA,2021-02-14,0,6,0,6,
JHARKHAND,KODERMA,2021-02-15,0,544,1,545,
JHARKHAND,LATEHAR,2021-02-11,4,1406,0,1410,
JHARKHAND,LATEHAR,2021-02-12,0,751,0,751,
JHARKHAND,LATEHAR,2021-02-13,0,939,1,940,
JHARKHAND,LATEHAR,2021-02-14,1,1280,1,1282,
JHARKHAND,LATEHAR,2021-02-15,3,1121,0,1124,
JHARKHAND,LOHARDAGA,2021-02-11,0,1174,0,1174,
JHARKHAND,LOHARDAGA,2021-02-12,0,1135,0,1135,
JHARKHAND,LOHARDAGA,2021-02-13,0,473,0,473,
JHARKHAND,LOHARDAGA,2021-02-14,0,256,0,256,
JHARKHAND,LOHARDAGA,2021-02-15,0,293,1,294,
JHARKHAND,PAKUR,2021-02-11,1,3,0,4,
JHARKHAND,PAKUR,2021-02-12,0,2,0,2,
JHARKHAND,PAKUR,2021-02-13,0,154,0,154,
JHARKHAND,PAKUR,2021-02-14,0,295,142,437,
JHARKHAND,PAKUR,2021-02-15,0,81,130,211,
JHARKHAND,PALAMU,2021-02-11,2,1130,0,1132,
JHARKHAND,PALAMU,2021-02-12,5,952,0,957,
JHARKHAND,PALAMU,2021-02-13,0,1072,0,1072,
JHARKHAND,PALAMU,2021-02-14,0,389,0,389,
JHARKHAND,PALAMU,2021-02-15,1,182,0,183,
JHARKHAND,RAMGARH,2021-02-11,1,130,0,131,
JHARKHAND,RAMGARH,2021-02-12,0,157,0,157,
JHARKHAND,RAMGARH,2021-02-13,0,125,0,125,
JHARKHAND,RAMGARH,2021-02-14,0,69,0,69,
JHARKHAND,RAMGARH,2021-02-15,0,458,0,458,
JHARKHAND,RANCHI,2021-02-11,48,2519,2,2569,
JHARKHAND,RANCHI,2021-02-12,53,1986,1,2040,
JHARKHAND,RANCHI,2021-02-13,35,3125,0,3160,
JHARKHAND,RANCHI,2021-02-14,37,1459,1,1497,
JHARKHAND,RANCHI,2021-02-15,37,1176,0,1213,
JHARKHAND,SAHEBGANJ,2021-02-11,0,630,0,630,
JHARKHAND,SAHEBGANJ,2021-02-12,0,102,0,102,
JHARKHAND,SAHEBGANJ,2021-02-13,0,118,0,118,
JHARKHAND,SAHEBGANJ,2021-02-14,0,41,4,45,
JHARKHAND,SAHEBGANJ,2021-02-15,1,79,72,152,
JHARKHAND,SARAIKELA KHARSAWAN,2021-02-11,15,2821,0,2836,
JHARKHAND,SARAIKELA KHARSAWAN,2021-02-12,0,611,0,611,
JHARKHAND,SARAIKELA KHARSAWAN,2021-02-13,0,455,0,455,
JHARKHAND,SARAIKELA KHARSAWAN,2021-02-14,1,21,0,22,
JHARKHAND,SARAIKELA KHARSAWAN,2021-02-15,5,722,0,727,
JHARKHAND,SIMDEGA,2021-02-11,0,740,0,740,
JHARKHAND,SIMDEGA,2021-02-12,0,630,0,630,
JHARKHAND,SIMDEGA,2021-02-13,1,602,0,603,
JHARKHAND,SIMDEGA,2021-02-14,0,180,0,180,
JHARKHAND,SIMDEGA,2021-02-15,0,415,0,415,
JHARKHAND,WEST SINGHBHUM,2021-02-11,0,2229,3,2232,
JHARKHAND,WEST SINGHBHUM,2021-02-12,0,1043,0,1043,
JHARKHAND,WEST SINGHBHUM,2021-02-13,2,1232,0,1234,
JHARKHAND,WEST SINGHBHUM,2021-02-14,0,607,0,607,
JHARKHAND,WEST SINGHBHUM,2021-02-15,1,624,0,625,
KARNATAKA,BAGALKOTE,2021-02-11,1,1238,0,1239,
KARNATAKA,BAGALKOTE,2021-02-12,0,1547,0,1547,
KARNATAKA,BAGALKOTE,2021-02-13,0,906,1,907,
KARNATAKA,BAGALKOTE,2021-02-14,1,949,8,958,
KARNATAKA,BAGALKOTE,2021-02-15,0,639,0,639,
KARNATAKA,BALLARI,2021-02-11,4,1508,0,1512,
KARNATAKA,BALLARI,2021-02-12,2,1698,30,1730,
KARNATAKA,BALLARI,2021-02-13,2,1693,14,1709,
KARNATAKA,BALLARI,2021-02-14,4,849,13,866,
KARNATAKA,BALLARI,2021-02-15,2,643,6,651,
KARNATAKA,BELAGAVI,2021-02-11,7,2741,1,2749,
KARNATAKA,BELAGAVI,2021-02-12,5,3523,3,3531,
KARNATAKA,BELAGAVI,2021-02-13,2,2479,1,2482,
KARNATAKA,BELAGAVI,2021-02-14,3,120,0,123,
KARNATAKA,BELAGAVI,2021-02-15,11,1941,0,1952,
KARNATAKA,BENGALURU RURAL,2021-02-11,14,1365,0,1379,
KARNATAKA,BENGALURU RURAL,2021-02-12,8,1163,1,1172,
KARNATAKA,BENGALURU RURAL,2021-02-13,12,986,1,999,
KARNATAKA,BENGALURU RURAL,2021-02-14,4,722,0,726,
KARNATAKA,BENGALURU RURAL,2021-02-15,7,1114,1,1122,
KARNATAKA,BENGALURU URBAN,2021-02-11,220,26679,81,26980,
KARNATAKA,BENGALURU URBAN,2021-02-12,287,24608,48,24943,
KARNATAKA,BENGALURU URBAN,2021-02-13,286,23903,95,24284,
KARNATAKA,BENGALURU URBAN,2021-02-14,210,14171,5,14386,
KARNATAKA,BENGALURU URBAN,2021-02-15,290,21782,103,22175,
KARNATAKA,BIDAR,2021-02-11,14,873,0,887,
KARNATAKA,BIDAR,2021-02-12,2,847,0,849,
KARNATAKA,BIDAR,2021-02-13,3,594,1,598,
KARNATAKA,BIDAR,2021-02-14,2,615,0,617,
KARNATAKA,BIDAR,2021-02-15,11,143,0,154,
KARNATAKA,CHAMARAJANAGARA,2021-02-11,1,656,0,657,
KARNATAKA,CHAMARAJANAGARA,2021-02-12,4,628,0,632,
KARNATAKA,CHAMARAJANAGARA,2021-02-13,0,395,1,396,
KARNATAKA,CHAMARAJANAGARA,2021-02-14,1,547,0,548,
KARNATAKA,CHAMARAJANAGARA,2021-02-15,4,232,0,236,
KARNATAKA,CHIKKABALLAPURA,2021-02-11,2,1876,9,1887,
KARNATAKA,CHIKKABALLAPURA,2021-02-12,6,1527,10,1543,
KARNATAKA,CHIKKABALLAPURA,2021-02-13,0,1919,6,1925,
KARNATAKA,CHIKKABALLAPURA,2021-02-14,4,868,9,881,
KARNATAKA,CHIKKABALLAPURA,2021-02-15,2,960,7,969,
KARNATAKA,CHIKKAMAGALURU,2021-02-11,3,1366,9,1378,
KARNATAKA,CHIKKAMAGALURU,2021-02-12,3,1162,4,1169,
KARNATAKA,CHIKKAMAGALURU,2021-02-13,4,958,2,964,
KARNATAKA,CHIKKAMAGALURU,2021-02-14,4,853,2,859,
KARNATAKA,CHIKKAMAGALURU,2021-02-15,3,458,0,461,
KARNATAKA,CHITRADURGA,2021-02-11,5,1491,1,1497,
KARNATAKA,CHITRADURGA,2021-02-12,9,1591,15,1615,
KARNATAKA,CHITRADURGA,2021-02-13,10,1123,20,1153,
KARNATAKA,CHITRADURGA,2021-02-14,2,1179,1,1182,
KARNATAKA,CHITRADURGA,2021-02-15,11,1175,0,1186,
KARNATAKA,DAKSHINA KANNADA,2021-02-11,28,1369,3,1400,
KARNATAKA,DAKSHINA KANNADA,2021-02-12,20,1585,0,1605,
KARNATAKA,DAKSHINA KANNADA,2021-02-13,33,1305,0,1338,
KARNATAKA,DAKSHINA KANNADA,2021-02-14,9,1338,1,1348,
KARNATAKA,DAKSHINA KANNADA,2021-02-15,20,1384,2,1406,
KARNATAKA,DAVANGERE,2021-02-11,6,565,27,598,
KARNATAKA,DAVANGERE,2021-02-12,7,1004,1,1012,
KARNATAKA,DAVANGERE,2021-02-13,7,1160,34,1201,
KARNATAKA,DAVANGERE,2021-02-14,3,158,0,161,
KARNATAKA,DAVANGERE,2021-02-15,2,709,1,712,
KARNATAKA,DHARWAD,2021-02-11,7,1925,70,2002,
KARNATAKA,DHARWAD,2021-02-12,13,2216,36,2265,
KARNATAKA,DHARWAD,2021-02-13,17,1734,40,1791,
KARNATAKA,DHARWAD,2021-02-14,4,1123,33,1160,
KARNATAKA,DHARWAD,2021-02-15,3,382,0,385,
KARNATAKA,GADAG,2021-02-11,0,1520,16,1536,
KARNATAKA,GADAG,2021-02-12,1,1190,83,1274,
KARNATAKA,GADAG,2021-02-13,1,892,48,941,
KARNATAKA,GADAG,2021-02-14,1,791,85,877,
KARNATAKA,GADAG,2021-02-15,0,1076,38,1114,
KARNATAKA,HASSAN,2021-02-11,9,2587,95,2691,
KARNATAKA,HASSAN,2021-02-12,4,1418,76,1498,
KARNATAKA,HASSAN,2021-02-13,7,2362,71,2440,
KARNATAKA,HASSAN,2021-02-14,4,1414,0,1418,
KARNATAKA,HASSAN,2021-02-15,7,2189,134,2330,
KARNATAKA,HAVERI,2021-02-11,1,713,0,714,
KARNATAKA,HAVERI,2021-02-12,1,1023,0,1024,
KARNATAKA,HAVERI,2021-02-13,0,1012,0,1012,
KARNATAKA,HAVERI,2021-02-14,1,159,0,160,
KARNATAKA,HAVERI,2021-02-15,0,1088,0,1088,
KARNATAKA,KALABURAGI,2021-02-11,15,1664,12,1691,
KARNATAKA,KALABURAGI,2021-02-12,23,1053,6,1082,
KARNATAKA,KALABURAGI,2021-02-13,17,2030,7,2054,
KARNATAKA,KALABURAGI,2021-02-14,8,1049,4,1061,
KARNATAKA,KALABURAGI,2021-02-15,20,416,1,437,
KARNATAKA,KODAGU,2021-02-11,0,808,7,815,
KARNATAKA,KODAGU,2021-02-12,6,918,8,932,
KARNATAKA,KODAGU,2021-02-13,3,1283,20,1306,
KARNATAKA,KODAGU,2021-02-14,0,17,0,17,
KARNATAKA,KODAGU,2021-02-15,3,539,7,549,
KARNATAKA,KOLAR,2021-02-11,6,1755,2,1763,
KARNATAKA,KOLAR,2021-02-12,8,1386,0,1394,
KARNATAKA,KOLAR,2021-02-13,5,300,2,307,
KARNATAKA,KOLAR,2021-02-14,1,2765,0,2766,
KARNATAKA,KOLAR,2021-02-15,2,641,4,647,
KARNATAKA,KOPPAL,2021-02-11,0,675,1,676,
KARNATAKA,KOPPAL,2021-02-12,0,688,2,690,
KARNATAKA,KOPPAL,2021-02-13,2,767,5,774,
KARNATAKA,KOPPAL,2021-02-14,0,376,0,376,
KARNATAKA,KOPPAL,2021-02-15,1,91,0,92,
KARNATAKA,MANDYA,2021-02-11,8,1932,8,1948,
KARNATAKA,MANDYA,2021-02-12,5,1723,1,1729,
KARNATAKA,MANDYA,2021-02-13,9,1900,1,1910,
KARNATAKA,MANDYA,2021-02-14,6,903,0,909,
KARNATAKA,MANDYA,2021-02-15,0,1162,0,1162,
KARNATAKA,MYSURU,2021-02-11,26,2634,3,2663,
KARNATAKA,MYSURU,2021-02-12,16,2776,2,2794,
KARNATAKA,MYSURU,2021-02-13,36,2797,1,2834,
KARNATAKA,MYSURU,2021-02-14,15,1496,0,1511,
KARNATAKA,MYSURU,2021-02-15,19,2006,2,2027,
KARNATAKA,RAICHUR,2021-02-11,3,1053,12,1068,
KARNATAKA,RAICHUR,2021-02-12,3,804,0,807,
KARNATAKA,RAICHUR,2021-02-13,3,504,8,515,
KARNATAKA,RAICHUR,2021-02-14,2,678,21,701,
KARNATAKA,RAICHUR,2021-02-15,0,641,17,658,
KARNATAKA,RAMANAGARA,2021-02-11,0,1055,1,1056,
KARNATAKA,RAMANAGARA,2021-02-12,1,704,0,705,
KARNATAKA,RAMANAGARA,2021-02-13,0,707,1,708,
KARNATAKA,RAMANAGARA,2021-02-14,0,79,0,79,
KARNATAKA,RAMANAGARA,2021-02-15,0,493,0,493,
KARNATAKA,SHIVAMOGGA,2021-02-11,3,1167,16,1186,
KARNATAKA,SHIVAMOGGA,2021-02-12,9,1172,2,1183,
KARNATAKA,SHIVAMOGGA,2021-02-13,15,1083,36,1134,
KARNATAKA,SHIVAMOGGA,2021-02-14,1,426,0,427,
KARNATAKA,SHIVAMOGGA,2021-02-15,5,420,0,425,
KARNATAKA,TUMAKURU,2021-02-11,7,2340,3,2350,
KARNATAKA,TUMAKURU,2021-02-12,23,2666,3,2692,
KARNATAKA,TUMAKURU,2021-02-13,19,1101,3,1123,
KARNATAKA,TUMAKURU,2021-02-14,17,3248,23,3288,
KARNATAKA,TUMAKURU,2021-02-15,9,613,4,626,
KARNATAKA,UDUPI,2021-02-11,12,1243,1,1256,
KARNATAKA,UDUPI,2021-02-12,4,1089,0,1093,
KARNATAKA,UDUPI,2021-02-13,13,737,1,751,
KARNATAKA,UDUPI,2021-02-14,5,835,0,840,
KARNATAKA,UDUPI,2021-02-15,12,930,0,942,
KARNATAKA,UTTARA KANNADA,2021-02-11,2,1414,156,1572,
KARNATAKA,UTTARA KANNADA,2021-02-12,6,1373,312,1691,
KARNATAKA,UTTARA KANNADA,2021-02-13,1,1399,266,1666,
KARNATAKA,UTTARA KANNADA,2021-02-14,4,1549,77,1630,
KARNATAKA,UTTARA KANNADA,2021-02-15,4,1364,203,1571,
KARNATAKA,VIJAYAPURA,2021-02-11,1,1380,0,1381,
KARNATAKA,VIJAYAPURA,2021-02-12,5,1740,0,1745,
KARNATAKA,VIJAYAPURA,2021-02-13,8,1177,1,1186,
KARNATAKA,VIJAYAPURA,2021-02-14,0,1575,0,1575,
KARNATAKA,VIJAYAPURA,2021-02-15,4,505,0,509,
KARNATAKA,YADGIR,2021-02-11,0,1292,0,1292,
KARNATAKA,YADGIR,2021-02-12,2,848,0,850,
KARNATAKA,YADGIR,2021-02-13,2,932,1,935,
KARNATAKA,YADGIR,2021-02-14,1,891,0,892,
KARNATAKA,YADGIR,2021-02-15,0,358,0,358,
KERALA,ALAPPUZHA,2021-02-11,416,3519,4,3939,
KERALA,ALAPPUZHA,2021-02-12,426,3193,15,3634,
KERALA,ALAPPUZHA,2021-02-13,564,4743,37,5344,
KERALA,ALAPPUZHA,2021-02-14,322,2575,15,2912,
KERALA,ALAPPUZHA,2021-02-15,351,3281,5,3637,
KERALA,ERNAKULAM,2021-02-11,824,9078,25,9927,
KERALA,ERNAKULAM,2021-02-12,473,11554,25,12052,
KERALA,ERNAKULAM,2021-02-13,1008,11936,77,13021,
KERALA,ERNAKULAM,2021-02-14,382,4088,20,4490,
KERALA,ERNAKULAM,2021-02-15,647,6195,21,6863,
KERALA,IDUKKI,2021-02-11,195,1894,4,2093,
KERALA,IDUKKI,2021-02-12,198,1672,1,1871,
KERALA,IDUKKI,2021-02-13,287,2590,4,2881,
KERALA,IDUKKI,2021-02-14,78,993,3,1074,
KERALA,IDUKKI,2021-02-15,108,1480,2,1590,
KERALA,KANNUR,2021-02-11,321,3212,3,3536,
KERALA,KANNUR,2021-02-12,213,4012,5,4230,
KERALA,KANNUR,2021-02-13,339,3904,4,4247,
KERALA,KANNUR,2021-02-14,175,1662,0,1837,
KERALA,KANNUR,2021-02-15,152,2306,0,2458,
KERALA,KASARAGOD,2021-02-11,129,1884,1,2014,
KERALA,KASARAGOD,2021-02-12,141,2011,1,2153,
KERALA,KASARAGOD,2021-02-13,176,2329,16,2521,
KERALA,KASARAGOD,2021-02-14,59,1284,4,1347,
KERALA,KASARAGOD,2021-02-15,73,1065,2,1140,
KERALA,KOLLAM,2021-02-11,696,4962,0,5658,
KERALA,KOLLAM,2021-02-12,438,4095,0,4533,
KERALA,KOLLAM,2021-02-13,634,5888,6,6528,
KERALA,KOLLAM,2021-02-14,211,3237,5,3453,
KERALA,KOLLAM,2021-02-15,505,3964,7,4476,
KERALA,KOTTAYAM,2021-02-11,585,5044,54,5683,
KERALA,KOTTAYAM,2021-02-12,423,4927,24,5374,
KERALA,KOTTAYAM,2021-02-13,765,6006,47,6818,
KERALA,KOTTAYAM,2021-02-14,264,2124,27,2415,
KERALA,KOTTAYAM,2021-02-15,441,3739,12,4192,
KERALA,KOZHIKODE,2021-02-11,719,5394,51,6164,
KERALA,KOZHIKODE,2021-02-12,529,4748,36,5313,
KERALA,KOZHIKODE,2021-02-13,985,7738,59,8782,
KERALA,KOZHIKODE,2021-02-14,426,2659,20,3105,
KERALA,KOZHIKODE,2021-02-15,405,4412,21,4838,
KERALA,MALAPPURAM,2021-02-11,426,3876,4,4306,
KERALA,MALAPPURAM,2021-02-12,396,3443,5,3844,
KERALA,MALAPPURAM,2021-02-13,423,4716,8,5147,
KERALA,MALAPPURAM,2021-02-14,526,2805,3,3334,
KERALA,MALAPPURAM,2021-02-15,614,4148,8,4770,
KERALA,PALAKKAD,2021-02-11,302,3376,0,3678,
KERALA,PALAKKAD,2021-02-12,111,2032,0,2143,
KERALA,PALAKKAD,2021-02-13,264,3520,2,3786,
KERALA,PALAKKAD,2021-02-14,142,1440,1,1583,
KERALA,PALAKKAD,2021-02-15,208,2430,2,2640,
KERALA,PATHANAMTHITTA,2021-02-11,586,3337,5,3928,
KERALA,PATHANAMTHITTA,2021-02-12,498,2288,1,2787,
KERALA,PATHANAMTHITTA,2021-02-13,682,3762,5,4449,
KERALA,PATHANAMTHITTA,2021-02-14,166,977,0,1143,
KERALA,PATHANAMTHITTA,2021-02-15,483,2748,3,3234,
KERALA,THIRUVANANTHAPURAM,2021-02-11,524,6149,0,6673,
KERALA,THIRUVANANTHAPURAM,2021-02-12,369,4667,24,5060,
KERALA,THIRUVANANTHAPURAM,2021-02-13,616,8326,18,8960,
KERALA,THIRUVANANTHAPURAM,2021-02-14,285,3828,5,4118,
KERALA,THIRUVANANTHAPURAM,2021-02-15,476,5425,21,5922,
KERALA,THRISSUR,2021-02-11,556,5995,0,6551,
KERALA,THRISSUR,2021-02-12,448,6318,0,6766,
KERALA,THRISSUR,2021-02-13,638,7395,3,8036,
KERALA,THRISSUR,2021-02-14,308,2489,1,2798,
KERALA,THRISSUR,2021-02-15,334,4902,1,5237,
KERALA,WAYANAD,2021-02-11,235,1869,7,2111,
KERALA,WAYANAD,2021-02-12,72,976,13,1061,
KERALA,WAYANAD,2021-02-13,270,2876,32,3178,
KERALA,WAYANAD,2021-02-14,67,731,2,800,
KERALA,WAYANAD,2021-02-15,102,850,2,954,
LADAKH,KARGIL,2021-02-11,0,36,0,36,
LADAKH,KARGIL,2021-02-12,0,133,2,135,
LADAKH,KARGIL,2021-02-13,0,50,0,50,
LADAKH,KARGIL,2021-02-14,0,48,0,48,
LADAKH,KARGIL,2021-02-15,1,61,0,62,
LADAKH,LEH LADAKH,2021-02-11,1,115,3,119,
LADAKH,LEH LADAKH,2021-02-12,1,167,1,169,
LADAKH,LEH LADAKH,2021-02-13,3,190,1,194,
LADAKH,LEH LADAKH,2021-02-14,1,71,0,72,
LADAKH,LEH LADAKH,2021-02-15,6,190,0,196,
LAKSHADWEEP,LAKSHADWEEP DISTRICT,2021-02-11,1,299,0,300,
LAKSHADWEEP,LAKSHADWEEP DISTRICT,2021-02-12,4,452,0,456,
LAKSHADWEEP,LAKSHADWEEP DISTRICT,2021-02-13,3,554,0,557,
LAKSHADWEEP,LAKSHADWEEP DISTRICT,2021-02-14,2,393,0,395,
LAKSHADWEEP,LAKSHADWEEP DISTRICT,2021-02-15,5,1015,0,1020,
MADHYA PRADESH,AGAR MALWA,2021-02-11,0,189,0,189,
MADHYA PRADESH,AGAR MALWA,2021-02-12,0,42,0,42,
MADHYA PRADESH,AGAR MALWA,2021-02-13,1,207,0,208,
MADHYA PRADESH,AGAR MALWA,2021-02-14,0,100,0,100,
MADHYA PRADESH,AGAR MALWA,2021-02-15,0,208,0,208,
MADHYA PRADESH,ALIRAJPUR,2021-02-11,2,112,0,114,
MADHYA PRADESH,ALIRAJPUR,2021-02-12,1,45,0,46,
MADHYA PRADESH,ALIRAJPUR,2021-02-13,0,75,0,75,
MADHYA PRADESH,ALIRAJPUR,2021-02-14,0,12,0,12,
MADHYA PRADESH,ALIRAJPUR,2021-02-15,0,272,0,272,
MADHYA PRADESH,ANUPPUR,2021-02-11,5,269,23,297,
MADHYA PRADESH,ANUPPUR,2021-02-12,2,407,8,417,
MADHYA PRADESH,ANUPPUR,2021-02-13,3,154,0,157,
MADHYA PRADESH,ANUPPUR,2021-02-14,0,68,0,68,
MADHYA PRADESH,ANUPPUR,2021-02-15,1,171,1,173,
MADHYA PRADESH,ASHOKNAGAR,2021-02-11,0,37,0,37,
MADHYA PRADESH,ASHOKNAGAR,2021-02-12,0,139,0,139,
MADHYA PRADESH,ASHOKNAGAR,2021-02-13,0,31,0,31,
MADHYA PRADESH,ASHOKNAGAR,2021-02-14,0,25,1,26,
MADHYA PRADESH,ASHOKNAGAR,2021-02-15,1,177,0,178,
MADHYA PRADESH,BALAGHAT,2021-02-11,0,439,0,439,
MADHYA PRADESH,BALAGHAT,2021-02-12,0,246,0,246,
MADHYA PRADESH,BALAGHAT,2021-02-13,5,399,2,406,
MADHYA PRADESH,BALAGHAT,2021-02-14,0,357,0,357,
MADHYA PRADESH,BALAGHAT,2021-02-15,3,543,0,546,
MADHYA PRADESH,BARWANI,2021-02-11,9,130,0,139,
MADHYA PRADESH,BARWANI,2021-02-12,3,309,0,312,
MADHYA PRADESH,BARWANI,2021-02-13,2,172,0,174,
MADHYA PRADESH,BARWANI,2021-02-14,1,43,0,44,
MADHYA PRADESH,BARWANI,2021-02-15,5,236,0,241,
MADHYA PRADESH,BETUL,2021-02-11,4,279,0,283,
MADHYA PRADESH,BETUL,2021-02-12,5,211,1,217,
MADHYA PRADESH,BETUL,2021-02-13,5,142,2,149,
MADHYA PRADESH,BETUL,2021-02-14,10,283,1,294,
MADHYA PRADESH,BETUL,2021-02-15,5,357,3,365,
MADHYA PRADESH,BHIND,2021-02-11,0,196,0,196,
MADHYA PRADESH,BHIND,2021-02-12,0,248,0,248,
MADHYA PRADESH,BHIND,2021-02-13,0,216,0,216,
MADHYA PRADESH,BHIND,2021-02-14,0,228,0,228,
MADHYA PRADESH,BHIND,2021-02-15,0,189,0,189,
MADHYA PRADESH,BHOPAL,2021-02-11,45,1275,6,1326,
MADHYA PRADESH,BHOPAL,2021-02-12,69,1445,14,1528,
MADHYA PRADESH,BHOPAL,2021-02-13,57,1130,10,1197,
MADHYA PRADESH,BHOPAL,2021-02-14,27,997,11,1035,
MADHYA PRADESH,BHOPAL,2021-02-15,60,1179,15,1254,
MADHYA PRADESH,BURHANPUR,2021-02-11,0,78,0,78,
MADHYA PRADESH,BURHANPUR,2021-02-12,0,174,0,174,
MADHYA PRADESH,BURHANPUR,2021-02-13,0,55,0,55,
MADHYA PRADESH,BURHANPUR,2021-02-14,0,98,2,100,
MADHYA PRADESH,BURHANPUR,2021-02-15,0,42,0,42,
MADHYA PRADESH,CHHATARPUR,2021-02-11,0,270,1,271,
MADHYA PRADESH,CHHATARPUR,2021-02-12,1,285,0,286,
MADHYA PRADESH,CHHATARPUR,2021-02-13,0,207,0,207,
MADHYA PRADESH,CHHATARPUR,2021-02-14,1,133,0,134,
MADHYA PRADESH,CHHATARPUR,2021-02-15,0,206,0,206,
MADHYA PRADESH,CHHINDWARA,2021-02-11,6,311,0,317,
MADHYA PRADESH,CHHINDWARA,2021-02-12,1,408,1,410,
MADHYA PRADESH,CHHINDWARA,2021-02-13,9,351,6,366,
MADHYA PRADESH,CHHINDWARA,2021-02-14,5,261,0,266,
MADHYA PRADESH,CHHINDWARA,2021-02-15,7,407,0,414,
MADHYA PRADESH,DAMOH,2021-02-11,10,253,1,264,
MADHYA PRADESH,DAMOH,2021-02-12,10,146,0,156,
MADHYA PRADESH,DAMOH,2021-02-13,13,176,2,191,
MADHYA PRADESH,DAMOH,2021-02-14,2,79,0,81,
MADHYA PRADESH,DAMOH,2021-02-15,10,213,1,224,
MADHYA PRADESH,DATIA,2021-02-11,1,198,9,208,
MADHYA PRADESH,DATIA,2021-02-12,0,251,6,257,
MADHYA PRADESH,DATIA,2021-02-13,1,184,0,185,
MADHYA PRADESH,DATIA,2021-02-14,0,152,4,156,
MADHYA PRADESH,DATIA,2021-02-15,0,230,8,238,
MADHYA PRADESH,DEWAS,2021-02-11,0,382,0,382,
MADHYA PRADESH,DEWAS,2021-02-12,8,397,0,405,
MADHYA PRADESH,DEWAS,2021-02-13,6,157,0,163,
MADHYA PRADESH,DEWAS,2021-02-14,0,43,0,43,
MADHYA PRADESH,DEWAS,2021-02-15,10,79,0,89,
MADHYA PRADESH,DHAR,2021-02-11,2,153,0,155,
MADHYA PRADESH,DHAR,2021-02-12,3,312,0,315,
MADHYA PRADESH,DHAR,2021-02-13,5,366,0,371,
MADHYA PRADESH,DHAR,2021-02-14,0,30,0,30,
MADHYA PRADESH,DHAR,2021-02-15,3,297,0,300,
MADHYA PRADESH,DINDORI,2021-02-11,2,324,0,326,
MADHYA PRADESH,DINDORI,2021-02-12,5,517,0,522,
MADHYA PRADESH,DINDORI,2021-02-13,5,270,0,275,
MADHYA PRADESH,DINDORI,2021-02-14,0,322,0,322,
MADHYA PRADESH,DINDORI,2021-02-15,1,283,0,284,
MADHYA PRADESH,EAST NIMAR,2021-02-11,1,243,0,244,
MADHYA PRADESH,EAST NIMAR,2021-02-12,2,322,0,324,
MADHYA PRADESH,EAST NIMAR,2021-02-13,1,209,0,210,
MADHYA PRADESH,EAST NIMAR,2021-02-14,4,294,2,300,
MADHYA PRADESH,EAST NIMAR,2021-02-15,0,130,0,130,
MADHYA PRADESH,GUNA,2021-02-11,0,159,0,159,
MADHYA PRADESH,GUNA,2021-02-12,0,266,0,266,
MADHYA PRADESH,GUNA,2021-02-13,0,245,0,245,
MADHYA PRADESH,GUNA,2021-02-14,2,313,1,316,
MADHYA PRADESH,GUNA,2021-02-15,1,253,0,254,
MADHYA PRADESH,GWALIOR,2021-02-11,3,575,1,579,
MADHYA PRADESH,GWALIOR,2021-02-12,3,578,0,581,
MADHYA PRADESH,GWALIOR,2021-02-13,4,461,3,468,
MADHYA PRADESH,GWALIOR,2021-02-14,3,377,1,381,
MADHYA PRADESH,GWALIOR,2021-02-15,10,520,0,530,
MADHYA PRADESH,HARDA,2021-02-11,2,177,0,179,
MADHYA PRADESH,HARDA,2021-02-12,3,233,0,236,
MADHYA PRADESH,HARDA,2021-02-13,1,219,0,220,
MADHYA PRADESH,HARDA,2021-02-14,0,171,0,171,
MADHYA PRADESH,HARDA,2021-02-15,1,234,0,235,
MADHYA PRADESH,HOSHANGABAD,2021-02-11,1,260,0,261,
MADHYA PRADESH,HOSHANGABAD,2021-02-12,2,299,1,302,
MADHYA PRADESH,HOSHANGABAD,2021-02-13,4,234,4,242,
MADHYA PRADESH,HOSHANGABAD,2021-02-14,1,48,0,49,
MADHYA PRADESH,HOSHANGABAD,2021-02-15,2,263,0,265,
MADHYA PRADESH,INDORE,2021-02-11,74,1064,1,1139,
MADHYA PRADESH,INDORE,2021-02-12,107,1351,0,1458,
MADHYA PRADESH,INDORE,2021-02-13,87,1085,1,1173,
MADHYA PRADESH,INDORE,2021-02-14,91,706,0,797,
MADHYA PRADESH,INDORE,2021-02-15,167,1346,1,1514,
MADHYA PRADESH,JABALPUR,2021-02-11,17,672,1,690,
MADHYA PRADESH,JABALPUR,2021-02-12,21,565,2,588,
MADHYA PRADESH,JABALPUR,2021-02-13,16,555,0,571,
MADHYA PRADESH,JABALPUR,2021-02-14,10,343,0,353,
MADHYA PRADESH,JABALPUR,2021-02-15,16,530,1,547,
MADHYA PRADESH,JHABUA,2021-02-11,1,178,0,179,
MADHYA PRADESH,JHABUA,2021-02-12,1,159,0,160,
MADHYA PRADESH,JHABUA,2021-02-13,3,213,0,216,
MADHYA PRADESH,JHABUA,2021-02-14,0,78,0,78,
MADHYA PRADESH,JHABUA,2021-02-15,3,267,0,270,
MADHYA PRADESH,KATNI,2021-02-11,0,223,0,223,
MADHYA PRADESH,KATNI,2021-02-12,0,210,0,210,
MADHYA PRADESH,KATNI,2021-02-13,0,122,0,122,
MADHYA PRADESH,KATNI,2021-02-14,1,121,0,122,
MADHYA PRADESH,KATNI,2021-02-15,0,79,0,79,
MADHYA PRADESH,KHARGONE,2021-02-11,6,306,0,312,
MADHYA PRADESH,KHARGONE,2021-02-12,8,347,0,355,
MADHYA PRADESH,KHARGONE,2021-02-13,6,262,0,268,
MADHYA PRADESH,KHARGONE,2021-02-14,5,79,0,84,
MADHYA PRADESH,KHARGONE,2021-02-15,7,288,0,295,
MADHYA PRADESH,MANDLA,2021-02-11,0,363,0,363,
MADHYA PRADESH,MANDLA,2021-02-12,0,721,0,721,
MADHYA PRADESH,MANDLA,2021-02-13,0,612,0,612,
MADHYA PRADESH,MANDLA,2021-02-14,0,151,0,151,
MADHYA PRADESH,MANDLA,2021-02-15,0,473,0,473,
MADHYA PRADESH,MANDSAUR,2021-02-11,13,117,5,135,
MADHYA PRADESH,MANDSAUR,2021-02-12,3,63,0,66,
MADHYA PRADESH,MANDSAUR,2021-02-13,3,131,0,134,
MADHYA PRADESH,MANDSAUR,2021-02-14,0,20,0,20,
MADHYA PRADESH,MANDSAUR,2021-02-15,3,113,0,116,
MADHYA PRADESH,MORENA,2021-02-11,0,354,1,355,
MADHYA PRADESH,MORENA,2021-02-12,0,386,0,386,
MADHYA PRADESH,MORENA,2021-02-13,0,263,0,263,
MADHYA PRADESH,MORENA,2021-02-14,0,194,0,194,
MADHYA PRADESH,MORENA,2021-02-15,0,183,0,183,
MADHYA PRADESH,NARSINGHPUR,2021-02-11,2,357,1,360,
MADHYA PRADESH,NARSINGHPUR,2021-02-12,1,637,1,639,
MADHYA PRADESH,NARSINGHPUR,2021-02-13,3,307,0,310,
MADHYA PRADESH,NARSINGHPUR,2021-02-14,1,357,7,365,
MADHYA PRADESH,NARSINGHPUR,2021-02-15,2,661,0,663,
MADHYA PRADESH,NEEMUCH,2021-02-11,2,104,0,106,
MADHYA PRADESH,NEEMUCH,2021-02-12,1,111,0,112,
MADHYA PRADESH,NEEMUCH,2021-02-13,1,137,2,140,
MADHYA PRADESH,NEEMUCH,2021-02-14,0,31,0,31,
MADHYA PRADESH,NEEMUCH,2021-02-15,1,81,1,83,
MADHYA PRADESH,NIWARI,2021-02-11,0,15,0,15,
MADHYA PRADESH,NIWARI,2021-02-12,0,196,0,196,
MADHYA PRADESH,NIWARI,2021-02-13,0,141,0,141,
MADHYA PRADESH,NIWARI,2021-02-14,0,4,0,4,
MADHYA PRADESH,NIWARI,2021-02-15,0,164,0,164,
MADHYA PRADESH,PANNA,2021-02-11,1,165,2,168,
MADHYA PRADESH,PANNA,2021-02-12,1,198,1,200,
MADHYA PRADESH,PANNA,2021-02-13,1,96,0,97,
MADHYA PRADESH,PANNA,2021-02-14,1,18,0,19,
MADHYA PRADESH,PANNA,2021-02-15,0,102,0,102,
MADHYA PRADESH,RAISEN,2021-02-11,0,157,0,157,
MADHYA PRADESH,RAISEN,2021-02-12,1,122,0,123,
MADHYA PRADESH,RAISEN,2021-02-13,1,129,0,130,
MADHYA PRADESH,RAISEN,2021-02-14,1,16,0,17,
MADHYA PRADESH,RAISEN,2021-02-15,2,86,0,88,
MADHYA PRADESH,RAJGARH,2021-02-11,5,158,0,163,
MADHYA PRADESH,RAJGARH,2021-02-12,0,185,0,185,
MADHYA PRADESH,RAJGARH,2021-02-13,2,157,0,159,
MADHYA PRADESH,RAJGARH,2021-02-14,3,123,0,126,
MADHYA PRADESH,RAJGARH,2021-02-15,2,255,1,258,
MADHYA PRADESH,RATLAM,2021-02-11,1,204,0,205,
MADHYA PRADESH,RATLAM,2021-02-12,2,198,0,200,
MADHYA PRADESH,RATLAM,2021-02-13,5,175,0,180,
MADHYA PRADESH,RATLAM,2021-02-14,0,35,0,35,
MADHYA PRADESH,RATLAM,2021-02-15,5,203,0,208,
MADHYA PRADESH,REWA,2021-02-11,7,541,3,551,
MADHYA PRADESH,REWA,2021-02-12,2,583,1,586,
MADHYA PRADESH,REWA,2021-02-13,1,434,6,441,
MADHYA PRADESH,REWA,2021-02-14,0,365,2,367,
MADHYA PRADESH,REWA,2021-02-15,3,486,0,489,
MADHYA PRADESH,SAGAR,2021-02-11,1,630,1,632,
MADHYA PRADESH,SAGAR,2021-02-12,11,766,1,778,
MADHYA PRADESH,SAGAR,2021-02-13,3,579,1,583,
MADHYA PRADESH,SAGAR,2021-02-14,7,753,1,761,
MADHYA PRADESH,SAGAR,2021-02-15,3,334,0,337,
MADHYA PRADESH,SATNA,2021-02-11,2,314,0,316,
MADHYA PRADESH,SATNA,2021-02-12,4,154,0,158,
MADHYA PRADESH,SATNA,2021-02-13,2,392,0,394,
MADHYA PRADESH,SATNA,2021-02-14,2,194,0,196,
MADHYA PRADESH,SATNA,2021-02-15,2,199,0,201,
MADHYA PRADESH,SEHORE,2021-02-11,0,225,0,225,
MADHYA PRADESH,SEHORE,2021-02-12,2,236,0,238,
MADHYA PRADESH,SEHORE,2021-02-13,2,293,2,297,
MADHYA PRADESH,SEHORE,2021-02-14,4,244,0,248,
MADHYA PRADESH,SEHORE,2021-02-15,2,154,0,156,
MADHYA PRADESH,SEONI,2021-02-11,0,220,1,221,
MADHYA PRADESH,SEONI,2021-02-12,0,333,0,333,
MADHYA PRADESH,SEONI,2021-02-13,0,289,2,291,
MADHYA PRADESH,SEONI,2021-02-14,0,274,4,278,
MADHYA PRADESH,SEONI,2021-02-15,3,212,1,216,
MADHYA PRADESH,SHAHDOL,2021-02-11,1,53,0,54,
MADHYA PRADESH,SHAHDOL,2021-02-12,0,50,0,50,
MADHYA PRADESH,SHAHDOL,2021-02-13,0,11,0,11,
MADHYA PRADESH,SHAHDOL,2021-02-14,0,15,0,15,
MADHYA PRADESH,SHAHDOL,2021-02-15,0,63,0,63,
MADHYA PRADESH,SHAJAPUR,2021-02-11,0,183,0,183,
MADHYA PRADESH,SHAJAPUR,2021-02-12,0,228,0,228,
MADHYA PRADESH,SHAJAPUR,2021-02-13,0,97,0,97,
MADHYA PRADESH,SHAJAPUR,2021-02-14,0,132,0,132,
MADHYA PRADESH,SHAJAPUR,2021-02-15,0,230,0,230,
MADHYA PRADESH,SHEOPUR,2021-02-11,0,263,1,264,
MADHYA PRADESH,SHEOPUR,2021-02-12,3,151,0,154,
MADHYA PRADESH,SHEOPUR,2021-02-13,2,38,0,40,
MADHYA PRADESH,SHEOPUR,2021-02-14,1,181,3,185,
MADHYA PRADESH,SHEOPUR,2021-02-15,1,269,1,271,
MADHYA PRADESH,SHIVPURI,2021-02-11,0,140,0,140,
MADHYA PRADESH,SHIVPURI,2021-02-12,0,165,0,165,
MADHYA PRADESH,SHIVPURI,2021-02-13,1,158,3,162,
MADHYA PRADESH,SHIVPURI,2021-02-14,0,27,0,27,
MADHYA PRADESH,SHIVPURI,2021-02-15,1,216,0,217,
MADHYA PRADESH,SIDHI,2021-02-11,0,61,0,61,
MADHYA PRADESH,SIDHI,2021-02-12,7,246,0,253,
MADHYA PRADESH,SIDHI,2021-02-13,3,64,0,67,
MADHYA PRADESH,SIDHI,2021-02-14,2,176,0,178,
MADHYA PRADESH,SIDHI,2021-02-15,5,194,0,199,
MADHYA PRADESH,SINGRAULI,2021-02-11,5,210,0,215,
MADHYA PRADESH,SINGRAULI,2021-02-12,1,22,0,23,
MADHYA PRADESH,SINGRAULI,2021-02-13,5,112,0,117,
MADHYA PRADESH,SINGRAULI,2021-02-14,0,205,1,206,
MADHYA PRADESH,SINGRAULI,2021-02-15,2,19,0,21,
MADHYA PRADESH,TIKAMGARH,2021-02-11,0,139,0,139,
MADHYA PRADESH,TIKAMGARH,2021-02-12,0,217,0,217,
MADHYA PRADESH,TIKAMGARH,2021-02-13,0,181,0,181,
MADHYA PRADESH,TIKAMGARH,2021-02-14,0,55,0,55,
MADHYA PRADESH,TIKAMGARH,2021-02-15,1,321,1,323,
MADHYA PRADESH,UJJAIN,2021-02-11,3,162,1,166,
MADHYA PRADESH,UJJAIN,2021-02-12,0,27,0,27,
MADHYA PRADESH,UJJAIN,2021-02-13,5,243,0,248,
MADHYA PRADESH,UJJAIN,2021-02-14,19,100,0,119,
MADHYA PRADESH,UJJAIN,2021-02-15,2,121,0,123,
MADHYA PRADESH,UMARIA,2021-02-11,0,136,10,146,
MADHYA PRADESH,UMARIA,2021-02-12,1,115,48,164,
MADHYA PRADESH,UMARIA,2021-02-13,0,48,5,53,
MADHYA PRADESH,UMARIA,2021-02-14,0,72,10,82,
MADHYA PRADESH,UMARIA,2021-02-15,1,148,33,182,
MADHYA PRADESH,VIDISHA,2021-02-11,2,132,0,134,
MADHYA PRADESH,VIDISHA,2021-02-12,0,123,4,127,
MADHYA PRADESH,VIDISHA,2021-02-13,0,78,0,78,
MADHYA PRADESH,VIDISHA,2021-02-14,1,14,0,15,
MADHYA PRADESH,VIDISHA,2021-02-15,1,43,1,45,
MAHARASHTRA,AHMEDNAGAR,2021-02-11,101,1639,1,1741,
MAHARASHTRA,AHMEDNAGAR,2021-02-12,76,643,0,719,
MAHARASHTRA,AHMEDNAGAR,2021-02-13,64,628,0,692,
MAHARASHTRA,AHMEDNAGAR,2021-02-14,82,1210,0,1292,
MAHARASHTRA,AHMEDNAGAR,2021-02-15,77,1104,4,1185,
MAHARASHTRA,AKOLA,2021-02-11,97,352,0,449,
MAHARASHTRA,AKOLA,2021-02-12,94,432,1,527,
MAHARASHTRA,AKOLA,2021-02-13,136,343,2,481,
MAHARASHTRA,AKOLA,2021-02-14,111,356,0,467,
MAHARASHTRA,AKOLA,2021-02-15,107,177,1,285,
MAHARASHTRA,AMRAVATI,2021-02-11,412,917,3,1332,
MAHARASHTRA,AMRAVATI,2021-02-12,477,749,4,1230,
MAHARASHTRA,AMRAVATI,2021-02-13,447,755,1,1203,
MAHARASHTRA,AMRAVATI,2021-02-14,521,384,1,906,
MAHARASHTRA,AMRAVATI,2021-02-15,420,644,0,1064,
MAHARASHTRA,AURANGABAD,2021-02-11,63,1459,1,1523,
MAHARASHTRA,AURANGABAD,2021-02-12,85,1380,4,1469,
MAHARASHTRA,AURANGABAD,2021-02-13,95,1373,0,1468,
MAHARASHTRA,AURANGABAD,2021-02-14,54,818,2,874,
MAHARASHTRA,AURANGABAD,2021-02-15,90,2251,33,2374,
MAHARASHTRA,BEED,2021-02-11,18,410,0,428,
MAHARASHTRA,BEED,2021-02-12,30,441,1,472,
MAHARASHTRA,BEED,2021-02-13,35,413,0,448,
MAHARASHTRA,BEED,2021-02-14,16,240,0,256,
MAHARASHTRA,BEED,2021-02-15,19,296,0,315,
MAHARASHTRA,BHANDARA,2021-02-11,11,372,0,383,
MAHARASHTRA,BHANDARA,2021-02-12,12,519,0,531,
MAHARASHTRA,BHANDARA,2021-02-13,19,260,0,279,
MAHARASHTRA,BHANDARA,2021-02-14,11,138,0,149,
MAHARASHTRA,BHANDARA,2021-02-15,20,516,0,536,
MAHARASHTRA,BULDHANA,2021-02-11,98,192,2,292,
MAHARASHTRA,BULDHANA,2021-02-12,87,381,16,484,
MAHARASHTRA,BULDHANA,2021-02-13,36,203,1,240,
MAHARASHTRA,BULDHANA,2021-02-14,177,461,23,661,
MAHARASHTRA,BULDHANA,2021-02-15,95,236,7,338,
MAHARASHTRA,CHANDRAPUR,2021-02-11,19,388,0,407,
MAHARASHTRA,CHANDRAPUR,2021-02-12,32,415,4,451,
MAHARASHTRA,CHANDRAPUR,2021-02-13,26,449,0,475,
MAHARASHTRA,CHANDRAPUR,2021-02-14,9,101,0,110,
MAHARASHTRA,CHANDRAPUR,2021-02-15,20,468,0,488,
MAHARASHTRA,DHULE,2021-02-11,20,211,1,232,
MAHARASHTRA,DHULE,2021-02-12,16,174,1,191,
MAHARASHTRA,DHULE,2021-02-13,27,238,0,265,
MAHARASHTRA,DHULE,2021-02-14,25,228,0,253,
MAHARASHTRA,DHULE,2021-02-15,22,409,2,433,
MAHARASHTRA,GADCHIROLI,2021-02-11,2,402,0,404,
MAHARASHTRA,GADCHIROLI,2021-02-12,1,436,0,437,
MAHARASHTRA,GADCHIROLI,2021-02-13,4,287,0,291,
MAHARASHTRA,GADCHIROLI,2021-02-14,7,148,0,155,
MAHARASHTRA,GADCHIROLI,2021-02-15,8,410,0,418,
MAHARASHTRA,GONDIA,2021-02-11,8,139,0,147,
MAHARASHTRA,GONDIA,2021-02-12,1,528,1,530,
MAHARASHTRA,GONDIA,2021-02-13,11,45,0,56,
MAHARASHTRA,GONDIA,2021-02-14,5,230,1,236,
MAHARASHTRA,GONDIA,2021-02-15,2,233,0,235,
MAHARASHTRA,HINGOLI,2021-02-11,12,197,0,209,
MAHARASHTRA,HINGOLI,2021-02-12,9,306,0,315,
MAHARASHTRA,HINGOLI,2021-02-13,0,6,0,6,
MAHARASHTRA,HINGOLI,2021-02-14,15,234,0,249,
MAHARASHTRA,HINGOLI,2021-02-15,10,150,0,160,
MAHARASHTRA,JALGAON,2021-02-11,51,867,0,918,
MAHARASHTRA,JALGAON,2021-02-12,64,884,0,948,
MAHARASHTRA,JALGAON,2021-02-13,65,530,0,595,
MAHARASHTRA,JALGAON,2021-02-14,83,716,0,799,
MAHARASHTRA,JALGAON,2021-02-15,57,660,0,717,
MAHARASHTRA,JALNA,2021-02-11,57,434,0,491,
MAHARASHTRA,JALNA,2021-02-12,44,602,0,646,
MAHARASHTRA,JALNA,2021-02-13,25,901,1,927,
MAHARASHTRA,JALNA,2021-02-14,43,699,0,742,
MAHARASHTRA,JALNA,2021-02-15,21,938,0,959,
MAHARASHTRA,KOLHAPUR,2021-02-11,29,925,6,960,
MAHARASHTRA,KOLHAPUR,2021-02-12,16,866,0,882,
MAHARASHTRA,KOLHAPUR,2021-02-13,4,158,0,162,
MAHARASHTRA,KOLHAPUR,2021-02-14,13,998,32,1043,
MAHARASHTRA,KOLHAPUR,2021-02-15,19,460,1,480,
MAHARASHTRA,LATUR,2021-02-11,36,705,1,742,
MAHARASHTRA,LATUR,2021-02-12,50,697,3,750,
MAHARASHTRA,LATUR,2021-02-13,44,584,0,628,
MAHARASHTRA,LATUR,2021-02-14,12,259,1,272,
MAHARASHTRA,LATUR,2021-02-15,24,402,4,430,
MAHARASHTRA,MUMBAI,2021-02-11,553,10697,36,11286,
MAHARASHTRA,MUMBAI,2021-02-12,483,11777,12,12272,
MAHARASHTRA,MUMBAI,2021-02-13,571,10495,120,11186,
MAHARASHTRA,MUMBAI,2021-02-14,444,9350,11,9805,
MAHARASHTRA,MUMBAI,2021-02-15,417,10199,99,10715,
MAHARASHTRA,MUMBAI SUBURBAN,2021-02-11,123,2885,4,3012,
MAHARASHTRA,MUMBAI SUBURBAN,2021-02-12,134,3082,1,3217,
MAHARASHTRA,MUMBAI SUBURBAN,2021-02-13,142,3062,8,3212,
MAHARASHTRA,MUMBAI SUBURBAN,2021-02-14,103,1630,0,1733,
MAHARASHTRA,MUMBAI SUBURBAN,2021-02-15,127,2575,4,2706,
MAHARASHTRA,NAGPUR,2021-02-11,486,3237,17,3740,
MAHARASHTRA,NAGPUR,2021-02-12,516,3002,14,3532,
MAHARASHTRA,NAGPUR,2021-02-13,544,3100,11,3655,
MAHARASHTRA,NAGPUR,2021-02-14,484,1788,22,2294,
MAHARASHTRA,NAGPUR,2021-02-15,612,3027,22,3661,
MAHARASHTRA,NANDED,2021-02-11,9,254,0,263,
MAHARASHTRA,NANDED,2021-02-12,38,535,1,574,
MAHARASHTRA,NANDED,2021-02-13,24,272,0,296,
MAHARASHTRA,NANDED,2021-02-14,45,432,28,505,
MAHARASHTRA,NANDED,2021-02-15,22,846,0,868,
MAHARASHTRA,NANDURBAR,2021-02-11,17,445,0,462,
MAHARASHTRA,NANDURBAR,2021-02-12,32,222,0,254,
MAHARASHTRA,NANDURBAR,2021-02-13,2,126,0,128,
MAHARASHTRA,NANDURBAR,2021-02-14,2,87,0,89,
MAHARASHTRA,NANDURBAR,2021-02-15,31,168,0,199,
MAHARASHTRA,NASHIK,2021-02-11,249,1653,15,1917,
MAHARASHTRA,NASHIK,2021-02-12,180,813,1,994,
MAHARASHTRA,NASHIK,2021-02-13,201,1534,3,1738,
MAHARASHTRA,NASHIK,2021-02-14,129,1110,5,1244,
MAHARASHTRA,NASHIK,2021-02-15,234,856,7,1097,
MAHARASHTRA,OSMANABAD,2021-02-11,15,198,0,213,
MAHARASHTRA,OSMANABAD,2021-02-12,18,291,11,320,
MAHARASHTRA,OSMANABAD,2021-02-13,11,403,8,422,
MAHARASHTRA,OSMANABAD,2021-02-14,5,44,0,49,
MAHARASHTRA,OSMANABAD,2021-02-15,16,188,8,212,
MAHARASHTRA,PALGHAR,2021-02-11,48,755,0,803,
MAHARASHTRA,PALGHAR,2021-02-12,42,753,0,795,
MAHARASHTRA,PALGHAR,2021-02-13,31,682,4,717,
MAHARASHTRA,PALGHAR,2021-02-14,22,259,0,281,
MAHARASHTRA,PALGHAR,2021-02-15,13,749,1,763,
MAHARASHTRA,PARBHANI,2021-02-11,10,1598,1,1609,
MAHARASHTRA,PARBHANI,2021-02-12,4,922,1,927,
MAHARASHTRA,PARBHANI,2021-02-13,21,588,9,618,
MAHARASHTRA,PARBHANI,2021-02-14,26,1093,2,1121,
MAHARASHTRA,PARBHANI,2021-02-15,33,963,5,1001,
MAHARASHTRA,PUNE,2021-02-11,597,5673,51,6321,
MAHARASHTRA,PUNE,2021-02-12,616,5607,53,6276,
MAHARASHTRA,PUNE,2021-02-13,702,4382,23,5107,
MAHARASHTRA,PUNE,2021-02-14,390,2315,6,2711,
MAHARASHTRA,PUNE,2021-02-15,709,4773,16,5498,
MAHARASHTRA,RAIGAD,2021-02-11,56,1005,7,1068,
MAHARASHTRA,RAIGAD,2021-02-12,82,896,0,978,
MAHARASHTRA,RAIGAD,2021-02-13,85,776,6,867,
MAHARASHTRA,RAIGAD,2021-02-14,64,684,0,748,
MAHARASHTRA,RAIGAD,2021-02-15,83,761,16,860,
MAHARASHTRA,RATNAGIRI,2021-02-11,15,283,1,299,
MAHARASHTRA,RATNAGIRI,2021-02-12,11,144,0,155,
MAHARASHTRA,RATNAGIRI,2021-02-13,18,107,0,125,
MAHARASHTRA,RATNAGIRI,2021-02-14,37,167,0,204,
MAHARASHTRA,RATNAGIRI,2021-02-15,33,189,0,222,
MAHARASHTRA,SANGLI,2021-02-11,11,450,2,463,
MAHARASHTRA,SANGLI,2021-02-12,13,368,1,382,
MAHARASHTRA,SANGLI,2021-02-13,22,404,0,426,
MAHARASHTRA,SANGLI,2021-02-14,12,325,1,338,
MAHARASHTRA,SANGLI,2021-02-15,14,597,0,611,
MAHARASHTRA,SATARA,2021-02-11,90,1073,5,1168,
MAHARASHTRA,SATARA,2021-02-12,67,1447,6,1520,
MAHARASHTRA,SATARA,2021-02-13,108,796,1,905,
MAHARASHTRA,SATARA,2021-02-14,75,974,3,1052,
MAHARASHTRA,SATARA,2021-02-15,41,563,0,604,
MAHARASHTRA,SINDHUDURG,2021-02-11,11,156,0,167,
MAHARASHTRA,SINDHUDURG,2021-02-12,8,133,0,141,
MAHARASHTRA,SINDHUDURG,2021-02-13,12,287,0,299,
MAHARASHTRA,SINDHUDURG,2021-02-14,4,13,0,17,
MAHARASHTRA,SINDHUDURG,2021-02-15,5,117,0,122,
MAHARASHTRA,SOLAPUR,2021-02-11,57,1004,7,1068,
MAHARASHTRA,SOLAPUR,2021-02-12,61,953,2,1016,
MAHARASHTRA,SOLAPUR,2021-02-13,34,1282,0,1316,
MAHARASHTRA,SOLAPUR,2021-02-14,48,1006,7,1061,
MAHARASHTRA,SOLAPUR,2021-02-15,66,1692,4,1762,
MAHARASHTRA,THANE,2021-02-11,367,8020,14,8401,
MAHARASHTRA,THANE,2021-02-12,321,6575,11,6907,
MAHARASHTRA,THANE,2021-02-13,426,6447,25,6898,
MAHARASHTRA,THANE,2021-02-14,340,3616,3,3959,
MAHARASHTRA,THANE,2021-02-15,365,5243,51,5659,
MAHARASHTRA,WARDHA,2021-02-11,146,362,12,520,
MAHARASHTRA,WARDHA,2021-02-12,85,358,5,448,
MAHARASHTRA,WARDHA,2021-02-13,91,331,10,432,
MAHARASHTRA,WARDHA,2021-02-14,17,58,0,75,
MAHARASHTRA,WARDHA,2021-02-15,77,416,12,505,
MAHARASHTRA,WASHIM,2021-02-11,10,397,3,410,
MAHARASHTRA,WASHIM,2021-02-12,16,378,2,396,
MAHARASHTRA,WASHIM,2021-02-13,40,338,0,378,
MAHARASHTRA,WASHIM,2021-02-14,7,177,0,184,
MAHARASHTRA,WASHIM,2021-02-15,36,176,0,212,
MAHARASHTRA,YAVATMAL,2021-02-11,85,492,0,577,
MAHARASHTRA,YAVATMAL,2021-02-12,84,468,0,552,
MAHARASHTRA,YAVATMAL,2021-02-13,116,431,0,547,
MAHARASHTRA,YAVATMAL,2021-02-14,53,264,0,317,
MAHARASHTRA,YAVATMAL,2021-02-15,72,286,3,361,
MANIPUR,BISHNUPUR,2021-02-11,0,52,0,52,
MANIPUR,BISHNUPUR,2021-02-12,0,77,0,77,
MANIPUR,BISHNUPUR,2021-02-13,0,115,0,115,
MANIPUR,BISHNUPUR,2021-02-14,0,155,0,155,
MANIPUR,BISHNUPUR,2021-02-15,0,109,0,109,
MANIPUR,CHANDEL,2021-02-11,0,33,0,33,
MANIPUR,CHANDEL,2021-02-12,1,26,0,27,
MANIPUR,CHANDEL,2021-02-13,0,43,0,43,
MANIPUR,CHANDEL,2021-02-14,0,21,0,21,
MANIPUR,CHANDEL,2021-02-15,2,33,0,35,
MANIPUR,CHURACHANDPUR,2021-02-11,1,92,0,93,
MANIPUR,CHURACHANDPUR,2021-02-12,0,63,0,63,
MANIPUR,CHURACHANDPUR,2021-02-13,1,150,0,151,
MANIPUR,CHURACHANDPUR,2021-02-14,0,53,0,53,
MANIPUR,CHURACHANDPUR,2021-02-15,3,143,0,146,
MANIPUR,IMPHAL EAST,2021-02-11,1,179,0,180,
MANIPUR,IMPHAL EAST,2021-02-12,3,207,0,210,
MANIPUR,IMPHAL EAST,2021-02-13,15,256,0,271,
MANIPUR,IMPHAL EAST,2021-02-14,2,203,0,205,
MANIPUR,IMPHAL EAST,2021-02-15,1,232,0,233,
MANIPUR,IMPHAL WEST,2021-02-11,3,483,0,486,
MANIPUR,IMPHAL WEST,2021-02-12,1,327,0,328,
MANIPUR,IMPHAL WEST,2021-02-13,1,629,0,630,
MANIPUR,IMPHAL WEST,2021-02-14,4,338,0,342,
MANIPUR,IMPHAL WEST,2021-02-15,2,269,0,271,
MANIPUR,JIRIBAM,2021-02-11,0,2,0,2,
MANIPUR,JIRIBAM,2021-02-12,0,3,1,4,
MANIPUR,JIRIBAM,2021-02-13,0,2,0,2,
MANIPUR,JIRIBAM,2021-02-14,0,18,0,18,
MANIPUR,JIRIBAM,2021-02-15,0,1,0,1,
MANIPUR,KAKCHING,2021-02-11,0,45,0,45,
MANIPUR,KAKCHING,2021-02-12,8,86,0,94,
MANIPUR,KAKCHING,2021-02-13,7,105,0,112,
MANIPUR,KAKCHING,2021-02-14,0,47,0,47,
MANIPUR,KAKCHING,2021-02-15,0,52,0,52,
MANIPUR,KAMJONG,2021-02-11,0,7,0,7,
MANIPUR,KAMJONG,2021-02-12,0,5,0,5,
MANIPUR,KAMJONG,2021-02-13,0,2,0,2,
MANIPUR,KAMJONG,2021-02-14,0,1,0,1,
MANIPUR,KAMJONG,2021-02-15,0,3,0,3,
MANIPUR,KANGPOKPI,2021-02-11,0,31,0,31,
MANIPUR,KANGPOKPI,2021-02-12,0,34,0,34,
MANIPUR,KANGPOKPI,2021-02-13,1,27,0,28,
MANIPUR,KANGPOKPI,2021-02-14,0,28,0,28,
MANIPUR,KANGPOKPI,2021-02-15,0,21,0,21,
MANIPUR,NONEY,2021-02-11,0,4,0,4,
MANIPUR,NONEY,2021-02-12,0,8,0,8,
MANIPUR,NONEY,2021-02-13,0,6,0,6,
MANIPUR,NONEY,2021-02-14,0,4,0,4,
MANIPUR,NONEY,2021-02-15,0,1,0,1,
MANIPUR,SENAPATI,2021-02-11,0,33,0,33,
MANIPUR,SENAPATI,2021-02-12,0,22,0,22,
MANIPUR,SENAPATI,2021-02-13,0,19,0,19,
MANIPUR,SENAPATI,2021-02-14,0,22,0,22,
MANIPUR,SENAPATI,2021-02-15,1,55,0,56,
MANIPUR,TAMENGLONG,2021-02-11,0,14,0,14,
MANIPUR,TAMENGLONG,2021-02-12,1,104,0,105,
MANIPUR,TAMENGLONG,2021-02-13,0,206,0,206,
MANIPUR,TAMENGLONG,2021-02-14,0,12,0,12,
MANIPUR,TAMENGLONG,2021-02-15,0,52,0,52,
MANIPUR,TENGNOUPAL,2021-02-11,0,8,0,8,
MANIPUR,TENGNOUPAL,2021-02-12,1,5,0,6,
MANIPUR,TENGNOUPAL,2021-02-13,0,1,0,1,
MANIPUR,TENGNOUPAL,2021-02-14,0,4,0,4,
MANIPUR,TENGNOUPAL,2021-02-15,0,22,0,22,
MANIPUR,THOUBAL,2021-02-11,13,118,0,131,
MANIPUR,THOUBAL,2021-02-12,2,118,0,120,
MANIPUR,THOUBAL,2021-02-13,0,84,0,84,
MANIPUR,THOUBAL,2021-02-14,0,142,0,142,
MANIPUR,THOUBAL,2021-02-15,0,57,0,57,
MANIPUR,UKHRUL,2021-02-11,0,128,0,128,
MANIPUR,UKHRUL,2021-02-12,2,162,0,164,
MANIPUR,UKHRUL,2021-02-13,0,72,0,72,
MANIPUR,UKHRUL,2021-02-14,0,17,0,17,
MANIPUR,UKHRUL,2021-02-15,0,44,0,44,
MEGHALAYA,EAST GARO HILLS,2021-02-11,0,14,0,14,
MEGHALAYA,EAST GARO HILLS,2021-02-12,0,20,0,20,
MEGHALAYA,EAST GARO HILLS,2021-02-13,0,20,0,20,
MEGHALAYA,EAST GARO HILLS,2021-02-15,0,6,0,6,
MEGHALAYA,EAST JAINTIA HILLS,2021-02-11,0,135,0,135,
MEGHALAYA,EAST JAINTIA HILLS,2021-02-12,1,80,0,81,
MEGHALAYA,EAST JAINTIA HILLS,2021-02-13,0,16,0,16,
MEGHALAYA,EAST JAINTIA HILLS,2021-02-14,0,6,0,6,
MEGHALAYA,EAST JAINTIA HILLS,2021-02-15,2,78,0,80,
MEGHALAYA,EAST KHASI HILLS,2021-02-11,0,862,0,862,
MEGHALAYA,EAST KHASI HILLS,2021-02-12,6,702,0,708,
MEGHALAYA,EAST KHASI HILLS,2021-02-13,6,527,2,535,
MEGHALAYA,EAST KHASI HILLS,2021-02-14,0,124,0,124,
MEGHALAYA,EAST KHASI HILLS,2021-02-15,2,669,0,671,
MEGHALAYA,NORTH GARO HILLS,2021-02-11,0,17,0,17,
MEGHALAYA,NORTH GARO HILLS,2021-02-12,0,19,0,19,
MEGHALAYA,NORTH GARO HILLS,2021-02-13,0,1,0,1,
MEGHALAYA,NORTH GARO HILLS,2021-02-15,0,6,0,6,
MEGHALAYA,RI BHOI,2021-02-11,0,141,0,141,
MEGHALAYA,RI BHOI,2021-02-12,1,104,0,105,
MEGHALAYA,RI BHOI,2021-02-13,0,82,1,83,
MEGHALAYA,RI BHOI,2021-02-14,0,14,0,14,
MEGHALAYA,RI BHOI,2021-02-15,0,61,0,61,
MEGHALAYA,SOUTH GARO HILLS,2021-02-11,0,22,0,22,
MEGHALAYA,SOUTH GARO HILLS,2021-02-12,0,6,0,6,
MEGHALAYA,SOUTH GARO HILLS,2021-02-13,0,6,0,6,
MEGHALAYA,SOUTH GARO HILLS,2021-02-15,0,6,0,6,
MEGHALAYA,SOUTH WEST GARO HILLS,2021-02-11,0,11,0,11,
MEGHALAYA,SOUTH WEST GARO HILLS,2021-02-12,0,26,0,26,
MEGHALAYA,SOUTH WEST GARO HILLS,2021-02-13,0,16,0,16,
MEGHALAYA,SOUTH WEST GARO HILLS,2021-02-14,0,10,0,10,
MEGHALAYA,SOUTH WEST GARO HILLS,2021-02-15,0,31,0,31,
MEGHALAYA,SOUTH WEST KHASI HILLS,2021-02-11,0,9,0,9,
MEGHALAYA,SOUTH WEST KHASI HILLS,2021-02-12,0,6,0,6,
MEGHALAYA,SOUTH WEST KHASI HILLS,2021-02-13,0,3,0,3,
MEGHALAYA,SOUTH WEST KHASI HILLS,2021-02-14,0,3,0,3,
MEGHALAYA,SOUTH WEST KHASI HILLS,2021-02-15,0,12,0,12,
MEGHALAYA,WEST GARO HILLS,2021-02-11,0,48,0,48,
MEGHALAYA,WEST GARO HILLS,2021-02-12,0,73,0,73,
MEGHALAYA,WEST GARO HILLS,2021-02-13,0,29,0,29,
MEGHALAYA,WEST GARO HILLS,2021-02-14,0,12,0,12,
MEGHALAYA,WEST GARO HILLS,2021-02-15,0,53,0,53,
MEGHALAYA,WEST JAINTIA HILLS,2021-02-11,0,80,0,80,
MEGHALAYA,WEST JAINTIA HILLS,2021-02-12,0,85,0,85,
MEGHALAYA,WEST JAINTIA HILLS,2021-02-13,0,59,0,59,
MEGHALAYA,WEST JAINTIA HILLS,2021-02-14,0,35,0,35,
MEGHALAYA,WEST JAINTIA HILLS,2021-02-15,0,72,0,72,
MEGHALAYA,WEST KHASI HILLS,2021-02-11,0,96,0,96,
MEGHALAYA,WEST KHASI HILLS,2021-02-12,0,29,0,29,
MEGHALAYA,WEST KHASI HILLS,2021-02-13,0,78,0,78,
MEGHALAYA,WEST KHASI HILLS,2021-02-14,0,35,0,35,
MEGHALAYA,WEST KHASI HILLS,2021-02-15,0,111,0,111,
MIZORAM,AIZAWL,2021-02-11,0,505,0,505,
MIZORAM,AIZAWL,2021-02-12,1,456,0,457,
MIZORAM,AIZAWL,2021-02-13,0,347,0,347,
MIZORAM,AIZAWL,2021-02-14,0,130,0,130,
MIZORAM,AIZAWL,2021-02-15,1,631,0,632,
MIZORAM,CHAMPHAI,2021-02-11,0,10,0,10,
MIZORAM,CHAMPHAI,2021-02-12,0,10,0,10,
MIZORAM,CHAMPHAI,2021-02-15,1,7,0,8,
MIZORAM,HNAHTHIAL,2021-02-12,0,1,0,1,
MIZORAM,HNAHTHIAL,2021-02-15,0,4,0,4,
MIZORAM,KHAWZAWL,2021-02-11,0,1,0,1,
MIZORAM,KHAWZAWL,2021-02-12,0,3,0,3,
MIZORAM,KHAWZAWL,2021-02-15,0,2,0,2,
MIZORAM,KOLASIB,2021-02-11,0,168,0,168,
MIZORAM,KOLASIB,2021-02-12,0,249,0,249,
MIZORAM,KOLASIB,2021-02-13,0,275,0,275,
MIZORAM,KOLASIB,2021-02-14,0,134,0,134,
MIZORAM,KOLASIB,2021-02-15,0,252,0,252,
MIZORAM,LAWNGTLAI,2021-02-11,0,12,0,12,
MIZORAM,LAWNGTLAI,2021-02-12,0,10,0,10,
MIZORAM,LAWNGTLAI,2021-02-15,1,29,0,30,
MIZORAM,LUNGLEI,2021-02-11,1,37,0,38,
MIZORAM,LUNGLEI,2021-02-12,0,17,0,17,
MIZORAM,LUNGLEI,2021-02-13,0,14,0,14,
MIZORAM,LUNGLEI,2021-02-15,1,56,0,57,
MIZORAM,MAMIT,2021-02-11,0,49,0,49,
MIZORAM,MAMIT,2021-02-12,0,38,0,38,
MIZORAM,MAMIT,2021-02-13,0,2,0,2,
MIZORAM,MAMIT,2021-02-14,0,53,0,53,
MIZORAM,MAMIT,2021-02-15,0,52,0,52,
MIZORAM,SAIHA,2021-02-12,0,6,0,6,
MIZORAM,SAIHA,2021-02-13,0,5,0,5,
MIZORAM,SAIHA,2021-02-14,0,23,0,23,
MIZORAM,SAIHA,2021-02-15,0,20,0,20,
MIZORAM,SAITUAL,2021-02-11,0,63,0,63,
MIZORAM,SAITUAL,2021-02-12,0,56,0,56,
MIZORAM,SAITUAL,2021-02-13,0,27,0,27,
MIZORAM,SAITUAL,2021-02-14,0,2,0,2,
MIZORAM,SAITUAL,2021-02-15,0,33,0,33,
MIZORAM,SERCHHIP,2021-02-11,0,19,0,19,
MIZORAM,SERCHHIP,2021-02-12,0,2,0,2,
MIZORAM,SERCHHIP,2021-02-14,0,1,0,1,
MIZORAM,SERCHHIP,2021-02-15,0,47,0,47,
NAGALAND,DIMAPUR,2021-02-11,0,87,0,87,
NAGALAND,DIMAPUR,2021-02-12,1,125,0,126,
NAGALAND,DIMAPUR,2021-02-13,1,103,0,104,
NAGALAND,DIMAPUR,2021-02-14,0,15,0,15,
NAGALAND,DIMAPUR,2021-02-15,24,184,0,208,
NAGALAND,KIPHIRE,2021-02-11,0,5,0,5,
NAGALAND,KIPHIRE,2021-02-12,0,2,0,2,
NAGALAND,KIPHIRE,2021-02-13,0,1,0,1,
NAGALAND,KIPHIRE,2021-02-15,0,8,0,8,
NAGALAND,KOHIMA,2021-02-11,1,138,0,139,
NAGALAND,KOHIMA,2021-02-12,12,260,0,272,
NAGALAND,KOHIMA,2021-02-13,0,209,0,209,
NAGALAND,KOHIMA,2021-02-14,0,2,0,2,
NAGALAND,KOHIMA,2021-02-15,0,92,0,92,
NAGALAND,LONGLENG,2021-02-11,0,2,0,2,
NAGALAND,LONGLENG,2021-02-12,0,1,0,1,
NAGALAND,LONGLENG,2021-02-13,0,1,0,1,
NAGALAND,LONGLENG,2021-02-14,0,1,0,1,
NAGALAND,LONGLENG,2021-02-15,0,2,0,2,
NAGALAND,MOKOKCHUNG,2021-02-11,0,14,0,14,
NAGALAND,MOKOKCHUNG,2021-02-12,3,8,0,11,
NAGALAND,MOKOKCHUNG,2021-02-13,0,14,0,14,
NAGALAND,MOKOKCHUNG,2021-02-14,0,10,0,10,
NAGALAND,MOKOKCHUNG,2021-02-15,1,12,0,13,
NAGALAND,MON,2021-02-11,0,2,0,2,
NAGALAND,MON,2021-02-12,0,2,0,2,
NAGALAND,MON,2021-02-13,2,37,0,39,
NAGALAND,MON,2021-02-14,0,2,0,2,
NAGALAND,MON,2021-02-15,0,2,0,2,
NAGALAND,PEREN,2021-02-11,0,3,0,3,
NAGALAND,PEREN,2021-02-12,4,2,0,6,
NAGALAND,PEREN,2021-02-13,0,3,0,3,
NAGALAND,PEREN,2021-02-15,0,5,0,5,
NAGALAND,PHEK,2021-02-11,0,1,0,1,
NAGALAND,PHEK,2021-02-12,0,2,0,2,
NAGALAND,PHEK,2021-02-13,0,4,0,4,
NAGALAND,PHEK,2021-02-15,0,1,0,1,
NAGALAND,TUENSANG,2021-02-13,0,1,0,1,
NAGALAND,TUENSANG,2021-02-15,0,1,0,1,
NAGALAND,WOKHA,2021-02-11,0,13,0,13,
NAGALAND,WOKHA,2021-02-13,0,3,0,3,
NAGALAND,WOKHA,2021-02-14,0,2,0,2,
NAGALAND,WOKHA,2021-02-15,0,2,0,2,
NAGALAND,ZUNHEBOTO,2021-02-12,7,0,0,7,
NAGALAND,ZUNHEBOTO,2021-02-13,0,68,0,68,
NAGALAND,ZUNHEBOTO,2021-02-14,0,1,0,1,
NAGALAND,ZUNHEBOTO,2021-02-15,0,3,0,3,
ODISHA,ANUGUL,2021-02-11,4,370,0,374,
ODISHA,ANUGUL,2021-02-12,9,478,0,487,
ODISHA,ANUGUL,2021-02-13,2,333,0,335,
ODISHA,ANUGUL,2021-02-14,4,306,0,310,
ODISHA,ANUGUL,2021-02-15,9,414,0,423,
ODISHA,BALANGIR,2021-02-11,1,1054,0,1055,
ODISHA,BALANGIR,2021-02-12,2,1020,0,1022,
ODISHA,BALANGIR,2021-02-13,1,953,4,958,
ODISHA,BALANGIR,2021-02-14,6,838,5,849,
ODISHA,BALANGIR,2021-02-15,0,822,2,824,
ODISHA,BALESHWAR,2021-02-11,6,3109,0,3115,
ODISHA,BALESHWAR,2021-02-12,3,3084,0,3087,
ODISHA,BALESHWAR,2021-02-13,3,2478,7,2488,
ODISHA,BALESHWAR,2021-02-14,3,2051,0,2054,
ODISHA,BALESHWAR,2021-02-15,10,2640,1,2651,
ODISHA,BARGARH,2021-02-11,3,550,0,553,
ODISHA,BARGARH,2021-02-12,6,375,0,381,
ODISHA,BARGARH,2021-02-13,7,550,0,557,
ODISHA,BARGARH,2021-02-14,0,236,0,236,
ODISHA,BARGARH,2021-02-15,3,377,0,380,
ODISHA,BHADRAK,2021-02-11,1,858,0,859,
ODISHA,BHADRAK,2021-02-12,0,881,0,881,
ODISHA,BHADRAK,2021-02-13,1,793,0,794,
ODISHA,BHADRAK,2021-02-14,1,535,0,536,
ODISHA,BHADRAK,2021-02-15,1,404,1,406,
ODISHA,BOUDH,2021-02-11,0,336,0,336,
ODISHA,BOUDH,2021-02-12,0,106,0,106,
ODISHA,BOUDH,2021-02-13,0,215,0,215,
ODISHA,BOUDH,2021-02-14,0,162,0,162,
ODISHA,BOUDH,2021-02-15,0,207,0,207,
ODISHA,CUTTACK,2021-02-11,4,1369,2,1375,
ODISHA,CUTTACK,2021-02-12,5,1293,0,1298,
ODISHA,CUTTACK,2021-02-13,1,1201,4,1206,
ODISHA,CUTTACK,2021-02-14,2,409,0,411,
ODISHA,CUTTACK,2021-02-15,5,1125,2,1132,
ODISHA,DEOGARH,2021-02-11,2,161,0,163,
ODISHA,DEOGARH,2021-02-12,1,159,0,160,
ODISHA,DEOGARH,2021-02-13,0,130,0,130,
ODISHA,DEOGARH,2021-02-14,0,140,1,141,
ODISHA,DEOGARH,2021-02-15,0,138,0,138,
ODISHA,DHENKANAL,2021-02-11,0,428,1,429,
ODISHA,DHENKANAL,2021-02-12,2,380,0,382,
ODISHA,DHENKANAL,2021-02-13,0,410,0,410,
ODISHA,DHENKANAL,2021-02-14,0,184,0,184,
ODISHA,DHENKANAL,2021-02-15,1,632,0,633,
ODISHA,GAJAPATI,2021-02-11,0,399,20,419,
ODISHA,GAJAPATI,2021-02-12,0,195,0,195,
ODISHA,GAJAPATI,2021-02-13,13,298,0,311,
ODISHA,GAJAPATI,2021-02-14,0,22,0,22,
ODISHA,GAJAPATI,2021-02-15,0,136,8,144,
ODISHA,GANJAM,2021-02-11,1,1279,25,1305,
ODISHA,GANJAM,2021-02-12,1,1142,57,1200,
ODISHA,GANJAM,2021-02-13,0,803,2,805,
ODISHA,GANJAM,2021-02-14,1,687,0,688,
ODISHA,GANJAM,2021-02-15,0,913,28,941,
ODISHA,JAGATSINGHAPUR,2021-02-11,0,557,0,557,
ODISHA,JAGATSINGHAPUR,2021-02-12,0,528,0,528,
ODISHA,JAGATSINGHAPUR,2021-02-13,1,383,0,384,
ODISHA,JAGATSINGHAPUR,2021-02-14,0,176,0,176,
ODISHA,JAGATSINGHAPUR,2021-02-15,0,279,1,280,
ODISHA,JAJAPUR,2021-02-11,3,552,1,556,
ODISHA,JAJAPUR,2021-02-12,0,482,1,483,
ODISHA,JAJAPUR,2021-02-13,4,306,0,310,
ODISHA,JAJAPUR,2021-02-14,1,143,0,144,
ODISHA,JAJAPUR,2021-02-15,3,294,0,297,
ODISHA,JHARSUGUDA,2021-02-11,1,316,1,318,
ODISHA,JHARSUGUDA,2021-02-12,2,370,3,375,
ODISHA,JHARSUGUDA,2021-02-13,0,266,0,266,
ODISHA,JHARSUGUDA,2021-02-14,1,245,1,247,
ODISHA,JHARSUGUDA,2021-02-15,0,242,0,242,
ODISHA,KALAHANDI,2021-02-11,1,336,0,337,
ODISHA,KALAHANDI,2021-02-12,0,141,0,141,
ODISHA,KALAHANDI,2021-02-13,0,399,0,399,
ODISHA,KALAHANDI,2021-02-14,0,367,0,367,
ODISHA,KALAHANDI,2021-02-15,0,486,0,486,
ODISHA,KANDHAMAL,2021-02-11,0,647,0,647,
ODISHA,KANDHAMAL,2021-02-12,0,616,0,616,
ODISHA,KANDHAMAL,2021-02-13,0,595,0,595,
ODISHA,KANDHAMAL,2021-02-14,0,633,0,633,
ODISHA,KANDHAMAL,2021-02-15,0,608,0,608,
ODISHA,KENDRAPARA,2021-02-11,1,1220,1,1222,
ODISHA,KENDRAPARA,2021-02-12,0,818,0,818,
ODISHA,KENDRAPARA,2021-02-13,0,926,0,926,
ODISHA,KENDRAPARA,2021-02-14,0,649,0,649,
ODISHA,KENDRAPARA,2021-02-15,0,753,0,753,
ODISHA,KENDUJHAR,2021-02-11,2,912,0,914,
ODISHA,KENDUJHAR,2021-02-12,0,795,0,795,
ODISHA,KENDUJHAR,2021-02-13,2,694,0,696,
ODISHA,KENDUJHAR,2021-02-14,0,615,0,615,
ODISHA,KENDUJHAR,2021-02-15,4,598,0,602,
ODISHA,KHORDHA,2021-02-11,6,1395,2,1403,
ODISHA,KHORDHA,2021-02-12,6,1306,0,1312,
ODISHA,KHORDHA,2021-02-13,9,1293,2,1304,
ODISHA,KHORDHA,2021-02-14,5,939,0,944,
ODISHA,KHORDHA,2021-02-15,3,1130,2,1135,
ODISHA,KORAPUT,2021-02-11,0,1035,0,1035,
ODISHA,KORAPUT,2021-02-12,1,1089,0,1090,
ODISHA,KORAPUT,2021-02-13,0,1062,0,1062,
ODISHA,KORAPUT,2021-02-14,0,994,0,994,
ODISHA,KORAPUT,2021-02-15,0,972,0,972,
ODISHA,MALKANGIRI,2021-02-11,2,433,0,435,
ODISHA,MALKANGIRI,2021-02-12,0,345,0,345,
ODISHA,MALKANGIRI,2021-02-13,1,272,0,273,
ODISHA,MALKANGIRI,2021-02-14,0,167,0,167,
ODISHA,MALKANGIRI,2021-02-15,0,167,0,167,
ODISHA,MAYURBHANJ,2021-02-11,4,1252,0,1256,
ODISHA,MAYURBHANJ,2021-02-12,2,1539,1,1542,
ODISHA,MAYURBHANJ,2021-02-13,5,1009,0,1014,
ODISHA,MAYURBHANJ,2021-02-14,7,991,0,998,
ODISHA,MAYURBHANJ,2021-02-15,2,976,0,978,
ODISHA,NABARANGPUR,2021-02-11,0,688,0,688,
ODISHA,NABARANGPUR,2021-02-12,0,702,0,702,
ODISHA,NABARANGPUR,2021-02-13,2,761,0,763,
ODISHA,NABARANGPUR,2021-02-14,0,440,0,440,
ODISHA,NABARANGPUR,2021-02-15,0,578,0,578,
ODISHA,NAYAGARH,2021-02-11,0,659,0,659,
ODISHA,NAYAGARH,2021-02-12,0,580,0,580,
ODISHA,NAYAGARH,2021-02-13,1,620,0,621,
ODISHA,NAYAGARH,2021-02-14,0,629,0,629,
ODISHA,NAYAGARH,2021-02-15,1,466,0,467,
ODISHA,NUAPADA,2021-02-11,2,127,0,129,
ODISHA,NUAPADA,2021-02-12,2,137,0,139,
ODISHA,NUAPADA,2021-02-13,3,83,0,86,
ODISHA,NUAPADA,2021-02-14,5,78,0,83,
ODISHA,NUAPADA,2021-02-15,0,213,0,213,
ODISHA,PURI,2021-02-11,8,802,0,810,
ODISHA,PURI,2021-02-12,4,748,0,752,
ODISHA,PURI,2021-02-13,9,634,0,643,
ODISHA,PURI,2021-02-14,13,465,0,478,
ODISHA,PURI,2021-02-15,1,527,0,528,
ODISHA,RAYAGADA,2021-02-11,0,570,0,570,
ODISHA,RAYAGADA,2021-02-12,4,711,0,715,
ODISHA,RAYAGADA,2021-02-13,0,634,0,634,
ODISHA,RAYAGADA,2021-02-14,0,356,3,359,
ODISHA,RAYAGADA,2021-02-15,6,386,0,392,
ODISHA,SAMBALPUR,2021-02-11,13,555,0,568,
ODISHA,SAMBALPUR,2021-02-12,10,528,0,538,
ODISHA,SAMBALPUR,2021-02-13,12,578,0,590,
ODISHA,SAMBALPUR,2021-02-14,15,504,0,519,
ODISHA,SAMBALPUR,2021-02-15,15,396,0,411,
ODISHA,SONEPUR,2021-02-11,0,425,0,425,
ODISHA,SONEPUR,2021-02-12,0,331,0,331,
ODISHA,SONEPUR,2021-02-13,0,179,0,179,
ODISHA,SONEPUR,2021-02-14,0,160,0,160,
ODISHA,SONEPUR,2021-02-15,0,219,1,220,
ODISHA,SUNDARGARH,2021-02-11,16,565,1,582,
ODISHA,SUNDARGARH,2021-02-12,8,498,0,506,
ODISHA,SUNDARGARH,2021-02-13,17,635,0,652,
ODISHA,SUNDARGARH,2021-02-14,2,419,0,421,
ODISHA,SUNDARGARH,2021-02-15,28,488,0,516,
PUDUCHERRY,KARAIKAL,2021-02-11,2,409,0,411,
PUDUCHERRY,KARAIKAL,2021-02-12,2,393,0,395,
PUDUCHERRY,KARAIKAL,2021-02-13,3,425,1,429,
PUDUCHERRY,KARAIKAL,2021-02-14,3,171,0,174,
PUDUCHERRY,KARAIKAL,2021-02-15,2,353,0,355,
PUDUCHERRY,MAHE,2021-02-11,6,267,0,273,
PUDUCHERRY,MAHE,2021-02-12,0,283,0,283,
PUDUCHERRY,MAHE,2021-02-13,2,265,0,267,
PUDUCHERRY,MAHE,2021-02-14,3,127,0,130,
PUDUCHERRY,MAHE,2021-02-15,5,237,0,242,
PUDUCHERRY,PONDICHERRY,2021-02-11,16,588,3,607,
PUDUCHERRY,PONDICHERRY,2021-02-12,19,687,2,708,
PUDUCHERRY,PONDICHERRY,2021-02-13,12,565,4,581,
PUDUCHERRY,PONDICHERRY,2021-02-14,12,270,5,287,
PUDUCHERRY,PONDICHERRY,2021-02-15,15,569,2,586,
PUDUCHERRY,YANAM,2021-02-11,0,161,0,161,
PUDUCHERRY,YANAM,2021-02-12,0,319,0,319,
PUDUCHERRY,YANAM,2021-02-13,0,56,0,56,
PUDUCHERRY,YANAM,2021-02-14,0,101,0,101,
PUDUCHERRY,YANAM,2021-02-15,0,117,0,117,
PUNJAB,AMRITSAR,2021-02-11,11,1079,9,1099,
PUNJAB,AMRITSAR,2021-02-12,23,749,3,775,
PUNJAB,AMRITSAR,2021-02-13,10,1248,1,1259,
PUNJAB,AMRITSAR,2021-02-14,20,1432,6,1458,
PUNJAB,AMRITSAR,2021-02-15,15,1003,0,1018,
PUNJAB,BARNALA,2021-02-11,0,109,11,120,
PUNJAB,BARNALA,2021-02-12,0,255,10,265,
PUNJAB,BARNALA,2021-02-13,1,195,6,202,
PUNJAB,BARNALA,2021-02-14,0,248,0,248,
PUNJAB,BARNALA,2021-02-15,0,142,0,142,
PUNJAB,BATHINDA,2021-02-11,13,614,4,631,
PUNJAB,BATHINDA,2021-02-12,9,552,19,580,
PUNJAB,BATHINDA,2021-02-13,4,528,3,535,
PUNJAB,BATHINDA,2021-02-14,5,459,46,510,
PUNJAB,BATHINDA,2021-02-15,7,396,4,407,
PUNJAB,FARIDKOT,2021-02-11,12,320,2,334,
PUNJAB,FARIDKOT,2021-02-12,10,245,7,262,
PUNJAB,FARIDKOT,2021-02-13,7,213,2,222,
PUNJAB,FARIDKOT,2021-02-14,5,182,0,187,
PUNJAB,FARIDKOT,2021-02-15,2,102,0,104,
PUNJAB,FATEHGARH SAHIB,2021-02-11,0,416,1,417,
PUNJAB,FATEHGARH SAHIB,2021-02-12,5,367,1,373,
PUNJAB,FATEHGARH SAHIB,2021-02-13,4,317,1,322,
PUNJAB,FATEHGARH SAHIB,2021-02-14,1,301,2,304,
PUNJAB,FATEHGARH SAHIB,2021-02-15,0,242,0,242,
PUNJAB,FAZILKA,2021-02-11,0,109,2,111,
PUNJAB,FAZILKA,2021-02-12,1,397,1,399,
PUNJAB,FAZILKA,2021-02-13,1,235,0,236,
PUNJAB,FAZILKA,2021-02-14,2,114,0,116,
PUNJAB,FAZILKA,2021-02-15,2,56,0,58,
PUNJAB,FIROZEPUR,2021-02-11,5,323,1,329,
PUNJAB,FIROZEPUR,2021-02-12,1,246,1,248,
PUNJAB,FIROZEPUR,2021-02-13,2,182,1,185,
PUNJAB,FIROZEPUR,2021-02-14,3,257,0,260,
PUNJAB,FIROZEPUR,2021-02-15,2,79,0,81,
PUNJAB,GURDASPUR,2021-02-11,9,1650,18,1677,
PUNJAB,GURDASPUR,2021-02-12,17,591,2,610,
PUNJAB,GURDASPUR,2021-02-13,1,1223,3,1227,
PUNJAB,GURDASPUR,2021-02-14,9,800,50,859,
PUNJAB,GURDASPUR,2021-02-15,10,1097,29,1136,
PUNJAB,HOSHIARPUR,2021-02-11,22,694,4,720,
PUNJAB,HOSHIARPUR,2021-02-12,18,912,6,936,
PUNJAB,HOSHIARPUR,2021-02-13,18,1612,0,1630,
PUNJAB,HOSHIARPUR,2021-02-14,22,1094,5,1121,
PUNJAB,HOSHIARPUR,2021-02-15,25,866,9,900,
PUNJAB,JALANDHAR,2021-02-11,37,3147,76,3260,
PUNJAB,JALANDHAR,2021-02-12,41,3084,175,3300,
PUNJAB,JALANDHAR,2021-02-13,35,2414,137,2586,
PUNJAB,JALANDHAR,2021-02-14,50,2272,101,2423,
PUNJAB,JALANDHAR,2021-02-15,28,583,1,612,
PUNJAB,KAPURTHALA,2021-02-11,12,1163,0,1175,
PUNJAB,KAPURTHALA,2021-02-12,22,929,5,956,
PUNJAB,KAPURTHALA,2021-02-13,10,758,10,778,
PUNJAB,KAPURTHALA,2021-02-14,15,699,0,714,
PUNJAB,KAPURTHALA,2021-02-15,12,585,0,597,
PUNJAB,LUDHIANA,2021-02-11,51,2227,17,2295,
PUNJAB,LUDHIANA,2021-02-12,44,2445,15,2504,
PUNJAB,LUDHIANA,2021-02-13,48,2727,22,2797,
PUNJAB,LUDHIANA,2021-02-14,41,2432,56,2529,
PUNJAB,LUDHIANA,2021-02-15,72,2680,6,2758,
PUNJAB,MANSA,2021-02-11,4,35,0,39,
PUNJAB,MANSA,2021-02-12,0,373,0,373,
PUNJAB,MANSA,2021-02-13,1,350,0,351,
PUNJAB,MANSA,2021-02-14,2,413,0,415,
PUNJAB,MANSA,2021-02-15,1,29,0,30,
PUNJAB,MOGA,2021-02-11,1,250,1,252,
PUNJAB,MOGA,2021-02-12,4,289,3,296,
PUNJAB,MOGA,2021-02-13,4,188,4,196,
PUNJAB,MOGA,2021-02-14,3,192,0,195,
PUNJAB,MOGA,2021-02-15,6,268,2,276,
PUNJAB,PATHANKOT,2021-02-11,2,630,5,637,
PUNJAB,PATHANKOT,2021-02-12,7,597,1,605,
PUNJAB,PATHANKOT,2021-02-13,1,578,1,580,
PUNJAB,PATHANKOT,2021-02-14,1,137,1,139,
PUNJAB,PATHANKOT,2021-02-15,2,512,7,521,
PUNJAB,PATIALA,2021-02-11,17,2328,5,2350,
PUNJAB,PATIALA,2021-02-12,12,2738,0,2750,
PUNJAB,PATIALA,2021-02-13,12,1537,1,1550,
PUNJAB,PATIALA,2021-02-14,26,1438,2,1466,
PUNJAB,PATIALA,2021-02-15,27,774,0,801,
PUNJAB,RUPNAGAR,2021-02-11,11,506,4,521,
PUNJAB,RUPNAGAR,2021-02-12,9,554,1,564,
PUNJAB,RUPNAGAR,2021-02-13,2,265,0,267,
PUNJAB,RUPNAGAR,2021-02-14,8,648,16,672,
PUNJAB,RUPNAGAR,2021-02-15,2,161,4,167,
PUNJAB,S.A.S NAGAR,2021-02-11,23,952,5,980,
PUNJAB,S.A.S NAGAR,2021-02-12,26,848,4,878,
PUNJAB,S.A.S NAGAR,2021-02-13,35,866,2,903,
PUNJAB,S.A.S NAGAR,2021-02-14,15,357,2,374,
PUNJAB,S.A.S NAGAR,2021-02-15,33,941,2,976,
PUNJAB,SANGRUR,2021-02-11,3,1498,1,1502,
PUNJAB,SANGRUR,2021-02-12,2,894,2,898,
PUNJAB,SANGRUR,2021-02-13,1,1051,29,1081,
PUNJAB,SANGRUR,2021-02-14,1,2332,3,2336,
PUNJAB,SANGRUR,2021-02-15,4,2250,7,2261,
PUNJAB,SHAHID BHAGAT SINGH NAGAR,2021-02-11,82,1284,3,1369,
PUNJAB,SHAHID BHAGAT SINGH NAGAR,2021-02-12,36,1203,1,1240,
PUNJAB,SHAHID BHAGAT SINGH NAGAR,2021-02-13,80,1327,0,1407,
PUNJAB,SHAHID BHAGAT SINGH NAGAR,2021-02-14,70,796,4,870,
PUNJAB,SHAHID BHAGAT SINGH NAGAR,2021-02-15,35,137,1,173,
PUNJAB,SRI MUKTSAR SAHIB,2021-02-11,4,245,2,251,
PUNJAB,SRI MUKTSAR SAHIB,2021-02-12,1,186,0,187,
PUNJAB,SRI MUKTSAR SAHIB,2021-02-13,2,227,2,231,
PUNJAB,SRI MUKTSAR SAHIB,2021-02-14,6,113,0,119,
PUNJAB,SRI MUKTSAR SAHIB,2021-02-15,2,191,1,194,
PUNJAB,TARN TARAN,2021-02-11,3,754,0,757,
PUNJAB,TARN TARAN,2021-02-12,5,439,1,445,
PUNJAB,TARN TARAN,2021-02-13,1,530,1,532,
PUNJAB,TARN TARAN,2021-02-14,2,497,0,499,
PUNJAB,TARN TARAN,2021-02-15,0,524,0,524,
RAJASTHAN,AJMER,2021-02-11,3,80,518,601,
RAJASTHAN,AJMER,2021-02-12,2,61,591,654,
RAJASTHAN,AJMER,2021-02-13,6,56,869,931,
RAJASTHAN,AJMER,2021-02-14,1,65,173,239,
RAJASTHAN,AJMER,2021-02-15,1,66,400,467,
RAJASTHAN,ALWAR,2021-02-11,10,3607,25,3642,
RAJASTHAN,ALWAR,2021-02-12,2,3623,41,3666,
RAJASTHAN,ALWAR,2021-02-13,4,2777,64,2845,
RAJASTHAN,ALWAR,2021-02-14,5,3335,38,3378,
RAJASTHAN,ALWAR,2021-02-15,0,3146,33,3179,
RAJASTHAN,BANSWARA,2021-02-11,2,23,0,25,
RAJASTHAN,BANSWARA,2021-02-12,1,68,0,69,
RAJASTHAN,BANSWARA,2021-02-13,4,81,0,85,
RAJASTHAN,BANSWARA,2021-02-14,3,118,1,122,
RAJASTHAN,BANSWARA,2021-02-15,4,121,0,125,
RAJASTHAN,BARAN,2021-02-11,0,67,0,67,
RAJASTHAN,BARAN,2021-02-12,1,138,0,139,
RAJASTHAN,BARAN,2021-02-13,0,88,0,88,
RAJASTHAN,BARAN,2021-02-14,0,183,0,183,
RAJASTHAN,BARAN,2021-02-15,2,128,0,130,
RAJASTHAN,BARMER,2021-02-11,6,190,0,196,
RAJASTHAN,BARMER,2021-02-12,17,181,0,198,
RAJASTHAN,BARMER,2021-02-13,4,339,1,344,
RAJASTHAN,BARMER,2021-02-14,5,248,7,260,
RAJASTHAN,BARMER,2021-02-15,12,249,0,261,
RAJASTHAN,BHARATPUR,2021-02-11,2,376,3,381,
RAJASTHAN,BHARATPUR,2021-02-12,2,145,4,151,
RAJASTHAN,BHARATPUR,2021-02-13,3,395,8,406,
RAJASTHAN,BHARATPUR,2021-02-14,6,409,2,417,
RAJASTHAN,BHARATPUR,2021-02-15,1,283,0,284,
RAJASTHAN,BHILWARA,2021-02-11,26,386,0,412,
RAJASTHAN,BHILWARA,2021-02-12,2,403,0,405,
RAJASTHAN,BHILWARA,2021-02-13,16,294,8,318,
RAJASTHAN,BHILWARA,2021-02-14,12,241,6,259,
RAJASTHAN,BHILWARA,2021-02-15,6,143,2,151,
RAJASTHAN,BIKANER,2021-02-11,1,1605,0,1606,
RAJASTHAN,BIKANER,2021-02-12,1,1532,2,1535,
RAJASTHAN,BIKANER,2021-02-13,2,1551,1,1554,
RAJASTHAN,BIKANER,2021-02-14,0,1004,1,1005,
RAJASTHAN,BIKANER,2021-02-15,25,1466,4,1495,
RAJASTHAN,BUNDI,2021-02-11,0,105,0,105,
RAJASTHAN,BUNDI,2021-02-12,0,188,0,188,
RAJASTHAN,BUNDI,2021-02-13,0,350,2,352,
RAJASTHAN,BUNDI,2021-02-14,0,65,3,68,
RAJASTHAN,BUNDI,2021-02-15,0,67,1,68,
RAJASTHAN,CHITTORGARH,2021-02-11,0,591,4,595,
RAJASTHAN,CHITTORGARH,2021-02-12,0,913,3,916,
RAJASTHAN,CHITTORGARH,2021-02-13,1,1070,6,1077,
RAJASTHAN,CHITTORGARH,2021-02-14,1,701,1,703,
RAJASTHAN,CHITTORGARH,2021-02-15,3,709,1,713,
RAJASTHAN,CHURU,2021-02-11,0,270,3,273,
RAJASTHAN,CHURU,2021-02-12,2,481,3,486,
RAJASTHAN,CHURU,2021-02-13,1,361,6,368,
RAJASTHAN,CHURU,2021-02-14,2,467,3,472,
RAJASTHAN,CHURU,2021-02-15,0,83,1,84,
RAJASTHAN,DAUSA,2021-02-11,0,322,4,326,
RAJASTHAN,DAUSA,2021-02-12,0,167,6,173,
RAJASTHAN,DAUSA,2021-02-13,0,321,8,329,
RAJASTHAN,DAUSA,2021-02-14,0,106,19,125,
RAJASTHAN,DAUSA,2021-02-15,1,313,7,321,
RAJASTHAN,DHOLPUR,2021-02-11,1,468,0,469,
RAJASTHAN,DHOLPUR,2021-02-12,0,389,4,393,
RAJASTHAN,DHOLPUR,2021-02-13,2,142,1,145,
RAJASTHAN,DHOLPUR,2021-02-14,0,4,0,4,
RAJASTHAN,DHOLPUR,2021-02-15,4,502,25,531,
RAJASTHAN,DUNGARPUR,2021-02-11,11,335,0,346,
RAJASTHAN,DUNGARPUR,2021-02-12,4,129,0,133,
RAJASTHAN,DUNGARPUR,2021-02-13,1,362,0,363,
RAJASTHAN,DUNGARPUR,2021-02-14,1,187,0,188,
RAJASTHAN,DUNGARPUR,2021-02-15,1,262,0,263,
RAJASTHAN,GANGANAGAR,2021-02-11,141,290,30,461,
RAJASTHAN,GANGANAGAR,2021-02-12,195,268,18,481,
RAJASTHAN,GANGANAGAR,2021-02-13,98,363,11,472,
RAJASTHAN,GANGANAGAR,2021-02-14,102,127,32,261,
RAJASTHAN,GANGANAGAR,2021-02-15,138,411,14,563,
RAJASTHAN,HANUMANGARH,2021-02-11,0,878,1,879,
RAJASTHAN,HANUMANGARH,2021-02-12,2,523,1,526,
RAJASTHAN,HANUMANGARH,2021-02-13,0,652,1,653,
RAJASTHAN,HANUMANGARH,2021-02-14,0,707,0,707,
RAJASTHAN,HANUMANGARH,2021-02-15,0,40,0,40,
RAJASTHAN,JAIPUR,2021-02-11,41,2085,244,2370,
RAJASTHAN,JAIPUR,2021-02-12,46,2159,252,2457,
RAJASTHAN,JAIPUR,2021-02-13,99,2027,245,2371,
RAJASTHAN,JAIPUR,2021-02-14,28,1499,205,1732,
RAJASTHAN,JAIPUR,2021-02-15,86,1604,203,1893,
RAJASTHAN,JAISALMER,2021-02-11,2,65,1,68,
RAJASTHAN,JAISALMER,2021-02-12,0,219,3,222,
RAJASTHAN,JAISALMER,2021-02-13,0,289,0,289,
RAJASTHAN,JAISALMER,2021-02-14,0,206,0,206,
RAJASTHAN,JAISALMER,2021-02-15,0,211,0,211,
RAJASTHAN,JALORE,2021-02-11,0,1394,4,1398,
RAJASTHAN,JALORE,2021-02-12,0,989,1,990,
RAJASTHAN,JALORE,2021-02-13,0,575,1,576,
RAJASTHAN,JALORE,2021-02-14,0,482,3,485,
RAJASTHAN,JALORE,2021-02-15,0,593,0,593,
RAJASTHAN,JHALAWAR,2021-02-11,2,651,3,656,
RAJASTHAN,JHALAWAR,2021-02-12,4,217,4,225,
RAJASTHAN,JHALAWAR,2021-02-13,2,712,0,714,
RAJASTHAN,JHALAWAR,2021-02-14,0,137,1,138,
RAJASTHAN,JHALAWAR,2021-02-15,1,308,0,309,
RAJASTHAN,JHUNJHUNU,2021-02-11,0,93,3,96,
RAJASTHAN,JHUNJHUNU,2021-02-12,2,73,3,78,
RAJASTHAN,JHUNJHUNU,2021-02-13,2,68,4,74,
RAJASTHAN,JHUNJHUNU,2021-02-14,1,58,4,63,
RAJASTHAN,JHUNJHUNU,2021-02-15,0,44,2,46,
RAJASTHAN,JODHPUR,2021-02-11,9,1132,0,1141,
RAJASTHAN,JODHPUR,2021-02-12,18,902,0,920,
RAJASTHAN,JODHPUR,2021-02-13,19,1220,2,1241,
RAJASTHAN,JODHPUR,2021-02-14,8,251,0,259,
RAJASTHAN,JODHPUR,2021-02-15,16,837,6,859,
RAJASTHAN,KARAULI,2021-02-11,8,574,7,589,
RAJASTHAN,KARAULI,2021-02-12,2,408,3,413,
RAJASTHAN,KARAULI,2021-02-13,3,439,7,449,
RAJASTHAN,KARAULI,2021-02-14,6,381,6,393,
RAJASTHAN,KARAULI,2021-02-15,0,200,1,201,
RAJASTHAN,KOTA,2021-02-11,15,1143,2,1160,
RAJASTHAN,KOTA,2021-02-12,0,1250,0,1250,
RAJASTHAN,KOTA,2021-02-13,0,827,0,827,
RAJASTHAN,KOTA,2021-02-14,1,987,2,990,
RAJASTHAN,KOTA,2021-02-15,104,805,2,911,
RAJASTHAN,NAGAUR,2021-02-11,189,43,535,767,
RAJASTHAN,NAGAUR,2021-02-12,252,54,547,853,
RAJASTHAN,NAGAUR,2021-02-13,439,61,158,658,
RAJASTHAN,NAGAUR,2021-02-14,315,42,616,973,
RAJASTHAN,NAGAUR,2021-02-15,201,37,122,360,
RAJASTHAN,PALI,2021-02-11,0,16,1,17,
RAJASTHAN,PALI,2021-02-12,2,173,32,207,
RAJASTHAN,PALI,2021-02-13,1,18,3,22,
RAJASTHAN,PALI,2021-02-14,2,261,1,264,
RAJASTHAN,PALI,2021-02-15,0,215,0,215,
RAJASTHAN,PRATAPGARH,2021-02-11,1,6,0,7,
RAJASTHAN,PRATAPGARH,2021-02-12,2,4,0,6,
RAJASTHAN,PRATAPGARH,2021-02-13,0,7,0,7,
RAJASTHAN,PRATAPGARH,2021-02-15,1,3,0,4,
RAJASTHAN,RAJSAMAND,2021-02-11,4,357,0,361,
RAJASTHAN,RAJSAMAND,2021-02-12,3,406,0,409,
RAJASTHAN,RAJSAMAND,2021-02-13,1,225,1,227,
RAJASTHAN,RAJSAMAND,2021-02-14,0,10,0,10,
RAJASTHAN,RAJSAMAND,2021-02-15,2,313,0,315,
RAJASTHAN,SAWAI MADHOPUR,2021-02-11,0,187,6,193,
RAJASTHAN,SAWAI MADHOPUR,2021-02-12,0,142,8,150,
RAJASTHAN,SAWAI MADHOPUR,2021-02-13,2,171,6,179,
RAJASTHAN,SAWAI MADHOPUR,2021-02-14,0,75,3,78,
RAJASTHAN,SAWAI MADHOPUR,2021-02-15,0,126,7,133,
RAJASTHAN,SIKAR,2021-02-11,0,399,8,407,
RAJASTHAN,SIKAR,2021-02-12,1,312,7,320,
RAJASTHAN,SIKAR,2021-02-13,1,321,4,326,
RAJASTHAN,SIKAR,2021-02-14,2,286,4,292,
RAJASTHAN,SIKAR,2021-02-15,1,136,7,144,
RAJASTHAN,SIROHI,2021-02-11,4,250,1,255,
RAJASTHAN,SIROHI,2021-02-12,13,326,0,339,
RAJASTHAN,SIROHI,2021-02-13,8,276,0,284,
RAJASTHAN,SIROHI,2021-02-14,0,99,0,99,
RAJASTHAN,SIROHI,2021-02-15,14,197,0,211,
RAJASTHAN,TONK,2021-02-11,0,406,98,504,
RAJASTHAN,TONK,2021-02-12,0,454,10,464,
RAJASTHAN,TONK,2021-02-13,2,423,11,436,
RAJASTHAN,TONK,2021-02-14,0,22,2,24,
RAJASTHAN,TONK,2021-02-15,0,561,36,597,
RAJASTHAN,UDAIPUR,2021-02-11,44,696,1,741,
RAJASTHAN,UDAIPUR,2021-02-12,31,580,0,611,
RAJASTHAN,UDAIPUR,2021-02-13,43,520,0,563,
RAJASTHAN,UDAIPUR,2021-02-14,30,487,0,517,
RAJASTHAN,UDAIPUR,2021-02-15,25,515,0,540,
SIKKIM,EAST DISTRICT,2021-02-11,3,132,0,135,
SIKKIM,EAST DISTRICT,2021-02-12,1,72,0,73,
SIKKIM,EAST DISTRICT,2021-02-13,0,41,0,41,
SIKKIM,EAST DISTRICT,2021-02-14,0,23,0,23,
SIKKIM,EAST DISTRICT,2021-02-15,4,145,0,149,
SIKKIM,NORTH DISTRICT,2021-02-11,0,2,0,2,
SIKKIM,NORTH DISTRICT,2021-02-12,0,2,0,2,
SIKKIM,NORTH DISTRICT,2021-02-13,0,1,0,1,
SIKKIM,NORTH DISTRICT,2021-02-14,0,2,0,2,
SIKKIM,NORTH DISTRICT,2021-02-15,0,4,0,4,
SIKKIM,SOUTH DISTRICT,2021-02-11,0,14,0,14,
SIKKIM,SOUTH DISTRICT,2021-02-13,1,14,0,15,
SIKKIM,SOUTH DISTRICT,2021-02-14,1,3,0,4,
SIKKIM,SOUTH DISTRICT,2021-02-15,0,13,0,13,
SIKKIM,WEST DISTRICT,2021-02-11,0,3,0,3,
SIKKIM,WEST DISTRICT,2021-02-12,0,2,0,2,
SIKKIM,WEST DISTRICT,2021-02-13,0,2,0,2,
SIKKIM,WEST DISTRICT,2021-02-15,0,5,0,5,
TAMIL NADU,ARIYALUR,2021-02-11,0,447,0,447,
TAMIL NADU,ARIYALUR,2021-02-12,0,809,0,809,
TAMIL NADU,ARIYALUR,2021-02-13,2,165,0,167,
TAMIL NADU,ARIYALUR,2021-02-14,1,41,0,42,
TAMIL NADU,ARIYALUR,2021-02-15,0,65,0,65,
TAMIL NADU,CHENGALPATTU,2021-02-11,24,3532,0,3556,
TAMIL NADU,CHENGALPATTU,2021-02-12,52,3314,1,3367,
TAMIL NADU,CHENGALPATTU,2021-02-13,18,2319,1,2338,
TAMIL NADU,CHENGALPATTU,2021-02-14,29,2392,1,2422,
TAMIL NADU,CHENGALPATTU,2021-02-15,40,2418,0,2458,
TAMIL NADU,CHENNAI,2021-02-11,181,11709,8,11898,
TAMIL NADU,CHENNAI,2021-02-12,248,11443,23,11714,
TAMIL NADU,CHENNAI,2021-02-13,191,12170,27,12388,
TAMIL NADU,CHENNAI,2021-02-14,130,9875,2,10007,
TAMIL NADU,CHENNAI,2021-02-15,202,8911,19,9132,
TAMIL NADU,COIMBATORE,2021-02-11,56,2196,1,2253,
TAMIL NADU,COIMBATORE,2021-02-12,64,2181,0,2245,
TAMIL NADU,COIMBATORE,2021-02-13,47,1627,0,1674,
TAMIL NADU,COIMBATORE,2021-02-14,42,1234,0,1276,
TAMIL NADU,COIMBATORE,2021-02-15,41,1524,1,1566,
TAMIL NADU,CUDDALORE,2021-02-11,6,1265,0,1271,
TAMIL NADU,CUDDALORE,2021-02-12,11,1396,0,1407,
TAMIL NADU,CUDDALORE,2021-02-13,10,1544,0,1554,
TAMIL NADU,CUDDALORE,2021-02-14,7,487,1,495,
TAMIL NADU,CUDDALORE,2021-02-15,5,863,0,868,
TAMIL NADU,DHARMAPURI,2021-02-11,0,665,0,665,
TAMIL NADU,DHARMAPURI,2021-02-12,3,818,0,821,
TAMIL NADU,DHARMAPURI,2021-02-13,2,567,0,569,
TAMIL NADU,DHARMAPURI,2021-02-14,1,548,0,549,
TAMIL NADU,DHARMAPURI,2021-02-15,5,659,0,664,
TAMIL NADU,DINDIGUL,2021-02-11,13,470,4,487,
TAMIL NADU,DINDIGUL,2021-02-12,7,549,0,556,
TAMIL NADU,DINDIGUL,2021-02-13,18,216,11,245,
TAMIL NADU,DINDIGUL,2021-02-14,6,93,0,99,
TAMIL NADU,DINDIGUL,2021-02-15,11,137,0,148,
TAMIL NADU,ERODE,2021-02-11,13,1752,0,1765,
TAMIL NADU,ERODE,2021-02-12,13,1651,1,1665,
TAMIL NADU,ERODE,2021-02-13,9,1519,0,1528,
TAMIL NADU,ERODE,2021-02-14,10,1358,0,1368,
TAMIL NADU,ERODE,2021-02-15,18,518,0,536,
TAMIL NADU,KALLAKURICHI,2021-02-11,2,336,0,338,
TAMIL NADU,KALLAKURICHI,2021-02-12,1,430,1,432,
TAMIL NADU,KALLAKURICHI,2021-02-13,0,688,0,688,
TAMIL NADU,KALLAKURICHI,2021-02-14,0,692,1,693,
TAMIL NADU,KALLAKURICHI,2021-02-15,1,496,0,497,
TAMIL NADU,KANCHIPURAM,2021-02-11,8,1897,0,1905,
TAMIL NADU,KANCHIPURAM,2021-02-12,9,2281,2,2292,
TAMIL NADU,KANCHIPURAM,2021-02-13,9,1624,1,1634,
TAMIL NADU,KANCHIPURAM,2021-02-14,15,1998,1,2014,
TAMIL NADU,KANCHIPURAM,2021-02-15,9,2123,1,2133,
TAMIL NADU,KANNIYAKUMARI,2021-02-11,11,1745,8,1764,
TAMIL NADU,KANNIYAKUMARI,2021-02-12,6,1235,3,1244,
TAMIL NADU,KANNIYAKUMARI,2021-02-13,2,1649,1,1652,
TAMIL NADU,KANNIYAKUMARI,2021-02-14,13,1125,1,1139,
TAMIL NADU,KANNIYAKUMARI,2021-02-15,12,1799,8,1819,
TAMIL NADU,KARUR,2021-02-11,6,1103,1,1110,
TAMIL NADU,KARUR,2021-02-12,4,1152,0,1156,
TAMIL NADU,KARUR,2021-02-13,3,1049,0,1052,
TAMIL NADU,KARUR,2021-02-14,6,1087,0,1093,
TAMIL NADU,KARUR,2021-02-15,2,865,2,869,
TAMIL NADU,KRISHNAGIRI,2021-02-11,3,1159,1,1163,
TAMIL NADU,KRISHNAGIRI,2021-02-12,2,1327,1,1330,
TAMIL NADU,KRISHNAGIRI,2021-02-13,3,824,0,827,
TAMIL NADU,KRISHNAGIRI,2021-02-14,2,179,0,181,
TAMIL NADU,KRISHNAGIRI,2021-02-15,1,948,1,950,
TAMIL NADU,MADURAI,2021-02-11,16,2526,0,2542,
TAMIL NADU,MADURAI,2021-02-12,11,2302,1,2314,
TAMIL NADU,MADURAI,2021-02-13,7,2317,0,2324,
TAMIL NADU,MADURAI,2021-02-14,9,2419,1,2429,
TAMIL NADU,MADURAI,2021-02-15,8,2555,1,2564,
TAMIL NADU,NAGAPATTINAM,2021-02-11,9,374,0,383,
TAMIL NADU,NAGAPATTINAM,2021-02-12,10,578,0,588,
TAMIL NADU,NAGAPATTINAM,2021-02-13,5,482,0,487,
TAMIL NADU,NAGAPATTINAM,2021-02-14,2,425,0,427,
TAMIL NADU,NAGAPATTINAM,2021-02-15,4,165,0,169,
TAMIL NADU,NAMAKKAL,2021-02-11,5,1533,1,1539,
TAMIL NADU,NAMAKKAL,2021-02-12,1,1273,2,1276,
TAMIL NADU,NAMAKKAL,2021-02-13,5,1371,1,1377,
TAMIL NADU,NAMAKKAL,2021-02-14,9,903,0,912,
TAMIL NADU,NAMAKKAL,2021-02-15,4,622,0,626,
TAMIL NADU,PERAMBALUR,2021-02-11,2,181,0,183,
TAMIL NADU,PERAMBALUR,2021-02-12,0,230,0,230,
TAMIL NADU,PERAMBALUR,2021-02-13,0,229,0,229,
TAMIL NADU,PERAMBALUR,2021-02-14,0,184,0,184,
TAMIL NADU,PERAMBALUR,2021-02-15,0,128,1,129,
TAMIL NADU,PUDUKKOTTAI,2021-02-11,3,758,1,762,
TAMIL NADU,PUDUKKOTTAI,2021-02-12,2,592,1,595,
TAMIL NADU,PUDUKKOTTAI,2021-02-13,2,704,1,707,
TAMIL NADU,PUDUKKOTTAI,2021-02-14,0,526,0,526,
TAMIL NADU,PUDUKKOTTAI,2021-02-15,2,140,0,142,
TAMIL NADU,RAMANATHAPURAM,2021-02-11,1,613,1,615,
TAMIL NADU,RAMANATHAPURAM,2021-02-12,2,895,0,897,
TAMIL NADU,RAMANATHAPURAM,2021-02-13,2,866,1,869,
TAMIL NADU,RAMANATHAPURAM,2021-02-14,5,792,0,797,
TAMIL NADU,RAMANATHAPURAM,2021-02-15,2,851,1,854,
TAMIL NADU,RANIPET,2021-02-11,7,597,0,604,
TAMIL NADU,RANIPET,2021-02-12,4,457,0,461,
TAMIL NADU,RANIPET,2021-02-13,4,435,0,439,
TAMIL NADU,RANIPET,2021-02-14,1,84,0,85,
TAMIL NADU,RANIPET,2021-02-15,0,352,0,352,
TAMIL NADU,SALEM,2021-02-11,16,219,0,235,
TAMIL NADU,SALEM,2021-02-12,8,238,0,246,
TAMIL NADU,SALEM,2021-02-13,10,192,0,202,
TAMIL NADU,SALEM,2021-02-14,4,135,0,139,
TAMIL NADU,SALEM,2021-02-15,5,195,1,201,
TAMIL NADU,SIVAGANGA,2021-02-11,3,426,1,430,
TAMIL NADU,SIVAGANGA,2021-02-12,9,472,0,481,
TAMIL NADU,SIVAGANGA,2021-02-13,1,554,0,555,
TAMIL NADU,SIVAGANGA,2021-02-14,5,250,0,255,
TAMIL NADU,SIVAGANGA,2021-02-15,4,254,0,258,
TAMIL NADU,TENKASI,2021-02-11,13,612,6,631,
TAMIL NADU,TENKASI,2021-02-12,0,543,31,574,
TAMIL NADU,TENKASI,2021-02-13,1,628,5,634,
TAMIL NADU,TENKASI,2021-02-14,2,486,2,490,
TAMIL NADU,TENKASI,2021-02-15,2,426,9,437,
TAMIL NADU,THANJAVUR,2021-02-11,18,818,4,840,
TAMIL NADU,THANJAVUR,2021-02-12,8,739,2,749,
TAMIL NADU,THANJAVUR,2021-02-13,12,582,0,594,
TAMIL NADU,THANJAVUR,2021-02-14,12,156,1,169,
TAMIL NADU,THANJAVUR,2021-02-15,16,473,2,491,
TAMIL NADU,THE NILGIRIS,2021-02-11,7,1194,0,1201,
TAMIL NADU,THE NILGIRIS,2021-02-12,2,1067,1,1070,
TAMIL NADU,THE NILGIRIS,2021-02-13,6,1064,1,1071,
TAMIL NADU,THE NILGIRIS,2021-02-14,4,974,1,979,
TAMIL NADU,THE NILGIRIS,2021-02-15,4,1089,0,1093,
TAMIL NADU,THENI,2021-02-11,4,375,0,379,
TAMIL NADU,THENI,2021-02-12,5,292,0,297,
TAMIL NADU,THENI,2021-02-13,1,113,0,114,
TAMIL NADU,THENI,2021-02-14,0,167,0,167,
TAMIL NADU,THENI,2021-02-15,1,380,0,381,
TAMIL NADU,THIRUVALLUR,2021-02-11,23,1896,6,1925,
TAMIL NADU,THIRUVALLUR,2021-02-12,25,1752,4,1781,
TAMIL NADU,THIRUVALLUR,2021-02-13,14,2074,0,2088,
TAMIL NADU,THIRUVALLUR,2021-02-14,25,2362,5,2392,
TAMIL NADU,THIRUVALLUR,2021-02-15,20,1487,15,1522,
TAMIL NADU,THIRUVARUR,2021-02-11,5,811,0,816,
TAMIL NADU,THIRUVARUR,2021-02-12,9,537,0,546,
TAMIL NADU,THIRUVARUR,2021-02-13,6,266,0,272,
TAMIL NADU,THIRUVARUR,2021-02-14,5,148,0,153,
TAMIL NADU,THIRUVARUR,2021-02-15,4,476,0,480,
TAMIL NADU,TIRUCHIRAPPALLI,2021-02-11,17,1508,0,1525,
TAMIL NADU,TIRUCHIRAPPALLI,2021-02-12,13,1416,0,1429,
TAMIL NADU,TIRUCHIRAPPALLI,2021-02-13,15,1396,0,1411,
TAMIL NADU,TIRUCHIRAPPALLI,2021-02-14,12,1304,2,1318,
TAMIL NADU,TIRUCHIRAPPALLI,2021-02-15,12,1203,1,1216,
TAMIL NADU,TIRUNELVELI,2021-02-11,11,1080,2,1093,
TAMIL NADU,TIRUNELVELI,2021-02-12,2,946,13,961,
TAMIL NADU,TIRUNELVELI,2021-02-13,5,697,1,703,
TAMIL NADU,TIRUNELVELI,2021-02-14,1,301,0,302,
TAMIL NADU,TIRUNELVELI,2021-02-15,10,1070,3,1083,
TAMIL NADU,TIRUPATHUR,2021-02-11,0,2877,3,2880,
TAMIL NADU,TIRUPATHUR,2021-02-12,2,2685,0,2687,
TAMIL NADU,TIRUPATHUR,2021-02-13,0,2273,0,2273,
TAMIL NADU,TIRUPATHUR,2021-02-14,1,1882,1,1884,
TAMIL NADU,TIRUPATHUR,2021-02-15,1,2265,1,2267,
TAMIL NADU,TIRUPPUR,2021-02-11,17,2649,8,2674,
TAMIL NADU,TIRUPPUR,2021-02-12,17,1862,1,1880,
TAMIL NADU,TIRUPPUR,2021-02-13,18,2287,2,2307,
TAMIL NADU,TIRUPPUR,2021-02-14,13,867,0,880,
TAMIL NADU,TIRUPPUR,2021-02-15,12,1095,0,1107,
TAMIL NADU,TIRUVANNAMALAI,2021-02-11,1,624,0,625,
TAMIL NADU,TIRUVANNAMALAI,2021-02-12,6,174,0,180,
TAMIL NADU,TIRUVANNAMALAI,2021-02-13,2,933,0,935,
TAMIL NADU,TIRUVANNAMALAI,2021-02-14,4,208,0,212,
TAMIL NADU,TIRUVANNAMALAI,2021-02-15,4,600,0,604,
TAMIL NADU,TUTICORIN,2021-02-11,1,780,1,782,
TAMIL NADU,TUTICORIN,2021-02-12,2,917,6,925,
TAMIL NADU,TUTICORIN,2021-02-13,8,885,1,894,
TAMIL NADU,TUTICORIN,2021-02-14,3,682,0,685,
TAMIL NADU,TUTICORIN,2021-02-15,0,380,8,388,
TAMIL NADU,VELLORE,2021-02-11,15,1533,0,1548,
TAMIL NADU,VELLORE,2021-02-12,7,1425,0,1432,
TAMIL NADU,VELLORE,2021-02-13,4,1579,2,1585,
TAMIL NADU,VELLORE,2021-02-14,7,805,0,812,
TAMIL NADU,VELLORE,2021-02-15,9,1200,0,1209,
TAMIL NADU,VILLUPURAM,2021-02-11,5,1076,0,1081,
TAMIL NADU,VILLUPURAM,2021-02-12,2,952,2,956,
TAMIL NADU,VILLUPURAM,2021-02-13,1,1183,0,1184,
TAMIL NADU,VILLUPURAM,2021-02-14,1,141,0,142,
TAMIL NADU,VILLUPURAM,2021-02-15,3,175,0,178,
TAMIL NADU,VIRUDHUNAGAR,2021-02-11,3,1344,5,1352,
TAMIL NADU,VIRUDHUNAGAR,2021-02-12,2,1300,6,1308,
TAMIL NADU,VIRUDHUNAGAR,2021-02-13,2,896,0,898,
TAMIL NADU,VIRUDHUNAGAR,2021-02-14,2,624,1,627,
TAMIL NADU,VIRUDHUNAGAR,2021-02-15,3,1296,3,1302,
TELANGANA,ADILABAD,2021-02-11,0,225,0,225,
TELANGANA,ADILABAD,2021-02-12,0,212,0,212,
TELANGANA,ADILABAD,2021-02-13,1,633,0,634,
TELANGANA,ADILABAD,2021-02-14,0,87,0,87,
TELANGANA,ADILABAD,2021-02-15,0,181,0,181,
TELANGANA,BHADRADRI KOTHAGUDEM,2021-02-11,0,515,0,515,
TELANGANA,BHADRADRI KOTHAGUDEM,2021-02-12,0,467,0,467,
TELANGANA,BHADRADRI KOTHAGUDEM,2021-02-13,0,489,0,489,
TELANGANA,BHADRADRI KOTHAGUDEM,2021-02-14,0,95,0,95,
TELANGANA,BHADRADRI KOTHAGUDEM,2021-02-15,0,614,0,614,
TELANGANA,HYDERABAD,2021-02-11,14,5806,5,5825,
TELANGANA,HYDERABAD,2021-02-12,18,5354,1,5373,
TELANGANA,HYDERABAD,2021-02-13,24,5456,3,5483,
TELANGANA,HYDERABAD,2021-02-14,18,3229,4,3251,
TELANGANA,HYDERABAD,2021-02-15,30,5146,1,5177,
TELANGANA,JAGITIAL,2021-02-11,0,387,0,387,
TELANGANA,JAGITIAL,2021-02-12,0,286,0,286,
TELANGANA,JAGITIAL,2021-02-13,0,470,0,470,
TELANGANA,JAGITIAL,2021-02-14,0,232,0,232,
TELANGANA,JAGITIAL,2021-02-15,0,419,0,419,
TELANGANA,JANGOAN,2021-02-11,0,539,0,539,
TELANGANA,JANGOAN,2021-02-12,0,345,0,345,
TELANGANA,JANGOAN,2021-02-13,0,432,0,432,
TELANGANA,JANGOAN,2021-02-14,0,279,0,279,
TELANGANA,JANGOAN,2021-02-15,0,464,0,464,
TELANGANA,JAYASHANKAR BHUPALAPALLY,2021-02-11,0,142,0,142,
TELANGANA,JAYASHANKAR BHUPALAPALLY,2021-02-12,0,135,0,135,
TELANGANA,JAYASHANKAR BHUPALAPALLY,2021-02-13,0,160,0,160,
TELANGANA,JAYASHANKAR BHUPALAPALLY,2021-02-14,0,44,0,44,
TELANGANA,JAYASHANKAR BHUPALAPALLY,2021-02-15,0,137,0,137,
TELANGANA,JOGULAMBA GADWAL,2021-02-11,0,365,0,365,
TELANGANA,JOGULAMBA GADWAL,2021-02-12,0,653,0,653,
TELANGANA,JOGULAMBA GADWAL,2021-02-13,0,851,0,851,
TELANGANA,JOGULAMBA GADWAL,2021-02-14,0,417,0,417,
TELANGANA,JOGULAMBA GADWAL,2021-02-15,0,409,0,409,
TELANGANA,KAMAREDDY,2021-02-11,0,241,0,241,
TELANGANA,KAMAREDDY,2021-02-12,0,278,0,278,
TELANGANA,KAMAREDDY,2021-02-13,0,388,0,388,
TELANGANA,KAMAREDDY,2021-02-14,0,45,0,45,
TELANGANA,KAMAREDDY,2021-02-15,0,361,0,361,
TELANGANA,KARIMNAGAR,2021-02-11,1,877,0,878,
TELANGANA,KARIMNAGAR,2021-02-12,0,1044,0,1044,
TELANGANA,KARIMNAGAR,2021-02-13,0,939,0,939,
TELANGANA,KARIMNAGAR,2021-02-14,1,511,0,512,
TELANGANA,KARIMNAGAR,2021-02-15,1,690,0,691,
TELANGANA,KHAMMAM,2021-02-11,0,506,0,506,
TELANGANA,KHAMMAM,2021-02-12,0,397,0,397,
TELANGANA,KHAMMAM,2021-02-13,0,450,0,450,
TELANGANA,KHAMMAM,2021-02-14,0,98,0,98,
TELANGANA,KHAMMAM,2021-02-15,0,550,0,550,
TELANGANA,KUMURAM BHEEM ASIFABAD,2021-02-11,0,493,0,493,
TELANGANA,KUMURAM BHEEM ASIFABAD,2021-02-12,0,350,0,350,
TELANGANA,KUMURAM BHEEM ASIFABAD,2021-02-13,0,310,0,310,
TELANGANA,KUMURAM BHEEM ASIFABAD,2021-02-14,0,181,0,181,
TELANGANA,KUMURAM BHEEM ASIFABAD,2021-02-15,0,323,0,323,
TELANGANA,MAHABUBABAD,2021-02-11,0,862,0,862,
TELANGANA,MAHABUBABAD,2021-02-12,0,260,0,260,
TELANGANA,MAHABUBABAD,2021-02-13,0,296,0,296,
TELANGANA,MAHABUBABAD,2021-02-14,0,184,0,184,
TELANGANA,MAHABUBABAD,2021-02-15,0,276,0,276,
TELANGANA,MAHABUBNAGAR,2021-02-11,0,497,0,497,
TELANGANA,MAHABUBNAGAR,2021-02-12,0,383,0,383,
TELANGANA,MAHABUBNAGAR,2021-02-13,0,368,0,368,
TELANGANA,MAHABUBNAGAR,2021-02-14,0,121,0,121,
TELANGANA,MAHABUBNAGAR,2021-02-15,0,456,0,456,
TELANGANA,MANCHERIAL,2021-02-11,0,492,0,492,
TELANGANA,MANCHERIAL,2021-02-12,0,435,0,435,
TELANGANA,MANCHERIAL,2021-02-13,0,574,0,574,
TELANGANA,MANCHERIAL,2021-02-14,0,248,0,248,
TELANGANA,MANCHERIAL,2021-02-15,0,504,0,504,
TELANGANA,MEDAK,2021-02-11,0,171,0,171,
TELANGANA,MEDAK,2021-02-12,0,225,0,225,
TELANGANA,MEDAK,2021-02-13,0,203,0,203,
TELANGANA,MEDAK,2021-02-14,5,60,0,65,
TELANGANA,MEDAK,2021-02-15,1,179,0,180,
TELANGANA,MEDCHAL MALKAJGIRI,2021-02-11,0,1079,0,1079,
TELANGANA,MEDCHAL MALKAJGIRI,2021-02-12,0,941,0,941,
TELANGANA,MEDCHAL MALKAJGIRI,2021-02-13,0,1083,0,1083,
TELANGANA,MEDCHAL MALKAJGIRI,2021-02-14,0,231,0,231,
TELANGANA,MEDCHAL MALKAJGIRI,2021-02-15,1,1048,0,1049,
TELANGANA,MULUGU,2021-02-11,0,94,0,94,
TELANGANA,MULUGU,2021-02-12,0,87,0,87,
TELANGANA,MULUGU,2021-02-13,0,314,0,314,
TELANGANA,MULUGU,2021-02-14,0,53,0,53,
TELANGANA,MULUGU,2021-02-15,0,85,0,85,
TELANGANA,NAGARKURNOOL,2021-02-11,0,906,0,906,
TELANGANA,NAGARKURNOOL,2021-02-12,0,701,0,701,
TELANGANA,NAGARKURNOOL,2021-02-13,0,899,0,899,
TELANGANA,NAGARKURNOOL,2021-02-14,0,428,0,428,
TELANGANA,NAGARKURNOOL,2021-02-15,0,818,0,818,
TELANGANA,NALGONDA,2021-02-11,0,918,1,919,
TELANGANA,NALGONDA,2021-02-12,0,590,0,590,
TELANGANA,NALGONDA,2021-02-13,1,1006,0,1007,
TELANGANA,NALGONDA,2021-02-14,0,70,0,70,
TELANGANA,NALGONDA,2021-02-15,0,802,0,802,
TELANGANA,NARAYANPET,2021-02-11,0,417,0,417,
TELANGANA,NARAYANPET,2021-02-12,0,296,0,296,
TELANGANA,NARAYANPET,2021-02-13,0,217,0,217,
TELANGANA,NARAYANPET,2021-02-14,0,80,0,80,
TELANGANA,NARAYANPET,2021-02-15,0,173,0,173,
TELANGANA,NIRMAL,2021-02-11,0,642,0,642,
TELANGANA,NIRMAL,2021-02-12,0,292,0,292,
TELANGANA,NIRMAL,2021-02-13,0,406,1,407,
TELANGANA,NIRMAL,2021-02-14,0,160,0,160,
TELANGANA,NIRMAL,2021-02-15,0,231,0,231,
TELANGANA,NIZAMABAD,2021-02-11,3,400,0,403,
TELANGANA,NIZAMABAD,2021-02-12,0,327,0,327,
TELANGANA,NIZAMABAD,2021-02-13,0,370,0,370,
TELANGANA,NIZAMABAD,2021-02-14,0,79,0,79,
TELANGANA,NIZAMABAD,2021-02-15,0,367,0,367,
TELANGANA,PEDDAPALLI,2021-02-11,0,935,0,935,
TELANGANA,PEDDAPALLI,2021-02-12,0,591,0,591,
TELANGANA,PEDDAPALLI,2021-02-13,0,805,0,805,
TELANGANA,PEDDAPALLI,2021-02-14,0,175,0,175,
TELANGANA,PEDDAPALLI,2021-02-15,0,716,0,716,
TELANGANA,RAJANNA SIRCILLA,2021-02-11,0,389,0,389,
TELANGANA,RAJANNA SIRCILLA,2021-02-12,0,213,0,213,
TELANGANA,RAJANNA SIRCILLA,2021-02-13,0,287,0,287,
TELANGANA,RAJANNA SIRCILLA,2021-02-14,0,37,0,37,
TELANGANA,RAJANNA SIRCILLA,2021-02-15,0,246,0,246,
TELANGANA,RANGA REDDY,2021-02-11,1,1695,0,1696,
TELANGANA,RANGA REDDY,2021-02-12,11,1585,0,1596,
TELANGANA,RANGA REDDY,2021-02-13,3,1725,1,1729,
TELANGANA,RANGA REDDY,2021-02-14,2,789,1,792,
TELANGANA,RANGA REDDY,2021-02-15,0,1581,0,1581,
TELANGANA,SANGAREDDY,2021-02-11,3,724,0,727,
TELANGANA,SANGAREDDY,2021-02-12,0,573,0,573,
TELANGANA,SANGAREDDY,2021-02-13,0,651,0,651,
TELANGANA,SANGAREDDY,2021-02-14,0,300,0,300,
TELANGANA,SANGAREDDY,2021-02-15,5,572,0,577,
TELANGANA,SIDDIPET,2021-02-11,0,951,0,951,
TELANGANA,SIDDIPET,2021-02-12,0,843,0,843,
TELANGANA,SIDDIPET,2021-02-13,0,529,0,529,
TELANGANA,SIDDIPET,2021-02-14,0,288,0,288,
TELANGANA,SIDDIPET,2021-02-15,0,527,0,527,
TELANGANA,SURYAPET,2021-02-11,0,848,0,848,
TELANGANA,SURYAPET,2021-02-12,0,650,0,650,
TELANGANA,SURYAPET,2021-02-13,0,831,0,831,
TELANGANA,SURYAPET,2021-02-14,0,276,0,276,
TELANGANA,SURYAPET,2021-02-15,0,925,0,925,
TELANGANA,VIKARABAD,2021-02-11,1,327,0,328,
TELANGANA,VIKARABAD,2021-02-12,0,308,0,308,
TELANGANA,VIKARABAD,2021-02-13,1,223,0,224,
TELANGANA,VIKARABAD,2021-02-14,0,131,0,131,
TELANGANA,VIKARABAD,2021-02-15,1,303,0,304,
TELANGANA,WANAPARTHY,2021-02-11,0,343,0,343,
TELANGANA,WANAPARTHY,2021-02-12,0,235,0,235,
TELANGANA,WANAPARTHY,2021-02-13,0,304,0,304,
TELANGANA,WANAPARTHY,2021-02-14,0,95,0,95,
TELANGANA,WANAPARTHY,2021-02-15,0,312,0,312,
TELANGANA,WARANGAL RURAL,2021-02-11,3,288,0,291,
TELANGANA,WARANGAL RURAL,2021-02-12,0,225,0,225,
TELANGANA,WARANGAL RURAL,2021-02-13,1,258,1,260,
TELANGANA,WARANGAL RURAL,2021-02-14,2,94,1,97,
TELANGANA,WARANGAL RURAL,2021-02-15,0,350,0,350,
TELANGANA,WARANGAL URBAN,2021-02-11,0,1267,0,1267,
TELANGANA,WARANGAL URBAN,2021-02-12,1,1237,0,1238,
TELANGANA,WARANGAL URBAN,2021-02-13,0,1405,0,1405,
TELANGANA,WARANGAL URBAN,2021-02-14,1,468,0,469,
TELANGANA,WARANGAL URBAN,2021-02-15,0,1097,0,1097,
TELANGANA,YADADRI BHUVANAGIRI,2021-02-11,0,319,0,319,
TELANGANA,YADADRI BHUVANAGIRI,2021-02-12,0,267,0,267,
TELANGANA,YADADRI BHUVANAGIRI,2021-02-13,0,316,0,316,
TELANGANA,YADADRI BHUVANAGIRI,2021-02-14,0,35,0,35,
TELANGANA,YADADRI BHUVANAGIRI,2021-02-15,0,379,1,380,
TRIPURA,DHALAI,2021-02-11,0,17,0,17,
TRIPURA,DHALAI,2021-02-12,0,8,0,8,
TRIPURA,DHALAI,2021-02-13,0,39,0,39,
TRIPURA,DHALAI,2021-02-15,0,7,0,7,
TRIPURA,GOMATI,2021-02-11,0,35,0,35,
TRIPURA,GOMATI,2021-02-12,0,41,0,41,
TRIPURA,GOMATI,2021-02-13,0,43,0,43,
TRIPURA,GOMATI,2021-02-14,0,26,0,26,
TRIPURA,GOMATI,2021-02-15,0,40,0,40,
TRIPURA,KHOWAI,2021-02-11,0,32,0,32,
TRIPURA,KHOWAI,2021-02-12,0,13,0,13,
TRIPURA,KHOWAI,2021-02-13,0,21,0,21,
TRIPURA,KHOWAI,2021-02-14,0,20,0,20,
TRIPURA,KHOWAI,2021-02-15,0,31,0,31,
TRIPURA,NORTH TRIPURA,2021-02-11,0,66,0,66,
TRIPURA,NORTH TRIPURA,2021-02-12,1,55,0,56,
TRIPURA,NORTH TRIPURA,2021-02-13,0,59,1,60,
TRIPURA,NORTH TRIPURA,2021-02-14,0,28,0,28,
TRIPURA,NORTH TRIPURA,2021-02-15,0,89,0,89,
TRIPURA,SEPAHIJALA,2021-02-11,0,37,0,37,
TRIPURA,SEPAHIJALA,2021-02-12,0,21,0,21,
TRIPURA,SEPAHIJALA,2021-02-13,0,36,0,36,
TRIPURA,SEPAHIJALA,2021-02-14,0,23,0,23,
TRIPURA,SEPAHIJALA,2021-02-15,0,19,0,19,
TRIPURA,SOUTH TRIPURA,2021-02-11,1,50,0,51,
TRIPURA,SOUTH TRIPURA,2021-02-12,0,52,0,52,
TRIPURA,SOUTH TRIPURA,2021-02-13,0,29,0,29,
TRIPURA,SOUTH TRIPURA,2021-02-14,0,53,0,53,
TRIPURA,SOUTH TRIPURA,2021-02-15,0,40,0,40,
TRIPURA,UNAKOTI,2021-02-11,0,5,0,5,
TRIPURA,UNAKOTI,2021-02-12,0,9,0,9,
TRIPURA,UNAKOTI,2021-02-13,0,16,0,16,
TRIPURA,UNAKOTI,2021-02-14,0,1,0,1,
TRIPURA,UNAKOTI,2021-02-15,0,5,0,5,
TRIPURA,WEST TRIPURA,2021-02-11,0,219,0,219,
TRIPURA,WEST TRIPURA,2021-02-12,0,187,1,188,
TRIPURA,WEST TRIPURA,2021-02-13,0,145,0,145,
TRIPURA,WEST TRIPURA,2021-02-14,0,93,0,93,
TRIPURA,WEST TRIPURA,2021-02-15,3,163,0,166,
UTTAR PRADESH,AGRA,2021-02-11,3,2070,3,2076,
UTTAR PRADESH,AGRA,2021-02-12,4,2253,2,2259,
UTTAR PRADESH,AGRA,2021-02-13,1,2409,5,2415,
UTTAR PRADESH,AGRA,2021-02-14,0,1131,1,1132,
UTTAR PRADESH,AGRA,2021-02-15,1,2027,1,2029,
UTTAR PRADESH,ALIGARH,2021-02-11,2,2536,0,2538,
UTTAR PRADESH,ALIGARH,2021-02-12,2,2795,9,2806,
UTTAR PRADESH,ALIGARH,2021-02-13,1,2272,6,2279,
UTTAR PRADESH,ALIGARH,2021-02-14,4,2265,21,2290,
UTTAR PRADESH,ALIGARH,2021-02-15,2,2197,0,2199,
UTTAR PRADESH,AMBEDKAR NAGAR,2021-02-11,0,1068,39,1107,
UTTAR PRADESH,AMBEDKAR NAGAR,2021-02-12,0,1416,10,1426,
UTTAR PRADESH,AMBEDKAR NAGAR,2021-02-13,0,1323,27,1350,
UTTAR PRADESH,AMBEDKAR NAGAR,2021-02-14,1,587,4,592,
UTTAR PRADESH,AMBEDKAR NAGAR,2021-02-15,0,608,0,608,
UTTAR PRADESH,AMETHI,2021-02-11,0,1067,0,1067,
UTTAR PRADESH,AMETHI,2021-02-12,0,1098,0,1098,
UTTAR PRADESH,AMETHI,2021-02-13,1,1434,0,1435,
UTTAR PRADESH,AMETHI,2021-02-14,0,991,1,992,
UTTAR PRADESH,AMETHI,2021-02-15,0,1175,28,1203,
UTTAR PRADESH,AMROHA,2021-02-11,2,1142,0,1144,
UTTAR PRADESH,AMROHA,2021-02-12,1,800,0,801,
UTTAR PRADESH,AMROHA,2021-02-13,0,386,1,387,
UTTAR PRADESH,AMROHA,2021-02-14,1,529,0,530,
UTTAR PRADESH,AMROHA,2021-02-15,2,1436,0,1438,
UTTAR PRADESH,AURAIYA,2021-02-11,0,672,46,718,
UTTAR PRADESH,AURAIYA,2021-02-12,0,983,13,996,
UTTAR PRADESH,AURAIYA,2021-02-13,0,1171,50,1221,
UTTAR PRADESH,AURAIYA,2021-02-14,0,360,89,449,
UTTAR PRADESH,AURAIYA,2021-02-15,0,949,82,1031,
UTTAR PRADESH,AYODHYA,2021-02-11,2,1980,2,1984,
UTTAR PRADESH,AYODHYA,2021-02-12,1,1476,3,1480,
UTTAR PRADESH,AYODHYA,2021-02-13,1,1533,0,1534,
UTTAR PRADESH,AYODHYA,2021-02-14,0,1717,2,1719,
UTTAR PRADESH,AYODHYA,2021-02-15,0,1176,0,1176,
UTTAR PRADESH,AZAMGARH,2021-02-11,3,1185,15,1203,
UTTAR PRADESH,AZAMGARH,2021-02-12,0,931,4,935,
UTTAR PRADESH,AZAMGARH,2021-02-13,0,719,7,726,
UTTAR PRADESH,AZAMGARH,2021-02-14,0,902,21,923,
UTTAR PRADESH,AZAMGARH,2021-02-15,1,706,2,709,
UTTAR PRADESH,BAGHPAT,2021-02-11,0,959,0,959,
UTTAR PRADESH,BAGHPAT,2021-02-12,1,2353,5,2359,
UTTAR PRADESH,BAGHPAT,2021-02-13,2,1390,77,1469,
UTTAR PRADESH,BAGHPAT,2021-02-14,1,976,2,979,
UTTAR PRADESH,BAGHPAT,2021-02-15,0,1409,55,1464,
UTTAR PRADESH,BAHRAICH,2021-02-11,1,1889,5,1895,
UTTAR PRADESH,BAHRAICH,2021-02-12,0,1890,21,1911,
UTTAR PRADESH,BAHRAICH,2021-02-13,0,1872,9,1881,
UTTAR PRADESH,BAHRAICH,2021-02-14,1,1677,12,1690,
UTTAR PRADESH,BAHRAICH,2021-02-15,0,1944,14,1958,
UTTAR PRADESH,BALLIA,2021-02-11,0,716,28,744,
UTTAR PRADESH,BALLIA,2021-02-12,0,1216,22,1238,
UTTAR PRADESH,BALLIA,2021-02-13,0,745,5,750,
UTTAR PRADESH,BALLIA,2021-02-14,0,578,3,581,
UTTAR PRADESH,BALLIA,2021-02-15,0,804,1,805,
UTTAR PRADESH,BALRAMPUR,2021-02-11,0,943,0,943,
UTTAR PRADESH,BALRAMPUR,2021-02-12,1,737,0,738,
UTTAR PRADESH,BALRAMPUR,2021-02-13,1,884,0,885,
UTTAR PRADESH,BALRAMPUR,2021-02-14,1,960,0,961,
UTTAR PRADESH,BALRAMPUR,2021-02-15,0,922,0,922,
UTTAR PRADESH,BANDA,2021-02-11,0,2014,31,2045,
UTTAR PRADESH,BANDA,2021-02-12,0,1925,82,2007,
UTTAR PRADESH,BANDA,2021-02-13,1,2371,13,2385,
UTTAR PRADESH,BANDA,2021-02-14,0,1653,5,1658,
UTTAR PRADESH,BANDA,2021-02-15,0,2138,26,2164,
UTTAR PRADESH,BARABANKI,2021-02-11,2,1738,1,1741,
UTTAR PRADESH,BARABANKI,2021-02-12,3,1729,0,1732,
UTTAR PRADESH,BARABANKI,2021-02-13,1,1482,3,1486,
UTTAR PRADESH,BARABANKI,2021-02-14,1,1437,0,1438,
UTTAR PRADESH,BARABANKI,2021-02-15,1,1950,0,1951,
UTTAR PRADESH,BAREILLY,2021-02-11,4,2618,2,2624,
UTTAR PRADESH,BAREILLY,2021-02-12,5,2618,0,2623,
UTTAR PRADESH,BAREILLY,2021-02-13,2,2361,2,2365,
UTTAR PRADESH,BAREILLY,2021-02-14,2,2147,7,2156,
UTTAR PRADESH,BAREILLY,2021-02-15,2,2004,1,2007,
UTTAR PRADESH,BASTI,2021-02-11,3,905,180,1088,
UTTAR PRADESH,BASTI,2021-02-12,2,971,59,1032,
UTTAR PRADESH,BASTI,2021-02-13,3,1151,45,1199,
UTTAR PRADESH,BASTI,2021-02-14,4,840,55,899,
UTTAR PRADESH,BASTI,2021-02-15,4,871,85,960,
UTTAR PRADESH,BHADOHI,2021-02-11,0,1518,2,1520,
UTTAR PRADESH,BHADOHI,2021-02-12,0,1571,1,1572,
UTTAR PRADESH,BHADOHI,2021-02-13,0,1415,0,1415,
UTTAR PRADESH,BHADOHI,2021-02-14,0,1473,1,1474,
UTTAR PRADESH,BHADOHI,2021-02-15,1,1519,1,1521,
UTTAR PRADESH,BIJNOR,2021-02-11,0,1543,0,1543,
UTTAR PRADESH,BIJNOR,2021-02-12,2,818,0,820,
UTTAR PRADESH,BIJNOR,2021-02-13,0,2171,0,2171,
UTTAR PRADESH,BIJNOR,2021-02-14,1,1487,0,1488,
UTTAR PRADESH,BIJNOR,2021-02-15,1,1237,1,1239,
UTTAR PRADESH,BUDAUN,2021-02-11,0,2165,55,2220,
UTTAR PRADESH,BUDAUN,2021-02-12,1,1441,17,1459,
UTTAR PRADESH,BUDAUN,2021-02-13,0,969,5,974,
UTTAR PRADESH,BUDAUN,2021-02-14,0,1316,11,1327,
UTTAR PRADESH,BUDAUN,2021-02-15,0,2881,22,2903,
UTTAR PRADESH,BULANDSHAHR,2021-02-11,2,837,0,839,
UTTAR PRADESH,BULANDSHAHR,2021-02-12,1,5356,0,5357,
UTTAR PRADESH,BULANDSHAHR,2021-02-13,1,2251,10,2262,
UTTAR PRADESH,BULANDSHAHR,2021-02-14,0,772,1,773,
UTTAR PRADESH,BULANDSHAHR,2021-02-15,0,3430,61,3491,
UTTAR PRADESH,CHANDAULI,2021-02-11,1,1001,156,1158,
UTTAR PRADESH,CHANDAULI,2021-02-12,0,881,15,896,
UTTAR PRADESH,CHANDAULI,2021-02-13,0,453,1,454,
UTTAR PRADESH,CHANDAULI,2021-02-14,3,1564,47,1614,
UTTAR PRADESH,CHANDAULI,2021-02-15,2,994,22,1018,
UTTAR PRADESH,CHITRAKOOT,2021-02-11,0,1086,23,1109,
UTTAR PRADESH,CHITRAKOOT,2021-02-12,0,3910,1,3911,
UTTAR PRADESH,CHITRAKOOT,2021-02-13,0,1143,5,1148,
UTTAR PRADESH,CHITRAKOOT,2021-02-14,0,724,0,724,
UTTAR PRADESH,CHITRAKOOT,2021-02-15,1,1148,49,1198,
UTTAR PRADESH,DEORIA,2021-02-11,0,1272,25,1297,
UTTAR PRADESH,DEORIA,2021-02-12,0,619,35,654,
UTTAR PRADESH,DEORIA,2021-02-13,1,1039,36,1076,
UTTAR PRADESH,DEORIA,2021-02-14,0,567,22,589,
UTTAR PRADESH,DEORIA,2021-02-15,1,280,41,322,
UTTAR PRADESH,ETAH,2021-02-11,0,1355,5,1360,
UTTAR PRADESH,ETAH,2021-02-12,0,848,11,859,
UTTAR PRADESH,ETAH,2021-02-13,1,1377,8,1386,
UTTAR PRADESH,ETAH,2021-02-14,0,1307,10,1317,
UTTAR PRADESH,ETAH,2021-02-15,0,1187,8,1195,
UTTAR PRADESH,ETAWAH,2021-02-11,2,1736,190,1928,
UTTAR PRADESH,ETAWAH,2021-02-12,1,1995,64,2060,
UTTAR PRADESH,ETAWAH,2021-02-13,1,729,112,842,
UTTAR PRADESH,ETAWAH,2021-02-14,0,1571,115,1686,
UTTAR PRADESH,ETAWAH,2021-02-15,0,366,23,389,
UTTAR PRADESH,FARRUKHABAD,2021-02-11,0,980,67,1047,
UTTAR PRADESH,FARRUKHABAD,2021-02-12,1,1167,100,1268,
UTTAR PRADESH,FARRUKHABAD,2021-02-13,0,877,46,923,
UTTAR PRADESH,FARRUKHABAD,2021-02-14,0,884,40,924,
UTTAR PRADESH,FARRUKHABAD,2021-02-15,0,541,27,568,
UTTAR PRADESH,FATEHPUR,2021-02-11,0,1495,63,1558,
UTTAR PRADESH,FATEHPUR,2021-02-12,0,1311,126,1437,
UTTAR PRADESH,FATEHPUR,2021-02-13,1,1755,115,1871,
UTTAR PRADESH,FATEHPUR,2021-02-14,0,1114,64,1178,
UTTAR PRADESH,FATEHPUR,2021-02-15,0,1359,57,1416,
UTTAR PRADESH,FIROZABAD,2021-02-11,2,2307,8,2317,
UTTAR PRADESH,FIROZABAD,2021-02-12,0,4647,0,4647,
UTTAR PRADESH,FIROZABAD,2021-02-13,0,876,12,888,
UTTAR PRADESH,FIROZABAD,2021-02-14,0,3163,5,3168,
UTTAR PRADESH,FIROZABAD,2021-02-15,1,2290,0,2291,
UTTAR PRADESH,GAUTAM BUDDHA NAGAR,2021-02-11,34,3102,8,3144,
UTTAR PRADESH,GAUTAM BUDDHA NAGAR,2021-02-12,11,2869,50,2930,
UTTAR PRADESH,GAUTAM BUDDHA NAGAR,2021-02-13,20,2738,70,2828,
UTTAR PRADESH,GAUTAM BUDDHA NAGAR,2021-02-14,23,2474,114,2611,
UTTAR PRADESH,GAUTAM BUDDHA NAGAR,2021-02-15,12,2075,25,2112,
UTTAR PRADESH,GHAZIABAD,2021-02-11,17,3027,47,3091,
UTTAR PRADESH,GHAZIABAD,2021-02-12,24,3312,51,3387,
UTTAR PRADESH,GHAZIABAD,2021-02-13,22,2024,111,2157,
UTTAR PRADESH,GHAZIABAD,2021-02-14,21,2283,60,2364,
UTTAR PRADESH,GHAZIABAD,2021-02-15,20,3065,70,3155,
UTTAR PRADESH,GHAZIPUR,2021-02-11,2,1212,0,1214,
UTTAR PRADESH,GHAZIPUR,2021-02-12,1,682,44,727,
UTTAR PRADESH,GHAZIPUR,2021-02-13,1,774,9,784,
UTTAR PRADESH,GHAZIPUR,2021-02-14,1,728,91,820,
UTTAR PRADESH,GHAZIPUR,2021-02-15,2,2435,3,2440,
UTTAR PRADESH,GONDA,2021-02-11,0,2129,128,2257,
UTTAR PRADESH,GONDA,2021-02-12,0,1716,0,1716,
UTTAR PRADESH,GONDA,2021-02-13,2,1687,15,1704,
UTTAR PRADESH,GONDA,2021-02-14,2,1769,121,1892,
UTTAR PRADESH,GONDA,2021-02-15,0,1260,0,1260,
UTTAR PRADESH,GORAKHPUR,2021-02-11,3,2817,48,2868,
UTTAR PRADESH,GORAKHPUR,2021-02-12,2,2301,20,2323,
UTTAR PRADESH,GORAKHPUR,2021-02-13,3,2776,66,2845,
UTTAR PRADESH,GORAKHPUR,2021-02-14,2,1145,2,1149,
UTTAR PRADESH,GORAKHPUR,2021-02-15,3,1611,76,1690,
UTTAR PRADESH,HAMIRPUR,2021-02-11,1,1225,53,1279,
UTTAR PRADESH,HAMIRPUR,2021-02-12,1,987,30,1018,
UTTAR PRADESH,HAMIRPUR,2021-02-13,0,910,69,979,
UTTAR PRADESH,HAMIRPUR,2021-02-14,0,825,0,825,
UTTAR PRADESH,HAMIRPUR,2021-02-15,1,647,280,928,
UTTAR PRADESH,HAPUR,2021-02-11,4,3188,75,3267,
UTTAR PRADESH,HAPUR,2021-02-12,2,1497,95,1594,
UTTAR PRADESH,HAPUR,2021-02-13,6,74,1,81,
UTTAR PRADESH,HAPUR,2021-02-14,2,3324,15,3341,
UTTAR PRADESH,HAPUR,2021-02-15,4,224,15,243,
UTTAR PRADESH,HARDOI,2021-02-11,1,1685,25,1711,
UTTAR PRADESH,HARDOI,2021-02-12,1,1324,71,1396,
UTTAR PRADESH,HARDOI,2021-02-13,0,1345,3,1348,
UTTAR PRADESH,HARDOI,2021-02-14,2,1531,9,1542,
UTTAR PRADESH,HARDOI,2021-02-15,1,1292,0,1293,
UTTAR PRADESH,HATHRAS,2021-02-11,0,1215,25,1240,
UTTAR PRADESH,HATHRAS,2021-02-12,0,2133,0,2133,
UTTAR PRADESH,HATHRAS,2021-02-13,0,1321,0,1321,
UTTAR PRADESH,HATHRAS,2021-02-14,0,1281,0,1281,
UTTAR PRADESH,HATHRAS,2021-02-15,0,3046,1,3047,
UTTAR PRADESH,JALAUN,2021-02-11,0,1441,0,1441,
UTTAR PRADESH,JALAUN,2021-02-12,1,1281,2,1284,
UTTAR PRADESH,JALAUN,2021-02-13,0,1133,5,1138,
UTTAR PRADESH,JALAUN,2021-02-14,0,723,1,724,
UTTAR PRADESH,JALAUN,2021-02-15,0,1069,1,1070,
UTTAR PRADESH,JAUNPUR,2021-02-11,2,1027,22,1051,
UTTAR PRADESH,JAUNPUR,2021-02-12,1,1217,0,1218,
UTTAR PRADESH,JAUNPUR,2021-02-13,1,2208,2,2211,
UTTAR PRADESH,JAUNPUR,2021-02-14,0,1280,607,1887,
UTTAR PRADESH,JAUNPUR,2021-02-15,1,1026,0,1027,
UTTAR PRADESH,JHANSI,2021-02-11,1,3327,2,3330,
UTTAR PRADESH,JHANSI,2021-02-12,2,2059,3,2064,
UTTAR PRADESH,JHANSI,2021-02-13,1,3164,0,3165,
UTTAR PRADESH,JHANSI,2021-02-14,1,2397,2,2400,
UTTAR PRADESH,JHANSI,2021-02-15,1,1878,1,1880,
UTTAR PRADESH,KANNAUJ,2021-02-11,0,2028,0,2028,
UTTAR PRADESH,KANNAUJ,2021-02-12,0,1979,0,1979,
UTTAR PRADESH,KANNAUJ,2021-02-13,0,1777,0,1777,
UTTAR PRADESH,KANNAUJ,2021-02-14,0,1766,0,1766,
UTTAR PRADESH,KANNAUJ,2021-02-15,0,2036,0,2036,
UTTAR PRADESH,KANPUR DEHAT,2021-02-11,0,790,57,847,
UTTAR PRADESH,KANPUR DEHAT,2021-02-12,0,1062,22,1084,
UTTAR PRADESH,KANPUR DEHAT,2021-02-13,0,1350,1,1351,
UTTAR PRADESH,KANPUR DEHAT,2021-02-14,0,1030,1,1031,
UTTAR PRADESH,KANPUR DEHAT,2021-02-15,0,738,0,738,
UTTAR PRADESH,KANPUR NAGAR,2021-02-11,3,2603,18,2624,
UTTAR PRADESH,KANPUR NAGAR,2021-02-12,12,2873,3,2888,
UTTAR PRADESH,KANPUR NAGAR,2021-02-13,6,3238,2,3246,
UTTAR PRADESH,KANPUR NAGAR,2021-02-14,2,2433,6,2441,
UTTAR PRADESH,KANPUR NAGAR,2021-02-15,2,2142,4,2148,
UTTAR PRADESH,KASGANJ,2021-02-11,1,1554,16,1571,
UTTAR PRADESH,KASGANJ,2021-02-12,0,1216,14,1230,
UTTAR PRADESH,KASGANJ,2021-02-13,0,1396,16,1412,
UTTAR PRADESH,KASGANJ,2021-02-14,0,394,8,402,
UTTAR PRADESH,KASGANJ,2021-02-15,0,1517,7,1524,
UTTAR PRADESH,KAUSHAMBI,2021-02-11,1,2621,0,2622,
UTTAR PRADESH,KAUSHAMBI,2021-02-12,0,1346,0,1346,
UTTAR PRADESH,KAUSHAMBI,2021-02-13,0,977,0,977,
UTTAR PRADESH,KAUSHAMBI,2021-02-14,1,1097,1,1099,
UTTAR PRADESH,KAUSHAMBI,2021-02-15,0,1013,0,1013,
UTTAR PRADESH,KHERI,2021-02-11,2,1691,5,1698,
UTTAR PRADESH,KHERI,2021-02-12,1,1408,31,1440,
UTTAR PRADESH,KHERI,2021-02-13,0,1848,30,1878,
UTTAR PRADESH,KHERI,2021-02-14,1,1519,17,1537,
UTTAR PRADESH,KHERI,2021-02-15,2,1561,0,1563,
UTTAR PRADESH,KUSHI NAGAR,2021-02-11,1,1068,12,1081,
UTTAR PRADESH,KUSHI NAGAR,2021-02-12,0,860,6,866,
UTTAR PRADESH,KUSHI NAGAR,2021-02-13,0,2782,30,2812,
UTTAR PRADESH,KUSHI NAGAR,2021-02-14,0,874,59,933,
UTTAR PRADESH,KUSHI NAGAR,2021-02-15,1,753,2,756,
UTTAR PRADESH,LALITPUR,2021-02-11,1,1498,13,1512,
UTTAR PRADESH,LALITPUR,2021-02-12,2,1250,1,1253,
UTTAR PRADESH,LALITPUR,2021-02-13,1,1155,0,1156,
UTTAR PRADESH,LALITPUR,2021-02-14,1,1554,0,1555,
UTTAR PRADESH,LALITPUR,2021-02-15,4,722,0,726,
UTTAR PRADESH,LUCKNOW,2021-02-11,28,6576,149,6753,
UTTAR PRADESH,LUCKNOW,2021-02-12,29,7830,58,7917,
UTTAR PRADESH,LUCKNOW,2021-02-13,19,6688,137,6844,
UTTAR PRADESH,LUCKNOW,2021-02-14,20,5913,93,6026,
UTTAR PRADESH,LUCKNOW,2021-02-15,19,5807,94,5920,
UTTAR PRADESH,MAHARAJGANJ,2021-02-11,0,1065,82,1147,
UTTAR PRADESH,MAHARAJGANJ,2021-02-12,1,713,94,808,
UTTAR PRADESH,MAHARAJGANJ,2021-02-13,1,738,106,845,
UTTAR PRADESH,MAHARAJGANJ,2021-02-14,0,677,159,836,
UTTAR PRADESH,MAHARAJGANJ,2021-02-15,0,539,0,539,
UTTAR PRADESH,MAHOBA,2021-02-11,0,519,0,519,
UTTAR PRADESH,MAHOBA,2021-02-12,0,473,0,473,
UTTAR PRADESH,MAHOBA,2021-02-13,0,451,3,454,
UTTAR PRADESH,MAHOBA,2021-02-14,0,234,19,253,
UTTAR PRADESH,MAHOBA,2021-02-15,0,274,0,274,
UTTAR PRADESH,MAINPURI,2021-02-11,1,1759,0,1760,
UTTAR PRADESH,MAINPURI,2021-02-12,0,1651,0,1651,
UTTAR PRADESH,MAINPURI,2021-02-13,5,1546,25,1576,
UTTAR PRADESH,MAINPURI,2021-02-14,0,1297,0,1297,
UTTAR PRADESH,MAINPURI,2021-02-15,4,1498,0,1502,
UTTAR PRADESH,MATHURA,2021-02-11,5,1238,0,1243,
UTTAR PRADESH,MATHURA,2021-02-12,4,2113,3,2120,
UTTAR PRADESH,MATHURA,2021-02-13,0,1865,6,1871,
UTTAR PRADESH,MATHURA,2021-02-14,1,1954,2,1957,
UTTAR PRADESH,MATHURA,2021-02-15,0,1646,0,1646,
UTTAR PRADESH,MAU,2021-02-11,0,1572,33,1605,
UTTAR PRADESH,MAU,2021-02-12,0,951,25,976,
UTTAR PRADESH,MAU,2021-02-13,0,962,3,965,
UTTAR PRADESH,MAU,2021-02-14,2,938,9,949,
UTTAR PRADESH,MAU,2021-02-15,1,1018,3,1022,
UTTAR PRADESH,MEERUT,2021-02-11,4,4701,1,4706,
UTTAR PRADESH,MEERUT,2021-02-12,5,4290,1,4296,
UTTAR PRADESH,MEERUT,2021-02-13,9,4231,2,4242,
UTTAR PRADESH,MEERUT,2021-02-14,6,3343,0,3349,
UTTAR PRADESH,MEERUT,2021-02-15,9,3606,3,3618,
UTTAR PRADESH,MIRZAPUR,2021-02-11,1,1481,0,1482,
UTTAR PRADESH,MIRZAPUR,2021-02-12,0,1268,0,1268,
UTTAR PRADESH,MIRZAPUR,2021-02-13,0,1420,2,1422,
UTTAR PRADESH,MIRZAPUR,2021-02-14,0,1202,0,1202,
UTTAR PRADESH,MIRZAPUR,2021-02-15,1,1418,0,1419,
UTTAR PRADESH,MORADABAD,2021-02-11,4,2270,5,2279,
UTTAR PRADESH,MORADABAD,2021-02-12,1,2474,5,2480,
UTTAR PRADESH,MORADABAD,2021-02-13,0,1632,0,1632,
UTTAR PRADESH,MORADABAD,2021-02-14,2,1955,5,1962,
UTTAR PRADESH,MORADABAD,2021-02-15,1,2598,1,2600,
UTTAR PRADESH,MUZAFFARNAGAR,2021-02-11,7,1637,3,1647,
UTTAR PRADESH,MUZAFFARNAGAR,2021-02-12,0,1444,1,1445,
UTTAR PRADESH,MUZAFFARNAGAR,2021-02-13,1,1169,2,1172,
UTTAR PRADESH,MUZAFFARNAGAR,2021-02-14,0,595,0,595,
UTTAR PRADESH,MUZAFFARNAGAR,2021-02-15,1,675,0,676,
UTTAR PRADESH,PILIBHIT,2021-02-11,0,1703,30,1733,
UTTAR PRADESH,PILIBHIT,2021-02-12,0,1611,0,1611,
UTTAR PRADESH,PILIBHIT,2021-02-13,0,816,1,817,
UTTAR PRADESH,PILIBHIT,2021-02-14,0,991,0,991,
UTTAR PRADESH,PILIBHIT,2021-02-15,0,1065,7,1072,
UTTAR PRADESH,PRATAPGARH,2021-02-11,0,1528,98,1626,
UTTAR PRADESH,PRATAPGARH,2021-02-12,3,2800,0,2803,
UTTAR PRADESH,PRATAPGARH,2021-02-13,1,1699,52,1752,
UTTAR PRADESH,PRATAPGARH,2021-02-14,0,1786,83,1869,
UTTAR PRADESH,PRATAPGARH,2021-02-15,1,2619,35,2655,
UTTAR PRADESH,PRAYAGRAJ,2021-02-11,9,5885,6,5900,
UTTAR PRADESH,PRAYAGRAJ,2021-02-12,2,3617,6,3625,
UTTAR PRADESH,PRAYAGRAJ,2021-02-13,18,4388,2,4408,
UTTAR PRADESH,PRAYAGRAJ,2021-02-14,5,4323,0,4328,
UTTAR PRADESH,PRAYAGRAJ,2021-02-15,11,3200,1,3212,
UTTAR PRADESH,RAE BARELI,2021-02-11,1,1841,1,1843,
UTTAR PRADESH,RAE BARELI,2021-02-12,2,1980,3,1985,
UTTAR PRADESH,RAE BARELI,2021-02-13,1,1709,2,1712,
UTTAR PRADESH,RAE BARELI,2021-02-14,2,1212,1,1215,
UTTAR PRADESH,RAE BARELI,2021-02-15,0,2183,1,2184,
UTTAR PRADESH,RAMPUR,2021-02-11,2,1456,42,1500,
UTTAR PRADESH,RAMPUR,2021-02-12,1,1722,13,1736,
UTTAR PRADESH,RAMPUR,2021-02-13,0,1423,50,1473,
UTTAR PRADESH,RAMPUR,2021-02-14,0,1441,13,1454,
UTTAR PRADESH,RAMPUR,2021-02-15,4,1279,35,1318,
UTTAR PRADESH,SAHARANPUR,2021-02-11,1,2995,46,3042,
UTTAR PRADESH,SAHARANPUR,2021-02-12,1,2433,52,2486,
UTTAR PRADESH,SAHARANPUR,2021-02-13,4,2468,1,2473,
UTTAR PRADESH,SAHARANPUR,2021-02-14,3,2340,1,2344,
UTTAR PRADESH,SAHARANPUR,2021-02-15,2,3625,0,3627,
UTTAR PRADESH,SAMBHAL,2021-02-11,2,979,0,981,
UTTAR PRADESH,SAMBHAL,2021-02-12,0,2545,22,2567,
UTTAR PRADESH,SAMBHAL,2021-02-13,2,1580,70,1652,
UTTAR PRADESH,SAMBHAL,2021-02-14,0,915,130,1045,
UTTAR PRADESH,SAMBHAL,2021-02-15,1,1429,42,1472,
UTTAR PRADESH,SANT KABEER NAGAR,2021-02-11,2,1786,0,1788,
UTTAR PRADESH,SANT KABEER NAGAR,2021-02-12,0,1385,0,1385,
UTTAR PRADESH,SANT KABEER NAGAR,2021-02-13,0,1364,1,1365,
UTTAR PRADESH,SANT KABEER NAGAR,2021-02-14,0,1511,0,1511,
UTTAR PRADESH,SANT KABEER NAGAR,2021-02-15,3,1507,0,1510,
UTTAR PRADESH,SHAHJAHANPUR,2021-02-11,1,2252,96,2349,
UTTAR PRADESH,SHAHJAHANPUR,2021-02-12,3,1567,121,1691,
UTTAR PRADESH,SHAHJAHANPUR,2021-02-13,0,1261,4,1265,
UTTAR PRADESH,SHAHJAHANPUR,2021-02-14,2,1106,58,1166,
UTTAR PRADESH,SHAHJAHANPUR,2021-02-15,0,1955,0,1955,
UTTAR PRADESH,SHAMLI,2021-02-11,3,1259,2,1264,
UTTAR PRADESH,SHAMLI,2021-02-12,2,1275,1,1278,
UTTAR PRADESH,SHAMLI,2021-02-13,1,1528,1,1530,
UTTAR PRADESH,SHAMLI,2021-02-14,0,1092,0,1092,
UTTAR PRADESH,SHAMLI,2021-02-15,0,2572,0,2572,
UTTAR PRADESH,SHRAVASTI,2021-02-11,0,876,1,877,
UTTAR PRADESH,SHRAVASTI,2021-02-12,0,827,0,827,
UTTAR PRADESH,SHRAVASTI,2021-02-13,0,797,0,797,
UTTAR PRADESH,SHRAVASTI,2021-02-14,0,610,0,610,
UTTAR PRADESH,SHRAVASTI,2021-02-15,0,620,23,643,
UTTAR PRADESH,SIDDHARTH NAGAR,2021-02-11,0,951,48,999,
UTTAR PRADESH,SIDDHARTH NAGAR,2021-02-12,0,1113,41,1154,
UTTAR PRADESH,SIDDHARTH NAGAR,2021-02-13,0,1216,148,1364,
UTTAR PRADESH,SIDDHARTH NAGAR,2021-02-14,2,784,102,888,
UTTAR PRADESH,SIDDHARTH NAGAR,2021-02-15,0,900,0,900,
UTTAR PRADESH,SITAPUR,2021-02-11,0,1489,16,1505,
UTTAR PRADESH,SITAPUR,2021-02-12,0,1589,9,1598,
UTTAR PRADESH,SITAPUR,2021-02-13,0,1304,8,1312,
UTTAR PRADESH,SITAPUR,2021-02-14,2,1165,6,1173,
UTTAR PRADESH,SITAPUR,2021-02-15,0,1106,7,1113,
UTTAR PRADESH,SONBHADRA,2021-02-11,7,2252,8,2267,
UTTAR PRADESH,SONBHADRA,2021-02-12,1,1923,39,1963,
UTTAR PRADESH,SONBHADRA,2021-02-13,0,1517,39,1556,
UTTAR PRADESH,SONBHADRA,2021-02-14,2,1426,15,1443,
UTTAR PRADESH,SONBHADRA,2021-02-15,3,980,0,983,
UTTAR PRADESH,SULTANPUR,2021-02-11,0,1366,18,1384,
UTTAR PRADESH,SULTANPUR,2021-02-12,1,1780,1,1782,
UTTAR PRADESH,SULTANPUR,2021-02-13,0,3918,11,3929,
UTTAR PRADESH,SULTANPUR,2021-02-14,4,3013,30,3047,
UTTAR PRADESH,SULTANPUR,2021-02-15,1,3381,6,3388,
UTTAR PRADESH,UNNAO,2021-02-11,2,2288,21,2311,
UTTAR PRADESH,UNNAO,2021-02-12,0,2002,37,2039,
UTTAR PRADESH,UNNAO,2021-02-13,0,1694,69,1763,
UTTAR PRADESH,UNNAO,2021-02-14,0,1760,176,1936,
UTTAR PRADESH,UNNAO,2021-02-15,0,1684,69,1753,
UTTAR PRADESH,VARANASI,2021-02-11,6,2753,74,2833,
UTTAR PRADESH,VARANASI,2021-02-12,5,2730,71,2806,
UTTAR PRADESH,VARANASI,2021-02-13,7,1196,101,1304,
UTTAR PRADESH,VARANASI,2021-02-14,0,2513,73,2586,
UTTAR PRADESH,VARANASI,2021-02-15,7,3893,6,3906,
UTTARAKHAND,ALMORA,2021-02-11,0,144,0,144,
UTTARAKHAND,ALMORA,2021-02-12,2,156,1,159,
UTTARAKHAND,ALMORA,2021-02-13,0,123,0,123,
UTTARAKHAND,ALMORA,2021-02-14,0,16,0,16,
UTTARAKHAND,ALMORA,2021-02-15,0,165,0,165,
UTTARAKHAND,BAGESHWAR,2021-02-11,1,473,3,477,
UTTARAKHAND,BAGESHWAR,2021-02-12,0,193,4,197,
UTTARAKHAND,BAGESHWAR,2021-02-13,0,28,0,28,
UTTARAKHAND,BAGESHWAR,2021-02-14,0,6,1,7,
UTTARAKHAND,BAGESHWAR,2021-02-15,0,274,0,274,
UTTARAKHAND,CHAMOLI,2021-02-11,3,450,0,453,
UTTARAKHAND,CHAMOLI,2021-02-12,2,244,1,247,
UTTARAKHAND,CHAMOLI,2021-02-13,0,326,5,331,
UTTARAKHAND,CHAMOLI,2021-02-14,0,152,8,160,
UTTARAKHAND,CHAMOLI,2021-02-15,1,40,0,41,
UTTARAKHAND,CHAMPAWAT,2021-02-11,0,168,0,168,
UTTARAKHAND,CHAMPAWAT,2021-02-12,1,118,2,121,
UTTARAKHAND,CHAMPAWAT,2021-02-13,0,61,0,61,
UTTARAKHAND,CHAMPAWAT,2021-02-14,1,5,0,6,
UTTARAKHAND,CHAMPAWAT,2021-02-15,0,123,3,126,
UTTARAKHAND,DEHRADUN,2021-02-11,22,1114,2,1138,
UTTARAKHAND,DEHRADUN,2021-02-12,22,2092,9,2123,
UTTARAKHAND,DEHRADUN,2021-02-13,17,1423,5,1445,
UTTARAKHAND,DEHRADUN,2021-02-14,17,840,4,861,
UTTARAKHAND,DEHRADUN,2021-02-15,14,1426,40,1480,
UTTARAKHAND,HARIDWAR,2021-02-11,14,5803,0,5817,
UTTARAKHAND,HARIDWAR,2021-02-12,10,8777,2,8789,
UTTARAKHAND,HARIDWAR,2021-02-13,18,4065,7,4090,
UTTARAKHAND,HARIDWAR,2021-02-14,1,1241,1,1243,
UTTARAKHAND,HARIDWAR,2021-02-15,12,2920,0,2932,
UTTARAKHAND,NAINITAL,2021-02-11,14,778,2,794,
UTTARAKHAND,NAINITAL,2021-02-12,8,754,4,766,
UTTARAKHAND,NAINITAL,2021-02-13,12,1169,1,1182,
UTTARAKHAND,NAINITAL,2021-02-14,6,168,5,179,
UTTARAKHAND,NAINITAL,2021-02-15,11,1009,0,1020,
UTTARAKHAND,PAURI GARHWAL,2021-02-11,1,244,5,250,
UTTARAKHAND,PAURI GARHWAL,2021-02-12,1,579,30,610,
UTTARAKHAND,PAURI GARHWAL,2021-02-13,0,380,5,385,
UTTARAKHAND,PAURI GARHWAL,2021-02-14,0,711,1,712,
UTTARAKHAND,PAURI GARHWAL,2021-02-15,4,452,1,457,
UTTARAKHAND,PITHORAGARH,2021-02-11,1,606,0,607,
UTTARAKHAND,PITHORAGARH,2021-02-12,1,220,1,222,
UTTARAKHAND,PITHORAGARH,2021-02-13,2,396,4,402,
UTTARAKHAND,PITHORAGARH,2021-02-14,0,1306,0,1306,
UTTARAKHAND,PITHORAGARH,2021-02-15,0,1291,0,1291,
UTTARAKHAND,RUDRA PRAYAG,2021-02-11,0,65,0,65,
UTTARAKHAND,RUDRA PRAYAG,2021-02-12,0,35,0,35,
UTTARAKHAND,RUDRA PRAYAG,2021-02-13,0,53,0,53,
UTTARAKHAND,RUDRA PRAYAG,2021-02-14,0,4,0,4,
UTTARAKHAND,RUDRA PRAYAG,2021-02-15,0,18,0,18,
UTTARAKHAND,TEHRI GARHWAL,2021-02-11,1,189,0,190,
UTTARAKHAND,TEHRI GARHWAL,2021-02-12,3,332,1,336,
UTTARAKHAND,TEHRI GARHWAL,2021-02-13,0,230,1,231,
UTTARAKHAND,TEHRI GARHWAL,2021-02-14,0,131,0,131,
UTTARAKHAND,TEHRI GARHWAL,2021-02-15,1,199,1,201,
UTTARAKHAND,UDAM SINGH NAGAR,2021-02-11,5,1227,64,1296,
UTTARAKHAND,UDAM SINGH NAGAR,2021-02-12,9,1649,41,1699,
UTTARAKHAND,UDAM SINGH NAGAR,2021-02-13,11,933,15,959,
UTTARAKHAND,UDAM SINGH NAGAR,2021-02-14,1,1050,3,1054,
UTTARAKHAND,UDAM SINGH NAGAR,2021-02-15,1,1271,109,1381,
UTTARAKHAND,UTTAR KASHI,2021-02-11,0,291,0,291,
UTTARAKHAND,UTTAR KASHI,2021-02-12,0,262,0,262,
UTTARAKHAND,UTTAR KASHI,2021-02-13,0,284,0,284,
UTTARAKHAND,UTTAR KASHI,2021-02-14,0,360,0,360,
UTTARAKHAND,UTTAR KASHI,2021-02-15,0,61,0,61,
WEST BENGAL,24 PARAGANAS NORTH,2021-02-11,43,3988,5,4036,
WEST BENGAL,24 PARAGANAS NORTH,2021-02-12,48,3481,12,3541,
WEST BENGAL,24 PARAGANAS NORTH,2021-02-13,60,3974,5,4039,
WEST BENGAL,24 PARAGANAS NORTH,2021-02-14,39,2308,16,2363,
WEST BENGAL,24 PARAGANAS NORTH,2021-02-15,41,2923,13,2977,
WEST BENGAL,24 PARAGANAS SOUTH,2021-02-11,13,3889,9,3911,
WEST BENGAL,24 PARAGANAS SOUTH,2021-02-12,7,2778,88,2873,
WEST BENGAL,24 PARAGANAS SOUTH,2021-02-13,7,3038,22,3067,
WEST BENGAL,24 PARAGANAS SOUTH,2021-02-14,2,2439,4,2445,
WEST BENGAL,24 PARAGANAS SOUTH,2021-02-15,10,2364,4,2378,
WEST BENGAL,ALIPURDUAR,2021-02-11,0,705,0,705,
WEST BENGAL,ALIPURDUAR,2021-02-12,0,129,0,129,
WEST BENGAL,ALIPURDUAR,2021-02-13,0,333,0,333,
WEST BENGAL,ALIPURDUAR,2021-02-14,1,317,0,318,
WEST BENGAL,ALIPURDUAR,2021-02-15,0,465,0,465,
WEST BENGAL,BANKURA,2021-02-11,2,655,13,670,
WEST BENGAL,BANKURA,2021-02-12,5,568,0,573,
WEST BENGAL,BANKURA,2021-02-13,1,628,0,629,
WEST BENGAL,BANKURA,2021-02-14,0,247,0,247,
WEST BENGAL,BANKURA,2021-02-15,0,610,0,610,
WEST BENGAL,BIRBHUM,2021-02-11,3,1064,6,1073,
WEST BENGAL,BIRBHUM,2021-02-12,1,874,4,879,
WEST BENGAL,BIRBHUM,2021-02-13,0,681,6,687,
WEST BENGAL,BIRBHUM,2021-02-14,0,470,3,473,
WEST BENGAL,BIRBHUM,2021-02-15,3,581,3,587,
WEST BENGAL,COOCHBEHAR,2021-02-11,2,1241,0,1243,
WEST BENGAL,COOCHBEHAR,2021-02-12,0,1406,0,1406,
WEST BENGAL,COOCHBEHAR,2021-02-13,0,904,1,905,
WEST BENGAL,COOCHBEHAR,2021-02-14,1,1664,0,1665,
WEST BENGAL,COOCHBEHAR,2021-02-15,1,1507,0,1508,
WEST BENGAL,DARJEELING,2021-02-11,5,596,1,602,
WEST BENGAL,DARJEELING,2021-02-12,5,508,0,513,
WEST BENGAL,DARJEELING,2021-02-13,9,614,1,624,
WEST BENGAL,DARJEELING,2021-02-14,4,431,0,435,
WEST BENGAL,DARJEELING,2021-02-15,12,504,0,516,
WEST BENGAL,DINAJPUR DAKSHIN,2021-02-11,2,745,0,747,
WEST BENGAL,DINAJPUR DAKSHIN,2021-02-12,1,685,1,687,
WEST BENGAL,DINAJPUR DAKSHIN,2021-02-13,0,659,4,663,
WEST BENGAL,DINAJPUR DAKSHIN,2021-02-14,0,613,11,624,
WEST BENGAL,DINAJPUR DAKSHIN,2021-02-15,1,425,9,435,
WEST BENGAL,DINAJPUR UTTAR,2021-02-11,2,382,0,384,
WEST BENGAL,DINAJPUR UTTAR,2021-02-12,2,419,0,421,
WEST BENGAL,DINAJPUR UTTAR,2021-02-13,1,371,0,372,
WEST BENGAL,DINAJPUR UTTAR,2021-02-14,2,114,0,116,
WEST BENGAL,DINAJPUR UTTAR,2021-02-15,4,200,0,204,
WEST BENGAL,HOOGHLY,2021-02-11,8,660,94,762,
WEST BENGAL,HOOGHLY,2021-02-12,8,612,28,648,
WEST BENGAL,HOOGHLY,2021-02-13,5,553,94,652,
WEST BENGAL,HOOGHLY,2021-02-14,8,344,0,352,
WEST BENGAL,HOOGHLY,2021-02-15,7,722,36,765,
WEST BENGAL,HOWRAH,2021-02-11,8,1114,65,1187,
WEST BENGAL,HOWRAH,2021-02-12,10,1180,76,1266,
WEST BENGAL,HOWRAH,2021-02-13,12,1223,53,1288,
WEST BENGAL,HOWRAH,2021-02-14,5,844,62,911,
WEST BENGAL,HOWRAH,2021-02-15,4,983,62,1049,
WEST BENGAL,JALPAIGURI,2021-02-11,6,503,0,509,
WEST BENGAL,JALPAIGURI,2021-02-12,2,327,2,331,
WEST BENGAL,JALPAIGURI,2021-02-13,5,359,1,365,
WEST BENGAL,JALPAIGURI,2021-02-14,0,254,0,254,
WEST BENGAL,JALPAIGURI,2021-02-15,0,422,0,422,
WEST BENGAL,JHARGRAM,2021-02-11,1,21,0,22,
WEST BENGAL,JHARGRAM,2021-02-12,0,119,1,120,
WEST BENGAL,JHARGRAM,2021-02-13,0,34,0,34,
WEST BENGAL,JHARGRAM,2021-02-14,0,25,0,25,
WEST BENGAL,JHARGRAM,2021-02-15,0,23,0,23,
WEST BENGAL,KALIMPONG,2021-02-11,0,96,0,96,
WEST BENGAL,KALIMPONG,2021-02-12,0,102,0,102,
WEST BENGAL,KALIMPONG,2021-02-13,1,24,0,25,
WEST BENGAL,KALIMPONG,2021-02-14,0,117,0,117,
WEST BENGAL,KALIMPONG,2021-02-15,0,48,0,48,
WEST BENGAL,KOLKATA,2021-02-11,71,2932,5,3008,
WEST BENGAL,KOLKATA,2021-02-12,95,3400,15,3510,
WEST BENGAL,KOLKATA,2021-02-13,74,3361,7,3442,
WEST BENGAL,KOLKATA,2021-02-14,48,1840,1,1889,
WEST BENGAL,KOLKATA,2021-02-15,67,2599,7,2673,
WEST BENGAL,MALDAH,2021-02-11,1,553,8,562,
WEST BENGAL,MALDAH,2021-02-12,1,461,4,466,
WEST BENGAL,MALDAH,2021-02-13,6,545,2,553,
WEST BENGAL,MALDAH,2021-02-14,2,87,0,89,
WEST BENGAL,MALDAH,2021-02-15,0,375,1,376,
WEST BENGAL,MEDINIPUR EAST,2021-02-11,4,746,0,750,
WEST BENGAL,MEDINIPUR EAST,2021-02-12,4,985,5,994,
WEST BENGAL,MEDINIPUR EAST,2021-02-13,7,788,7,802,
WEST BENGAL,MEDINIPUR EAST,2021-02-14,1,514,2,517,
WEST BENGAL,MEDINIPUR EAST,2021-02-15,3,801,0,804,
WEST BENGAL,MEDINIPUR WEST,2021-02-11,4,370,6,380,
WEST BENGAL,MEDINIPUR WEST,2021-02-12,4,348,6,358,
WEST BENGAL,MEDINIPUR WEST,2021-02-13,4,361,3,368,
WEST BENGAL,MEDINIPUR WEST,2021-02-14,1,284,7,292,
WEST BENGAL,MEDINIPUR WEST,2021-02-15,2,326,0,328,
WEST BENGAL,MURSHIDABAD,2021-02-11,3,905,1,909,
WEST BENGAL,MURSHIDABAD,2021-02-12,2,761,0,763,
WEST BENGAL,MURSHIDABAD,2021-02-13,2,885,0,887,
WEST BENGAL,MURSHIDABAD,2021-02-14,1,538,0,539,
WEST BENGAL,MURSHIDABAD,2021-02-15,1,1140,3,1144,
WEST BENGAL,NADIA,2021-02-11,4,886,11,901,
WEST BENGAL,NADIA,2021-02-12,2,715,8,725,
WEST BENGAL,NADIA,2021-02-13,1,602,5,608,
WEST BENGAL,NADIA,2021-02-14,3,486,5,494,
WEST BENGAL,NADIA,2021-02-15,2,653,9,664,
WEST BENGAL,PASCHIM BARDHAMAN,2021-02-11,13,547,0,560,
WEST BENGAL,PASCHIM BARDHAMAN,2021-02-12,4,687,1,692,
WEST BENGAL,PASCHIM BARDHAMAN,2021-02-13,2,788,3,793,
WEST BENGAL,PASCHIM BARDHAMAN,2021-02-14,12,789,0,801,
WEST BENGAL,PASCHIM BARDHAMAN,2021-02-15,10,688,7,705,
WEST BENGAL,PURBA BARDHAMAN,2021-02-11,4,658,0,662,
WEST BENGAL,PURBA BARDHAMAN,2021-02-12,0,594,0,594,
WEST BENGAL,PURBA BARDHAMAN,2021-02-13,2,562,0,564,
WEST BENGAL,PURBA BARDHAMAN,2021-02-14,1,438,0,439,
WEST BENGAL,PURBA BARDHAMAN,2021-02-15,2,539,1,542,
WEST BENGAL,PURULIA,2021-02-11,7,764,0,771,
WEST BENGAL,PURULIA,2021-02-12,4,438,0,442,
WEST BENGAL,PURULIA,2021-02-13,2,560,1,563,
WEST BENGAL,PURULIA,2021-02-14,4,269,0,273,
WEST BENGAL,PURULIA,2021-02-15,3,115,0,118,
ANDAMAN AND NICOBAR ISLANDS,NICOBARS,2021-02-16,0,22,0,22,
ANDAMAN AND NICOBAR ISLANDS,NICOBARS,2021-02-17,0,7,0,7,
ANDAMAN AND NICOBAR ISLANDS,NICOBARS,2021-02-18,0,17,0,17,
ANDAMAN AND NICOBAR ISLANDS,NICOBARS,2021-02-19,0,30,0,30,
ANDAMAN AND NICOBAR ISLANDS,NICOBARS,2021-02-20,0,6,0,6,
ANDAMAN AND NICOBAR ISLANDS,NORTH AND MIDDLE ANDAMAN,2021-02-16,0,14,0,14,
ANDAMAN AND NICOBAR ISLANDS,NORTH AND MIDDLE ANDAMAN,2021-02-17,0,10,0,10,
ANDAMAN AND NICOBAR ISLANDS,NORTH AND MIDDLE ANDAMAN,2021-02-18,0,7,0,7,
ANDAMAN AND NICOBAR ISLANDS,NORTH AND MIDDLE ANDAMAN,2021-02-19,0,11,0,11,
ANDAMAN AND NICOBAR ISLANDS,NORTH AND MIDDLE ANDAMAN,2021-02-20,0,11,0,11,
ANDAMAN AND NICOBAR ISLANDS,SOUTH ANDAMANS,2021-02-16,6,519,0,525,
ANDAMAN AND NICOBAR ISLANDS,SOUTH ANDAMANS,2021-02-17,0,310,0,310,
ANDAMAN AND NICOBAR ISLANDS,SOUTH ANDAMANS,2021-02-18,1,465,1,467,
ANDAMAN AND NICOBAR ISLANDS,SOUTH ANDAMANS,2021-02-19,3,369,0,372,
ANDAMAN AND NICOBAR ISLANDS,SOUTH ANDAMANS,2021-02-20,0,432,1,433,
ANDHRA PRADESH,ANANTAPUR,2021-02-16,1,42,3,46,
ANDHRA PRADESH,ANANTAPUR,2021-02-17,0,38,1,39,
ANDHRA PRADESH,ANANTAPUR,2021-02-18,1,68,0,69,
ANDHRA PRADESH,ANANTAPUR,2021-02-19,1,48,4,53,
ANDHRA PRADESH,ANANTAPUR,2021-02-20,0,60,0,60,
ANDHRA PRADESH,CHITTOOR,2021-02-16,0,190,0,190,
ANDHRA PRADESH,CHITTOOR,2021-02-17,3,185,0,188,
ANDHRA PRADESH,CHITTOOR,2021-02-18,1,107,1,109,
ANDHRA PRADESH,CHITTOOR,2021-02-19,4,115,0,119,
ANDHRA PRADESH,CHITTOOR,2021-02-20,1,129,0,130,
ANDHRA PRADESH,EAST GODAVARI,2021-02-16,1,12,0,13,
ANDHRA PRADESH,EAST GODAVARI,2021-02-17,1,13,0,14,
ANDHRA PRADESH,EAST GODAVARI,2021-02-18,1,16,1,18,
ANDHRA PRADESH,EAST GODAVARI,2021-02-19,0,7,0,7,
ANDHRA PRADESH,EAST GODAVARI,2021-02-20,0,24,0,24,
ANDHRA PRADESH,GUNTUR,2021-02-16,0,9,1,10,
ANDHRA PRADESH,GUNTUR,2021-02-17,0,19,0,19,
ANDHRA PRADESH,GUNTUR,2021-02-18,1,22,0,23,
ANDHRA PRADESH,GUNTUR,2021-02-19,0,17,0,17,
ANDHRA PRADESH,GUNTUR,2021-02-20,0,12,0,12,
ANDHRA PRADESH,KRISHNA,2021-02-16,0,12,0,12,
ANDHRA PRADESH,KRISHNA,2021-02-17,0,7,0,7,
ANDHRA PRADESH,KRISHNA,2021-02-18,4,6,0,10,
ANDHRA PRADESH,KRISHNA,2021-02-19,0,18,0,18,
ANDHRA PRADESH,KRISHNA,2021-02-20,0,8,0,8,
ANDHRA PRADESH,KURNOOL,2021-02-16,3,4,0,7,
ANDHRA PRADESH,KURNOOL,2021-02-17,1,15,0,16,
ANDHRA PRADESH,KURNOOL,2021-02-18,2,5,0,7,
ANDHRA PRADESH,KURNOOL,2021-02-19,0,8,0,8,
ANDHRA PRADESH,KURNOOL,2021-02-20,1,11,0,12,
ANDHRA PRADESH,PRAKASAM,2021-02-16,0,8,0,8,
ANDHRA PRADESH,PRAKASAM,2021-02-17,0,13,0,13,
ANDHRA PRADESH,PRAKASAM,2021-02-18,0,4,0,4,
ANDHRA PRADESH,PRAKASAM,2021-02-19,0,6,0,6,
ANDHRA PRADESH,PRAKASAM,2021-02-20,0,9,0,9,
ANDHRA PRADESH,SPSR NELLORE,2021-02-16,1,23,0,24,
ANDHRA PRADESH,SPSR NELLORE,2021-02-17,0,26,0,26,
ANDHRA PRADESH,SPSR NELLORE,2021-02-18,0,26,0,26,
ANDHRA PRADESH,SPSR NELLORE,2021-02-19,0,16,0,16,
ANDHRA PRADESH,SPSR NELLORE,2021-02-20,1,14,0,15,
ANDHRA PRADESH,SRIKAKULAM,2021-02-16,0,20,0,20,
ANDHRA PRADESH,SRIKAKULAM,2021-02-17,1,9,0,10,
ANDHRA PRADESH,SRIKAKULAM,2021-02-18,0,9,0,9,
ANDHRA PRADESH,SRIKAKULAM,2021-02-19,1,7,0,8,
ANDHRA PRADESH,SRIKAKULAM,2021-02-20,0,11,0,11,
ANDHRA PRADESH,VISAKHAPATANAM,2021-02-16,3,156,0,159,
ANDHRA PRADESH,VISAKHAPATANAM,2021-02-17,2,115,0,117,
ANDHRA PRADESH,VISAKHAPATANAM,2021-02-18,0,155,0,155,
ANDHRA PRADESH,VISAKHAPATANAM,2021-02-19,3,127,0,130,
ANDHRA PRADESH,VISAKHAPATANAM,2021-02-20,2,91,0,93,
ANDHRA PRADESH,VIZIANAGARAM,2021-02-16,0,15,0,15,
ANDHRA PRADESH,VIZIANAGARAM,2021-02-17,0,9,0,9,
ANDHRA PRADESH,VIZIANAGARAM,2021-02-18,0,10,0,10,
ANDHRA PRADESH,VIZIANAGARAM,2021-02-19,0,9,0,9,
ANDHRA PRADESH,VIZIANAGARAM,2021-02-20,0,4,0,4,
ANDHRA PRADESH,WEST GODAVARI,2021-02-16,1,6,0,7,
ANDHRA PRADESH,WEST GODAVARI,2021-02-17,0,14,0,14,
ANDHRA PRADESH,WEST GODAVARI,2021-02-18,2,23,0,25,
ANDHRA PRADESH,WEST GODAVARI,2021-02-19,0,8,0,8,
ANDHRA PRADESH,WEST GODAVARI,2021-02-20,0,10,0,10,
ANDHRA PRADESH,Y.S.R.,2021-02-16,0,7,0,7,
ANDHRA PRADESH,Y.S.R.,2021-02-17,0,21,0,21,
ANDHRA PRADESH,Y.S.R.,2021-02-18,1,18,0,19,
ANDHRA PRADESH,Y.S.R.,2021-02-19,1,26,0,27,
ANDHRA PRADESH,Y.S.R.,2021-02-20,2,9,0,11,
ARUNACHAL PRADESH,ANJAW,2021-02-17,0,9,0,9,
ARUNACHAL PRADESH,ANJAW,2021-02-18,0,2,0,2,
ARUNACHAL PRADESH,ANJAW,2021-02-20,0,1,0,1,
ARUNACHAL PRADESH,CHANGLANG,2021-02-16,0,1,0,1,
ARUNACHAL PRADESH,CHANGLANG,2021-02-17,0,1,0,1,
ARUNACHAL PRADESH,CHANGLANG,2021-02-18,0,1,0,1,
ARUNACHAL PRADESH,CHANGLANG,2021-02-20,0,2,0,2,
ARUNACHAL PRADESH,DIBANG VALLEY,2021-02-16,0,1,0,1,
ARUNACHAL PRADESH,DIBANG VALLEY,2021-02-18,0,1,0,1,
ARUNACHAL PRADESH,DIBANG VALLEY,2021-02-19,0,1,0,1,
ARUNACHAL PRADESH,DIBANG VALLEY,2021-02-20,0,1,0,1,
ARUNACHAL PRADESH,EAST KAMENG,2021-02-18,0,1,0,1,
ARUNACHAL PRADESH,EAST KAMENG,2021-02-19,0,1,0,1,
ARUNACHAL PRADESH,EAST KAMENG,2021-02-20,0,1,0,1,
ARUNACHAL PRADESH,EAST SIANG,2021-02-16,0,32,0,32,
ARUNACHAL PRADESH,EAST SIANG,2021-02-17,0,32,0,32,
ARUNACHAL PRADESH,EAST SIANG,2021-02-18,0,23,0,23,
ARUNACHAL PRADESH,EAST SIANG,2021-02-19,0,22,0,22,
ARUNACHAL PRADESH,EAST SIANG,2021-02-20,0,8,0,8,
ARUNACHAL PRADESH,KAMLE,2021-02-18,0,3,0,3,
ARUNACHAL PRADESH,KRA  DAADI,2021-02-19,0,1,0,1,
ARUNACHAL PRADESH,LEPARADA,2021-02-16,1,3,0,4,
ARUNACHAL PRADESH,LEPARADA,2021-02-17,1,1,0,2,
ARUNACHAL PRADESH,LEPARADA,2021-02-19,5,4,0,9,
ARUNACHAL PRADESH,LOHIT,2021-02-17,0,3,0,3,
ARUNACHAL PRADESH,LOHIT,2021-02-18,0,2,0,2,
ARUNACHAL PRADESH,LOHIT,2021-02-19,0,3,0,3,
ARUNACHAL PRADESH,LONGDING,2021-02-17,0,1,0,1,
ARUNACHAL PRADESH,LONGDING,2021-02-18,0,3,0,3,
ARUNACHAL PRADESH,LOWER DIBANG VALLEY,2021-02-16,0,1,0,1,
ARUNACHAL PRADESH,LOWER DIBANG VALLEY,2021-02-18,0,4,0,4,
ARUNACHAL PRADESH,LOWER DIBANG VALLEY,2021-02-19,0,1,0,1,
ARUNACHAL PRADESH,LOWER SIANG,2021-02-16,0,5,0,5,
ARUNACHAL PRADESH,LOWER SIANG,2021-02-17,0,3,0,3,
ARUNACHAL PRADESH,LOWER SIANG,2021-02-18,0,11,0,11,
ARUNACHAL PRADESH,LOWER SIANG,2021-02-19,0,6,0,6,
ARUNACHAL PRADESH,LOWER SIANG,2021-02-20,0,7,0,7,
ARUNACHAL PRADESH,LOWER SUBANSIRI,2021-02-18,0,16,0,16,
ARUNACHAL PRADESH,LOWER SUBANSIRI,2021-02-19,0,9,0,9,
ARUNACHAL PRADESH,LOWER SUBANSIRI,2021-02-20,0,1,0,1,
ARUNACHAL PRADESH,NAMSAI,2021-02-16,0,1,0,1,
ARUNACHAL PRADESH,NAMSAI,2021-02-17,0,1,0,1,
ARUNACHAL PRADESH,NAMSAI,2021-02-18,3,2,0,5,
ARUNACHAL PRADESH,NAMSAI,2021-02-19,0,2,0,2,
ARUNACHAL PRADESH,NAMSAI,2021-02-20,0,1,0,1,
ARUNACHAL PRADESH,PAKKE KESSANG,2021-02-18,0,1,0,1,
ARUNACHAL PRADESH,PAKKE KESSANG,2021-02-19,0,1,0,1,
ARUNACHAL PRADESH,PAPUM PARE,2021-02-16,0,19,0,19,
ARUNACHAL PRADESH,PAPUM PARE,2021-02-17,0,9,0,9,
ARUNACHAL PRADESH,PAPUM PARE,2021-02-18,0,28,0,28,
ARUNACHAL PRADESH,PAPUM PARE,2021-02-19,0,21,0,21,
ARUNACHAL PRADESH,PAPUM PARE,2021-02-20,0,2,0,2,
ARUNACHAL PRADESH,SIANG,2021-02-17,0,1,0,1,
ARUNACHAL PRADESH,TAWANG,2021-02-16,0,1,0,1,
ARUNACHAL PRADESH,TAWANG,2021-02-17,0,1,0,1,
ARUNACHAL PRADESH,TAWANG,2021-02-18,0,2,0,2,
ARUNACHAL PRADESH,TAWANG,2021-02-19,0,2,0,2,
ARUNACHAL PRADESH,TIRAP,2021-02-16,0,3,0,3,
ARUNACHAL PRADESH,TIRAP,2021-02-17,0,2,0,2,
ARUNACHAL PRADESH,UPPER SUBANSIRI,2021-02-18,0,1,0,1,
ARUNACHAL PRADESH,WEST KAMENG,2021-02-16,0,106,0,106,
ARUNACHAL PRADESH,WEST KAMENG,2021-02-17,0,73,0,73,
ARUNACHAL PRADESH,WEST KAMENG,2021-02-18,0,20,0,20,
ARUNACHAL PRADESH,WEST KAMENG,2021-02-19,0,3,0,3,
ARUNACHAL PRADESH,WEST KAMENG,2021-02-20,0,1,0,1,
ARUNACHAL PRADESH,WEST SIANG,2021-02-16,0,48,0,48,
ARUNACHAL PRADESH,WEST SIANG,2021-02-17,0,5,0,5,
ARUNACHAL PRADESH,WEST SIANG,2021-02-18,0,4,0,4,
ARUNACHAL PRADESH,WEST SIANG,2021-02-19,0,3,0,3,
ARUNACHAL PRADESH,WEST SIANG,2021-02-20,0,1,0,1,
ASSAM,BAKSA,2021-02-16,0,15,0,15,
ASSAM,BAKSA,2021-02-17,0,50,0,50,
ASSAM,BAKSA,2021-02-18,0,53,0,53,
ASSAM,BAKSA,2021-02-19,0,25,0,25,
ASSAM,BAKSA,2021-02-20,0,35,0,35,
ASSAM,BARPETA,2021-02-16,0,156,0,156,
ASSAM,BARPETA,2021-02-17,0,154,0,154,
ASSAM,BARPETA,2021-02-18,0,173,0,173,
ASSAM,BARPETA,2021-02-19,0,141,0,141,
ASSAM,BARPETA,2021-02-20,0,108,0,108,
ASSAM,BISWANATH,2021-02-16,1,6,0,7,
ASSAM,BISWANATH,2021-02-17,5,147,0,152,
ASSAM,BISWANATH,2021-02-18,0,165,0,165,
ASSAM,BISWANATH,2021-02-19,0,422,0,422,
ASSAM,BISWANATH,2021-02-20,0,240,0,240,
ASSAM,BONGAIGAON,2021-02-16,0,143,0,143,
ASSAM,BONGAIGAON,2021-02-17,0,249,0,249,
ASSAM,BONGAIGAON,2021-02-18,0,176,0,176,
ASSAM,BONGAIGAON,2021-02-19,0,197,0,197,
ASSAM,BONGAIGAON,2021-02-20,0,171,0,171,
ASSAM,CACHAR,2021-02-16,0,163,18,181,
ASSAM,CACHAR,2021-02-17,0,161,2,163,
ASSAM,CACHAR,2021-02-18,3,5446,52,5501,
ASSAM,CACHAR,2021-02-19,0,205,2,207,
ASSAM,CACHAR,2021-02-20,1,3339,23,3363,
ASSAM,CHARAIDEO,2021-02-16,0,82,0,82,
ASSAM,CHARAIDEO,2021-02-17,0,72,0,72,
ASSAM,CHARAIDEO,2021-02-18,0,94,0,94,
ASSAM,CHARAIDEO,2021-02-19,0,116,0,116,
ASSAM,CHARAIDEO,2021-02-20,0,145,0,145,
ASSAM,CHIRANG,2021-02-16,0,46,0,46,
ASSAM,CHIRANG,2021-02-17,0,44,0,44,
ASSAM,CHIRANG,2021-02-18,0,109,0,109,
ASSAM,CHIRANG,2021-02-19,0,190,0,190,
ASSAM,CHIRANG,2021-02-20,0,14,0,14,
ASSAM,DARRANG,2021-02-16,1,333,0,334,
ASSAM,DARRANG,2021-02-17,0,323,1,324,
ASSAM,DARRANG,2021-02-18,1,356,0,357,
ASSAM,DARRANG,2021-02-19,0,439,0,439,
ASSAM,DARRANG,2021-02-20,0,335,0,335,
ASSAM,DHEMAJI,2021-02-16,0,45,0,45,
ASSAM,DHEMAJI,2021-02-17,0,22,0,22,
ASSAM,DHEMAJI,2021-02-18,0,35,0,35,
ASSAM,DHEMAJI,2021-02-19,1,34,0,35,
ASSAM,DHEMAJI,2021-02-20,0,115,0,115,
ASSAM,DHUBRI,2021-02-16,0,210,0,210,
ASSAM,DHUBRI,2021-02-17,0,254,0,254,
ASSAM,DHUBRI,2021-02-18,0,151,0,151,
ASSAM,DHUBRI,2021-02-19,0,218,0,218,
ASSAM,DHUBRI,2021-02-20,0,238,0,238,
ASSAM,DIBRUGARH,2021-02-16,0,490,0,490,
ASSAM,DIBRUGARH,2021-02-17,6,254,0,260,
ASSAM,DIBRUGARH,2021-02-18,3,329,0,332,
ASSAM,DIBRUGARH,2021-02-19,1,379,0,380,
ASSAM,DIBRUGARH,2021-02-20,3,403,0,406,
ASSAM,DIMA HASAO,2021-02-16,0,31,0,31,
ASSAM,DIMA HASAO,2021-02-17,0,23,0,23,
ASSAM,DIMA HASAO,2021-02-18,0,27,0,27,
ASSAM,DIMA HASAO,2021-02-19,0,22,0,22,
ASSAM,DIMA HASAO,2021-02-20,0,29,0,29,
ASSAM,GOALPARA,2021-02-16,0,229,0,229,
ASSAM,GOALPARA,2021-02-17,0,327,0,327,
ASSAM,GOALPARA,2021-02-18,0,289,0,289,
ASSAM,GOALPARA,2021-02-19,1,353,0,354,
ASSAM,GOALPARA,2021-02-20,0,188,0,188,
ASSAM,GOLAGHAT,2021-02-16,0,176,0,176,
ASSAM,GOLAGHAT,2021-02-17,0,317,0,317,
ASSAM,GOLAGHAT,2021-02-18,1,172,0,173,
ASSAM,GOLAGHAT,2021-02-19,0,136,0,136,
ASSAM,GOLAGHAT,2021-02-20,0,137,0,137,
ASSAM,HAILAKANDI,2021-02-16,1,114,65,180,
ASSAM,HAILAKANDI,2021-02-17,1,197,1,199,
ASSAM,HAILAKANDI,2021-02-18,0,181,1,182,
ASSAM,HAILAKANDI,2021-02-19,0,205,21,226,
ASSAM,HAILAKANDI,2021-02-20,0,154,2,156,
ASSAM,HOJAI,2021-02-16,0,109,0,109,
ASSAM,HOJAI,2021-02-17,0,148,0,148,
ASSAM,HOJAI,2021-02-18,1,131,0,132,
ASSAM,HOJAI,2021-02-19,0,335,0,335,
ASSAM,HOJAI,2021-02-20,0,193,0,193,
ASSAM,JORHAT,2021-02-16,1,288,0,289,
ASSAM,JORHAT,2021-02-17,6,323,0,329,
ASSAM,JORHAT,2021-02-18,0,276,0,276,
ASSAM,JORHAT,2021-02-19,0,241,0,241,
ASSAM,JORHAT,2021-02-20,0,314,0,314,
ASSAM,KAMRUP,2021-02-16,0,430,0,430,
ASSAM,KAMRUP,2021-02-17,0,484,0,484,
ASSAM,KAMRUP,2021-02-18,3,495,1,499,
ASSAM,KAMRUP,2021-02-19,0,483,0,483,
ASSAM,KAMRUP,2021-02-20,1,569,0,570,
ASSAM,KAMRUP METRO,2021-02-16,9,1318,1,1328,
ASSAM,KAMRUP METRO,2021-02-17,6,1137,0,1143,
ASSAM,KAMRUP METRO,2021-02-18,6,1470,3,1479,
ASSAM,KAMRUP METRO,2021-02-19,4,1535,0,1539,
ASSAM,KAMRUP METRO,2021-02-20,13,1323,0,1336,
ASSAM,KARBI ANGLONG,2021-02-16,0,14,0,14,
ASSAM,KARBI ANGLONG,2021-02-17,0,62,0,62,
ASSAM,KARBI ANGLONG,2021-02-18,0,37,0,37,
ASSAM,KARBI ANGLONG,2021-02-19,1,22,0,23,
ASSAM,KARBI ANGLONG,2021-02-20,0,42,0,42,
ASSAM,KARIMGANJ,2021-02-16,0,166,8,174,
ASSAM,KARIMGANJ,2021-02-17,1,236,0,237,
ASSAM,KARIMGANJ,2021-02-18,0,336,25,361,
ASSAM,KARIMGANJ,2021-02-19,0,242,0,242,
ASSAM,KARIMGANJ,2021-02-20,0,227,1,228,
ASSAM,KOKRAJHAR,2021-02-16,0,83,0,83,
ASSAM,KOKRAJHAR,2021-02-17,0,37,0,37,
ASSAM,KOKRAJHAR,2021-02-18,0,28,0,28,
ASSAM,KOKRAJHAR,2021-02-19,0,72,0,72,
ASSAM,KOKRAJHAR,2021-02-20,0,16,0,16,
ASSAM,LAKHIMPUR,2021-02-16,0,158,0,158,
ASSAM,LAKHIMPUR,2021-02-17,0,125,0,125,
ASSAM,LAKHIMPUR,2021-02-18,0,294,0,294,
ASSAM,LAKHIMPUR,2021-02-19,0,220,0,220,
ASSAM,LAKHIMPUR,2021-02-20,0,227,0,227,
ASSAM,MAJULI,2021-02-16,0,4,0,4,
ASSAM,MAJULI,2021-02-17,0,4,0,4,
ASSAM,MAJULI,2021-02-18,0,3,0,3,
ASSAM,MAJULI,2021-02-19,2,12,0,14,
ASSAM,MAJULI,2021-02-20,0,12,0,12,
ASSAM,MARIGAON,2021-02-16,0,246,0,246,
ASSAM,MARIGAON,2021-02-17,0,205,0,205,
ASSAM,MARIGAON,2021-02-18,0,111,0,111,
ASSAM,MARIGAON,2021-02-19,0,105,0,105,
ASSAM,MARIGAON,2021-02-20,0,206,0,206,
ASSAM,NAGAON,2021-02-16,0,263,0,263,
ASSAM,NAGAON,2021-02-17,1,1074,0,1075,
ASSAM,NAGAON,2021-02-18,0,539,0,539,
ASSAM,NAGAON,2021-02-19,1,295,0,296,
ASSAM,NAGAON,2021-02-20,0,329,0,329,
ASSAM,NALBARI,2021-02-16,1,35,0,36,
ASSAM,NALBARI,2021-02-17,0,60,0,60,
ASSAM,NALBARI,2021-02-18,0,44,0,44,
ASSAM,NALBARI,2021-02-19,0,73,0,73,
ASSAM,NALBARI,2021-02-20,0,40,0,40,
ASSAM,SIVASAGAR,2021-02-16,0,121,0,121,
ASSAM,SIVASAGAR,2021-02-17,0,97,0,97,
ASSAM,SIVASAGAR,2021-02-18,0,146,0,146,
ASSAM,SIVASAGAR,2021-02-19,0,205,0,205,
ASSAM,SIVASAGAR,2021-02-20,0,191,0,191,
ASSAM,SONITPUR,2021-02-16,2,114,0,116,
ASSAM,SONITPUR,2021-02-17,1,239,0,240,
ASSAM,SONITPUR,2021-02-18,1,693,0,694,
ASSAM,SONITPUR,2021-02-19,2,395,0,397,
ASSAM,SONITPUR,2021-02-20,2,240,0,242,
ASSAM,SOUTH SALMARA MANCACHAR,2021-02-16,0,21,0,21,
ASSAM,SOUTH SALMARA MANCACHAR,2021-02-17,0,25,0,25,
ASSAM,SOUTH SALMARA MANCACHAR,2021-02-18,0,21,0,21,
ASSAM,SOUTH SALMARA MANCACHAR,2021-02-19,0,24,0,24,
ASSAM,SOUTH SALMARA MANCACHAR,2021-02-20,0,41,0,41,
ASSAM,TINSUKIA,2021-02-16,1,90,0,91,
ASSAM,TINSUKIA,2021-02-17,3,398,0,401,
ASSAM,TINSUKIA,2021-02-18,5,294,2,301,
ASSAM,TINSUKIA,2021-02-19,1,264,0,265,
ASSAM,TINSUKIA,2021-02-20,3,223,1,227,
ASSAM,UDALGURI,2021-02-16,0,16,0,16,
ASSAM,UDALGURI,2021-02-17,0,2,0,2,
ASSAM,UDALGURI,2021-02-18,0,22,0,22,
ASSAM,UDALGURI,2021-02-19,0,12,0,12,
ASSAM,UDALGURI,2021-02-20,0,4,0,4,
ASSAM,WEST KARBI ANGLONG,2021-02-16,0,48,0,48,
ASSAM,WEST KARBI ANGLONG,2021-02-17,0,18,0,18,
ASSAM,WEST KARBI ANGLONG,2021-02-18,0,21,0,21,
ASSAM,WEST KARBI ANGLONG,2021-02-19,0,17,0,17,
ASSAM,WEST KARBI ANGLONG,2021-02-20,0,12,0,12,
BIHAR,ARARIA,2021-02-16,1,2297,0,2298,
BIHAR,ARARIA,2021-02-17,2,1604,0,1606,
BIHAR,ARARIA,2021-02-18,0,1500,0,1500,
BIHAR,ARARIA,2021-02-19,0,3239,0,3239,
BIHAR,ARARIA,2021-02-20,5,9841,0,9846,
BIHAR,ARWAL,2021-02-16,0,969,0,969,
BIHAR,ARWAL,2021-02-17,0,1453,9,1462,
BIHAR,ARWAL,2021-02-18,0,1370,4,1374,
BIHAR,ARWAL,2021-02-19,0,552,0,552,
BIHAR,ARWAL,2021-02-20,0,870,7,877,
BIHAR,AURANGABAD,2021-02-16,1,1521,6,1528,
BIHAR,AURANGABAD,2021-02-17,2,746,0,748,
BIHAR,AURANGABAD,2021-02-18,1,999,1,1001,
BIHAR,AURANGABAD,2021-02-19,3,1570,0,1573,
BIHAR,AURANGABAD,2021-02-20,28,13128,0,13156,
BIHAR,BANKA,2021-02-16,0,581,12,593,
BIHAR,BANKA,2021-02-17,3,1462,24,1489,
BIHAR,BANKA,2021-02-18,3,686,0,689,
BIHAR,BANKA,2021-02-19,1,771,59,831,
BIHAR,BANKA,2021-02-20,2,4201,39,4242,
BIHAR,BEGUSARAI,2021-02-16,3,1631,0,1634,
BIHAR,BEGUSARAI,2021-02-17,6,4451,1,4458,
BIHAR,BEGUSARAI,2021-02-18,2,8238,0,8240,
BIHAR,BEGUSARAI,2021-02-19,4,8406,0,8410,
BIHAR,BEGUSARAI,2021-02-20,0,4564,0,4564,
BIHAR,BHAGALPUR,2021-02-16,0,1026,51,1077,
BIHAR,BHAGALPUR,2021-02-17,2,4208,42,4252,
BIHAR,BHAGALPUR,2021-02-18,5,14090,18,14113,
BIHAR,BHAGALPUR,2021-02-19,6,10915,0,10921,
BIHAR,BHAGALPUR,2021-02-20,2,4284,0,4286,
BIHAR,BHOJPUR,2021-02-16,0,396,12,408,
BIHAR,BHOJPUR,2021-02-17,0,410,1,411,
BIHAR,BHOJPUR,2021-02-18,0,518,0,518,
BIHAR,BHOJPUR,2021-02-19,2,2049,21,2072,
BIHAR,BHOJPUR,2021-02-20,4,7094,27,7125,
BIHAR,BUXAR,2021-02-16,1,265,1,267,
BIHAR,BUXAR,2021-02-17,0,693,1,694,
BIHAR,BUXAR,2021-02-18,0,607,8,615,
BIHAR,BUXAR,2021-02-19,1,198,0,199,
BIHAR,BUXAR,2021-02-20,0,2214,0,2214,
BIHAR,DARBHANGA,2021-02-16,1,1177,27,1205,
BIHAR,DARBHANGA,2021-02-17,0,444,37,481,
BIHAR,DARBHANGA,2021-02-18,0,835,12,847,
BIHAR,DARBHANGA,2021-02-19,2,915,0,917,
BIHAR,DARBHANGA,2021-02-20,1,807,0,808,
BIHAR,GAYA,2021-02-16,1,1432,14,1447,
BIHAR,GAYA,2021-02-17,0,1601,50,1651,
BIHAR,GAYA,2021-02-18,1,2890,9,2900,
BIHAR,GAYA,2021-02-19,12,6015,3,6030,
BIHAR,GAYA,2021-02-20,7,16938,1,16946,
BIHAR,GOPALGANJ,2021-02-16,1,384,1,386,
BIHAR,GOPALGANJ,2021-02-17,2,636,0,638,
BIHAR,GOPALGANJ,2021-02-18,4,427,1,432,
BIHAR,GOPALGANJ,2021-02-19,0,903,22,925,
BIHAR,GOPALGANJ,2021-02-20,1,623,2,626,
BIHAR,JAMUI,2021-02-16,0,21,5,26,
BIHAR,JAMUI,2021-02-17,0,330,0,330,
BIHAR,JAMUI,2021-02-18,0,472,1,473,
BIHAR,JAMUI,2021-02-19,0,961,2,963,
BIHAR,JAMUI,2021-02-20,0,944,0,944,
BIHAR,JEHANABAD,2021-02-16,3,914,0,917,
BIHAR,JEHANABAD,2021-02-17,2,3704,0,3706,
BIHAR,JEHANABAD,2021-02-18,3,5776,0,5779,
BIHAR,JEHANABAD,2021-02-19,0,5818,1,5819,
BIHAR,JEHANABAD,2021-02-20,3,8907,238,9148,
BIHAR,KAIMUR (BHABUA),2021-02-16,0,1925,0,1925,
BIHAR,KAIMUR (BHABUA),2021-02-17,1,1976,0,1977,
BIHAR,KAIMUR (BHABUA),2021-02-18,2,2252,0,2254,
BIHAR,KAIMUR (BHABUA),2021-02-19,0,3955,0,3955,
BIHAR,KAIMUR (BHABUA),2021-02-20,2,4874,0,4876,
BIHAR,KATIHAR,2021-02-16,0,612,0,612,
BIHAR,KATIHAR,2021-02-17,0,1059,0,1059,
BIHAR,KATIHAR,2021-02-18,0,341,0,341,
BIHAR,KATIHAR,2021-02-19,0,841,1,842,
BIHAR,KATIHAR,2021-02-20,0,2813,0,2813,
BIHAR,KHAGARIA,2021-02-16,2,924,0,926,
BIHAR,KHAGARIA,2021-02-17,0,3714,2,3716,
BIHAR,KHAGARIA,2021-02-18,0,2875,5,2880,
BIHAR,KHAGARIA,2021-02-19,1,3074,0,3075,
BIHAR,KHAGARIA,2021-02-20,4,4931,0,4935,
BIHAR,KISHANGANJ,2021-02-16,1,800,0,801,
BIHAR,KISHANGANJ,2021-02-17,0,1147,0,1147,
BIHAR,KISHANGANJ,2021-02-18,0,1133,0,1133,
BIHAR,KISHANGANJ,2021-02-19,1,1248,0,1249,
BIHAR,KISHANGANJ,2021-02-20,3,5109,0,5112,
BIHAR,LAKHISARAI,2021-02-16,2,1082,26,1110,
BIHAR,LAKHISARAI,2021-02-17,3,1013,16,1032,
BIHAR,LAKHISARAI,2021-02-18,2,2146,1,2149,
BIHAR,LAKHISARAI,2021-02-19,4,2571,0,2575,
BIHAR,LAKHISARAI,2021-02-20,0,2313,0,2313,
BIHAR,MADHEPURA,2021-02-16,0,681,0,681,
BIHAR,MADHEPURA,2021-02-17,0,1321,0,1321,
BIHAR,MADHEPURA,2021-02-18,0,1028,3,1031,
BIHAR,MADHEPURA,2021-02-19,0,1312,0,1312,
BIHAR,MADHEPURA,2021-02-20,0,3511,0,3511,
BIHAR,MADHUBANI,2021-02-16,0,1389,9,1398,
BIHAR,MADHUBANI,2021-02-17,4,1699,0,1703,
BIHAR,MADHUBANI,2021-02-18,5,2280,37,2322,
BIHAR,MADHUBANI,2021-02-19,3,2295,14,2312,
BIHAR,MADHUBANI,2021-02-20,2,4128,13,4143,
BIHAR,MUNGER,2021-02-16,1,1425,0,1426,
BIHAR,MUNGER,2021-02-17,0,2362,20,2382,
BIHAR,MUNGER,2021-02-18,2,3367,5,3374,
BIHAR,MUNGER,2021-02-19,1,2049,19,2069,
BIHAR,MUNGER,2021-02-20,1,4471,0,4472,
BIHAR,MUZAFFARPUR,2021-02-16,1,1662,0,1663,
BIHAR,MUZAFFARPUR,2021-02-17,0,4095,0,4095,
BIHAR,MUZAFFARPUR,2021-02-18,3,13015,0,13018,
BIHAR,MUZAFFARPUR,2021-02-19,6,18985,1,18992,
BIHAR,MUZAFFARPUR,2021-02-20,7,15883,1,15891,
BIHAR,NALANDA,2021-02-16,0,1887,1,1888,
BIHAR,NALANDA,2021-02-17,0,2598,1,2599,
BIHAR,NALANDA,2021-02-18,1,2080,9,2090,
BIHAR,NALANDA,2021-02-19,1,1390,3,1394,
BIHAR,NALANDA,2021-02-20,2,1898,1,1901,
BIHAR,NAWADA,2021-02-16,2,4731,0,4733,
BIHAR,NAWADA,2021-02-17,1,9751,0,9752,
BIHAR,NAWADA,2021-02-18,9,21201,1,21211,
BIHAR,NAWADA,2021-02-19,10,16315,1,16326,
BIHAR,NAWADA,2021-02-20,12,28724,0,28736,
BIHAR,PASHCHIM CHAMPARAN,2021-02-16,1,511,0,512,
BIHAR,PASHCHIM CHAMPARAN,2021-02-17,0,830,0,830,
BIHAR,PASHCHIM CHAMPARAN,2021-02-18,2,2950,1,2953,
BIHAR,PASHCHIM CHAMPARAN,2021-02-19,4,7519,0,7523,
BIHAR,PASHCHIM CHAMPARAN,2021-02-20,9,9831,0,9840,
BIHAR,PATNA,2021-02-16,12,2281,0,2293,
BIHAR,PATNA,2021-02-17,28,2852,0,2880,
BIHAR,PATNA,2021-02-18,19,3681,2,3702,
BIHAR,PATNA,2021-02-19,9,3153,4,3166,
BIHAR,PATNA,2021-02-20,36,2893,30,2959,
BIHAR,PURBI CHAMPARAN,2021-02-16,0,1952,3,1955,
BIHAR,PURBI CHAMPARAN,2021-02-17,0,1846,0,1846,
BIHAR,PURBI CHAMPARAN,2021-02-18,0,7225,7,7232,
BIHAR,PURBI CHAMPARAN,2021-02-19,2,9010,4,9016,
BIHAR,PURBI CHAMPARAN,2021-02-20,3,7841,3,7847,
BIHAR,PURNIA,2021-02-16,0,627,27,654,
BIHAR,PURNIA,2021-02-17,3,1452,11,1466,
BIHAR,PURNIA,2021-02-18,0,3781,161,3942,
BIHAR,PURNIA,2021-02-19,2,6576,1,6579,
BIHAR,PURNIA,2021-02-20,7,15447,0,15454,
BIHAR,ROHTAS,2021-02-16,0,535,0,535,
BIHAR,ROHTAS,2021-02-17,1,1223,57,1281,
BIHAR,ROHTAS,2021-02-18,1,576,7,584,
BIHAR,ROHTAS,2021-02-19,1,1329,6,1336,
BIHAR,ROHTAS,2021-02-20,1,1753,0,1754,
BIHAR,SAHARSA,2021-02-16,0,325,0,325,
BIHAR,SAHARSA,2021-02-17,0,566,0,566,
BIHAR,SAHARSA,2021-02-18,0,386,0,386,
BIHAR,SAHARSA,2021-02-19,2,4739,0,4741,
BIHAR,SAHARSA,2021-02-20,3,7651,0,7654,
BIHAR,SAMASTIPUR,2021-02-16,0,1136,8,1144,
BIHAR,SAMASTIPUR,2021-02-17,1,5431,11,5443,
BIHAR,SAMASTIPUR,2021-02-18,2,9070,80,9152,
BIHAR,SAMASTIPUR,2021-02-19,2,10579,35,10616,
BIHAR,SAMASTIPUR,2021-02-20,2,8765,19,8786,
BIHAR,SARAN,2021-02-16,1,1060,0,1061,
BIHAR,SARAN,2021-02-17,0,1722,0,1722,
BIHAR,SARAN,2021-02-18,6,4478,0,4484,
BIHAR,SARAN,2021-02-19,2,5277,5,5284,
BIHAR,SARAN,2021-02-20,11,6320,0,6331,
BIHAR,SHEIKHPURA,2021-02-16,0,2,0,2,
BIHAR,SHEIKHPURA,2021-02-17,0,246,0,246,
BIHAR,SHEIKHPURA,2021-02-18,0,142,0,142,
BIHAR,SHEIKHPURA,2021-02-19,0,110,1,111,
BIHAR,SHEIKHPURA,2021-02-20,0,180,2,182,
BIHAR,SHEOHAR,2021-02-16,6,1329,0,1335,
BIHAR,SHEOHAR,2021-02-17,1,1929,0,1930,
BIHAR,SHEOHAR,2021-02-18,0,3394,0,3394,
BIHAR,SHEOHAR,2021-02-19,1,2236,0,2237,
BIHAR,SHEOHAR,2021-02-20,0,357,0,357,
BIHAR,SITAMARHI,2021-02-16,3,164,1,168,
BIHAR,SITAMARHI,2021-02-17,0,664,0,664,
BIHAR,SITAMARHI,2021-02-18,0,607,1,608,
BIHAR,SITAMARHI,2021-02-19,2,1287,0,1289,
BIHAR,SITAMARHI,2021-02-20,2,3604,3,3609,
BIHAR,SIWAN,2021-02-16,0,801,0,801,
BIHAR,SIWAN,2021-02-17,2,1447,1,1450,
BIHAR,SIWAN,2021-02-18,0,916,0,916,
BIHAR,SIWAN,2021-02-19,1,3222,5,3228,
BIHAR,SIWAN,2021-02-20,2,8780,1,8783,
BIHAR,SUPAUL,2021-02-16,0,1294,7,1301,
BIHAR,SUPAUL,2021-02-17,0,2342,56,2398,
BIHAR,SUPAUL,2021-02-18,0,3060,0,3060,
BIHAR,SUPAUL,2021-02-19,2,2850,1,2853,
BIHAR,SUPAUL,2021-02-20,0,5285,22,5307,
BIHAR,VAISHALI,2021-02-16,4,1743,340,2087,
BIHAR,VAISHALI,2021-02-17,1,2161,0,2162,
BIHAR,VAISHALI,2021-02-18,0,2265,20,2285,
BIHAR,VAISHALI,2021-02-19,0,1150,55,1205,
BIHAR,VAISHALI,2021-02-20,2,6447,64,6513,
CHANDIGARH,CHANDIGARH,2021-02-16,26,1393,17,1436,
CHANDIGARH,CHANDIGARH,2021-02-17,23,1317,9,1349,
CHANDIGARH,CHANDIGARH,2021-02-18,33,1734,10,1777,
CHANDIGARH,CHANDIGARH,2021-02-19,28,1552,5,1585,
CHANDIGARH,CHANDIGARH,2021-02-20,39,1389,11,1439,
CHHATTISGARH,BALOD,2021-02-16,3,858,0,861,
CHHATTISGARH,BALOD,2021-02-17,2,1004,0,1006,
CHHATTISGARH,BALOD,2021-02-18,3,954,0,957,
CHHATTISGARH,BALOD,2021-02-19,5,1032,0,1037,
CHHATTISGARH,BALOD,2021-02-20,1,892,0,893,
CHHATTISGARH,BALODA BAZAR,2021-02-16,10,467,1,478,
CHHATTISGARH,BALODA BAZAR,2021-02-17,5,510,0,515,
CHHATTISGARH,BALODA BAZAR,2021-02-18,6,294,6,306,
CHHATTISGARH,BALODA BAZAR,2021-02-19,7,586,2,595,
CHHATTISGARH,BALODA BAZAR,2021-02-20,9,402,4,415,
CHHATTISGARH,BALRAMPUR,2021-02-16,4,338,0,342,
CHHATTISGARH,BALRAMPUR,2021-02-17,1,194,0,195,
CHHATTISGARH,BALRAMPUR,2021-02-18,1,269,0,270,
CHHATTISGARH,BALRAMPUR,2021-02-19,1,238,0,239,
CHHATTISGARH,BALRAMPUR,2021-02-20,3,222,0,225,
CHHATTISGARH,BASTAR,2021-02-16,5,1169,0,1174,
CHHATTISGARH,BASTAR,2021-02-17,4,906,0,910,
CHHATTISGARH,BASTAR,2021-02-18,4,1249,0,1253,
CHHATTISGARH,BASTAR,2021-02-19,7,1361,0,1368,
CHHATTISGARH,BASTAR,2021-02-20,4,1591,0,1595,
CHHATTISGARH,BEMETARA,2021-02-16,4,418,0,422,
CHHATTISGARH,BEMETARA,2021-02-17,2,405,0,407,
CHHATTISGARH,BEMETARA,2021-02-18,0,442,0,442,
CHHATTISGARH,BEMETARA,2021-02-19,1,401,0,402,
CHHATTISGARH,BEMETARA,2021-02-20,2,537,0,539,
CHHATTISGARH,BIJAPUR,2021-02-16,0,150,0,150,
CHHATTISGARH,BIJAPUR,2021-02-17,0,88,0,88,
CHHATTISGARH,BIJAPUR,2021-02-18,0,39,0,39,
CHHATTISGARH,BIJAPUR,2021-02-19,0,118,0,118,
CHHATTISGARH,BIJAPUR,2021-02-20,0,142,0,142,
CHHATTISGARH,BILASPUR,2021-02-16,9,463,2,474,
CHHATTISGARH,BILASPUR,2021-02-17,14,548,5,567,
CHHATTISGARH,BILASPUR,2021-02-18,18,917,10,945,
CHHATTISGARH,BILASPUR,2021-02-19,12,911,1,924,
CHHATTISGARH,BILASPUR,2021-02-20,18,937,13,968,
CHHATTISGARH,DANTEWADA,2021-02-16,0,329,0,329,
CHHATTISGARH,DANTEWADA,2021-02-17,1,243,0,244,
CHHATTISGARH,DANTEWADA,2021-02-18,2,375,0,377,
CHHATTISGARH,DANTEWADA,2021-02-19,1,462,0,463,
CHHATTISGARH,DANTEWADA,2021-02-20,0,125,0,125,
CHHATTISGARH,DHAMTARI,2021-02-16,10,722,13,745,
CHHATTISGARH,DHAMTARI,2021-02-17,14,518,8,540,
CHHATTISGARH,DHAMTARI,2021-02-18,3,675,14,692,
CHHATTISGARH,DHAMTARI,2021-02-19,7,526,1,534,
CHHATTISGARH,DHAMTARI,2021-02-20,4,463,2,469,
CHHATTISGARH,DURG,2021-02-16,60,1043,5,1108,
CHHATTISGARH,DURG,2021-02-17,71,1101,0,1172,
CHHATTISGARH,DURG,2021-02-18,79,1171,3,1253,
CHHATTISGARH,DURG,2021-02-19,47,1034,1,1082,
CHHATTISGARH,DURG,2021-02-20,68,780,0,848,
CHHATTISGARH,GARIYABAND,2021-02-16,3,266,15,284,
CHHATTISGARH,GARIYABAND,2021-02-17,10,272,8,290,
CHHATTISGARH,GARIYABAND,2021-02-18,14,329,5,348,
CHHATTISGARH,GARIYABAND,2021-02-19,5,195,3,203,
CHHATTISGARH,GARIYABAND,2021-02-20,14,341,5,360,
CHHATTISGARH,GAURELLA PENDRA MARWAHI,2021-02-16,0,256,0,256,
CHHATTISGARH,GAURELLA PENDRA MARWAHI,2021-02-17,1,77,0,78,
CHHATTISGARH,GAURELLA PENDRA MARWAHI,2021-02-18,2,330,2,334,
CHHATTISGARH,GAURELLA PENDRA MARWAHI,2021-02-19,0,619,0,619,
CHHATTISGARH,GAURELLA PENDRA MARWAHI,2021-02-20,1,286,26,313,
CHHATTISGARH,JANJGIR CHAMPA,2021-02-16,1,1522,1,1524,
CHHATTISGARH,JANJGIR CHAMPA,2021-02-17,2,1477,0,1479,
CHHATTISGARH,JANJGIR CHAMPA,2021-02-18,3,1703,1,1707,
CHHATTISGARH,JANJGIR CHAMPA,2021-02-19,4,1943,0,1947,
CHHATTISGARH,JANJGIR CHAMPA,2021-02-20,4,1461,2,1467,
CHHATTISGARH,JASHPUR,2021-02-16,10,436,0,446,
CHHATTISGARH,JASHPUR,2021-02-17,8,103,0,111,
CHHATTISGARH,JASHPUR,2021-02-18,8,371,0,379,
CHHATTISGARH,JASHPUR,2021-02-19,7,292,0,299,
CHHATTISGARH,JASHPUR,2021-02-20,7,238,0,245,
CHHATTISGARH,KABIRDHAM,2021-02-16,2,299,0,301,
CHHATTISGARH,KABIRDHAM,2021-02-17,2,159,4,165,
CHHATTISGARH,KABIRDHAM,2021-02-18,0,418,6,424,
CHHATTISGARH,KABIRDHAM,2021-02-19,2,71,7,80,
CHHATTISGARH,KABIRDHAM,2021-02-20,1,490,6,497,
CHHATTISGARH,KANKER,2021-02-16,4,498,0,502,
CHHATTISGARH,KANKER,2021-02-17,1,584,0,585,
CHHATTISGARH,KANKER,2021-02-18,3,502,0,505,
CHHATTISGARH,KANKER,2021-02-19,3,524,0,527,
CHHATTISGARH,KANKER,2021-02-20,1,484,0,485,
CHHATTISGARH,KONDAGAON,2021-02-16,0,670,0,670,
CHHATTISGARH,KONDAGAON,2021-02-17,3,1009,0,1012,
CHHATTISGARH,KONDAGAON,2021-02-18,0,457,0,457,
CHHATTISGARH,KONDAGAON,2021-02-19,1,736,0,737,
CHHATTISGARH,KONDAGAON,2021-02-20,2,583,0,585,
CHHATTISGARH,KORBA,2021-02-16,9,685,0,694,
CHHATTISGARH,KORBA,2021-02-17,10,1174,0,1184,
CHHATTISGARH,KORBA,2021-02-18,1,1037,3,1041,
CHHATTISGARH,KORBA,2021-02-19,12,988,0,1000,
CHHATTISGARH,KORBA,2021-02-20,10,822,0,832,
CHHATTISGARH,KOREA,2021-02-16,2,431,0,433,
CHHATTISGARH,KOREA,2021-02-17,3,745,0,748,
CHHATTISGARH,KOREA,2021-02-18,18,518,0,536,
CHHATTISGARH,KOREA,2021-02-19,12,885,0,897,
CHHATTISGARH,KOREA,2021-02-20,12,651,5,668,
CHHATTISGARH,MAHASAMUND,2021-02-16,10,1361,6,1377,
CHHATTISGARH,MAHASAMUND,2021-02-17,15,1184,3,1202,
CHHATTISGARH,MAHASAMUND,2021-02-18,5,1412,5,1422,
CHHATTISGARH,MAHASAMUND,2021-02-19,11,1111,2,1124,
CHHATTISGARH,MAHASAMUND,2021-02-20,38,1372,9,1419,
CHHATTISGARH,MUNGELI,2021-02-16,1,644,1,646,
CHHATTISGARH,MUNGELI,2021-02-17,2,277,0,279,
CHHATTISGARH,MUNGELI,2021-02-18,2,448,0,450,
CHHATTISGARH,MUNGELI,2021-02-19,0,456,1,457,
CHHATTISGARH,MUNGELI,2021-02-20,0,232,0,232,
CHHATTISGARH,NARAYANPUR,2021-02-16,0,140,0,140,
CHHATTISGARH,NARAYANPUR,2021-02-17,1,67,0,68,
CHHATTISGARH,NARAYANPUR,2021-02-18,0,247,0,247,
CHHATTISGARH,NARAYANPUR,2021-02-19,1,164,0,165,
CHHATTISGARH,NARAYANPUR,2021-02-20,0,125,0,125,
CHHATTISGARH,RAIGARH,2021-02-16,14,930,2,946,
CHHATTISGARH,RAIGARH,2021-02-17,8,837,1,846,
CHHATTISGARH,RAIGARH,2021-02-18,21,920,0,941,
CHHATTISGARH,RAIGARH,2021-02-19,15,1032,3,1050,
CHHATTISGARH,RAIGARH,2021-02-20,7,941,0,948,
CHHATTISGARH,RAIPUR,2021-02-16,81,2513,30,2624,
CHHATTISGARH,RAIPUR,2021-02-17,129,2119,14,2262,
CHHATTISGARH,RAIPUR,2021-02-18,86,2344,12,2442,
CHHATTISGARH,RAIPUR,2021-02-19,112,2179,3,2294,
CHHATTISGARH,RAIPUR,2021-02-20,89,1999,13,2101,
CHHATTISGARH,RAJNANDGAON,2021-02-16,18,634,0,652,
CHHATTISGARH,RAJNANDGAON,2021-02-17,15,863,4,882,
CHHATTISGARH,RAJNANDGAON,2021-02-18,20,894,2,916,
CHHATTISGARH,RAJNANDGAON,2021-02-19,13,949,0,962,
CHHATTISGARH,RAJNANDGAON,2021-02-20,14,889,12,915,
CHHATTISGARH,SUKMA,2021-02-16,0,151,0,151,
CHHATTISGARH,SUKMA,2021-02-17,0,37,0,37,
CHHATTISGARH,SUKMA,2021-02-18,0,272,0,272,
CHHATTISGARH,SUKMA,2021-02-19,0,111,0,111,
CHHATTISGARH,SUKMA,2021-02-20,1,115,0,116,
CHHATTISGARH,SURAJPUR,2021-02-16,9,888,0,897,
CHHATTISGARH,SURAJPUR,2021-02-17,7,785,2,794,
CHHATTISGARH,SURAJPUR,2021-02-18,4,1103,0,1107,
CHHATTISGARH,SURAJPUR,2021-02-19,5,691,0,696,
CHHATTISGARH,SURAJPUR,2021-02-20,3,822,1,826,
CHHATTISGARH,SURGUJA,2021-02-16,13,380,0,393,
CHHATTISGARH,SURGUJA,2021-02-17,16,521,0,537,
CHHATTISGARH,SURGUJA,2021-02-18,7,575,1,583,
CHHATTISGARH,SURGUJA,2021-02-19,10,555,0,565,
CHHATTISGARH,SURGUJA,2021-02-20,11,552,0,563,
DADRA AND NAGAR HAVELI,DADRA AND NAGAR HAVELI,2021-02-16,0,215,0,215,
DADRA AND NAGAR HAVELI,DADRA AND NAGAR HAVELI,2021-02-17,0,210,0,210,
DADRA AND NAGAR HAVELI,DADRA AND NAGAR HAVELI,2021-02-18,0,360,0,360,
DADRA AND NAGAR HAVELI,DADRA AND NAGAR HAVELI,2021-02-19,0,476,0,476,
DADRA AND NAGAR HAVELI,DADRA AND NAGAR HAVELI,2021-02-20,0,445,0,445,
DAMAN AND DIU,DAMAN,2021-02-16,0,83,0,83,
DAMAN AND DIU,DAMAN,2021-02-17,2,87,0,89,
DAMAN AND DIU,DAMAN,2021-02-18,0,105,0,105,
DAMAN AND DIU,DAMAN,2021-02-19,0,107,0,107,
DAMAN AND DIU,DAMAN,2021-02-20,0,83,0,83,
DAMAN AND DIU,DIU,2021-02-16,0,26,0,26,
DAMAN AND DIU,DIU,2021-02-17,0,23,0,23,
DAMAN AND DIU,DIU,2021-02-18,0,28,0,28,
DAMAN AND DIU,DIU,2021-02-19,0,46,0,46,
DAMAN AND DIU,DIU,2021-02-20,0,18,0,18,
DELHI,CENTRAL,2021-02-16,14,4458,19,4491,
DELHI,CENTRAL,2021-02-17,11,4111,20,4142,
DELHI,CENTRAL,2021-02-18,6,3393,5,3404,
DELHI,CENTRAL,2021-02-19,10,6174,63,6247,
DELHI,CENTRAL,2021-02-20,13,4308,72,4393,
DELHI,EAST,2021-02-16,11,4125,17,4153,
DELHI,EAST,2021-02-17,8,3252,2,3262,
DELHI,EAST,2021-02-18,15,3583,11,3609,
DELHI,EAST,2021-02-19,11,3163,3,3177,
DELHI,EAST,2021-02-20,5,3954,7,3966,
DELHI,NEW DELHI,2021-02-16,16,5540,4,5560,
DELHI,NEW DELHI,2021-02-17,25,5130,12,5167,
DELHI,NEW DELHI,2021-02-18,26,6465,74,6565,
DELHI,NEW DELHI,2021-02-19,23,5792,10,5825,
DELHI,NEW DELHI,2021-02-20,19,5501,22,5542,
DELHI,NORTH,2021-02-16,4,7034,15,7053,
DELHI,NORTH,2021-02-17,6,7493,2,7501,
DELHI,NORTH,2021-02-18,9,7554,10,7573,
DELHI,NORTH,2021-02-19,5,6711,10,6726,
DELHI,NORTH,2021-02-20,4,7360,99,7463,
DELHI,NORTH EAST,2021-02-16,3,3057,150,3210,
DELHI,NORTH EAST,2021-02-17,1,6491,29,6521,
DELHI,NORTH EAST,2021-02-18,2,5112,31,5145,
DELHI,NORTH EAST,2021-02-19,4,4432,47,4483,
DELHI,NORTH EAST,2021-02-20,5,5193,17,5215,
DELHI,NORTH WEST,2021-02-16,11,4910,13,4934,
DELHI,NORTH WEST,2021-02-17,14,4320,9,4343,
DELHI,NORTH WEST,2021-02-18,16,5530,35,5581,
DELHI,NORTH WEST,2021-02-19,20,5053,2,5075,
DELHI,NORTH WEST,2021-02-20,27,6061,42,6130,
DELHI,SHAHDARA,2021-02-16,8,7926,8,7942,
DELHI,SHAHDARA,2021-02-17,5,6206,3,6214,
DELHI,SHAHDARA,2021-02-18,6,5477,18,5501,
DELHI,SHAHDARA,2021-02-19,5,7204,39,7248,
DELHI,SHAHDARA,2021-02-20,4,6961,15,6980,
DELHI,SOUTH,2021-02-16,36,5009,17,5062,
DELHI,SOUTH,2021-02-17,37,6145,37,6219,
DELHI,SOUTH,2021-02-18,30,5696,16,5742,
DELHI,SOUTH,2021-02-19,29,5683,43,5755,
DELHI,SOUTH,2021-02-20,32,5708,68,5808,
DELHI,SOUTH EAST,2021-02-16,4,5080,2,5086,
DELHI,SOUTH EAST,2021-02-17,10,4562,4,4576,
DELHI,SOUTH EAST,2021-02-18,10,5205,3,5218,
DELHI,SOUTH EAST,2021-02-19,8,3389,5,3402,
DELHI,SOUTH EAST,2021-02-20,10,5308,20,5338,
DELHI,SOUTH WEST,2021-02-16,33,3113,10,3156,
DELHI,SOUTH WEST,2021-02-17,19,3451,3,3473,
DELHI,SOUTH WEST,2021-02-18,18,3917,7,3942,
DELHI,SOUTH WEST,2021-02-19,23,3359,2,3384,
DELHI,SOUTH WEST,2021-02-20,31,3992,6,4029,
DELHI,WEST,2021-02-16,19,9149,3,9171,
DELHI,WEST,2021-02-17,23,8820,176,9019,
DELHI,WEST,2021-02-18,27,8431,63,8521,
DELHI,WEST,2021-02-19,28,10669,28,10725,
DELHI,WEST,2021-02-20,14,8907,18,8939,
GOA,NORTH GOA,2021-02-16,31,835,2,868,
GOA,NORTH GOA,2021-02-17,23,699,0,722,
GOA,NORTH GOA,2021-02-18,29,726,3,758,
GOA,NORTH GOA,2021-02-19,22,918,0,940,
GOA,NORTH GOA,2021-02-20,28,671,4,703,
GOA,SOUTH GOA,2021-02-16,27,849,1,877,
GOA,SOUTH GOA,2021-02-17,28,828,0,856,
GOA,SOUTH GOA,2021-02-18,16,733,0,749,
GOA,SOUTH GOA,2021-02-19,30,897,0,927,
GOA,SOUTH GOA,2021-02-20,24,796,0,820,
GUJARAT,AHMADABAD,2021-02-16,195,3818,62,4075,
GUJARAT,AHMADABAD,2021-02-17,130,4328,33,4491,
GUJARAT,AHMADABAD,2021-02-18,75,2743,122,2940,
GUJARAT,AHMADABAD,2021-02-19,137,2957,23,3117,
GUJARAT,AHMADABAD,2021-02-20,251,3555,98,3904,
GUJARAT,AMRELI,2021-02-16,3,717,3,723,
GUJARAT,AMRELI,2021-02-17,3,1058,16,1077,
GUJARAT,AMRELI,2021-02-18,5,900,0,905,
GUJARAT,AMRELI,2021-02-19,1,1028,0,1029,
GUJARAT,AMRELI,2021-02-20,19,522,9,550,
GUJARAT,ANAND,2021-02-16,9,258,0,267,
GUJARAT,ANAND,2021-02-17,15,270,3,288,
GUJARAT,ANAND,2021-02-18,7,269,48,324,
GUJARAT,ANAND,2021-02-19,17,177,1,195,
GUJARAT,ANAND,2021-02-20,6,243,36,285,
GUJARAT,ARVALLI,2021-02-16,3,288,0,291,
GUJARAT,ARVALLI,2021-02-17,9,215,0,224,
GUJARAT,ARVALLI,2021-02-18,44,354,3,401,
GUJARAT,ARVALLI,2021-02-19,1,300,0,301,
GUJARAT,ARVALLI,2021-02-20,0,99,1,100,
GUJARAT,BANAS KANTHA,2021-02-16,6,180,0,186,
GUJARAT,BANAS KANTHA,2021-02-17,6,216,0,222,
GUJARAT,BANAS KANTHA,2021-02-18,8,150,1,159,
GUJARAT,BANAS KANTHA,2021-02-19,1,181,0,182,
GUJARAT,BANAS KANTHA,2021-02-20,0,121,0,121,
GUJARAT,BHARUCH,2021-02-16,12,302,0,314,
GUJARAT,BHARUCH,2021-02-17,7,336,1,344,
GUJARAT,BHARUCH,2021-02-18,9,322,3,334,
GUJARAT,BHARUCH,2021-02-19,3,413,1,417,
GUJARAT,BHARUCH,2021-02-20,5,504,0,509,
GUJARAT,BHAVNAGAR,2021-02-16,3,511,0,514,
GUJARAT,BHAVNAGAR,2021-02-17,0,605,0,605,
GUJARAT,BHAVNAGAR,2021-02-18,8,407,0,415,
GUJARAT,BHAVNAGAR,2021-02-19,12,594,0,606,
GUJARAT,BHAVNAGAR,2021-02-20,12,361,0,373,
GUJARAT,BOTAD,2021-02-16,0,331,0,331,
GUJARAT,BOTAD,2021-02-17,0,267,0,267,
GUJARAT,BOTAD,2021-02-18,0,206,0,206,
GUJARAT,BOTAD,2021-02-19,0,130,0,130,
GUJARAT,BOTAD,2021-02-20,0,211,0,211,
GUJARAT,CHHOTAUDEPUR,2021-02-16,1,192,1,194,
GUJARAT,CHHOTAUDEPUR,2021-02-17,0,123,0,123,
GUJARAT,CHHOTAUDEPUR,2021-02-18,0,282,0,282,
GUJARAT,CHHOTAUDEPUR,2021-02-19,4,118,0,122,
GUJARAT,CHHOTAUDEPUR,2021-02-20,1,72,0,73,
GUJARAT,DANG,2021-02-16,0,64,0,64,
GUJARAT,DANG,2021-02-17,0,56,0,56,
GUJARAT,DANG,2021-02-18,0,62,0,62,
GUJARAT,DANG,2021-02-19,0,74,0,74,
GUJARAT,DANG,2021-02-20,0,46,0,46,
GUJARAT,DEVBHUMI DWARKA,2021-02-16,2,187,0,189,
GUJARAT,DEVBHUMI DWARKA,2021-02-17,0,212,0,212,
GUJARAT,DEVBHUMI DWARKA,2021-02-18,3,156,1,160,
GUJARAT,DEVBHUMI DWARKA,2021-02-19,0,155,0,155,
GUJARAT,DEVBHUMI DWARKA,2021-02-20,8,62,1,71,
GUJARAT,DOHAD,2021-02-16,4,469,0,473,
GUJARAT,DOHAD,2021-02-17,5,290,0,295,
GUJARAT,DOHAD,2021-02-18,1,390,0,391,
GUJARAT,DOHAD,2021-02-19,2,282,4,288,
GUJARAT,DOHAD,2021-02-20,5,94,0,99,
GUJARAT,GANDHINAGAR,2021-02-16,7,400,1,408,
GUJARAT,GANDHINAGAR,2021-02-17,8,742,3,753,
GUJARAT,GANDHINAGAR,2021-02-18,10,489,4,503,
GUJARAT,GANDHINAGAR,2021-02-19,8,508,1,517,
GUJARAT,GANDHINAGAR,2021-02-20,8,420,12,440,
GUJARAT,GIR SOMNATH,2021-02-16,7,193,0,200,
GUJARAT,GIR SOMNATH,2021-02-17,5,336,0,341,
GUJARAT,GIR SOMNATH,2021-02-18,4,243,0,247,
GUJARAT,GIR SOMNATH,2021-02-19,7,197,0,204,
GUJARAT,GIR SOMNATH,2021-02-20,8,145,0,153,
GUJARAT,JAMNAGAR,2021-02-16,5,1185,1,1191,
GUJARAT,JAMNAGAR,2021-02-17,11,703,0,714,
GUJARAT,JAMNAGAR,2021-02-18,14,1095,11,1120,
GUJARAT,JAMNAGAR,2021-02-19,8,990,0,998,
GUJARAT,JAMNAGAR,2021-02-20,11,741,0,752,
GUJARAT,JUNAGADH,2021-02-16,3,516,1,520,
GUJARAT,JUNAGADH,2021-02-17,6,470,0,476,
GUJARAT,JUNAGADH,2021-02-18,4,394,0,398,
GUJARAT,JUNAGADH,2021-02-19,10,327,0,337,
GUJARAT,JUNAGADH,2021-02-20,4,174,1,179,
GUJARAT,KACHCHH,2021-02-16,8,309,5,322,
GUJARAT,KACHCHH,2021-02-17,26,411,3,440,
GUJARAT,KACHCHH,2021-02-18,26,349,10,385,
GUJARAT,KACHCHH,2021-02-19,17,414,9,440,
GUJARAT,KACHCHH,2021-02-20,21,374,4,399,
GUJARAT,KHEDA,2021-02-16,14,350,2,366,
GUJARAT,KHEDA,2021-02-17,8,392,1,401,
GUJARAT,KHEDA,2021-02-18,6,1002,9,1017,
GUJARAT,KHEDA,2021-02-19,29,679,0,708,
GUJARAT,KHEDA,2021-02-20,10,305,4,319,
GUJARAT,MAHESANA,2021-02-16,5,189,0,194,
GUJARAT,MAHESANA,2021-02-17,9,257,0,266,
GUJARAT,MAHESANA,2021-02-18,5,386,0,391,
GUJARAT,MAHESANA,2021-02-19,2,203,0,205,
GUJARAT,MAHESANA,2021-02-20,2,292,2,296,
GUJARAT,MAHISAGAR,2021-02-16,4,413,0,417,
GUJARAT,MAHISAGAR,2021-02-17,0,242,35,277,
GUJARAT,MAHISAGAR,2021-02-18,4,204,1,209,
GUJARAT,MAHISAGAR,2021-02-19,4,327,20,351,
GUJARAT,MAHISAGAR,2021-02-20,3,395,0,398,
GUJARAT,MORBI,2021-02-16,0,238,0,238,
GUJARAT,MORBI,2021-02-17,2,192,0,194,
GUJARAT,MORBI,2021-02-18,1,323,0,324,
GUJARAT,MORBI,2021-02-19,3,234,1,238,
GUJARAT,MORBI,2021-02-20,3,137,0,140,
GUJARAT,NARMADA,2021-02-16,1,43,0,44,
GUJARAT,NARMADA,2021-02-17,1,47,0,48,
GUJARAT,NARMADA,2021-02-18,3,27,0,30,
GUJARAT,NARMADA,2021-02-19,0,24,3,27,
GUJARAT,NARMADA,2021-02-20,2,18,0,20,
GUJARAT,NAVSARI,2021-02-16,3,223,1,227,
GUJARAT,NAVSARI,2021-02-17,2,285,0,287,
GUJARAT,NAVSARI,2021-02-18,3,278,0,281,
GUJARAT,NAVSARI,2021-02-19,1,315,0,316,
GUJARAT,NAVSARI,2021-02-20,2,264,2,268,
GUJARAT,PANCH MAHALS,2021-02-16,7,286,1,294,
GUJARAT,PANCH MAHALS,2021-02-17,4,394,0,398,
GUJARAT,PANCH MAHALS,2021-02-18,8,340,0,348,
GUJARAT,PANCH MAHALS,2021-02-19,11,279,2,292,
GUJARAT,PANCH MAHALS,2021-02-20,3,190,0,193,
GUJARAT,PATAN,2021-02-16,2,517,0,519,
GUJARAT,PATAN,2021-02-17,2,510,0,512,
GUJARAT,PATAN,2021-02-18,2,396,2,400,
GUJARAT,PATAN,2021-02-19,3,481,2,486,
GUJARAT,PATAN,2021-02-20,0,347,0,347,
GUJARAT,PORBANDAR,2021-02-16,0,645,0,645,
GUJARAT,PORBANDAR,2021-02-17,0,325,0,325,
GUJARAT,PORBANDAR,2021-02-18,1,417,0,418,
GUJARAT,PORBANDAR,2021-02-19,0,402,0,402,
GUJARAT,PORBANDAR,2021-02-20,1,424,0,425,
GUJARAT,RAJKOT,2021-02-16,63,1828,13,1904,
GUJARAT,RAJKOT,2021-02-17,26,1627,50,1703,
GUJARAT,RAJKOT,2021-02-18,36,1623,28,1687,
GUJARAT,RAJKOT,2021-02-19,57,1433,17,1507,
GUJARAT,RAJKOT,2021-02-20,41,1126,20,1187,
GUJARAT,SABAR KANTHA,2021-02-16,1,163,3,167,
GUJARAT,SABAR KANTHA,2021-02-17,4,125,0,129,
GUJARAT,SABAR KANTHA,2021-02-18,1,153,2,156,
GUJARAT,SABAR KANTHA,2021-02-19,8,161,5,174,
GUJARAT,SABAR KANTHA,2021-02-20,3,44,17,64,
GUJARAT,SURAT,2021-02-16,36,1557,8,1601,
GUJARAT,SURAT,2021-02-17,35,1426,6,1467,
GUJARAT,SURAT,2021-02-18,48,1764,7,1819,
GUJARAT,SURAT,2021-02-19,49,1348,3,1400,
GUJARAT,SURAT,2021-02-20,23,1320,3,1346,
GUJARAT,SURENDRANAGAR,2021-02-16,0,472,0,472,
GUJARAT,SURENDRANAGAR,2021-02-17,1,563,0,564,
GUJARAT,SURENDRANAGAR,2021-02-18,1,401,0,402,
GUJARAT,SURENDRANAGAR,2021-02-19,2,612,0,614,
GUJARAT,SURENDRANAGAR,2021-02-20,2,250,0,252,
GUJARAT,TAPI,2021-02-16,4,248,0,252,
GUJARAT,TAPI,2021-02-17,8,180,5,193,
GUJARAT,TAPI,2021-02-18,4,328,1,333,
GUJARAT,TAPI,2021-02-19,2,382,0,384,
GUJARAT,TAPI,2021-02-20,5,165,0,170,
GUJARAT,VADODARA,2021-02-16,58,1232,39,1329,
GUJARAT,VADODARA,2021-02-17,45,1180,32,1257,
GUJARAT,VADODARA,2021-02-18,37,1144,59,1240,
GUJARAT,VADODARA,2021-02-19,64,1387,59,1510,
GUJARAT,VADODARA,2021-02-20,46,1212,45,1303,
GUJARAT,VALSAD,2021-02-16,2,505,1,508,
GUJARAT,VALSAD,2021-02-17,0,495,0,495,
GUJARAT,VALSAD,2021-02-18,5,416,0,421,
GUJARAT,VALSAD,2021-02-19,3,497,0,500,
GUJARAT,VALSAD,2021-02-20,6,301,0,307,
HARYANA,AMBALA,2021-02-16,7,594,22,623,
HARYANA,AMBALA,2021-02-17,19,786,40,845,
HARYANA,AMBALA,2021-02-18,17,1029,30,1076,
HARYANA,AMBALA,2021-02-19,15,829,6,850,
HARYANA,AMBALA,2021-02-20,19,618,13,650,
HARYANA,BHIWANI,2021-02-16,2,561,2,565,
HARYANA,BHIWANI,2021-02-17,1,527,0,528,
HARYANA,BHIWANI,2021-02-18,3,424,2,429,
HARYANA,BHIWANI,2021-02-19,1,207,0,208,
HARYANA,BHIWANI,2021-02-20,0,994,0,994,
HARYANA,CHARKI DADRI,2021-02-16,0,139,0,139,
HARYANA,CHARKI DADRI,2021-02-17,0,362,0,362,
HARYANA,CHARKI DADRI,2021-02-18,1,686,2,689,
HARYANA,CHARKI DADRI,2021-02-19,2,328,0,330,
HARYANA,CHARKI DADRI,2021-02-20,0,376,0,376,
HARYANA,FARIDABAD,2021-02-16,18,991,5,1014,
HARYANA,FARIDABAD,2021-02-17,17,1054,0,1071,
HARYANA,FARIDABAD,2021-02-18,13,676,2,691,
HARYANA,FARIDABAD,2021-02-19,10,938,5,953,
HARYANA,FARIDABAD,2021-02-20,12,796,1,809,
HARYANA,FATEHABAD,2021-02-16,0,59,1,60,
HARYANA,FATEHABAD,2021-02-17,0,178,0,178,
HARYANA,FATEHABAD,2021-02-18,0,358,1,359,
HARYANA,FATEHABAD,2021-02-19,0,140,0,140,
HARYANA,FATEHABAD,2021-02-20,0,99,0,99,
HARYANA,GURUGRAM,2021-02-16,31,3398,19,3448,
HARYANA,GURUGRAM,2021-02-17,30,2616,15,2661,
HARYANA,GURUGRAM,2021-02-18,36,3310,4,3350,
HARYANA,GURUGRAM,2021-02-19,32,2670,14,2716,
HARYANA,GURUGRAM,2021-02-20,50,3000,6,3056,
HARYANA,HISAR,2021-02-16,1,721,1,723,
HARYANA,HISAR,2021-02-17,4,1135,2,1141,
HARYANA,HISAR,2021-02-18,1,1267,5,1273,
HARYANA,HISAR,2021-02-19,0,1680,1,1681,
HARYANA,HISAR,2021-02-20,8,1485,3,1496,
HARYANA,JHAJJAR,2021-02-16,0,1148,3,1151,
HARYANA,JHAJJAR,2021-02-17,0,1366,0,1366,
HARYANA,JHAJJAR,2021-02-18,0,1443,2,1445,
HARYANA,JHAJJAR,2021-02-19,0,880,0,880,
HARYANA,JHAJJAR,2021-02-20,0,1814,1,1815,
HARYANA,JIND,2021-02-16,0,171,2,173,
HARYANA,JIND,2021-02-17,0,268,0,268,
HARYANA,JIND,2021-02-18,4,192,0,196,
HARYANA,JIND,2021-02-19,0,619,10,629,
HARYANA,JIND,2021-02-20,1,368,4,373,
HARYANA,KAITHAL,2021-02-16,5,235,4,244,
HARYANA,KAITHAL,2021-02-17,6,425,1,432,
HARYANA,KAITHAL,2021-02-18,2,325,0,327,
HARYANA,KAITHAL,2021-02-19,3,469,0,472,
HARYANA,KAITHAL,2021-02-20,2,326,2,330,
HARYANA,KARNAL,2021-02-16,3,181,4,188,
HARYANA,KARNAL,2021-02-17,23,681,0,704,
HARYANA,KARNAL,2021-02-18,1,1137,3,1141,
HARYANA,KARNAL,2021-02-19,30,1000,12,1042,
HARYANA,KARNAL,2021-02-20,25,1156,11,1192,
HARYANA,KURUKSHETRA,2021-02-16,6,730,3,739,
HARYANA,KURUKSHETRA,2021-02-17,10,1137,1,1148,
HARYANA,KURUKSHETRA,2021-02-18,10,1157,2,1169,
HARYANA,KURUKSHETRA,2021-02-19,8,1554,5,1567,
HARYANA,KURUKSHETRA,2021-02-20,17,1249,1,1267,
HARYANA,MAHENDRAGARH,2021-02-16,0,127,0,127,
HARYANA,MAHENDRAGARH,2021-02-17,0,523,0,523,
HARYANA,MAHENDRAGARH,2021-02-18,0,152,0,152,
HARYANA,MAHENDRAGARH,2021-02-19,0,49,1,50,
HARYANA,MAHENDRAGARH,2021-02-20,0,229,1,230,
HARYANA,NUH,2021-02-16,2,101,0,103,
HARYANA,NUH,2021-02-17,0,394,0,394,
HARYANA,NUH,2021-02-18,0,526,1,527,
HARYANA,NUH,2021-02-19,1,720,0,721,
HARYANA,NUH,2021-02-20,1,552,1,554,
HARYANA,PALWAL,2021-02-16,1,40,0,41,
HARYANA,PALWAL,2021-02-17,0,108,0,108,
HARYANA,PALWAL,2021-02-18,0,254,0,254,
HARYANA,PALWAL,2021-02-19,1,257,0,258,
HARYANA,PALWAL,2021-02-20,0,168,0,168,
HARYANA,PANCHKULA,2021-02-16,8,235,2,245,
HARYANA,PANCHKULA,2021-02-17,19,492,5,516,
HARYANA,PANCHKULA,2021-02-18,24,643,0,667,
HARYANA,PANCHKULA,2021-02-19,24,609,5,638,
HARYANA,PANCHKULA,2021-02-20,20,763,34,817,
HARYANA,PANIPAT,2021-02-16,3,344,0,347,
HARYANA,PANIPAT,2021-02-17,8,423,0,431,
HARYANA,PANIPAT,2021-02-18,4,416,1,421,
HARYANA,PANIPAT,2021-02-19,3,576,0,579,
HARYANA,PANIPAT,2021-02-20,6,444,1,451,
HARYANA,REWARI,2021-02-16,2,514,2,518,
HARYANA,REWARI,2021-02-17,0,216,0,216,
HARYANA,REWARI,2021-02-18,0,799,1,800,
HARYANA,REWARI,2021-02-19,1,430,1,432,
HARYANA,REWARI,2021-02-20,0,416,0,416,
HARYANA,ROHTAK,2021-02-16,0,725,0,725,
HARYANA,ROHTAK,2021-02-17,6,677,0,683,
HARYANA,ROHTAK,2021-02-18,2,752,0,754,
HARYANA,ROHTAK,2021-02-19,2,1138,0,1140,
HARYANA,ROHTAK,2021-02-20,1,774,0,775,
HARYANA,SIRSA,2021-02-16,1,335,0,336,
HARYANA,SIRSA,2021-02-17,0,517,2,519,
HARYANA,SIRSA,2021-02-18,0,849,1,850,
HARYANA,SIRSA,2021-02-19,2,916,6,924,
HARYANA,SIRSA,2021-02-20,0,921,4,925,
HARYANA,SONIPAT,2021-02-16,4,1101,1,1106,
HARYANA,SONIPAT,2021-02-17,0,848,0,848,
HARYANA,SONIPAT,2021-02-18,3,913,1,917,
HARYANA,SONIPAT,2021-02-19,0,921,4,925,
HARYANA,SONIPAT,2021-02-20,1,1133,0,1134,
HARYANA,YAMUNANAGAR,2021-02-16,3,1777,4,1784,
HARYANA,YAMUNANAGAR,2021-02-17,15,1749,5,1769,
HARYANA,YAMUNANAGAR,2021-02-18,7,1574,22,1603,
HARYANA,YAMUNANAGAR,2021-02-19,1,1463,3,1467,
HARYANA,YAMUNANAGAR,2021-02-20,5,1234,8,1247,
HIMACHAL PRADESH,BILASPUR,2021-02-16,0,154,2,156,
HIMACHAL PRADESH,BILASPUR,2021-02-17,3,472,0,475,
HIMACHAL PRADESH,BILASPUR,2021-02-18,0,906,0,906,
HIMACHAL PRADESH,BILASPUR,2021-02-19,6,657,0,663,
HIMACHAL PRADESH,BILASPUR,2021-02-20,3,634,0,637,
HIMACHAL PRADESH,CHAMBA,2021-02-16,0,807,4,811,
HIMACHAL PRADESH,CHAMBA,2021-02-17,0,519,3,522,
HIMACHAL PRADESH,CHAMBA,2021-02-18,1,955,7,963,
HIMACHAL PRADESH,CHAMBA,2021-02-19,2,974,15,991,
HIMACHAL PRADESH,CHAMBA,2021-02-20,1,1371,9,1381,
HIMACHAL PRADESH,HAMIRPUR,2021-02-16,1,351,0,352,
HIMACHAL PRADESH,HAMIRPUR,2021-02-17,3,408,1,412,
HIMACHAL PRADESH,HAMIRPUR,2021-02-18,1,388,0,389,
HIMACHAL PRADESH,HAMIRPUR,2021-02-19,3,414,0,417,
HIMACHAL PRADESH,HAMIRPUR,2021-02-20,2,328,0,330,
HIMACHAL PRADESH,KANGRA,2021-02-16,4,1050,0,1054,
HIMACHAL PRADESH,KANGRA,2021-02-17,4,1578,2,1584,
HIMACHAL PRADESH,KANGRA,2021-02-18,2,1862,0,1864,
HIMACHAL PRADESH,KANGRA,2021-02-19,3,1559,1,1563,
HIMACHAL PRADESH,KANGRA,2021-02-20,1,1898,2,1901,
HIMACHAL PRADESH,KINNAUR,2021-02-16,0,43,0,43,
HIMACHAL PRADESH,KINNAUR,2021-02-17,0,50,0,50,
HIMACHAL PRADESH,KINNAUR,2021-02-18,6,78,0,84,
HIMACHAL PRADESH,KINNAUR,2021-02-19,0,29,0,29,
HIMACHAL PRADESH,KINNAUR,2021-02-20,0,274,0,274,
HIMACHAL PRADESH,KULLU,2021-02-16,2,258,0,260,
HIMACHAL PRADESH,KULLU,2021-02-17,3,314,2,319,
HIMACHAL PRADESH,KULLU,2021-02-18,3,370,1,374,
HIMACHAL PRADESH,KULLU,2021-02-19,1,286,2,289,
HIMACHAL PRADESH,KULLU,2021-02-20,0,170,0,170,
HIMACHAL PRADESH,LAHUL AND SPITI,2021-02-16,0,2,0,2,
HIMACHAL PRADESH,LAHUL AND SPITI,2021-02-17,0,3,0,3,
HIMACHAL PRADESH,LAHUL AND SPITI,2021-02-18,0,1,0,1,
HIMACHAL PRADESH,LAHUL AND SPITI,2021-02-20,0,3,0,3,
HIMACHAL PRADESH,MANDI,2021-02-16,1,556,3,560,
HIMACHAL PRADESH,MANDI,2021-02-17,6,439,1,446,
HIMACHAL PRADESH,MANDI,2021-02-18,3,377,13,393,
HIMACHAL PRADESH,MANDI,2021-02-19,13,453,19,485,
HIMACHAL PRADESH,MANDI,2021-02-20,1,298,5,304,
HIMACHAL PRADESH,SHIMLA,2021-02-16,4,556,2,562,
HIMACHAL PRADESH,SHIMLA,2021-02-17,3,500,1,504,
HIMACHAL PRADESH,SHIMLA,2021-02-18,1,774,1,776,
HIMACHAL PRADESH,SHIMLA,2021-02-19,2,733,3,738,
HIMACHAL PRADESH,SHIMLA,2021-02-20,8,949,4,961,
HIMACHAL PRADESH,SIRMAUR,2021-02-16,7,305,2,314,
HIMACHAL PRADESH,SIRMAUR,2021-02-17,2,412,5,419,
HIMACHAL PRADESH,SIRMAUR,2021-02-18,4,543,0,547,
HIMACHAL PRADESH,SIRMAUR,2021-02-19,2,446,3,451,
HIMACHAL PRADESH,SIRMAUR,2021-02-20,2,505,0,507,
HIMACHAL PRADESH,SOLAN,2021-02-16,5,366,1,372,
HIMACHAL PRADESH,SOLAN,2021-02-17,5,359,0,364,
HIMACHAL PRADESH,SOLAN,2021-02-18,1,518,0,519,
HIMACHAL PRADESH,SOLAN,2021-02-19,5,427,0,432,
HIMACHAL PRADESH,SOLAN,2021-02-20,0,533,5,538,
HIMACHAL PRADESH,UNA,2021-02-16,6,286,0,292,
HIMACHAL PRADESH,UNA,2021-02-17,5,334,0,339,
HIMACHAL PRADESH,UNA,2021-02-18,6,309,0,315,
HIMACHAL PRADESH,UNA,2021-02-19,6,513,0,519,
HIMACHAL PRADESH,UNA,2021-02-20,4,480,0,484,
INDIA,INDIA,2021-02-16,3,4,0,7,
INDIA,INDIA,2021-02-17,4,4,0,8,
INDIA,INDIA,2021-02-18,2,1,0,3,
INDIA,INDIA,2021-02-19,6,4,0,10,
INDIA,INDIA,2021-02-20,2,0,0,2,
JAMMU AND KASHMIR,ANANTNAG,2021-02-16,8,298,0,306,
JAMMU AND KASHMIR,ANANTNAG,2021-02-17,6,256,0,262,
JAMMU AND KASHMIR,ANANTNAG,2021-02-18,3,377,0,380,
JAMMU AND KASHMIR,ANANTNAG,2021-02-19,3,218,0,221,
JAMMU AND KASHMIR,ANANTNAG,2021-02-20,4,250,0,254,
JAMMU AND KASHMIR,BANDIPORA,2021-02-16,1,83,0,84,
JAMMU AND KASHMIR,BANDIPORA,2021-02-17,0,15,0,15,
JAMMU AND KASHMIR,BANDIPORA,2021-02-18,0,68,0,68,
JAMMU AND KASHMIR,BANDIPORA,2021-02-19,0,34,0,34,
JAMMU AND KASHMIR,BANDIPORA,2021-02-20,0,137,0,137,
JAMMU AND KASHMIR,BARAMULLA,2021-02-16,3,271,0,274,
JAMMU AND KASHMIR,BARAMULLA,2021-02-17,6,289,0,295,
JAMMU AND KASHMIR,BARAMULLA,2021-02-18,0,274,0,274,
JAMMU AND KASHMIR,BARAMULLA,2021-02-19,4,292,0,296,
JAMMU AND KASHMIR,BARAMULLA,2021-02-20,6,346,0,352,
JAMMU AND KASHMIR,BUDGAM,2021-02-16,8,578,0,586,
JAMMU AND KASHMIR,BUDGAM,2021-02-17,12,576,0,588,
JAMMU AND KASHMIR,BUDGAM,2021-02-18,4,636,1,641,
JAMMU AND KASHMIR,BUDGAM,2021-02-19,4,572,0,576,
JAMMU AND KASHMIR,BUDGAM,2021-02-20,7,618,0,625,
JAMMU AND KASHMIR,DODA,2021-02-16,0,7,0,7,
JAMMU AND KASHMIR,DODA,2021-02-17,2,21,0,23,
JAMMU AND KASHMIR,DODA,2021-02-18,0,47,1,48,
JAMMU AND KASHMIR,DODA,2021-02-19,0,8,0,8,
JAMMU AND KASHMIR,DODA,2021-02-20,0,19,0,19,
JAMMU AND KASHMIR,GANDERBAL,2021-02-16,8,96,0,104,
JAMMU AND KASHMIR,GANDERBAL,2021-02-17,0,84,0,84,
JAMMU AND KASHMIR,GANDERBAL,2021-02-18,0,98,0,98,
JAMMU AND KASHMIR,GANDERBAL,2021-02-19,0,106,0,106,
JAMMU AND KASHMIR,GANDERBAL,2021-02-20,1,108,0,109,
JAMMU AND KASHMIR,JAMMU,2021-02-16,11,424,0,435,
JAMMU AND KASHMIR,JAMMU,2021-02-17,10,459,3,472,
JAMMU AND KASHMIR,JAMMU,2021-02-18,19,547,0,566,
JAMMU AND KASHMIR,JAMMU,2021-02-19,9,821,0,830,
JAMMU AND KASHMIR,JAMMU,2021-02-20,4,608,2,614,
JAMMU AND KASHMIR,KATHUA,2021-02-16,0,138,0,138,
JAMMU AND KASHMIR,KATHUA,2021-02-17,1,196,0,197,
JAMMU AND KASHMIR,KATHUA,2021-02-18,0,207,0,207,
JAMMU AND KASHMIR,KATHUA,2021-02-19,0,206,0,206,
JAMMU AND KASHMIR,KATHUA,2021-02-20,0,70,0,70,
JAMMU AND KASHMIR,KISHTWAR,2021-02-16,0,19,0,19,
JAMMU AND KASHMIR,KISHTWAR,2021-02-17,0,142,0,142,
JAMMU AND KASHMIR,KISHTWAR,2021-02-18,1,204,0,205,
JAMMU AND KASHMIR,KISHTWAR,2021-02-19,0,72,0,72,
JAMMU AND KASHMIR,KISHTWAR,2021-02-20,0,57,0,57,
JAMMU AND KASHMIR,KULGAM,2021-02-16,2,153,0,155,
JAMMU AND KASHMIR,KULGAM,2021-02-17,0,150,0,150,
JAMMU AND KASHMIR,KULGAM,2021-02-18,1,103,0,104,
JAMMU AND KASHMIR,KULGAM,2021-02-19,1,148,0,149,
JAMMU AND KASHMIR,KULGAM,2021-02-20,0,174,1,175,
JAMMU AND KASHMIR,KUPWARA,2021-02-16,3,209,0,212,
JAMMU AND KASHMIR,KUPWARA,2021-02-17,0,146,0,146,
JAMMU AND KASHMIR,KUPWARA,2021-02-18,0,331,0,331,
JAMMU AND KASHMIR,KUPWARA,2021-02-19,0,27,0,27,
JAMMU AND KASHMIR,KUPWARA,2021-02-20,0,243,0,243,
JAMMU AND KASHMIR,POONCH,2021-02-16,2,307,0,309,
JAMMU AND KASHMIR,POONCH,2021-02-17,7,371,1,379,
JAMMU AND KASHMIR,POONCH,2021-02-18,1,342,0,343,
JAMMU AND KASHMIR,POONCH,2021-02-19,0,303,0,303,
JAMMU AND KASHMIR,POONCH,2021-02-20,0,238,0,238,
JAMMU AND KASHMIR,PULWAMA,2021-02-16,8,402,0,410,
JAMMU AND KASHMIR,PULWAMA,2021-02-17,2,494,1,497,
JAMMU AND KASHMIR,PULWAMA,2021-02-18,9,593,1,603,
JAMMU AND KASHMIR,PULWAMA,2021-02-19,9,424,0,433,
JAMMU AND KASHMIR,PULWAMA,2021-02-20,12,566,2,580,
JAMMU AND KASHMIR,RAJOURI,2021-02-16,0,199,0,199,
JAMMU AND KASHMIR,RAJOURI,2021-02-17,0,117,0,117,
JAMMU AND KASHMIR,RAJOURI,2021-02-18,0,214,0,214,
JAMMU AND KASHMIR,RAJOURI,2021-02-19,1,354,1,356,
JAMMU AND KASHMIR,RAJOURI,2021-02-20,1,262,1,264,
JAMMU AND KASHMIR,RAMBAN,2021-02-16,1,169,0,170,
JAMMU AND KASHMIR,RAMBAN,2021-02-17,1,215,0,216,
JAMMU AND KASHMIR,RAMBAN,2021-02-18,1,292,0,293,
JAMMU AND KASHMIR,RAMBAN,2021-02-19,1,237,0,238,
JAMMU AND KASHMIR,RAMBAN,2021-02-20,0,203,0,203,
JAMMU AND KASHMIR,REASI,2021-02-16,1,96,0,97,
JAMMU AND KASHMIR,REASI,2021-02-17,0,52,0,52,
JAMMU AND KASHMIR,REASI,2021-02-18,3,82,0,85,
JAMMU AND KASHMIR,REASI,2021-02-19,1,99,0,100,
JAMMU AND KASHMIR,REASI,2021-02-20,1,44,0,45,
JAMMU AND KASHMIR,SAMBA,2021-02-16,0,69,0,69,
JAMMU AND KASHMIR,SAMBA,2021-02-17,0,97,0,97,
JAMMU AND KASHMIR,SAMBA,2021-02-18,0,60,0,60,
JAMMU AND KASHMIR,SAMBA,2021-02-19,1,100,0,101,
JAMMU AND KASHMIR,SAMBA,2021-02-20,0,102,0,102,
JAMMU AND KASHMIR,SHOPIAN,2021-02-16,1,231,0,232,
JAMMU AND KASHMIR,SHOPIAN,2021-02-17,4,423,1,428,
JAMMU AND KASHMIR,SHOPIAN,2021-02-18,2,310,0,312,
JAMMU AND KASHMIR,SHOPIAN,2021-02-19,1,42,2,45,
JAMMU AND KASHMIR,SHOPIAN,2021-02-20,2,246,1,249,
JAMMU AND KASHMIR,SRINAGAR,2021-02-16,58,3668,3,3729,
JAMMU AND KASHMIR,SRINAGAR,2021-02-17,47,3371,2,3420,
JAMMU AND KASHMIR,SRINAGAR,2021-02-18,50,3503,4,3557,
JAMMU AND KASHMIR,SRINAGAR,2021-02-19,22,3366,3,3391,
JAMMU AND KASHMIR,SRINAGAR,2021-02-20,40,3779,3,3822,
JAMMU AND KASHMIR,UDHAMPUR,2021-02-16,65,300,0,365,
JAMMU AND KASHMIR,UDHAMPUR,2021-02-17,2,394,1,397,
JAMMU AND KASHMIR,UDHAMPUR,2021-02-18,3,324,0,327,
JAMMU AND KASHMIR,UDHAMPUR,2021-02-19,81,462,0,543,
JAMMU AND KASHMIR,UDHAMPUR,2021-02-20,18,382,0,400,
JHARKHAND,BOKARO,2021-02-16,2,131,0,133,
JHARKHAND,BOKARO,2021-02-17,0,887,12,899,
JHARKHAND,BOKARO,2021-02-18,2,786,0,788,
JHARKHAND,BOKARO,2021-02-19,0,596,0,596,
JHARKHAND,BOKARO,2021-02-20,2,978,1,981,
JHARKHAND,CHATRA,2021-02-16,0,257,0,257,
JHARKHAND,CHATRA,2021-02-17,1,200,0,201,
JHARKHAND,CHATRA,2021-02-18,0,585,0,585,
JHARKHAND,CHATRA,2021-02-19,0,814,0,814,
JHARKHAND,CHATRA,2021-02-20,1,382,0,383,
JHARKHAND,DEOGHAR,2021-02-16,3,168,5,176,
JHARKHAND,DEOGHAR,2021-02-17,10,551,15,576,
JHARKHAND,DEOGHAR,2021-02-18,1,1088,11,1100,
JHARKHAND,DEOGHAR,2021-02-19,3,197,0,200,
JHARKHAND,DEOGHAR,2021-02-20,0,409,6,415,
JHARKHAND,DHANBAD,2021-02-16,1,73,1,75,
JHARKHAND,DHANBAD,2021-02-17,4,843,1,848,
JHARKHAND,DHANBAD,2021-02-18,7,804,2,813,
JHARKHAND,DHANBAD,2021-02-19,3,586,0,589,
JHARKHAND,DHANBAD,2021-02-20,7,462,0,469,
JHARKHAND,DUMKA,2021-02-16,4,132,20,156,
JHARKHAND,DUMKA,2021-02-17,1,1043,20,1064,
JHARKHAND,DUMKA,2021-02-18,1,501,23,525,
JHARKHAND,DUMKA,2021-02-19,1,136,23,160,
JHARKHAND,DUMKA,2021-02-20,1,436,36,473,
JHARKHAND,EAST SINGHBUM,2021-02-16,7,3541,0,3548,
JHARKHAND,EAST SINGHBUM,2021-02-17,22,4834,0,4856,
JHARKHAND,EAST SINGHBUM,2021-02-18,18,5813,2,5833,
JHARKHAND,EAST SINGHBUM,2021-02-19,11,1839,1,1851,
JHARKHAND,EAST SINGHBUM,2021-02-20,8,2746,0,2754,
JHARKHAND,GARHWA,2021-02-16,0,123,1,124,
JHARKHAND,GARHWA,2021-02-17,1,251,2,254,
JHARKHAND,GARHWA,2021-02-18,0,136,0,136,
JHARKHAND,GARHWA,2021-02-19,0,670,1,671,
JHARKHAND,GARHWA,2021-02-20,0,584,1,585,
JHARKHAND,GIRIDIH,2021-02-16,0,3051,0,3051,
JHARKHAND,GIRIDIH,2021-02-17,2,4366,0,4368,
JHARKHAND,GIRIDIH,2021-02-18,1,566,0,567,
JHARKHAND,GIRIDIH,2021-02-19,0,291,0,291,
JHARKHAND,GIRIDIH,2021-02-20,0,536,0,536,
JHARKHAND,GODDA,2021-02-16,0,126,156,282,
JHARKHAND,GODDA,2021-02-17,1,937,0,938,
JHARKHAND,GODDA,2021-02-18,0,671,0,671,
JHARKHAND,GODDA,2021-02-19,0,401,0,401,
JHARKHAND,GODDA,2021-02-20,0,463,0,463,
JHARKHAND,GUMLA,2021-02-16,4,2540,0,2544,
JHARKHAND,GUMLA,2021-02-17,3,2393,0,2396,
JHARKHAND,GUMLA,2021-02-18,0,1606,0,1606,
JHARKHAND,GUMLA,2021-02-19,1,2503,0,2504,
JHARKHAND,GUMLA,2021-02-20,1,400,0,401,
JHARKHAND,HAZARIBAGH,2021-02-16,1,87,0,88,
JHARKHAND,HAZARIBAGH,2021-02-17,1,170,0,171,
JHARKHAND,HAZARIBAGH,2021-02-18,0,416,1,417,
JHARKHAND,HAZARIBAGH,2021-02-19,1,505,0,506,
JHARKHAND,HAZARIBAGH,2021-02-20,1,524,0,525,
JHARKHAND,JAMTARA,2021-02-16,0,162,0,162,
JHARKHAND,JAMTARA,2021-02-17,0,115,0,115,
JHARKHAND,JAMTARA,2021-02-18,0,151,0,151,
JHARKHAND,JAMTARA,2021-02-19,0,317,0,317,
JHARKHAND,JAMTARA,2021-02-20,0,540,0,540,
JHARKHAND,KHUNTI,2021-02-16,1,34,0,35,
JHARKHAND,KHUNTI,2021-02-17,0,375,7,382,
JHARKHAND,KHUNTI,2021-02-18,0,328,7,335,
JHARKHAND,KHUNTI,2021-02-19,0,367,8,375,
JHARKHAND,KHUNTI,2021-02-20,0,156,6,162,
JHARKHAND,KODERMA,2021-02-16,2,34,0,36,
JHARKHAND,KODERMA,2021-02-17,0,228,0,228,
JHARKHAND,KODERMA,2021-02-18,0,597,0,597,
JHARKHAND,KODERMA,2021-02-19,0,527,0,527,
JHARKHAND,KODERMA,2021-02-20,0,743,0,743,
JHARKHAND,LATEHAR,2021-02-16,0,822,5,827,
JHARKHAND,LATEHAR,2021-02-17,0,1474,15,1489,
JHARKHAND,LATEHAR,2021-02-18,0,891,1,892,
JHARKHAND,LATEHAR,2021-02-19,0,1202,0,1202,
JHARKHAND,LATEHAR,2021-02-20,6,1112,0,1118,
JHARKHAND,LOHARDAGA,2021-02-16,0,386,0,386,
JHARKHAND,LOHARDAGA,2021-02-17,0,457,0,457,
JHARKHAND,LOHARDAGA,2021-02-18,0,481,0,481,
JHARKHAND,LOHARDAGA,2021-02-19,1,287,0,288,
JHARKHAND,LOHARDAGA,2021-02-20,5,331,4,340,
JHARKHAND,PAKUR,2021-02-16,1,13,70,84,
JHARKHAND,PAKUR,2021-02-17,0,151,0,151,
JHARKHAND,PAKUR,2021-02-18,0,594,0,594,
JHARKHAND,PAKUR,2021-02-19,0,259,3,262,
JHARKHAND,PAKUR,2021-02-20,0,466,7,473,
JHARKHAND,PALAMU,2021-02-16,0,157,3,160,
JHARKHAND,PALAMU,2021-02-17,3,67,0,70,
JHARKHAND,PALAMU,2021-02-18,1,105,0,106,
JHARKHAND,PALAMU,2021-02-19,3,1214,0,1217,
JHARKHAND,PALAMU,2021-02-20,1,2048,0,2049,
JHARKHAND,RAMGARH,2021-02-16,0,17,0,17,
JHARKHAND,RAMGARH,2021-02-17,1,150,1,152,
JHARKHAND,RAMGARH,2021-02-18,0,87,1,88,
JHARKHAND,RAMGARH,2021-02-19,1,50,0,51,
JHARKHAND,RAMGARH,2021-02-20,0,80,0,80,
JHARKHAND,RANCHI,2021-02-16,50,803,1,854,
JHARKHAND,RANCHI,2021-02-17,42,948,1,991,
JHARKHAND,RANCHI,2021-02-18,40,953,1,994,
JHARKHAND,RANCHI,2021-02-19,41,752,0,793,
JHARKHAND,RANCHI,2021-02-20,27,638,1,666,
JHARKHAND,SAHEBGANJ,2021-02-16,0,19,5,24,
JHARKHAND,SAHEBGANJ,2021-02-17,0,30,0,30,
JHARKHAND,SAHEBGANJ,2021-02-18,0,37,0,37,
JHARKHAND,SAHEBGANJ,2021-02-19,0,59,0,59,
JHARKHAND,SAHEBGANJ,2021-02-20,0,68,0,68,
JHARKHAND,SARAIKELA KHARSAWAN,2021-02-16,0,45,0,45,
JHARKHAND,SARAIKELA KHARSAWAN,2021-02-17,1,279,0,280,
JHARKHAND,SARAIKELA KHARSAWAN,2021-02-18,22,238,0,260,
JHARKHAND,SARAIKELA KHARSAWAN,2021-02-19,0,208,0,208,
JHARKHAND,SARAIKELA KHARSAWAN,2021-02-20,0,310,0,310,
JHARKHAND,SIMDEGA,2021-02-16,0,172,1,173,
JHARKHAND,SIMDEGA,2021-02-17,2,838,0,840,
JHARKHAND,SIMDEGA,2021-02-18,0,599,0,599,
JHARKHAND,SIMDEGA,2021-02-19,0,641,0,641,
JHARKHAND,SIMDEGA,2021-02-20,0,963,0,963,
JHARKHAND,WEST SINGHBHUM,2021-02-16,0,523,1,524,
JHARKHAND,WEST SINGHBHUM,2021-02-17,0,605,0,605,
JHARKHAND,WEST SINGHBHUM,2021-02-18,2,230,0,232,
JHARKHAND,WEST SINGHBHUM,2021-02-19,0,538,0,538,
JHARKHAND,WEST SINGHBHUM,2021-02-20,0,609,0,609,
KARNATAKA,BAGALKOTE,2021-02-16,0,881,2,883,
KARNATAKA,BAGALKOTE,2021-02-17,3,836,7,846,
KARNATAKA,BAGALKOTE,2021-02-18,3,1075,3,1081,
KARNATAKA,BAGALKOTE,2021-02-19,1,887,5,893,
KARNATAKA,BAGALKOTE,2021-02-20,4,1128,2,1134,
KARNATAKA,BALLARI,2021-02-16,2,1193,22,1217,
KARNATAKA,BALLARI,2021-02-17,0,1712,24,1736,
KARNATAKA,BALLARI,2021-02-18,10,1429,53,1492,
KARNATAKA,BALLARI,2021-02-19,6,1406,36,1448,
KARNATAKA,BALLARI,2021-02-20,4,1038,21,1063,
KARNATAKA,BELAGAVI,2021-02-16,2,1942,5,1949,
KARNATAKA,BELAGAVI,2021-02-17,12,1076,1,1089,
KARNATAKA,BELAGAVI,2021-02-18,10,1326,0,1336,
KARNATAKA,BELAGAVI,2021-02-19,14,1878,2,1894,
KARNATAKA,BELAGAVI,2021-02-20,14,1412,4,1430,
KARNATAKA,BENGALURU RURAL,2021-02-16,5,1726,3,1734,
KARNATAKA,BENGALURU RURAL,2021-02-17,7,1085,0,1092,
KARNATAKA,BENGALURU RURAL,2021-02-18,7,1161,1,1169,
KARNATAKA,BENGALURU RURAL,2021-02-19,11,780,2,793,
KARNATAKA,BENGALURU RURAL,2021-02-20,14,623,0,637,
KARNATAKA,BENGALURU URBAN,2021-02-16,251,20391,191,20833,
KARNATAKA,BENGALURU URBAN,2021-02-17,291,23060,37,23388,
KARNATAKA,BENGALURU URBAN,2021-02-18,247,23348,140,23735,
KARNATAKA,BENGALURU URBAN,2021-02-19,279,20755,165,21199,
KARNATAKA,BENGALURU URBAN,2021-02-20,265,20675,60,21000,
KARNATAKA,BIDAR,2021-02-16,2,990,0,992,
KARNATAKA,BIDAR,2021-02-17,8,624,0,632,
KARNATAKA,BIDAR,2021-02-18,6,687,0,693,
KARNATAKA,BIDAR,2021-02-19,12,942,2,956,
KARNATAKA,BIDAR,2021-02-20,4,834,0,838,
KARNATAKA,CHAMARAJANAGARA,2021-02-16,1,786,3,790,
KARNATAKA,CHAMARAJANAGARA,2021-02-17,1,664,2,667,
KARNATAKA,CHAMARAJANAGARA,2021-02-18,0,578,1,579,
KARNATAKA,CHAMARAJANAGARA,2021-02-19,3,749,0,752,
KARNATAKA,CHAMARAJANAGARA,2021-02-20,1,648,1,650,
KARNATAKA,CHIKKABALLAPURA,2021-02-16,6,1315,14,1335,
KARNATAKA,CHIKKABALLAPURA,2021-02-17,4,1306,31,1341,
KARNATAKA,CHIKKABALLAPURA,2021-02-18,4,1875,11,1890,
KARNATAKA,CHIKKABALLAPURA,2021-02-19,4,1577,7,1588,
KARNATAKA,CHIKKABALLAPURA,2021-02-20,7,1546,0,1553,
KARNATAKA,CHIKKAMAGALURU,2021-02-16,4,725,8,737,
KARNATAKA,CHIKKAMAGALURU,2021-02-17,3,1090,3,1096,
KARNATAKA,CHIKKAMAGALURU,2021-02-18,4,746,8,758,
KARNATAKA,CHIKKAMAGALURU,2021-02-19,6,874,9,889,
KARNATAKA,CHIKKAMAGALURU,2021-02-20,3,1293,10,1306,
KARNATAKA,CHITRADURGA,2021-02-16,1,133,1,135,
KARNATAKA,CHITRADURGA,2021-02-17,2,1074,1,1077,
KARNATAKA,CHITRADURGA,2021-02-18,3,1387,1,1391,
KARNATAKA,CHITRADURGA,2021-02-19,5,1668,2,1675,
KARNATAKA,CHITRADURGA,2021-02-20,5,1603,2,1610,
KARNATAKA,DAKSHINA KANNADA,2021-02-16,24,1916,0,1940,
KARNATAKA,DAKSHINA KANNADA,2021-02-17,29,1837,1,1867,
KARNATAKA,DAKSHINA KANNADA,2021-02-18,24,1814,2,1840,
KARNATAKA,DAKSHINA KANNADA,2021-02-19,16,1647,2,1665,
KARNATAKA,DAKSHINA KANNADA,2021-02-20,17,1337,2,1356,
KARNATAKA,DAVANGERE,2021-02-16,5,1051,2,1058,
KARNATAKA,DAVANGERE,2021-02-17,4,982,8,994,
KARNATAKA,DAVANGERE,2021-02-18,6,1170,14,1190,
KARNATAKA,DAVANGERE,2021-02-19,7,1027,5,1039,
KARNATAKA,DAVANGERE,2021-02-20,2,788,5,795,
KARNATAKA,DHARWAD,2021-02-16,5,1650,15,1670,
KARNATAKA,DHARWAD,2021-02-17,6,1670,9,1685,
KARNATAKA,DHARWAD,2021-02-18,4,1878,3,1885,
KARNATAKA,DHARWAD,2021-02-19,9,2278,25,2312,
KARNATAKA,DHARWAD,2021-02-20,7,1529,6,1542,
KARNATAKA,GADAG,2021-02-16,1,638,3,642,
KARNATAKA,GADAG,2021-02-17,2,954,192,1148,
KARNATAKA,GADAG,2021-02-18,1,981,114,1096,
KARNATAKA,GADAG,2021-02-19,1,888,19,908,
KARNATAKA,GADAG,2021-02-20,2,918,25,945,
KARNATAKA,HASSAN,2021-02-16,1,3598,43,3642,
KARNATAKA,HASSAN,2021-02-17,6,2281,50,2337,
KARNATAKA,HASSAN,2021-02-18,7,2056,60,2123,
KARNATAKA,HASSAN,2021-02-19,18,1441,67,1526,
KARNATAKA,HASSAN,2021-02-20,4,485,4,493,
KARNATAKA,HAVERI,2021-02-16,0,887,0,887,
KARNATAKA,HAVERI,2021-02-17,0,779,0,779,
KARNATAKA,HAVERI,2021-02-18,1,1164,0,1165,
KARNATAKA,HAVERI,2021-02-19,1,787,1,789,
KARNATAKA,HAVERI,2021-02-20,0,780,2,782,
KARNATAKA,KALABURAGI,2021-02-16,14,583,2,599,
KARNATAKA,KALABURAGI,2021-02-17,15,1768,1,1784,
KARNATAKA,KALABURAGI,2021-02-18,26,1471,23,1520,
KARNATAKA,KALABURAGI,2021-02-19,14,1512,10,1536,
KARNATAKA,KALABURAGI,2021-02-20,28,1217,2,1247,
KARNATAKA,KODAGU,2021-02-16,3,534,9,546,
KARNATAKA,KODAGU,2021-02-17,0,289,0,289,
KARNATAKA,KODAGU,2021-02-18,2,569,6,577,
KARNATAKA,KODAGU,2021-02-19,3,653,15,671,
KARNATAKA,KODAGU,2021-02-20,6,1179,16,1201,
KARNATAKA,KOLAR,2021-02-16,3,1699,9,1711,
KARNATAKA,KOLAR,2021-02-17,3,1762,0,1765,
KARNATAKA,KOLAR,2021-02-18,8,1586,1,1595,
KARNATAKA,KOLAR,2021-02-19,15,1731,4,1750,
KARNATAKA,KOLAR,2021-02-20,1,1620,2,1623,
KARNATAKA,KOPPAL,2021-02-16,0,615,2,617,
KARNATAKA,KOPPAL,2021-02-17,0,528,1,529,
KARNATAKA,KOPPAL,2021-02-18,0,445,4,449,
KARNATAKA,KOPPAL,2021-02-19,1,438,1,440,
KARNATAKA,KOPPAL,2021-02-20,0,318,1,319,
KARNATAKA,MANDYA,2021-02-16,3,1804,3,1810,
KARNATAKA,MANDYA,2021-02-17,6,1841,3,1850,
KARNATAKA,MANDYA,2021-02-18,3,1556,3,1562,
KARNATAKA,MANDYA,2021-02-19,5,1686,3,1694,
KARNATAKA,MANDYA,2021-02-20,2,1159,0,1161,
KARNATAKA,MYSURU,2021-02-16,11,2053,1,2065,
KARNATAKA,MYSURU,2021-02-17,22,2607,4,2633,
KARNATAKA,MYSURU,2021-02-18,36,2782,3,2821,
KARNATAKA,MYSURU,2021-02-19,25,2451,3,2479,
KARNATAKA,MYSURU,2021-02-20,41,2495,3,2539,
KARNATAKA,RAICHUR,2021-02-16,1,731,2,734,
KARNATAKA,RAICHUR,2021-02-17,3,901,4,908,
KARNATAKA,RAICHUR,2021-02-18,1,665,17,683,
KARNATAKA,RAICHUR,2021-02-19,1,785,1,787,
KARNATAKA,RAICHUR,2021-02-20,1,840,12,853,
KARNATAKA,RAMANAGARA,2021-02-16,2,749,7,758,
KARNATAKA,RAMANAGARA,2021-02-17,2,559,0,561,
KARNATAKA,RAMANAGARA,2021-02-18,0,807,0,807,
KARNATAKA,RAMANAGARA,2021-02-19,0,544,4,548,
KARNATAKA,RAMANAGARA,2021-02-20,2,270,0,272,
KARNATAKA,SHIVAMOGGA,2021-02-16,0,842,4,846,
KARNATAKA,SHIVAMOGGA,2021-02-17,5,601,0,606,
KARNATAKA,SHIVAMOGGA,2021-02-18,12,1205,0,1217,
KARNATAKA,SHIVAMOGGA,2021-02-19,3,1305,6,1314,
KARNATAKA,SHIVAMOGGA,2021-02-20,11,1274,3,1288,
KARNATAKA,TUMAKURU,2021-02-16,9,223,10,242,
KARNATAKA,TUMAKURU,2021-02-17,29,2288,2,2319,
KARNATAKA,TUMAKURU,2021-02-18,16,2004,0,2020,
KARNATAKA,TUMAKURU,2021-02-19,25,2192,8,2225,
KARNATAKA,TUMAKURU,2021-02-20,7,2075,32,2114,
KARNATAKA,UDUPI,2021-02-16,6,1156,0,1162,
KARNATAKA,UDUPI,2021-02-17,5,1165,0,1170,
KARNATAKA,UDUPI,2021-02-18,10,1328,0,1338,
KARNATAKA,UDUPI,2021-02-19,11,1145,0,1156,
KARNATAKA,UDUPI,2021-02-20,8,1282,0,1290,
KARNATAKA,UTTARA KANNADA,2021-02-16,6,1317,170,1493,
KARNATAKA,UTTARA KANNADA,2021-02-17,6,1408,133,1547,
KARNATAKA,UTTARA KANNADA,2021-02-18,1,1552,51,1604,
KARNATAKA,UTTARA KANNADA,2021-02-19,4,1347,157,1508,
KARNATAKA,UTTARA KANNADA,2021-02-20,4,1304,281,1589,
KARNATAKA,VIJAYAPURA,2021-02-16,7,744,0,751,
KARNATAKA,VIJAYAPURA,2021-02-17,5,1161,0,1166,
KARNATAKA,VIJAYAPURA,2021-02-18,9,987,0,996,
KARNATAKA,VIJAYAPURA,2021-02-19,5,1241,0,1246,
KARNATAKA,VIJAYAPURA,2021-02-20,11,1719,1,1731,
KARNATAKA,YADGIR,2021-02-16,3,865,1,869,
KARNATAKA,YADGIR,2021-02-17,2,843,0,845,
KARNATAKA,YADGIR,2021-02-18,1,880,0,881,
KARNATAKA,YADGIR,2021-02-19,2,751,0,753,
KARNATAKA,YADGIR,2021-02-20,0,926,0,926,
KERALA,ALAPPUZHA,2021-02-16,428,3803,13,4244,
KERALA,ALAPPUZHA,2021-02-17,426,4164,8,4598,
KERALA,ALAPPUZHA,2021-02-18,356,3927,23,4306,
KERALA,ALAPPUZHA,2021-02-19,451,4217,22,4690,
KERALA,ALAPPUZHA,2021-02-20,345,3953,10,4308,
KERALA,ERNAKULAM,2021-02-16,737,8557,46,9340,
KERALA,ERNAKULAM,2021-02-17,647,8136,33,8816,
KERALA,ERNAKULAM,2021-02-18,660,7777,39,8476,
KERALA,ERNAKULAM,2021-02-19,545,7105,6,7656,
KERALA,ERNAKULAM,2021-02-20,638,7098,23,7759,
KERALA,IDUKKI,2021-02-16,170,2233,5,2408,
KERALA,IDUKKI,2021-02-17,164,1941,4,2109,
KERALA,IDUKKI,2021-02-18,122,1774,4,1900,
KERALA,IDUKKI,2021-02-19,115,1588,3,1706,
KERALA,IDUKKI,2021-02-20,119,2277,1,2397,
KERALA,KANNUR,2021-02-16,316,3306,10,3632,
KERALA,KANNUR,2021-02-17,242,3154,6,3402,
KERALA,KANNUR,2021-02-18,296,2563,4,2863,
KERALA,KANNUR,2021-02-19,229,2582,7,2818,
KERALA,KANNUR,2021-02-20,213,2424,3,2640,
KERALA,KASARAGOD,2021-02-16,174,2086,3,2263,
KERALA,KASARAGOD,2021-02-17,152,1713,1,1866,
KERALA,KASARAGOD,2021-02-18,116,1727,0,1843,
KERALA,KASARAGOD,2021-02-19,110,1358,11,1479,
KERALA,KASARAGOD,2021-02-20,138,1708,4,1850,
KERALA,KOLLAM,2021-02-16,679,5312,14,6005,
KERALA,KOLLAM,2021-02-17,510,4578,15,5103,
KERALA,KOLLAM,2021-02-18,537,4301,7,4845,
KERALA,KOLLAM,2021-02-19,532,4850,17,5399,
KERALA,KOLLAM,2021-02-20,552,4561,8,5121,
KERALA,KOTTAYAM,2021-02-16,536,5375,27,5938,
KERALA,KOTTAYAM,2021-02-17,548,4426,46,5020,
KERALA,KOTTAYAM,2021-02-18,439,3793,29,4261,
KERALA,KOTTAYAM,2021-02-19,436,3760,31,4227,
KERALA,KOTTAYAM,2021-02-20,442,4182,28,4652,
KERALA,KOZHIKODE,2021-02-16,581,5150,47,5778,
KERALA,KOZHIKODE,2021-02-17,658,6573,50,7281,
KERALA,KOZHIKODE,2021-02-18,711,6021,46,6778,
KERALA,KOZHIKODE,2021-02-19,751,5245,64,6060,
KERALA,KOZHIKODE,2021-02-20,625,5061,66,5752,
KERALA,MALAPPURAM,2021-02-16,377,3881,5,4263,
KERALA,MALAPPURAM,2021-02-17,364,4894,4,5262,
KERALA,MALAPPURAM,2021-02-18,562,4321,3,4886,
KERALA,MALAPPURAM,2021-02-19,443,3969,1,4413,
KERALA,MALAPPURAM,2021-02-20,460,4684,7,5151,
KERALA,PALAKKAD,2021-02-16,248,3109,0,3357,
KERALA,PALAKKAD,2021-02-17,201,3368,1,3570,
KERALA,PALAKKAD,2021-02-18,173,2627,1,2801,
KERALA,PALAKKAD,2021-02-19,211,3068,3,3282,
KERALA,PALAKKAD,2021-02-20,195,2489,0,2684,
KERALA,PATHANAMTHITTA,2021-02-16,451,3478,3,3932,
KERALA,PATHANAMTHITTA,2021-02-17,660,3219,4,3883,
KERALA,PATHANAMTHITTA,2021-02-18,478,2783,3,3264,
KERALA,PATHANAMTHITTA,2021-02-19,417,3058,3,3478,
KERALA,PATHANAMTHITTA,2021-02-20,476,2880,2,3358,
KERALA,THIRUVANANTHAPURAM,2021-02-16,471,6158,14,6643,
KERALA,THIRUVANANTHAPURAM,2021-02-17,536,5814,14,6364,
KERALA,THIRUVANANTHAPURAM,2021-02-18,449,5275,20,5744,
KERALA,THIRUVANANTHAPURAM,2021-02-19,420,5106,11,5537,
KERALA,THIRUVANANTHAPURAM,2021-02-20,431,4982,9,5422,
KERALA,THRISSUR,2021-02-16,552,5449,1,6002,
KERALA,THRISSUR,2021-02-17,495,5051,0,5546,
KERALA,THRISSUR,2021-02-18,456,4630,3,5089,
KERALA,THRISSUR,2021-02-19,491,5264,0,5755,
KERALA,THRISSUR,2021-02-20,468,5395,1,5864,
KERALA,WAYANAD,2021-02-16,218,1403,13,1634,
KERALA,WAYANAD,2021-02-17,158,1528,9,1695,
KERALA,WAYANAD,2021-02-18,180,1088,14,1282,
KERALA,WAYANAD,2021-02-19,104,1243,6,1353,
KERALA,WAYANAD,2021-02-20,145,989,12,1146,
LADAKH,KARGIL,2021-02-16,0,83,1,84,
LADAKH,KARGIL,2021-02-17,0,112,0,112,
LADAKH,KARGIL,2021-02-18,0,126,0,126,
LADAKH,KARGIL,2021-02-19,0,145,0,145,
LADAKH,KARGIL,2021-02-20,0,113,0,113,
LADAKH,LEH LADAKH,2021-02-16,1,262,1,264,
LADAKH,LEH LADAKH,2021-02-17,2,134,1,137,
LADAKH,LEH LADAKH,2021-02-18,1,288,1,290,
LADAKH,LEH LADAKH,2021-02-19,2,171,0,173,
LADAKH,LEH LADAKH,2021-02-20,0,250,0,250,
LAKSHADWEEP,LAKSHADWEEP DISTRICT,2021-02-16,5,374,0,379,
LAKSHADWEEP,LAKSHADWEEP DISTRICT,2021-02-17,0,277,0,277,
LAKSHADWEEP,LAKSHADWEEP DISTRICT,2021-02-18,1,449,0,450,
LAKSHADWEEP,LAKSHADWEEP DISTRICT,2021-02-19,0,374,0,374,
LAKSHADWEEP,LAKSHADWEEP DISTRICT,2021-02-20,1,223,0,224,
MADHYA PRADESH,AGAR MALWA,2021-02-16,0,291,0,291,
MADHYA PRADESH,AGAR MALWA,2021-02-17,1,102,0,103,
MADHYA PRADESH,AGAR MALWA,2021-02-18,0,56,0,56,
MADHYA PRADESH,AGAR MALWA,2021-02-19,1,243,0,244,
MADHYA PRADESH,AGAR MALWA,2021-02-20,0,57,0,57,
MADHYA PRADESH,ALIRAJPUR,2021-02-16,0,99,0,99,
MADHYA PRADESH,ALIRAJPUR,2021-02-17,0,48,0,48,
MADHYA PRADESH,ALIRAJPUR,2021-02-18,0,57,0,57,
MADHYA PRADESH,ALIRAJPUR,2021-02-19,1,22,0,23,
MADHYA PRADESH,ALIRAJPUR,2021-02-20,0,96,0,96,
MADHYA PRADESH,ANUPPUR,2021-02-16,1,104,0,105,
MADHYA PRADESH,ANUPPUR,2021-02-17,1,88,0,89,
MADHYA PRADESH,ANUPPUR,2021-02-18,1,56,0,57,
MADHYA PRADESH,ANUPPUR,2021-02-19,0,30,0,30,
MADHYA PRADESH,ANUPPUR,2021-02-20,1,37,0,38,
MADHYA PRADESH,ASHOKNAGAR,2021-02-16,1,33,0,34,
MADHYA PRADESH,ASHOKNAGAR,2021-02-17,1,76,0,77,
MADHYA PRADESH,ASHOKNAGAR,2021-02-18,0,104,0,104,
MADHYA PRADESH,ASHOKNAGAR,2021-02-19,0,46,0,46,
MADHYA PRADESH,ASHOKNAGAR,2021-02-20,0,142,0,142,
MADHYA PRADESH,BALAGHAT,2021-02-16,0,519,0,519,
MADHYA PRADESH,BALAGHAT,2021-02-17,1,424,1,426,
MADHYA PRADESH,BALAGHAT,2021-02-18,1,350,0,351,
MADHYA PRADESH,BALAGHAT,2021-02-19,3,337,1,341,
MADHYA PRADESH,BALAGHAT,2021-02-20,5,310,0,315,
MADHYA PRADESH,BARWANI,2021-02-16,2,145,0,147,
MADHYA PRADESH,BARWANI,2021-02-17,4,191,0,195,
MADHYA PRADESH,BARWANI,2021-02-18,1,189,0,190,
MADHYA PRADESH,BARWANI,2021-02-19,3,196,1,200,
MADHYA PRADESH,BARWANI,2021-02-20,5,182,0,187,
MADHYA PRADESH,BETUL,2021-02-16,2,173,4,179,
MADHYA PRADESH,BETUL,2021-02-17,9,255,9,273,
MADHYA PRADESH,BETUL,2021-02-18,14,296,13,323,
MADHYA PRADESH,BETUL,2021-02-19,20,217,8,245,
MADHYA PRADESH,BETUL,2021-02-20,9,249,0,258,
MADHYA PRADESH,BHIND,2021-02-16,1,160,0,161,
MADHYA PRADESH,BHIND,2021-02-17,0,242,0,242,
MADHYA PRADESH,BHIND,2021-02-18,0,135,0,135,
MADHYA PRADESH,BHIND,2021-02-19,0,259,1,260,
MADHYA PRADESH,BHIND,2021-02-20,0,103,0,103,
MADHYA PRADESH,BHOPAL,2021-02-16,74,1374,9,1457,
MADHYA PRADESH,BHOPAL,2021-02-17,98,1511,8,1617,
MADHYA PRADESH,BHOPAL,2021-02-18,61,1250,3,1314,
MADHYA PRADESH,BHOPAL,2021-02-19,69,1320,10,1399,
MADHYA PRADESH,BHOPAL,2021-02-20,80,1372,11,1463,
MADHYA PRADESH,BURHANPUR,2021-02-16,1,163,0,164,
MADHYA PRADESH,BURHANPUR,2021-02-17,2,89,0,91,
MADHYA PRADESH,BURHANPUR,2021-02-18,5,166,1,172,
MADHYA PRADESH,BURHANPUR,2021-02-19,3,55,0,58,
MADHYA PRADESH,BURHANPUR,2021-02-20,2,237,0,239,
MADHYA PRADESH,CHHATARPUR,2021-02-16,0,88,0,88,
MADHYA PRADESH,CHHATARPUR,2021-02-17,0,262,0,262,
MADHYA PRADESH,CHHATARPUR,2021-02-18,0,123,0,123,
MADHYA PRADESH,CHHATARPUR,2021-02-19,0,327,0,327,
MADHYA PRADESH,CHHATARPUR,2021-02-20,0,139,0,139,
MADHYA PRADESH,CHHINDWARA,2021-02-16,11,415,2,428,
MADHYA PRADESH,CHHINDWARA,2021-02-17,6,436,0,442,
MADHYA PRADESH,CHHINDWARA,2021-02-18,28,352,30,410,
MADHYA PRADESH,CHHINDWARA,2021-02-19,7,393,5,405,
MADHYA PRADESH,CHHINDWARA,2021-02-20,13,347,0,360,
MADHYA PRADESH,DAMOH,2021-02-16,3,176,0,179,
MADHYA PRADESH,DAMOH,2021-02-17,6,185,1,192,
MADHYA PRADESH,DAMOH,2021-02-18,0,168,0,168,
MADHYA PRADESH,DAMOH,2021-02-19,6,166,0,172,
MADHYA PRADESH,DAMOH,2021-02-20,1,294,1,296,
MADHYA PRADESH,DATIA,2021-02-16,1,217,6,224,
MADHYA PRADESH,DATIA,2021-02-17,1,164,8,173,
MADHYA PRADESH,DATIA,2021-02-18,2,218,4,224,
MADHYA PRADESH,DATIA,2021-02-19,0,212,5,217,
MADHYA PRADESH,DATIA,2021-02-20,0,157,14,171,
MADHYA PRADESH,DEWAS,2021-02-16,0,98,0,98,
MADHYA PRADESH,DEWAS,2021-02-17,0,355,1,356,
MADHYA PRADESH,DEWAS,2021-02-18,3,151,0,154,
MADHYA PRADESH,DEWAS,2021-02-19,18,153,0,171,
MADHYA PRADESH,DEWAS,2021-02-20,7,160,0,167,
MADHYA PRADESH,DHAR,2021-02-16,0,135,0,135,
MADHYA PRADESH,DHAR,2021-02-17,2,162,0,164,
MADHYA PRADESH,DHAR,2021-02-18,9,220,0,229,
MADHYA PRADESH,DHAR,2021-02-19,0,186,0,186,
MADHYA PRADESH,DHAR,2021-02-20,8,285,0,293,
MADHYA PRADESH,DINDORI,2021-02-16,0,374,0,374,
MADHYA PRADESH,DINDORI,2021-02-17,3,309,0,312,
MADHYA PRADESH,DINDORI,2021-02-18,1,154,3,158,
MADHYA PRADESH,DINDORI,2021-02-19,0,388,0,388,
MADHYA PRADESH,DINDORI,2021-02-20,1,222,2,225,
MADHYA PRADESH,EAST NIMAR,2021-02-16,0,152,0,152,
MADHYA PRADESH,EAST NIMAR,2021-02-17,0,325,0,325,
MADHYA PRADESH,EAST NIMAR,2021-02-18,5,297,2,304,
MADHYA PRADESH,EAST NIMAR,2021-02-19,1,136,0,137,
MADHYA PRADESH,EAST NIMAR,2021-02-20,1,173,0,174,
MADHYA PRADESH,GUNA,2021-02-16,1,169,0,170,
MADHYA PRADESH,GUNA,2021-02-17,1,198,0,199,
MADHYA PRADESH,GUNA,2021-02-18,0,246,0,246,
MADHYA PRADESH,GUNA,2021-02-19,0,255,0,255,
MADHYA PRADESH,GUNA,2021-02-20,1,195,0,196,
MADHYA PRADESH,GWALIOR,2021-02-16,6,456,1,463,
MADHYA PRADESH,GWALIOR,2021-02-17,4,664,1,669,
MADHYA PRADESH,GWALIOR,2021-02-18,2,679,0,681,
MADHYA PRADESH,GWALIOR,2021-02-19,5,541,1,547,
MADHYA PRADESH,GWALIOR,2021-02-20,2,389,0,391,
MADHYA PRADESH,HARDA,2021-02-16,2,219,6,227,
MADHYA PRADESH,HARDA,2021-02-17,0,218,0,218,
MADHYA PRADESH,HARDA,2021-02-18,1,220,2,223,
MADHYA PRADESH,HARDA,2021-02-19,2,222,0,224,
MADHYA PRADESH,HARDA,2021-02-20,2,222,0,224,
MADHYA PRADESH,HOSHANGABAD,2021-02-16,1,273,0,274,
MADHYA PRADESH,HOSHANGABAD,2021-02-17,1,296,0,297,
MADHYA PRADESH,HOSHANGABAD,2021-02-18,4,282,2,288,
MADHYA PRADESH,HOSHANGABAD,2021-02-19,0,225,0,225,
MADHYA PRADESH,HOSHANGABAD,2021-02-20,5,151,0,156,
MADHYA PRADESH,INDORE,2021-02-16,134,1012,0,1146,
MADHYA PRADESH,INDORE,2021-02-17,135,1266,0,1401,
MADHYA PRADESH,INDORE,2021-02-18,208,1643,0,1851,
MADHYA PRADESH,INDORE,2021-02-19,126,1455,0,1581,
MADHYA PRADESH,INDORE,2021-02-20,170,1475,1,1646,
MADHYA PRADESH,JABALPUR,2021-02-16,13,768,1,782,
MADHYA PRADESH,JABALPUR,2021-02-17,17,1059,1,1077,
MADHYA PRADESH,JABALPUR,2021-02-18,16,868,1,885,
MADHYA PRADESH,JABALPUR,2021-02-19,20,1044,3,1067,
MADHYA PRADESH,JABALPUR,2021-02-20,15,1170,4,1189,
MADHYA PRADESH,JHABUA,2021-02-16,2,175,0,177,
MADHYA PRADESH,JHABUA,2021-02-17,3,215,0,218,
MADHYA PRADESH,JHABUA,2021-02-18,13,87,0,100,
MADHYA PRADESH,JHABUA,2021-02-19,5,211,0,216,
MADHYA PRADESH,JHABUA,2021-02-20,5,235,0,240,
MADHYA PRADESH,KATNI,2021-02-16,0,34,0,34,
MADHYA PRADESH,KATNI,2021-02-17,0,120,0,120,
MADHYA PRADESH,KATNI,2021-02-18,0,209,5,214,
MADHYA PRADESH,KATNI,2021-02-19,1,102,5,108,
MADHYA PRADESH,KATNI,2021-02-20,0,274,1,275,
MADHYA PRADESH,KHARGONE,2021-02-16,1,170,0,171,
MADHYA PRADESH,KHARGONE,2021-02-17,4,333,0,337,
MADHYA PRADESH,KHARGONE,2021-02-18,8,231,0,239,
MADHYA PRADESH,KHARGONE,2021-02-19,3,295,0,298,
MADHYA PRADESH,KHARGONE,2021-02-20,3,236,0,239,
MADHYA PRADESH,MANDLA,2021-02-16,0,291,0,291,
MADHYA PRADESH,MANDLA,2021-02-17,0,569,0,569,
MADHYA PRADESH,MANDLA,2021-02-18,0,430,0,430,
MADHYA PRADESH,MANDLA,2021-02-19,0,201,1,202,
MADHYA PRADESH,MANDLA,2021-02-20,1,241,0,242,
MADHYA PRADESH,MANDSAUR,2021-02-16,2,146,0,148,
MADHYA PRADESH,MANDSAUR,2021-02-17,6,134,0,140,
MADHYA PRADESH,MANDSAUR,2021-02-18,8,67,0,75,
MADHYA PRADESH,MANDSAUR,2021-02-19,2,107,1,110,
MADHYA PRADESH,MANDSAUR,2021-02-20,1,139,0,140,
MADHYA PRADESH,MORENA,2021-02-16,0,299,0,299,
MADHYA PRADESH,MORENA,2021-02-17,0,264,0,264,
MADHYA PRADESH,MORENA,2021-02-18,0,232,0,232,
MADHYA PRADESH,MORENA,2021-02-19,0,298,0,298,
MADHYA PRADESH,MORENA,2021-02-20,0,370,0,370,
MADHYA PRADESH,NARSINGHPUR,2021-02-16,1,587,1,589,
MADHYA PRADESH,NARSINGHPUR,2021-02-17,0,376,0,376,
MADHYA PRADESH,NARSINGHPUR,2021-02-18,2,468,0,470,
MADHYA PRADESH,NARSINGHPUR,2021-02-19,0,481,4,485,
MADHYA PRADESH,NARSINGHPUR,2021-02-20,1,479,1,481,
MADHYA PRADESH,NEEMUCH,2021-02-16,0,143,0,143,
MADHYA PRADESH,NEEMUCH,2021-02-17,4,103,1,108,
MADHYA PRADESH,NEEMUCH,2021-02-18,1,111,0,112,
MADHYA PRADESH,NEEMUCH,2021-02-19,1,129,2,132,
MADHYA PRADESH,NEEMUCH,2021-02-20,4,68,0,72,
MADHYA PRADESH,NIWARI,2021-02-16,0,38,0,38,
MADHYA PRADESH,NIWARI,2021-02-17,0,33,0,33,
MADHYA PRADESH,NIWARI,2021-02-18,0,58,0,58,
MADHYA PRADESH,NIWARI,2021-02-19,0,98,0,98,
MADHYA PRADESH,NIWARI,2021-02-20,0,88,0,88,
MADHYA PRADESH,PANNA,2021-02-16,0,67,0,67,
MADHYA PRADESH,PANNA,2021-02-17,0,78,0,78,
MADHYA PRADESH,PANNA,2021-02-18,0,320,2,322,
MADHYA PRADESH,PANNA,2021-02-19,0,67,0,67,
MADHYA PRADESH,PANNA,2021-02-20,0,85,0,85,
MADHYA PRADESH,RAISEN,2021-02-16,1,83,0,84,
MADHYA PRADESH,RAISEN,2021-02-17,1,150,0,151,
MADHYA PRADESH,RAISEN,2021-02-18,0,142,0,142,
MADHYA PRADESH,RAISEN,2021-02-19,2,148,0,150,
MADHYA PRADESH,RAISEN,2021-02-20,0,86,0,86,
MADHYA PRADESH,RAJGARH,2021-02-16,2,111,2,115,
MADHYA PRADESH,RAJGARH,2021-02-17,2,260,0,262,
MADHYA PRADESH,RAJGARH,2021-02-18,0,224,0,224,
MADHYA PRADESH,RAJGARH,2021-02-19,2,193,0,195,
MADHYA PRADESH,RAJGARH,2021-02-20,2,223,0,225,
MADHYA PRADESH,RATLAM,2021-02-16,5,158,0,163,
MADHYA PRADESH,RATLAM,2021-02-17,11,141,7,159,
MADHYA PRADESH,RATLAM,2021-02-18,5,207,0,212,
MADHYA PRADESH,RATLAM,2021-02-19,2,125,1,128,
MADHYA PRADESH,RATLAM,2021-02-20,4,340,9,353,
MADHYA PRADESH,REWA,2021-02-16,7,155,1,163,
MADHYA PRADESH,REWA,2021-02-17,6,472,4,482,
MADHYA PRADESH,REWA,2021-02-18,2,737,4,743,
MADHYA PRADESH,REWA,2021-02-19,1,662,7,670,
MADHYA PRADESH,REWA,2021-02-20,11,656,2,669,
MADHYA PRADESH,SAGAR,2021-02-16,5,654,0,659,
MADHYA PRADESH,SAGAR,2021-02-17,6,598,0,604,
MADHYA PRADESH,SAGAR,2021-02-18,3,642,0,645,
MADHYA PRADESH,SAGAR,2021-02-19,3,468,3,474,
MADHYA PRADESH,SAGAR,2021-02-20,7,639,1,647,
MADHYA PRADESH,SATNA,2021-02-16,1,299,0,300,
MADHYA PRADESH,SATNA,2021-02-17,1,304,0,305,
MADHYA PRADESH,SATNA,2021-02-18,7,458,3,468,
MADHYA PRADESH,SATNA,2021-02-19,2,119,0,121,
MADHYA PRADESH,SATNA,2021-02-20,0,182,0,182,
MADHYA PRADESH,SEHORE,2021-02-16,0,290,0,290,
MADHYA PRADESH,SEHORE,2021-02-17,0,250,0,250,
MADHYA PRADESH,SEHORE,2021-02-18,2,210,3,215,
MADHYA PRADESH,SEHORE,2021-02-19,2,257,0,259,
MADHYA PRADESH,SEHORE,2021-02-20,5,244,0,249,
MADHYA PRADESH,SEONI,2021-02-16,1,279,3,283,
MADHYA PRADESH,SEONI,2021-02-17,0,275,0,275,
MADHYA PRADESH,SEONI,2021-02-18,3,203,0,206,
MADHYA PRADESH,SEONI,2021-02-19,1,172,31,204,
MADHYA PRADESH,SEONI,2021-02-20,2,307,3,312,
MADHYA PRADESH,SHAHDOL,2021-02-16,1,43,0,44,
MADHYA PRADESH,SHAHDOL,2021-02-17,1,33,2,36,
MADHYA PRADESH,SHAHDOL,2021-02-18,0,32,0,32,
MADHYA PRADESH,SHAHDOL,2021-02-19,12,15,0,27,
MADHYA PRADESH,SHAHDOL,2021-02-20,0,19,0,19,
MADHYA PRADESH,SHAJAPUR,2021-02-16,1,183,0,184,
MADHYA PRADESH,SHAJAPUR,2021-02-17,0,253,0,253,
MADHYA PRADESH,SHAJAPUR,2021-02-18,1,213,0,214,
MADHYA PRADESH,SHAJAPUR,2021-02-19,1,184,0,185,
MADHYA PRADESH,SHAJAPUR,2021-02-20,0,87,0,87,
MADHYA PRADESH,SHEOPUR,2021-02-16,1,65,0,66,
MADHYA PRADESH,SHEOPUR,2021-02-17,1,188,0,189,
MADHYA PRADESH,SHEOPUR,2021-02-18,0,41,0,41,
MADHYA PRADESH,SHEOPUR,2021-02-19,0,37,1,38,
MADHYA PRADESH,SHEOPUR,2021-02-20,3,80,1,84,
MADHYA PRADESH,SHIVPURI,2021-02-16,1,100,1,102,
MADHYA PRADESH,SHIVPURI,2021-02-17,1,105,0,106,
MADHYA PRADESH,SHIVPURI,2021-02-18,3,147,0,150,
MADHYA PRADESH,SHIVPURI,2021-02-19,0,104,1,105,
MADHYA PRADESH,SHIVPURI,2021-02-20,1,287,7,295,
MADHYA PRADESH,SIDHI,2021-02-16,4,46,0,50,
MADHYA PRADESH,SIDHI,2021-02-17,0,142,1,143,
MADHYA PRADESH,SIDHI,2021-02-18,8,161,0,169,
MADHYA PRADESH,SIDHI,2021-02-19,7,31,0,38,
MADHYA PRADESH,SIDHI,2021-02-20,9,203,0,212,
MADHYA PRADESH,SINGRAULI,2021-02-16,2,95,1,98,
MADHYA PRADESH,SINGRAULI,2021-02-17,7,101,0,108,
MADHYA PRADESH,SINGRAULI,2021-02-18,2,92,0,94,
MADHYA PRADESH,SINGRAULI,2021-02-19,0,100,0,100,
MADHYA PRADESH,SINGRAULI,2021-02-20,1,88,0,89,
MADHYA PRADESH,TIKAMGARH,2021-02-16,0,132,0,132,
MADHYA PRADESH,TIKAMGARH,2021-02-17,0,134,2,136,
MADHYA PRADESH,TIKAMGARH,2021-02-18,1,113,1,115,
MADHYA PRADESH,TIKAMGARH,2021-02-19,0,331,0,331,
MADHYA PRADESH,TIKAMGARH,2021-02-20,0,222,0,222,
MADHYA PRADESH,UJJAIN,2021-02-16,0,261,0,261,
MADHYA PRADESH,UJJAIN,2021-02-17,19,122,0,141,
MADHYA PRADESH,UJJAIN,2021-02-18,4,114,0,118,
MADHYA PRADESH,UJJAIN,2021-02-19,3,36,1,40,
MADHYA PRADESH,UJJAIN,2021-02-20,5,138,0,143,
MADHYA PRADESH,UMARIA,2021-02-16,1,161,41,203,
MADHYA PRADESH,UMARIA,2021-02-17,1,191,101,293,
MADHYA PRADESH,UMARIA,2021-02-18,0,199,70,269,
MADHYA PRADESH,UMARIA,2021-02-19,0,170,80,250,
MADHYA PRADESH,UMARIA,2021-02-20,1,66,32,99,
MADHYA PRADESH,VIDISHA,2021-02-16,4,180,6,190,
MADHYA PRADESH,VIDISHA,2021-02-17,1,70,0,71,
MADHYA PRADESH,VIDISHA,2021-02-18,1,176,1,178,
MADHYA PRADESH,VIDISHA,2021-02-19,7,97,0,104,
MADHYA PRADESH,VIDISHA,2021-02-20,0,155,1,156,
MAHARASHTRA,AHMEDNAGAR,2021-02-16,120,1006,2,1128,
MAHARASHTRA,AHMEDNAGAR,2021-02-17,143,1699,2,1844,
MAHARASHTRA,AHMEDNAGAR,2021-02-18,133,989,4,1126,
MAHARASHTRA,AHMEDNAGAR,2021-02-19,140,693,0,833,
MAHARASHTRA,AHMEDNAGAR,2021-02-20,168,1151,0,1319,
MAHARASHTRA,AKOLA,2021-02-16,202,424,2,628,
MAHARASHTRA,AKOLA,2021-02-17,200,478,1,679,
MAHARASHTRA,AKOLA,2021-02-18,196,119,0,315,
MAHARASHTRA,AKOLA,2021-02-19,360,650,1,1011,
MAHARASHTRA,AKOLA,2021-02-20,237,740,0,977,
MAHARASHTRA,AMRAVATI,2021-02-16,646,678,5,1329,
MAHARASHTRA,AMRAVATI,2021-02-17,769,900,2,1671,
MAHARASHTRA,AMRAVATI,2021-02-18,811,1389,4,2204,
MAHARASHTRA,AMRAVATI,2021-02-19,1092,992,3,2087,
MAHARASHTRA,AMRAVATI,2021-02-20,1010,1311,1,2322,
MAHARASHTRA,AURANGABAD,2021-02-16,111,1900,5,2016,
MAHARASHTRA,AURANGABAD,2021-02-17,164,2272,2,2438,
MAHARASHTRA,AURANGABAD,2021-02-18,147,1575,2,1724,
MAHARASHTRA,AURANGABAD,2021-02-19,185,1692,25,1902,
MAHARASHTRA,AURANGABAD,2021-02-20,129,2164,1,2294,
MAHARASHTRA,BEED,2021-02-16,30,395,0,425,
MAHARASHTRA,BEED,2021-02-17,40,407,0,447,
MAHARASHTRA,BEED,2021-02-18,35,386,0,421,
MAHARASHTRA,BEED,2021-02-19,61,374,0,435,
MAHARASHTRA,BEED,2021-02-20,53,364,1,418,
MAHARASHTRA,BHANDARA,2021-02-16,14,509,0,523,
MAHARASHTRA,BHANDARA,2021-02-17,19,680,0,699,
MAHARASHTRA,BHANDARA,2021-02-18,18,590,0,608,
MAHARASHTRA,BHANDARA,2021-02-19,19,521,0,540,
MAHARASHTRA,BHANDARA,2021-02-20,21,496,1,518,
MAHARASHTRA,BULDHANA,2021-02-16,102,243,10,355,
MAHARASHTRA,BULDHANA,2021-02-17,144,205,10,359,
MAHARASHTRA,BULDHANA,2021-02-18,106,310,7,423,
MAHARASHTRA,BULDHANA,2021-02-19,139,439,8,586,
MAHARASHTRA,BULDHANA,2021-02-20,221,617,29,867,
MAHARASHTRA,CHANDRAPUR,2021-02-16,27,460,1,488,
MAHARASHTRA,CHANDRAPUR,2021-02-17,19,411,4,434,
MAHARASHTRA,CHANDRAPUR,2021-02-18,33,451,1,485,
MAHARASHTRA,CHANDRAPUR,2021-02-19,31,222,2,255,
MAHARASHTRA,CHANDRAPUR,2021-02-20,40,515,3,558,
MAHARASHTRA,DHULE,2021-02-16,23,329,3,355,
MAHARASHTRA,DHULE,2021-02-17,43,344,0,387,
MAHARASHTRA,DHULE,2021-02-18,46,429,4,479,
MAHARASHTRA,DHULE,2021-02-19,39,398,2,439,
MAHARASHTRA,DHULE,2021-02-20,39,429,2,470,
MAHARASHTRA,GADCHIROLI,2021-02-16,13,790,2,805,
MAHARASHTRA,GADCHIROLI,2021-02-17,9,675,0,684,
MAHARASHTRA,GADCHIROLI,2021-02-18,11,537,3,551,
MAHARASHTRA,GADCHIROLI,2021-02-19,2,368,0,370,
MAHARASHTRA,GADCHIROLI,2021-02-20,5,159,0,164,
MAHARASHTRA,GONDIA,2021-02-16,7,216,1,224,
MAHARASHTRA,GONDIA,2021-02-17,2,326,0,328,
MAHARASHTRA,GONDIA,2021-02-18,6,305,1,312,
MAHARASHTRA,GONDIA,2021-02-19,5,271,0,276,
MAHARASHTRA,GONDIA,2021-02-20,6,156,0,162,
MAHARASHTRA,HINGOLI,2021-02-16,0,85,0,85,
MAHARASHTRA,HINGOLI,2021-02-17,11,99,0,110,
MAHARASHTRA,HINGOLI,2021-02-18,14,239,0,253,
MAHARASHTRA,HINGOLI,2021-02-19,28,188,0,216,
MAHARASHTRA,HINGOLI,2021-02-20,13,25,0,38,
MAHARASHTRA,JALGAON,2021-02-16,148,924,0,1072,
MAHARASHTRA,JALGAON,2021-02-17,137,1127,2,1266,
MAHARASHTRA,JALGAON,2021-02-18,215,1151,4,1370,
MAHARASHTRA,JALGAON,2021-02-19,169,651,1,821,
MAHARASHTRA,JALGAON,2021-02-20,239,1126,3,1368,
MAHARASHTRA,JALNA,2021-02-16,96,1228,0,1324,
MAHARASHTRA,JALNA,2021-02-17,29,854,0,883,
MAHARASHTRA,JALNA,2021-02-18,48,1130,0,1178,
MAHARASHTRA,JALNA,2021-02-19,62,1174,0,1236,
MAHARASHTRA,JALNA,2021-02-20,67,1189,0,1256,
MAHARASHTRA,KOLHAPUR,2021-02-16,17,623,5,645,
MAHARASHTRA,KOLHAPUR,2021-02-17,18,721,4,743,
MAHARASHTRA,KOLHAPUR,2021-02-18,12,761,0,773,
MAHARASHTRA,KOLHAPUR,2021-02-19,20,639,1,660,
MAHARASHTRA,KOLHAPUR,2021-02-20,22,692,2,716,
MAHARASHTRA,LATUR,2021-02-16,44,674,1,719,
MAHARASHTRA,LATUR,2021-02-17,45,1015,1,1061,
MAHARASHTRA,LATUR,2021-02-18,44,727,1,772,
MAHARASHTRA,LATUR,2021-02-19,29,894,0,923,
MAHARASHTRA,LATUR,2021-02-20,51,763,2,816,
MAHARASHTRA,MUMBAI,2021-02-16,660,13586,72,14318,
MAHARASHTRA,MUMBAI,2021-02-17,634,16534,46,17214,
MAHARASHTRA,MUMBAI,2021-02-18,754,14209,20,14983,
MAHARASHTRA,MUMBAI,2021-02-19,784,13682,21,14487,
MAHARASHTRA,MUMBAI,2021-02-20,791,12340,67,13198,
MAHARASHTRA,MUMBAI SUBURBAN,2021-02-16,177,2846,13,3036,
MAHARASHTRA,MUMBAI SUBURBAN,2021-02-17,205,3119,5,3329,
MAHARASHTRA,MUMBAI SUBURBAN,2021-02-18,181,2897,4,3082,
MAHARASHTRA,MUMBAI SUBURBAN,2021-02-19,266,2758,5,3029,
MAHARASHTRA,MUMBAI SUBURBAN,2021-02-20,269,2416,10,2695,
MAHARASHTRA,NAGPUR,2021-02-16,583,3545,22,4150,
MAHARASHTRA,NAGPUR,2021-02-17,769,3508,30,4307,
MAHARASHTRA,NAGPUR,2021-02-18,725,3875,16,4616,
MAHARASHTRA,NAGPUR,2021-02-19,755,3635,20,4410,
MAHARASHTRA,NAGPUR,2021-02-20,901,4129,15,5045,
MAHARASHTRA,NANDED,2021-02-16,25,1007,3,1035,
MAHARASHTRA,NANDED,2021-02-17,46,904,2,952,
MAHARASHTRA,NANDED,2021-02-18,56,759,1,816,
MAHARASHTRA,NANDED,2021-02-19,42,443,6,491,
MAHARASHTRA,NANDED,2021-02-20,61,649,6,716,
MAHARASHTRA,NANDURBAR,2021-02-16,23,326,0,349,
MAHARASHTRA,NANDURBAR,2021-02-17,11,111,0,122,
MAHARASHTRA,NANDURBAR,2021-02-18,55,246,0,301,
MAHARASHTRA,NANDURBAR,2021-02-19,3,115,0,118,
MAHARASHTRA,NANDURBAR,2021-02-20,21,51,0,72,
MAHARASHTRA,NASHIK,2021-02-16,222,1121,3,1346,
MAHARASHTRA,NASHIK,2021-02-17,169,1109,7,1285,
MAHARASHTRA,NASHIK,2021-02-18,296,1085,1,1382,
MAHARASHTRA,NASHIK,2021-02-19,295,1077,0,1372,
MAHARASHTRA,NASHIK,2021-02-20,398,1294,6,1698,
MAHARASHTRA,OSMANABAD,2021-02-16,19,433,6,458,
MAHARASHTRA,OSMANABAD,2021-02-17,27,329,2,358,
MAHARASHTRA,OSMANABAD,2021-02-18,29,242,1,272,
MAHARASHTRA,OSMANABAD,2021-02-19,17,310,3,330,
MAHARASHTRA,OSMANABAD,2021-02-20,37,353,9,399,
MAHARASHTRA,PALGHAR,2021-02-16,52,729,0,781,
MAHARASHTRA,PALGHAR,2021-02-17,68,910,1,979,
MAHARASHTRA,PALGHAR,2021-02-18,39,734,1,774,
MAHARASHTRA,PALGHAR,2021-02-19,52,626,1,679,
MAHARASHTRA,PALGHAR,2021-02-20,49,814,2,865,
MAHARASHTRA,PARBHANI,2021-02-16,22,323,10,355,
MAHARASHTRA,PARBHANI,2021-02-17,29,618,1,648,
MAHARASHTRA,PARBHANI,2021-02-18,38,2415,3,2456,
MAHARASHTRA,PARBHANI,2021-02-19,21,1764,2,1787,
MAHARASHTRA,PARBHANI,2021-02-20,22,560,0,582,
MAHARASHTRA,PUNE,2021-02-16,913,4749,97,5759,
MAHARASHTRA,PUNE,2021-02-17,899,5366,53,6318,
MAHARASHTRA,PUNE,2021-02-18,1057,5562,159,6778,
MAHARASHTRA,PUNE,2021-02-19,993,5999,116,7108,
MAHARASHTRA,PUNE,2021-02-20,1211,5421,73,6705,
MAHARASHTRA,RAIGAD,2021-02-16,75,948,6,1029,
MAHARASHTRA,RAIGAD,2021-02-17,113,1198,1,1312,
MAHARASHTRA,RAIGAD,2021-02-18,108,986,1,1095,
MAHARASHTRA,RAIGAD,2021-02-19,96,1104,0,1200,
MAHARASHTRA,RAIGAD,2021-02-20,118,924,0,1042,
MAHARASHTRA,RATNAGIRI,2021-02-16,30,403,0,433,
MAHARASHTRA,RATNAGIRI,2021-02-17,3,44,0,47,
MAHARASHTRA,RATNAGIRI,2021-02-18,44,171,0,215,
MAHARASHTRA,RATNAGIRI,2021-02-19,75,337,0,412,
MAHARASHTRA,RATNAGIRI,2021-02-20,15,256,0,271,
MAHARASHTRA,SANGLI,2021-02-16,21,522,0,543,
MAHARASHTRA,SANGLI,2021-02-17,19,478,1,498,
MAHARASHTRA,SANGLI,2021-02-18,10,519,0,529,
MAHARASHTRA,SANGLI,2021-02-19,16,379,1,396,
MAHARASHTRA,SANGLI,2021-02-20,42,801,0,843,
MAHARASHTRA,SATARA,2021-02-16,90,868,11,969,
MAHARASHTRA,SATARA,2021-02-17,94,1574,3,1671,
MAHARASHTRA,SATARA,2021-02-18,76,1717,8,1801,
MAHARASHTRA,SATARA,2021-02-19,74,1822,19,1915,
MAHARASHTRA,SATARA,2021-02-20,56,1910,19,1985,
MAHARASHTRA,SINDHUDURG,2021-02-16,7,151,0,158,
MAHARASHTRA,SINDHUDURG,2021-02-17,6,215,0,221,
MAHARASHTRA,SINDHUDURG,2021-02-18,6,280,0,286,
MAHARASHTRA,SINDHUDURG,2021-02-19,1,201,0,202,
MAHARASHTRA,SINDHUDURG,2021-02-20,4,225,0,229,
MAHARASHTRA,SOLAPUR,2021-02-16,63,1457,11,1531,
MAHARASHTRA,SOLAPUR,2021-02-17,96,1863,5,1964,
MAHARASHTRA,SOLAPUR,2021-02-18,85,1901,5,1991,
MAHARASHTRA,SOLAPUR,2021-02-19,83,2555,8,2646,
MAHARASHTRA,SOLAPUR,2021-02-20,88,5417,1,5506,
MAHARASHTRA,THANE,2021-02-16,461,6963,25,7449,
MAHARASHTRA,THANE,2021-02-17,595,6993,19,7607,
MAHARASHTRA,THANE,2021-02-18,552,7665,16,8233,
MAHARASHTRA,THANE,2021-02-19,612,7192,14,7818,
MAHARASHTRA,THANE,2021-02-20,681,7564,24,8269,
MAHARASHTRA,WARDHA,2021-02-16,113,359,20,492,
MAHARASHTRA,WARDHA,2021-02-17,100,523,9,632,
MAHARASHTRA,WARDHA,2021-02-18,117,390,19,526,
MAHARASHTRA,WARDHA,2021-02-19,107,219,33,359,
MAHARASHTRA,WARDHA,2021-02-20,143,389,0,532,
MAHARASHTRA,WASHIM,2021-02-16,45,363,3,411,
MAHARASHTRA,WASHIM,2021-02-17,39,484,10,533,
MAHARASHTRA,WASHIM,2021-02-18,95,838,5,938,
MAHARASHTRA,WASHIM,2021-02-19,96,529,5,630,
MAHARASHTRA,WASHIM,2021-02-20,126,516,5,647,
MAHARASHTRA,YAVATMAL,2021-02-16,86,408,0,494,
MAHARASHTRA,YAVATMAL,2021-02-17,134,247,1,382,
MAHARASHTRA,YAVATMAL,2021-02-18,264,621,2,887,
MAHARASHTRA,YAVATMAL,2021-02-19,95,330,3,428,
MAHARASHTRA,YAVATMAL,2021-02-20,97,299,0,396,
MANIPUR,BISHNUPUR,2021-02-16,0,75,0,75,
MANIPUR,BISHNUPUR,2021-02-17,1,118,0,119,
MANIPUR,BISHNUPUR,2021-02-18,0,110,0,110,
MANIPUR,BISHNUPUR,2021-02-19,0,90,0,90,
MANIPUR,BISHNUPUR,2021-02-20,2,98,0,100,
MANIPUR,CHANDEL,2021-02-16,0,51,0,51,
MANIPUR,CHANDEL,2021-02-17,1,24,0,25,
MANIPUR,CHANDEL,2021-02-18,0,28,0,28,
MANIPUR,CHANDEL,2021-02-19,1,25,0,26,
MANIPUR,CHANDEL,2021-02-20,0,7,0,7,
MANIPUR,CHURACHANDPUR,2021-02-16,4,117,0,121,
MANIPUR,CHURACHANDPUR,2021-02-17,1,115,0,116,
MANIPUR,CHURACHANDPUR,2021-02-18,2,132,0,134,
MANIPUR,CHURACHANDPUR,2021-02-19,1,98,0,99,
MANIPUR,CHURACHANDPUR,2021-02-20,1,101,0,102,
MANIPUR,IMPHAL EAST,2021-02-16,0,193,0,193,
MANIPUR,IMPHAL EAST,2021-02-17,1,164,0,165,
MANIPUR,IMPHAL EAST,2021-02-18,0,222,0,222,
MANIPUR,IMPHAL EAST,2021-02-19,1,214,0,215,
MANIPUR,IMPHAL EAST,2021-02-20,1,147,0,148,
MANIPUR,IMPHAL WEST,2021-02-16,2,649,0,651,
MANIPUR,IMPHAL WEST,2021-02-17,2,644,0,646,
MANIPUR,IMPHAL WEST,2021-02-18,1,610,0,611,
MANIPUR,IMPHAL WEST,2021-02-19,3,722,0,725,
MANIPUR,IMPHAL WEST,2021-02-20,4,552,0,556,
MANIPUR,JIRIBAM,2021-02-16,0,2,0,2,
MANIPUR,JIRIBAM,2021-02-18,0,3,0,3,
MANIPUR,JIRIBAM,2021-02-19,0,2,0,2,
MANIPUR,KAKCHING,2021-02-16,1,62,0,63,
MANIPUR,KAKCHING,2021-02-17,1,76,0,77,
MANIPUR,KAKCHING,2021-02-18,1,50,0,51,
MANIPUR,KAKCHING,2021-02-19,7,86,0,93,
MANIPUR,KAKCHING,2021-02-20,0,41,0,41,
MANIPUR,KAMJONG,2021-02-16,0,8,0,8,
MANIPUR,KAMJONG,2021-02-17,0,3,0,3,
MANIPUR,KAMJONG,2021-02-18,0,11,0,11,
MANIPUR,KAMJONG,2021-02-19,0,15,0,15,
MANIPUR,KAMJONG,2021-02-20,0,4,0,4,
MANIPUR,KANGPOKPI,2021-02-16,0,37,0,37,
MANIPUR,KANGPOKPI,2021-02-17,0,26,0,26,
MANIPUR,KANGPOKPI,2021-02-18,0,29,0,29,
MANIPUR,KANGPOKPI,2021-02-19,0,18,0,18,
MANIPUR,KANGPOKPI,2021-02-20,0,23,0,23,
MANIPUR,NONEY,2021-02-16,0,3,0,3,
MANIPUR,NONEY,2021-02-17,0,4,0,4,
MANIPUR,NONEY,2021-02-18,0,2,0,2,
MANIPUR,NONEY,2021-02-19,0,3,0,3,
MANIPUR,NONEY,2021-02-20,0,2,0,2,
MANIPUR,PHERZAWL,2021-02-19,0,1,0,1,
MANIPUR,SENAPATI,2021-02-16,0,38,0,38,
MANIPUR,SENAPATI,2021-02-17,0,21,0,21,
MANIPUR,SENAPATI,2021-02-18,0,32,0,32,
MANIPUR,SENAPATI,2021-02-19,2,32,0,34,
MANIPUR,SENAPATI,2021-02-20,0,64,0,64,
MANIPUR,TAMENGLONG,2021-02-16,0,11,0,11,
MANIPUR,TAMENGLONG,2021-02-17,1,13,0,14,
MANIPUR,TAMENGLONG,2021-02-18,0,174,0,174,
MANIPUR,TAMENGLONG,2021-02-19,0,127,0,127,
MANIPUR,TAMENGLONG,2021-02-20,0,55,0,55,
MANIPUR,TENGNOUPAL,2021-02-16,0,6,0,6,
MANIPUR,TENGNOUPAL,2021-02-17,0,8,0,8,
MANIPUR,TENGNOUPAL,2021-02-18,0,8,0,8,
MANIPUR,TENGNOUPAL,2021-02-19,0,4,0,4,
MANIPUR,TENGNOUPAL,2021-02-20,0,7,0,7,
MANIPUR,THOUBAL,2021-02-16,0,89,0,89,
MANIPUR,THOUBAL,2021-02-17,1,145,0,146,
MANIPUR,THOUBAL,2021-02-18,2,202,0,204,
MANIPUR,THOUBAL,2021-02-19,0,134,0,134,
MANIPUR,THOUBAL,2021-02-20,0,123,0,123,
MANIPUR,UKHRUL,2021-02-16,1,65,0,66,
MANIPUR,UKHRUL,2021-02-17,1,104,0,105,
MANIPUR,UKHRUL,2021-02-18,0,151,0,151,
MANIPUR,UKHRUL,2021-02-19,0,113,0,113,
MANIPUR,UKHRUL,2021-02-20,0,81,0,81,
MEGHALAYA,EAST GARO HILLS,2021-02-16,0,17,0,17,
MEGHALAYA,EAST GARO HILLS,2021-02-17,0,33,0,33,
MEGHALAYA,EAST GARO HILLS,2021-02-18,0,17,0,17,
MEGHALAYA,EAST GARO HILLS,2021-02-19,0,11,0,11,
MEGHALAYA,EAST GARO HILLS,2021-02-20,0,12,0,12,
MEGHALAYA,EAST JAINTIA HILLS,2021-02-16,0,49,0,49,
MEGHALAYA,EAST JAINTIA HILLS,2021-02-17,0,136,0,136,
MEGHALAYA,EAST JAINTIA HILLS,2021-02-18,0,49,0,49,
MEGHALAYA,EAST JAINTIA HILLS,2021-02-19,0,14,0,14,
MEGHALAYA,EAST JAINTIA HILLS,2021-02-20,0,22,0,22,
MEGHALAYA,EAST KHASI HILLS,2021-02-16,0,477,0,477,
MEGHALAYA,EAST KHASI HILLS,2021-02-17,4,918,0,922,
MEGHALAYA,EAST KHASI HILLS,2021-02-18,2,679,0,681,
MEGHALAYA,EAST KHASI HILLS,2021-02-19,0,359,0,359,
MEGHALAYA,EAST KHASI HILLS,2021-02-20,5,678,0,683,
MEGHALAYA,NORTH GARO HILLS,2021-02-17,0,5,0,5,
MEGHALAYA,NORTH GARO HILLS,2021-02-18,0,2,0,2,
MEGHALAYA,NORTH GARO HILLS,2021-02-19,0,3,0,3,
MEGHALAYA,NORTH GARO HILLS,2021-02-20,0,14,0,14,
MEGHALAYA,RI BHOI,2021-02-16,2,67,0,69,
MEGHALAYA,RI BHOI,2021-02-17,0,60,0,60,
MEGHALAYA,RI BHOI,2021-02-18,0,203,0,203,
MEGHALAYA,RI BHOI,2021-02-19,0,81,0,81,
MEGHALAYA,RI BHOI,2021-02-20,0,109,0,109,
MEGHALAYA,SOUTH GARO HILLS,2021-02-16,0,7,0,7,
MEGHALAYA,SOUTH GARO HILLS,2021-02-17,0,5,0,5,
MEGHALAYA,SOUTH GARO HILLS,2021-02-19,0,2,0,2,
MEGHALAYA,SOUTH GARO HILLS,2021-02-20,0,2,0,2,
MEGHALAYA,SOUTH WEST GARO HILLS,2021-02-16,0,24,0,24,
MEGHALAYA,SOUTH WEST GARO HILLS,2021-02-17,0,15,0,15,
MEGHALAYA,SOUTH WEST GARO HILLS,2021-02-18,0,3,0,3,
MEGHALAYA,SOUTH WEST GARO HILLS,2021-02-19,0,11,0,11,
MEGHALAYA,SOUTH WEST GARO HILLS,2021-02-20,0,6,0,6,
MEGHALAYA,SOUTH WEST KHASI HILLS,2021-02-16,0,2,0,2,
MEGHALAYA,SOUTH WEST KHASI HILLS,2021-02-17,0,8,0,8,
MEGHALAYA,SOUTH WEST KHASI HILLS,2021-02-18,0,5,0,5,
MEGHALAYA,SOUTH WEST KHASI HILLS,2021-02-19,0,13,0,13,
MEGHALAYA,SOUTH WEST KHASI HILLS,2021-02-20,0,2,0,2,
MEGHALAYA,WEST GARO HILLS,2021-02-16,0,48,0,48,
MEGHALAYA,WEST GARO HILLS,2021-02-17,0,11,0,11,
MEGHALAYA,WEST GARO HILLS,2021-02-18,0,25,0,25,
MEGHALAYA,WEST GARO HILLS,2021-02-19,0,29,0,29,
MEGHALAYA,WEST GARO HILLS,2021-02-20,0,8,0,8,
MEGHALAYA,WEST JAINTIA HILLS,2021-02-16,0,39,0,39,
MEGHALAYA,WEST JAINTIA HILLS,2021-02-17,0,107,0,107,
MEGHALAYA,WEST JAINTIA HILLS,2021-02-18,1,92,0,93,
MEGHALAYA,WEST JAINTIA HILLS,2021-02-19,0,45,0,45,
MEGHALAYA,WEST JAINTIA HILLS,2021-02-20,1,65,0,66,
MEGHALAYA,WEST KHASI HILLS,2021-02-16,1,56,0,57,
MEGHALAYA,WEST KHASI HILLS,2021-02-17,0,77,0,77,
MEGHALAYA,WEST KHASI HILLS,2021-02-18,0,40,0,40,
MEGHALAYA,WEST KHASI HILLS,2021-02-19,0,79,0,79,
MEGHALAYA,WEST KHASI HILLS,2021-02-20,0,40,0,40,
MIZORAM,AIZAWL,2021-02-16,1,179,0,180,
MIZORAM,AIZAWL,2021-02-17,1,553,1,555,
MIZORAM,AIZAWL,2021-02-18,2,494,0,496,
MIZORAM,AIZAWL,2021-02-19,0,464,0,464,
MIZORAM,AIZAWL,2021-02-20,1,387,0,388,
MIZORAM,CHAMPHAI,2021-02-16,0,20,0,20,
MIZORAM,CHAMPHAI,2021-02-17,0,10,0,10,
MIZORAM,CHAMPHAI,2021-02-18,1,33,0,34,
MIZORAM,CHAMPHAI,2021-02-19,1,34,0,35,
MIZORAM,CHAMPHAI,2021-02-20,2,93,0,95,
MIZORAM,HNAHTHIAL,2021-02-16,0,18,0,18,
MIZORAM,HNAHTHIAL,2021-02-17,0,26,0,26,
MIZORAM,HNAHTHIAL,2021-02-18,0,30,0,30,
MIZORAM,HNAHTHIAL,2021-02-19,0,18,0,18,
MIZORAM,HNAHTHIAL,2021-02-20,0,12,0,12,
MIZORAM,KHAWZAWL,2021-02-17,0,11,0,11,
MIZORAM,KHAWZAWL,2021-02-19,0,38,0,38,
MIZORAM,KOLASIB,2021-02-16,0,202,0,202,
MIZORAM,KOLASIB,2021-02-17,0,248,0,248,
MIZORAM,KOLASIB,2021-02-18,0,203,0,203,
MIZORAM,KOLASIB,2021-02-19,0,186,0,186,
MIZORAM,KOLASIB,2021-02-20,0,176,0,176,
MIZORAM,LAWNGTLAI,2021-02-16,0,48,0,48,
MIZORAM,LAWNGTLAI,2021-02-17,2,86,0,88,
MIZORAM,LAWNGTLAI,2021-02-18,4,45,0,49,
MIZORAM,LAWNGTLAI,2021-02-19,0,33,0,33,
MIZORAM,LAWNGTLAI,2021-02-20,0,5,0,5,
MIZORAM,LUNGLEI,2021-02-16,0,23,0,23,
MIZORAM,LUNGLEI,2021-02-17,1,14,0,15,
MIZORAM,LUNGLEI,2021-02-18,0,8,0,8,
MIZORAM,LUNGLEI,2021-02-19,1,61,0,62,
MIZORAM,MAMIT,2021-02-16,0,44,0,44,
MIZORAM,MAMIT,2021-02-17,0,50,0,50,
MIZORAM,MAMIT,2021-02-18,0,16,0,16,
MIZORAM,MAMIT,2021-02-19,0,89,0,89,
MIZORAM,MAMIT,2021-02-20,0,19,0,19,
MIZORAM,SAIHA,2021-02-16,0,7,0,7,
MIZORAM,SAIHA,2021-02-17,0,5,0,5,
MIZORAM,SAIHA,2021-02-18,0,11,0,11,
MIZORAM,SAIHA,2021-02-19,0,15,0,15,
MIZORAM,SAITUAL,2021-02-16,0,12,0,12,
MIZORAM,SAITUAL,2021-02-17,1,50,0,51,
MIZORAM,SAITUAL,2021-02-18,0,52,0,52,
MIZORAM,SAITUAL,2021-02-19,0,45,0,45,
MIZORAM,SAITUAL,2021-02-20,0,19,0,19,
MIZORAM,SERCHHIP,2021-02-16,0,6,0,6,
MIZORAM,SERCHHIP,2021-02-17,0,4,0,4,
MIZORAM,SERCHHIP,2021-02-18,0,26,0,26,
MIZORAM,SERCHHIP,2021-02-19,0,30,0,30,
MIZORAM,SERCHHIP,2021-02-20,0,3,0,3,
NAGALAND,DIMAPUR,2021-02-16,1,127,0,128,
NAGALAND,DIMAPUR,2021-02-17,1,55,0,56,
NAGALAND,DIMAPUR,2021-02-18,0,142,0,142,
NAGALAND,DIMAPUR,2021-02-19,24,109,0,133,
NAGALAND,DIMAPUR,2021-02-20,11,209,0,220,
NAGALAND,KIPHIRE,2021-02-16,0,6,0,6,
NAGALAND,KIPHIRE,2021-02-17,0,3,0,3,
NAGALAND,KIPHIRE,2021-02-18,0,4,0,4,
NAGALAND,KIPHIRE,2021-02-19,0,7,0,7,
NAGALAND,KIPHIRE,2021-02-20,0,4,0,4,
NAGALAND,KOHIMA,2021-02-16,0,15,0,15,
NAGALAND,KOHIMA,2021-02-17,42,79,0,121,
NAGALAND,KOHIMA,2021-02-18,17,209,0,226,
NAGALAND,KOHIMA,2021-02-19,25,161,0,186,
NAGALAND,KOHIMA,2021-02-20,28,25,0,53,
NAGALAND,LONGLENG,2021-02-20,0,1,0,1,
NAGALAND,MOKOKCHUNG,2021-02-16,0,13,0,13,
NAGALAND,MOKOKCHUNG,2021-02-17,0,2,0,2,
NAGALAND,MOKOKCHUNG,2021-02-18,0,7,0,7,
NAGALAND,MOKOKCHUNG,2021-02-19,1,17,0,18,
NAGALAND,MOKOKCHUNG,2021-02-20,0,15,0,15,
NAGALAND,MON,2021-02-17,0,6,0,6,
NAGALAND,MON,2021-02-18,0,5,0,5,
NAGALAND,MON,2021-02-19,0,5,0,5,
NAGALAND,MON,2021-02-20,0,5,0,5,
NAGALAND,PEREN,2021-02-16,0,1,0,1,
NAGALAND,PEREN,2021-02-17,2,6,0,8,
NAGALAND,PEREN,2021-02-18,0,1,0,1,
NAGALAND,PEREN,2021-02-19,1,9,0,10,
NAGALAND,PHEK,2021-02-16,0,4,0,4,
NAGALAND,PHEK,2021-02-17,0,2,0,2,
NAGALAND,PHEK,2021-02-18,0,2,0,2,
NAGALAND,PHEK,2021-02-20,0,4,0,4,
NAGALAND,TUENSANG,2021-02-16,0,1,0,1,
NAGALAND,TUENSANG,2021-02-17,0,2,0,2,
NAGALAND,TUENSANG,2021-02-18,0,1,0,1,
NAGALAND,WOKHA,2021-02-18,0,1,0,1,
NAGALAND,WOKHA,2021-02-20,0,3,0,3,
NAGALAND,ZUNHEBOTO,2021-02-17,0,1,0,1,
NAGALAND,ZUNHEBOTO,2021-02-18,0,3,0,3,
ODISHA,ANUGUL,2021-02-16,1,348,0,349,
ODISHA,ANUGUL,2021-02-17,0,384,0,384,
ODISHA,ANUGUL,2021-02-18,2,451,0,453,
ODISHA,ANUGUL,2021-02-19,2,378,0,380,
ODISHA,ANUGUL,2021-02-20,3,531,0,534,
ODISHA,BALANGIR,2021-02-16,1,649,0,650,
ODISHA,BALANGIR,2021-02-17,2,998,2,1002,
ODISHA,BALANGIR,2021-02-18,1,867,7,875,
ODISHA,BALANGIR,2021-02-19,0,1027,0,1027,
ODISHA,BALANGIR,2021-02-20,2,1032,13,1047,
ODISHA,BALESHWAR,2021-02-16,3,2201,1,2205,
ODISHA,BALESHWAR,2021-02-17,3,2901,0,2904,
ODISHA,BALESHWAR,2021-02-18,3,2636,0,2639,
ODISHA,BALESHWAR,2021-02-19,4,2878,0,2882,
ODISHA,BALESHWAR,2021-02-20,5,2255,0,2260,
ODISHA,BARGARH,2021-02-16,1,373,0,374,
ODISHA,BARGARH,2021-02-17,4,409,0,413,
ODISHA,BARGARH,2021-02-18,4,368,0,372,
ODISHA,BARGARH,2021-02-19,0,382,0,382,
ODISHA,BARGARH,2021-02-20,0,336,0,336,
ODISHA,BHADRAK,2021-02-16,1,399,0,400,
ODISHA,BHADRAK,2021-02-17,0,587,1,588,
ODISHA,BHADRAK,2021-02-18,3,376,0,379,
ODISHA,BHADRAK,2021-02-19,3,331,0,334,
ODISHA,BHADRAK,2021-02-20,0,525,0,525,
ODISHA,BOUDH,2021-02-16,0,103,0,103,
ODISHA,BOUDH,2021-02-17,0,260,0,260,
ODISHA,BOUDH,2021-02-18,1,175,0,176,
ODISHA,BOUDH,2021-02-19,0,225,0,225,
ODISHA,BOUDH,2021-02-20,1,242,0,243,
ODISHA,CUTTACK,2021-02-16,0,810,0,810,
ODISHA,CUTTACK,2021-02-17,3,1285,0,1288,
ODISHA,CUTTACK,2021-02-18,5,1255,0,1260,
ODISHA,CUTTACK,2021-02-19,2,1263,0,1265,
ODISHA,CUTTACK,2021-02-20,5,1312,1,1318,
ODISHA,DEOGARH,2021-02-16,0,57,0,57,
ODISHA,DEOGARH,2021-02-17,0,168,0,168,
ODISHA,DEOGARH,2021-02-18,0,141,0,141,
ODISHA,DEOGARH,2021-02-19,4,356,0,360,
ODISHA,DEOGARH,2021-02-20,0,148,0,148,
ODISHA,DHENKANAL,2021-02-16,0,334,0,334,
ODISHA,DHENKANAL,2021-02-17,0,358,0,358,
ODISHA,DHENKANAL,2021-02-18,0,328,0,328,
ODISHA,DHENKANAL,2021-02-19,0,332,0,332,
ODISHA,DHENKANAL,2021-02-20,1,384,0,385,
ODISHA,GAJAPATI,2021-02-16,0,101,0,101,
ODISHA,GAJAPATI,2021-02-17,0,297,0,297,
ODISHA,GAJAPATI,2021-02-18,0,168,0,168,
ODISHA,GAJAPATI,2021-02-19,0,330,0,330,
ODISHA,GAJAPATI,2021-02-20,1,147,0,148,
ODISHA,GANJAM,2021-02-16,0,814,1,815,
ODISHA,GANJAM,2021-02-17,15,1175,17,1207,
ODISHA,GANJAM,2021-02-18,0,773,0,773,
ODISHA,GANJAM,2021-02-19,0,1097,19,1116,
ODISHA,GANJAM,2021-02-20,1,989,17,1007,
ODISHA,JAGATSINGHAPUR,2021-02-16,2,456,0,458,
ODISHA,JAGATSINGHAPUR,2021-02-17,0,593,1,594,
ODISHA,JAGATSINGHAPUR,2021-02-18,0,598,0,598,
ODISHA,JAGATSINGHAPUR,2021-02-19,0,416,0,416,
ODISHA,JAGATSINGHAPUR,2021-02-20,0,502,0,502,
ODISHA,JAJAPUR,2021-02-16,7,237,1,245,
ODISHA,JAJAPUR,2021-02-17,4,388,2,394,
ODISHA,JAJAPUR,2021-02-18,3,512,1,516,
ODISHA,JAJAPUR,2021-02-19,4,346,0,350,
ODISHA,JAJAPUR,2021-02-20,4,504,0,508,
ODISHA,JHARSUGUDA,2021-02-16,11,224,0,235,
ODISHA,JHARSUGUDA,2021-02-17,6,301,0,307,
ODISHA,JHARSUGUDA,2021-02-18,0,322,0,322,
ODISHA,JHARSUGUDA,2021-02-19,2,245,0,247,
ODISHA,JHARSUGUDA,2021-02-20,1,212,1,214,
ODISHA,KALAHANDI,2021-02-16,0,419,0,419,
ODISHA,KALAHANDI,2021-02-17,0,517,0,517,
ODISHA,KALAHANDI,2021-02-18,1,366,0,367,
ODISHA,KALAHANDI,2021-02-19,2,400,0,402,
ODISHA,KALAHANDI,2021-02-20,1,189,0,190,
ODISHA,KANDHAMAL,2021-02-16,0,638,0,638,
ODISHA,KANDHAMAL,2021-02-17,0,529,0,529,
ODISHA,KANDHAMAL,2021-02-18,0,660,0,660,
ODISHA,KANDHAMAL,2021-02-19,0,510,0,510,
ODISHA,KANDHAMAL,2021-02-20,0,629,0,629,
ODISHA,KENDRAPARA,2021-02-16,1,633,0,634,
ODISHA,KENDRAPARA,2021-02-17,0,1274,1,1275,
ODISHA,KENDRAPARA,2021-02-18,0,1253,1,1254,
ODISHA,KENDRAPARA,2021-02-19,0,1212,2,1214,
ODISHA,KENDRAPARA,2021-02-20,0,940,1,941,
ODISHA,KENDUJHAR,2021-02-16,0,778,0,778,
ODISHA,KENDUJHAR,2021-02-17,1,896,0,897,
ODISHA,KENDUJHAR,2021-02-18,0,805,0,805,
ODISHA,KENDUJHAR,2021-02-19,0,816,0,816,
ODISHA,KENDUJHAR,2021-02-20,0,535,0,535,
ODISHA,KHORDHA,2021-02-16,9,1647,3,1659,
ODISHA,KHORDHA,2021-02-17,7,1173,1,1181,
ODISHA,KHORDHA,2021-02-18,7,2117,2,2126,
ODISHA,KHORDHA,2021-02-19,8,1370,2,1380,
ODISHA,KHORDHA,2021-02-20,6,1531,4,1541,
ODISHA,KORAPUT,2021-02-16,1,1059,0,1060,
ODISHA,KORAPUT,2021-02-17,0,1141,0,1141,
ODISHA,KORAPUT,2021-02-18,3,1088,0,1091,
ODISHA,KORAPUT,2021-02-19,0,1156,0,1156,
ODISHA,KORAPUT,2021-02-20,0,969,0,969,
ODISHA,MALKANGIRI,2021-02-16,0,240,0,240,
ODISHA,MALKANGIRI,2021-02-17,0,331,0,331,
ODISHA,MALKANGIRI,2021-02-18,0,413,0,413,
ODISHA,MALKANGIRI,2021-02-19,0,297,0,297,
ODISHA,MALKANGIRI,2021-02-20,0,288,0,288,
ODISHA,MAYURBHANJ,2021-02-16,3,1027,0,1030,
ODISHA,MAYURBHANJ,2021-02-17,2,1253,0,1255,
ODISHA,MAYURBHANJ,2021-02-18,1,1712,0,1713,
ODISHA,MAYURBHANJ,2021-02-19,6,1582,1,1589,
ODISHA,MAYURBHANJ,2021-02-20,5,1191,0,1196,
ODISHA,NABARANGPUR,2021-02-16,0,820,0,820,
ODISHA,NABARANGPUR,2021-02-17,0,890,0,890,
ODISHA,NABARANGPUR,2021-02-18,0,797,0,797,
ODISHA,NABARANGPUR,2021-02-19,0,988,0,988,
ODISHA,NABARANGPUR,2021-02-20,0,766,0,766,
ODISHA,NAYAGARH,2021-02-16,0,301,0,301,
ODISHA,NAYAGARH,2021-02-17,0,548,1,549,
ODISHA,NAYAGARH,2021-02-18,0,669,0,669,
ODISHA,NAYAGARH,2021-02-19,1,381,1,383,
ODISHA,NAYAGARH,2021-02-20,0,448,0,448,
ODISHA,NUAPADA,2021-02-16,4,248,0,252,
ODISHA,NUAPADA,2021-02-17,2,214,0,216,
ODISHA,NUAPADA,2021-02-18,4,206,0,210,
ODISHA,NUAPADA,2021-02-19,1,104,0,105,
ODISHA,NUAPADA,2021-02-20,3,147,0,150,
ODISHA,PURI,2021-02-16,4,395,0,399,
ODISHA,PURI,2021-02-17,2,627,3,632,
ODISHA,PURI,2021-02-18,2,463,0,465,
ODISHA,PURI,2021-02-19,2,469,1,472,
ODISHA,PURI,2021-02-20,1,544,2,547,
ODISHA,RAYAGADA,2021-02-16,0,470,0,470,
ODISHA,RAYAGADA,2021-02-17,1,851,0,852,
ODISHA,RAYAGADA,2021-02-18,1,689,0,690,
ODISHA,RAYAGADA,2021-02-19,0,694,0,694,
ODISHA,RAYAGADA,2021-02-20,2,670,0,672,
ODISHA,SAMBALPUR,2021-02-16,16,474,0,490,
ODISHA,SAMBALPUR,2021-02-17,6,376,0,382,
ODISHA,SAMBALPUR,2021-02-18,22,629,0,651,
ODISHA,SAMBALPUR,2021-02-19,18,436,0,454,
ODISHA,SAMBALPUR,2021-02-20,32,597,0,629,
ODISHA,SONEPUR,2021-02-16,0,202,0,202,
ODISHA,SONEPUR,2021-02-17,1,253,0,254,
ODISHA,SONEPUR,2021-02-18,0,418,0,418,
ODISHA,SONEPUR,2021-02-19,0,241,0,241,
ODISHA,SONEPUR,2021-02-20,0,372,0,372,
ODISHA,SUNDARGARH,2021-02-16,5,296,1,302,
ODISHA,SUNDARGARH,2021-02-17,0,327,0,327,
ODISHA,SUNDARGARH,2021-02-18,1,475,0,476,
ODISHA,SUNDARGARH,2021-02-19,4,424,1,429,
ODISHA,SUNDARGARH,2021-02-20,5,349,0,354,
PUDUCHERRY,KARAIKAL,2021-02-16,3,277,0,280,
PUDUCHERRY,KARAIKAL,2021-02-17,3,488,0,491,
PUDUCHERRY,KARAIKAL,2021-02-18,2,406,0,408,
PUDUCHERRY,KARAIKAL,2021-02-19,5,407,0,412,
PUDUCHERRY,KARAIKAL,2021-02-20,4,369,0,373,
PUDUCHERRY,MAHE,2021-02-16,5,306,0,311,
PUDUCHERRY,MAHE,2021-02-17,4,319,0,323,
PUDUCHERRY,MAHE,2021-02-18,14,431,0,445,
PUDUCHERRY,MAHE,2021-02-19,4,401,0,405,
PUDUCHERRY,MAHE,2021-02-20,9,234,0,243,
PUDUCHERRY,PONDICHERRY,2021-02-16,15,452,3,470,
PUDUCHERRY,PONDICHERRY,2021-02-17,25,386,0,411,
PUDUCHERRY,PONDICHERRY,2021-02-18,15,402,6,423,
PUDUCHERRY,PONDICHERRY,2021-02-19,19,418,8,445,
PUDUCHERRY,PONDICHERRY,2021-02-20,14,294,6,314,
PUDUCHERRY,YANAM,2021-02-16,0,12,0,12,
PUDUCHERRY,YANAM,2021-02-17,0,143,0,143,
PUDUCHERRY,YANAM,2021-02-18,0,88,0,88,
PUDUCHERRY,YANAM,2021-02-19,0,66,0,66,
PUDUCHERRY,YANAM,2021-02-20,0,142,0,142,
PUNJAB,AMRITSAR,2021-02-16,17,1093,4,1114,
PUNJAB,AMRITSAR,2021-02-17,24,1163,1,1188,
PUNJAB,AMRITSAR,2021-02-18,15,1621,4,1640,
PUNJAB,AMRITSAR,2021-02-19,26,1717,3,1746,
PUNJAB,AMRITSAR,2021-02-20,49,1059,6,1114,
PUNJAB,BARNALA,2021-02-16,2,193,0,195,
PUNJAB,BARNALA,2021-02-17,2,183,0,185,
PUNJAB,BARNALA,2021-02-18,1,138,5,144,
PUNJAB,BARNALA,2021-02-19,1,128,1,130,
PUNJAB,BARNALA,2021-02-20,0,170,12,182,
PUNJAB,BATHINDA,2021-02-16,6,586,8,600,
PUNJAB,BATHINDA,2021-02-17,11,540,1,552,
PUNJAB,BATHINDA,2021-02-18,21,642,2,665,
PUNJAB,BATHINDA,2021-02-19,11,586,2,599,
PUNJAB,BATHINDA,2021-02-20,5,682,0,687,
PUNJAB,FARIDKOT,2021-02-16,2,254,0,256,
PUNJAB,FARIDKOT,2021-02-17,5,259,1,265,
PUNJAB,FARIDKOT,2021-02-18,8,268,2,278,
PUNJAB,FARIDKOT,2021-02-19,9,260,4,273,
PUNJAB,FARIDKOT,2021-02-20,6,218,2,226,
PUNJAB,FATEHGARH SAHIB,2021-02-16,5,298,0,303,
PUNJAB,FATEHGARH SAHIB,2021-02-17,6,351,0,357,
PUNJAB,FATEHGARH SAHIB,2021-02-18,9,366,1,376,
PUNJAB,FATEHGARH SAHIB,2021-02-19,10,376,2,388,
PUNJAB,FATEHGARH SAHIB,2021-02-20,0,86,0,86,
PUNJAB,FAZILKA,2021-02-16,1,74,0,75,
PUNJAB,FAZILKA,2021-02-17,0,341,4,345,
PUNJAB,FAZILKA,2021-02-18,1,212,2,215,
PUNJAB,FAZILKA,2021-02-19,2,134,0,136,
PUNJAB,FAZILKA,2021-02-20,1,132,3,136,
PUNJAB,FIROZEPUR,2021-02-16,2,223,0,225,
PUNJAB,FIROZEPUR,2021-02-17,4,133,0,137,
PUNJAB,FIROZEPUR,2021-02-18,6,313,0,319,
PUNJAB,FIROZEPUR,2021-02-19,0,205,0,205,
PUNJAB,FIROZEPUR,2021-02-20,2,200,1,203,
PUNJAB,GURDASPUR,2021-02-16,5,1382,19,1406,
PUNJAB,GURDASPUR,2021-02-17,9,776,0,785,
PUNJAB,GURDASPUR,2021-02-18,4,791,0,795,
PUNJAB,GURDASPUR,2021-02-19,6,1371,5,1382,
PUNJAB,GURDASPUR,2021-02-20,16,445,9,470,
PUNJAB,HOSHIARPUR,2021-02-16,23,687,3,713,
PUNJAB,HOSHIARPUR,2021-02-17,25,1040,5,1070,
PUNJAB,HOSHIARPUR,2021-02-18,43,1385,3,1431,
PUNJAB,HOSHIARPUR,2021-02-19,30,559,7,596,
PUNJAB,HOSHIARPUR,2021-02-20,52,1483,3,1538,
PUNJAB,JALANDHAR,2021-02-16,30,1885,1,1916,
PUNJAB,JALANDHAR,2021-02-17,54,2283,134,2471,
PUNJAB,JALANDHAR,2021-02-18,85,3386,172,3643,
PUNJAB,JALANDHAR,2021-02-19,54,1711,125,1890,
PUNJAB,JALANDHAR,2021-02-20,56,1866,7,1929,
PUNJAB,KAPURTHALA,2021-02-16,13,500,4,517,
PUNJAB,KAPURTHALA,2021-02-17,15,1240,11,1266,
PUNJAB,KAPURTHALA,2021-02-18,28,702,17,747,
PUNJAB,KAPURTHALA,2021-02-19,34,971,14,1019,
PUNJAB,KAPURTHALA,2021-02-20,34,404,1,439,
PUNJAB,LUDHIANA,2021-02-16,51,1473,7,1531,
PUNJAB,LUDHIANA,2021-02-17,46,2091,28,2165,
PUNJAB,LUDHIANA,2021-02-18,67,2767,100,2934,
PUNJAB,LUDHIANA,2021-02-19,57,2865,27,2949,
PUNJAB,LUDHIANA,2021-02-20,70,2247,13,2330,
PUNJAB,MANSA,2021-02-16,1,406,1,408,
PUNJAB,MANSA,2021-02-17,1,412,1,414,
PUNJAB,MANSA,2021-02-18,1,461,0,462,
PUNJAB,MANSA,2021-02-19,1,67,0,68,
PUNJAB,MANSA,2021-02-20,0,274,1,275,
PUNJAB,MOGA,2021-02-16,0,93,0,93,
PUNJAB,MOGA,2021-02-17,7,258,2,267,
PUNJAB,MOGA,2021-02-18,4,256,3,263,
PUNJAB,MOGA,2021-02-19,9,145,0,154,
PUNJAB,MOGA,2021-02-20,2,211,3,216,
PUNJAB,PATHANKOT,2021-02-16,0,109,1,110,
PUNJAB,PATHANKOT,2021-02-17,0,636,1,637,
PUNJAB,PATHANKOT,2021-02-18,2,665,1,668,
PUNJAB,PATHANKOT,2021-02-19,11,111,0,122,
PUNJAB,PATHANKOT,2021-02-20,5,423,0,428,
PUNJAB,PATIALA,2021-02-16,22,1109,0,1131,
PUNJAB,PATIALA,2021-02-17,32,1070,1,1103,
PUNJAB,PATIALA,2021-02-18,40,1368,0,1408,
PUNJAB,PATIALA,2021-02-19,38,1316,0,1354,
PUNJAB,PATIALA,2021-02-20,32,1499,1,1532,
PUNJAB,RUPNAGAR,2021-02-16,6,631,0,637,
PUNJAB,RUPNAGAR,2021-02-17,6,701,1,708,
PUNJAB,RUPNAGAR,2021-02-18,7,629,3,639,
PUNJAB,RUPNAGAR,2021-02-19,8,331,2,341,
PUNJAB,RUPNAGAR,2021-02-20,7,516,3,526,
PUNJAB,S.A.S NAGAR,2021-02-16,24,973,6,1003,
PUNJAB,S.A.S NAGAR,2021-02-17,45,931,8,984,
PUNJAB,S.A.S NAGAR,2021-02-18,50,1057,2,1109,
PUNJAB,S.A.S NAGAR,2021-02-19,31,1186,2,1219,
PUNJAB,S.A.S NAGAR,2021-02-20,44,962,21,1027,
PUNJAB,SANGRUR,2021-02-16,6,2081,0,2087,
PUNJAB,SANGRUR,2021-02-17,1,2447,0,2448,
PUNJAB,SANGRUR,2021-02-18,3,1464,1,1468,
PUNJAB,SANGRUR,2021-02-19,8,1063,1,1072,
PUNJAB,SANGRUR,2021-02-20,7,1037,3,1047,
PUNJAB,SHAHID BHAGAT SINGH NAGAR,2021-02-16,37,1092,1,1130,
PUNJAB,SHAHID BHAGAT SINGH NAGAR,2021-02-17,111,993,0,1104,
PUNJAB,SHAHID BHAGAT SINGH NAGAR,2021-02-18,52,892,3,947,
PUNJAB,SHAHID BHAGAT SINGH NAGAR,2021-02-19,62,906,0,968,
PUNJAB,SHAHID BHAGAT SINGH NAGAR,2021-02-20,72,855,0,927,
PUNJAB,SRI MUKTSAR SAHIB,2021-02-16,0,53,0,53,
PUNJAB,SRI MUKTSAR SAHIB,2021-02-17,0,267,1,268,
PUNJAB,SRI MUKTSAR SAHIB,2021-02-18,11,337,2,350,
PUNJAB,SRI MUKTSAR SAHIB,2021-02-19,3,165,0,168,
PUNJAB,SRI MUKTSAR SAHIB,2021-02-20,1,216,1,218,
PUNJAB,TARN TARAN,2021-02-16,1,669,0,670,
PUNJAB,TARN TARAN,2021-02-17,5,401,0,406,
PUNJAB,TARN TARAN,2021-02-18,3,173,1,177,
PUNJAB,TARN TARAN,2021-02-19,2,520,2,524,
PUNJAB,TARN TARAN,2021-02-20,8,475,1,484,
RAJASTHAN,AJMER,2021-02-16,1,52,394,447,
RAJASTHAN,AJMER,2021-02-17,1,60,527,588,
RAJASTHAN,AJMER,2021-02-18,1,86,491,578,
RAJASTHAN,AJMER,2021-02-19,2,72,390,464,
RAJASTHAN,AJMER,2021-02-20,9,65,612,686,
RAJASTHAN,ALWAR,2021-02-16,3,1828,16,1847,
RAJASTHAN,ALWAR,2021-02-17,2,3420,54,3476,
RAJASTHAN,ALWAR,2021-02-18,0,3334,67,3401,
RAJASTHAN,ALWAR,2021-02-19,1,3336,163,3500,
RAJASTHAN,ALWAR,2021-02-20,2,3042,364,3408,
RAJASTHAN,BANSWARA,2021-02-16,0,119,0,119,
RAJASTHAN,BANSWARA,2021-02-17,2,28,0,30,
RAJASTHAN,BANSWARA,2021-02-18,5,49,1,55,
RAJASTHAN,BANSWARA,2021-02-19,16,147,1,164,
RAJASTHAN,BANSWARA,2021-02-20,5,60,0,65,
RAJASTHAN,BARAN,2021-02-16,0,69,0,69,
RAJASTHAN,BARAN,2021-02-17,0,72,0,72,
RAJASTHAN,BARAN,2021-02-18,0,99,0,99,
RAJASTHAN,BARAN,2021-02-19,0,132,0,132,
RAJASTHAN,BARAN,2021-02-20,4,62,0,66,
RAJASTHAN,BARMER,2021-02-16,0,109,2,111,
RAJASTHAN,BARMER,2021-02-17,1,254,0,255,
RAJASTHAN,BARMER,2021-02-18,0,353,0,353,
RAJASTHAN,BARMER,2021-02-19,0,195,0,195,
RAJASTHAN,BARMER,2021-02-20,1,67,0,68,
RAJASTHAN,BHARATPUR,2021-02-16,4,480,2,486,
RAJASTHAN,BHARATPUR,2021-02-17,5,457,2,464,
RAJASTHAN,BHARATPUR,2021-02-18,1,440,4,445,
RAJASTHAN,BHARATPUR,2021-02-19,0,152,3,155,
RAJASTHAN,BHARATPUR,2021-02-20,2,515,5,522,
RAJASTHAN,BHILWARA,2021-02-16,8,327,2,337,
RAJASTHAN,BHILWARA,2021-02-17,5,378,4,387,
RAJASTHAN,BHILWARA,2021-02-18,11,310,4,325,
RAJASTHAN,BHILWARA,2021-02-19,10,370,1,381,
RAJASTHAN,BHILWARA,2021-02-20,17,348,2,367,
RAJASTHAN,BIKANER,2021-02-16,8,1390,3,1401,
RAJASTHAN,BIKANER,2021-02-17,0,1545,1,1546,
RAJASTHAN,BIKANER,2021-02-18,5,1351,1,1357,
RAJASTHAN,BIKANER,2021-02-19,21,1668,7,1696,
RAJASTHAN,BIKANER,2021-02-20,3,1604,1,1608,
RAJASTHAN,BUNDI,2021-02-16,0,68,3,71,
RAJASTHAN,BUNDI,2021-02-17,0,195,0,195,
RAJASTHAN,BUNDI,2021-02-18,1,163,0,164,
RAJASTHAN,BUNDI,2021-02-19,0,163,0,163,
RAJASTHAN,BUNDI,2021-02-20,0,67,0,67,
RAJASTHAN,CHITTORGARH,2021-02-16,0,707,3,710,
RAJASTHAN,CHITTORGARH,2021-02-17,49,687,3,739,
RAJASTHAN,CHITTORGARH,2021-02-18,1,532,0,533,
RAJASTHAN,CHITTORGARH,2021-02-19,15,85,4,104,
RAJASTHAN,CHITTORGARH,2021-02-20,2,797,1,800,
RAJASTHAN,CHURU,2021-02-16,2,357,6,365,
RAJASTHAN,CHURU,2021-02-17,1,425,0,426,
RAJASTHAN,CHURU,2021-02-18,1,420,1,422,
RAJASTHAN,CHURU,2021-02-19,2,401,3,406,
RAJASTHAN,CHURU,2021-02-20,0,332,5,337,
RAJASTHAN,DAUSA,2021-02-16,0,124,5,129,
RAJASTHAN,DAUSA,2021-02-17,0,420,1,421,
RAJASTHAN,DAUSA,2021-02-18,0,278,10,288,
RAJASTHAN,DAUSA,2021-02-19,1,361,12,374,
RAJASTHAN,DAUSA,2021-02-20,0,329,9,338,
RAJASTHAN,DHOLPUR,2021-02-16,7,515,15,537,
RAJASTHAN,DHOLPUR,2021-02-17,1,11,0,12,
RAJASTHAN,DHOLPUR,2021-02-18,1,92,1,94,
RAJASTHAN,DHOLPUR,2021-02-19,5,380,19,404,
RAJASTHAN,DHOLPUR,2021-02-20,6,423,3,432,
RAJASTHAN,DUNGARPUR,2021-02-16,2,270,0,272,
RAJASTHAN,DUNGARPUR,2021-02-17,2,373,0,375,
RAJASTHAN,DUNGARPUR,2021-02-18,2,292,0,294,
RAJASTHAN,DUNGARPUR,2021-02-19,4,263,0,267,
RAJASTHAN,DUNGARPUR,2021-02-20,3,281,0,284,
RAJASTHAN,GANGANAGAR,2021-02-16,170,382,34,586,
RAJASTHAN,GANGANAGAR,2021-02-17,109,369,37,515,
RAJASTHAN,GANGANAGAR,2021-02-18,142,376,34,552,
RAJASTHAN,GANGANAGAR,2021-02-19,205,325,28,558,
RAJASTHAN,GANGANAGAR,2021-02-20,118,284,19,421,
RAJASTHAN,HANUMANGARH,2021-02-16,1,679,0,680,
RAJASTHAN,HANUMANGARH,2021-02-17,0,525,0,525,
RAJASTHAN,HANUMANGARH,2021-02-18,0,535,1,536,
RAJASTHAN,HANUMANGARH,2021-02-19,1,577,5,583,
RAJASTHAN,HANUMANGARH,2021-02-20,0,477,0,477,
RAJASTHAN,JAIPUR,2021-02-16,45,2393,288,2726,
RAJASTHAN,JAIPUR,2021-02-17,74,1952,267,2293,
RAJASTHAN,JAIPUR,2021-02-18,54,2253,310,2617,
RAJASTHAN,JAIPUR,2021-02-19,63,2359,347,2769,
RAJASTHAN,JAIPUR,2021-02-20,57,2147,230,2434,
RAJASTHAN,JAISALMER,2021-02-16,7,218,0,225,
RAJASTHAN,JAISALMER,2021-02-17,0,121,0,121,
RAJASTHAN,JAISALMER,2021-02-18,0,110,0,110,
RAJASTHAN,JAISALMER,2021-02-19,0,67,0,67,
RAJASTHAN,JAISALMER,2021-02-20,1,117,0,118,
RAJASTHAN,JALORE,2021-02-16,0,595,0,595,
RAJASTHAN,JALORE,2021-02-17,1,521,3,525,
RAJASTHAN,JALORE,2021-02-18,0,856,0,856,
RAJASTHAN,JALORE,2021-02-19,0,138,0,138,
RAJASTHAN,JALORE,2021-02-20,0,156,0,156,
RAJASTHAN,JHALAWAR,2021-02-16,1,304,0,305,
RAJASTHAN,JHALAWAR,2021-02-17,0,874,0,874,
RAJASTHAN,JHALAWAR,2021-02-18,1,503,0,504,
RAJASTHAN,JHALAWAR,2021-02-19,12,626,6,644,
RAJASTHAN,JHALAWAR,2021-02-20,0,290,0,290,
RAJASTHAN,JHUNJHUNU,2021-02-16,1,67,3,71,
RAJASTHAN,JHUNJHUNU,2021-02-17,1,72,2,75,
RAJASTHAN,JHUNJHUNU,2021-02-18,3,84,5,92,
RAJASTHAN,JHUNJHUNU,2021-02-19,1,66,1,68,
RAJASTHAN,JHUNJHUNU,2021-02-20,0,82,7,89,
RAJASTHAN,JODHPUR,2021-02-16,21,1283,2,1306,
RAJASTHAN,JODHPUR,2021-02-17,14,1556,1,1571,
RAJASTHAN,JODHPUR,2021-02-18,13,1530,7,1550,
RAJASTHAN,JODHPUR,2021-02-19,10,1160,2,1172,
RAJASTHAN,JODHPUR,2021-02-20,11,1019,7,1037,
RAJASTHAN,KARAULI,2021-02-16,6,203,8,217,
RAJASTHAN,KARAULI,2021-02-17,1,224,8,233,
RAJASTHAN,KARAULI,2021-02-18,0,420,5,425,
RAJASTHAN,KARAULI,2021-02-19,0,172,3,175,
RAJASTHAN,KARAULI,2021-02-20,2,217,1,220,
RAJASTHAN,KOTA,2021-02-16,0,1107,2,1109,
RAJASTHAN,KOTA,2021-02-17,0,974,1,975,
RAJASTHAN,KOTA,2021-02-18,0,831,2,833,
RAJASTHAN,KOTA,2021-02-19,1,1024,0,1025,
RAJASTHAN,KOTA,2021-02-20,94,1002,1,1097,
RAJASTHAN,NAGAUR,2021-02-16,0,47,143,190,
RAJASTHAN,NAGAUR,2021-02-17,3,198,163,364,
RAJASTHAN,NAGAUR,2021-02-18,1,165,235,401,
RAJASTHAN,NAGAUR,2021-02-19,0,402,322,724,
RAJASTHAN,NAGAUR,2021-02-20,0,155,468,623,
RAJASTHAN,PALI,2021-02-16,1,17,0,18,
RAJASTHAN,PALI,2021-02-17,0,33,3,36,
RAJASTHAN,PALI,2021-02-18,0,20,1,21,
RAJASTHAN,PALI,2021-02-19,2,142,5,149,
RAJASTHAN,PALI,2021-02-20,0,20,1,21,
RAJASTHAN,PRATAPGARH,2021-02-16,1,4,0,5,
RAJASTHAN,PRATAPGARH,2021-02-17,0,10,0,10,
RAJASTHAN,PRATAPGARH,2021-02-18,0,3,0,3,
RAJASTHAN,PRATAPGARH,2021-02-19,0,3,0,3,
RAJASTHAN,PRATAPGARH,2021-02-20,0,5,0,5,
RAJASTHAN,RAJSAMAND,2021-02-16,4,498,0,502,
RAJASTHAN,RAJSAMAND,2021-02-17,9,865,1,875,
RAJASTHAN,RAJSAMAND,2021-02-18,26,590,1,617,
RAJASTHAN,RAJSAMAND,2021-02-19,41,694,0,735,
RAJASTHAN,RAJSAMAND,2021-02-20,35,791,0,826,
RAJASTHAN,SAWAI MADHOPUR,2021-02-16,1,106,6,113,
RAJASTHAN,SAWAI MADHOPUR,2021-02-17,1,183,9,193,
RAJASTHAN,SAWAI MADHOPUR,2021-02-18,0,108,0,108,
RAJASTHAN,SAWAI MADHOPUR,2021-02-19,0,163,6,169,
RAJASTHAN,SAWAI MADHOPUR,2021-02-20,1,479,4,484,
RAJASTHAN,SIKAR,2021-02-16,0,336,5,341,
RAJASTHAN,SIKAR,2021-02-17,1,392,7,400,
RAJASTHAN,SIKAR,2021-02-18,0,360,7,367,
RAJASTHAN,SIKAR,2021-02-19,0,301,6,307,
RAJASTHAN,SIKAR,2021-02-20,0,350,8,358,
RAJASTHAN,SIROHI,2021-02-16,13,225,0,238,
RAJASTHAN,SIROHI,2021-02-17,7,272,0,279,
RAJASTHAN,SIROHI,2021-02-18,9,192,0,201,
RAJASTHAN,SIROHI,2021-02-19,10,369,0,379,
RAJASTHAN,SIROHI,2021-02-20,4,323,0,327,
RAJASTHAN,TONK,2021-02-16,0,484,12,496,
RAJASTHAN,TONK,2021-02-17,0,435,13,448,
RAJASTHAN,TONK,2021-02-18,0,577,8,585,
RAJASTHAN,TONK,2021-02-19,1,256,17,274,
RAJASTHAN,TONK,2021-02-20,0,284,3,287,
RAJASTHAN,UDAIPUR,2021-02-16,16,738,1,755,
RAJASTHAN,UDAIPUR,2021-02-17,37,493,0,530,
RAJASTHAN,UDAIPUR,2021-02-18,26,727,1,754,
RAJASTHAN,UDAIPUR,2021-02-19,38,673,2,713,
RAJASTHAN,UDAIPUR,2021-02-20,55,557,2,614,
SIKKIM,EAST DISTRICT,2021-02-16,1,137,0,138,
SIKKIM,EAST DISTRICT,2021-02-17,4,55,0,59,
SIKKIM,EAST DISTRICT,2021-02-18,3,221,0,224,
SIKKIM,EAST DISTRICT,2021-02-19,0,134,0,134,
SIKKIM,EAST DISTRICT,2021-02-20,0,122,0,122,
SIKKIM,NORTH DISTRICT,2021-02-16,0,14,0,14,
SIKKIM,NORTH DISTRICT,2021-02-17,0,2,0,2,
SIKKIM,NORTH DISTRICT,2021-02-18,0,3,0,3,
SIKKIM,NORTH DISTRICT,2021-02-19,0,1,0,1,
SIKKIM,NORTH DISTRICT,2021-02-20,0,1,0,1,
SIKKIM,SOUTH DISTRICT,2021-02-16,0,15,0,15,
SIKKIM,SOUTH DISTRICT,2021-02-17,0,9,0,9,
SIKKIM,SOUTH DISTRICT,2021-02-18,0,31,0,31,
SIKKIM,SOUTH DISTRICT,2021-02-19,0,5,0,5,
SIKKIM,SOUTH DISTRICT,2021-02-20,4,32,1,37,
SIKKIM,WEST DISTRICT,2021-02-16,0,6,0,6,
SIKKIM,WEST DISTRICT,2021-02-17,0,3,0,3,
SIKKIM,WEST DISTRICT,2021-02-18,0,10,0,10,
SIKKIM,WEST DISTRICT,2021-02-19,1,2,0,3,
SIKKIM,WEST DISTRICT,2021-02-20,0,5,0,5,
TAMIL NADU,ARIYALUR,2021-02-16,1,76,0,77,
TAMIL NADU,ARIYALUR,2021-02-17,0,352,0,352,
TAMIL NADU,ARIYALUR,2021-02-18,2,901,0,903,
TAMIL NADU,ARIYALUR,2021-02-19,2,612,0,614,
TAMIL NADU,ARIYALUR,2021-02-20,0,72,0,72,
TAMIL NADU,CHENGALPATTU,2021-02-16,35,2703,1,2739,
TAMIL NADU,CHENGALPATTU,2021-02-17,33,2613,0,2646,
TAMIL NADU,CHENGALPATTU,2021-02-18,32,2891,0,2923,
TAMIL NADU,CHENGALPATTU,2021-02-19,40,3263,0,3303,
TAMIL NADU,CHENGALPATTU,2021-02-20,19,2324,0,2343,
TAMIL NADU,CHENNAI,2021-02-16,186,10931,15,11132,
TAMIL NADU,CHENNAI,2021-02-17,161,11113,13,11287,
TAMIL NADU,CHENNAI,2021-02-18,182,10871,10,11063,
TAMIL NADU,CHENNAI,2021-02-19,208,10507,22,10737,
TAMIL NADU,CHENNAI,2021-02-20,171,10438,5,10614,
TAMIL NADU,COIMBATORE,2021-02-16,47,2119,0,2166,
TAMIL NADU,COIMBATORE,2021-02-17,70,2184,0,2254,
TAMIL NADU,COIMBATORE,2021-02-18,62,1655,0,1717,
TAMIL NADU,COIMBATORE,2021-02-19,54,2766,41,2861,
TAMIL NADU,COIMBATORE,2021-02-20,50,1986,48,2084,
TAMIL NADU,CUDDALORE,2021-02-16,7,808,2,817,
TAMIL NADU,CUDDALORE,2021-02-17,8,1529,3,1540,
TAMIL NADU,CUDDALORE,2021-02-18,11,1161,1,1173,
TAMIL NADU,CUDDALORE,2021-02-19,4,1282,0,1286,
TAMIL NADU,CUDDALORE,2021-02-20,8,964,0,972,
TAMIL NADU,DHARMAPURI,2021-02-16,3,651,0,654,
TAMIL NADU,DHARMAPURI,2021-02-17,3,466,0,469,
TAMIL NADU,DHARMAPURI,2021-02-18,2,806,1,809,
TAMIL NADU,DHARMAPURI,2021-02-19,2,623,1,626,
TAMIL NADU,DHARMAPURI,2021-02-20,1,617,0,618,
TAMIL NADU,DINDIGUL,2021-02-16,9,357,2,368,
TAMIL NADU,DINDIGUL,2021-02-17,6,165,0,171,
TAMIL NADU,DINDIGUL,2021-02-18,4,371,9,384,
TAMIL NADU,DINDIGUL,2021-02-19,8,532,3,543,
TAMIL NADU,DINDIGUL,2021-02-20,4,423,0,427,
TAMIL NADU,ERODE,2021-02-16,22,1181,0,1203,
TAMIL NADU,ERODE,2021-02-17,14,1342,0,1356,
TAMIL NADU,ERODE,2021-02-18,18,1373,0,1391,
TAMIL NADU,ERODE,2021-02-19,7,1252,0,1259,
TAMIL NADU,ERODE,2021-02-20,11,1217,0,1228,
TAMIL NADU,KALLAKURICHI,2021-02-16,0,262,0,262,
TAMIL NADU,KALLAKURICHI,2021-02-17,0,375,1,376,
TAMIL NADU,KALLAKURICHI,2021-02-18,0,661,1,662,
TAMIL NADU,KALLAKURICHI,2021-02-19,1,350,0,351,
TAMIL NADU,KALLAKURICHI,2021-02-20,0,241,0,241,
TAMIL NADU,KANCHIPURAM,2021-02-16,18,2059,0,2077,
TAMIL NADU,KANCHIPURAM,2021-02-17,22,1686,0,1708,
TAMIL NADU,KANCHIPURAM,2021-02-18,12,2593,0,2605,
TAMIL NADU,KANCHIPURAM,2021-02-19,14,2645,2,2661,
TAMIL NADU,KANCHIPURAM,2021-02-20,15,2496,0,2511,
TAMIL NADU,KANNIYAKUMARI,2021-02-16,8,1542,2,1552,
TAMIL NADU,KANNIYAKUMARI,2021-02-17,10,1568,7,1585,
TAMIL NADU,KANNIYAKUMARI,2021-02-18,10,1623,8,1641,
TAMIL NADU,KANNIYAKUMARI,2021-02-19,12,1624,4,1640,
TAMIL NADU,KANNIYAKUMARI,2021-02-20,14,1226,3,1243,
TAMIL NADU,KARUR,2021-02-16,3,914,0,917,
TAMIL NADU,KARUR,2021-02-17,4,1129,0,1133,
TAMIL NADU,KARUR,2021-02-18,3,956,0,959,
TAMIL NADU,KARUR,2021-02-19,2,1099,1,1102,
TAMIL NADU,KARUR,2021-02-20,2,938,0,940,
TAMIL NADU,KRISHNAGIRI,2021-02-16,5,1469,4,1478,
TAMIL NADU,KRISHNAGIRI,2021-02-17,2,1124,0,1126,
TAMIL NADU,KRISHNAGIRI,2021-02-18,1,1304,0,1305,
TAMIL NADU,KRISHNAGIRI,2021-02-19,5,1103,0,1108,
TAMIL NADU,KRISHNAGIRI,2021-02-20,2,1233,3,1238,
TAMIL NADU,MADURAI,2021-02-16,11,2363,0,2374,
TAMIL NADU,MADURAI,2021-02-17,7,2396,4,2407,
TAMIL NADU,MADURAI,2021-02-18,6,2340,0,2346,
TAMIL NADU,MADURAI,2021-02-19,6,1694,0,1700,
TAMIL NADU,MADURAI,2021-02-20,14,2633,0,2647,
TAMIL NADU,NAGAPATTINAM,2021-02-16,3,487,0,490,
TAMIL NADU,NAGAPATTINAM,2021-02-17,4,565,0,569,
TAMIL NADU,NAGAPATTINAM,2021-02-18,4,432,0,436,
TAMIL NADU,NAGAPATTINAM,2021-02-19,4,337,0,341,
TAMIL NADU,NAGAPATTINAM,2021-02-20,3,362,1,366,
TAMIL NADU,NAMAKKAL,2021-02-16,4,1767,1,1772,
TAMIL NADU,NAMAKKAL,2021-02-17,5,1101,0,1106,
TAMIL NADU,NAMAKKAL,2021-02-18,6,1336,3,1345,
TAMIL NADU,NAMAKKAL,2021-02-19,4,1255,0,1259,
TAMIL NADU,NAMAKKAL,2021-02-20,7,940,0,947,
TAMIL NADU,PERAMBALUR,2021-02-16,1,225,0,226,
TAMIL NADU,PERAMBALUR,2021-02-17,1,200,0,201,
TAMIL NADU,PERAMBALUR,2021-02-18,0,228,0,228,
TAMIL NADU,PERAMBALUR,2021-02-19,0,204,0,204,
TAMIL NADU,PERAMBALUR,2021-02-20,0,215,0,215,
TAMIL NADU,PUDUKKOTTAI,2021-02-16,3,559,0,562,
TAMIL NADU,PUDUKKOTTAI,2021-02-17,5,521,0,526,
TAMIL NADU,PUDUKKOTTAI,2021-02-18,2,556,0,558,
TAMIL NADU,PUDUKKOTTAI,2021-02-19,2,562,1,565,
TAMIL NADU,PUDUKKOTTAI,2021-02-20,2,528,0,530,
TAMIL NADU,RAMANATHAPURAM,2021-02-16,1,910,0,911,
TAMIL NADU,RAMANATHAPURAM,2021-02-17,2,835,0,837,
TAMIL NADU,RAMANATHAPURAM,2021-02-18,2,815,0,817,
TAMIL NADU,RAMANATHAPURAM,2021-02-19,2,877,0,879,
TAMIL NADU,RAMANATHAPURAM,2021-02-20,0,645,0,645,
TAMIL NADU,RANIPET,2021-02-16,4,63,0,67,
TAMIL NADU,RANIPET,2021-02-17,5,681,0,686,
TAMIL NADU,RANIPET,2021-02-18,3,992,0,995,
TAMIL NADU,RANIPET,2021-02-19,0,464,0,464,
TAMIL NADU,RANIPET,2021-02-20,7,390,0,397,
TAMIL NADU,SALEM,2021-02-16,4,260,0,264,
TAMIL NADU,SALEM,2021-02-17,5,625,0,630,
TAMIL NADU,SALEM,2021-02-18,9,398,12,419,
TAMIL NADU,SALEM,2021-02-19,7,919,1,927,
TAMIL NADU,SALEM,2021-02-20,8,196,2,206,
TAMIL NADU,SIVAGANGA,2021-02-16,6,514,0,520,
TAMIL NADU,SIVAGANGA,2021-02-17,8,527,0,535,
TAMIL NADU,SIVAGANGA,2021-02-18,4,520,0,524,
TAMIL NADU,SIVAGANGA,2021-02-19,10,446,0,456,
TAMIL NADU,SIVAGANGA,2021-02-20,4,490,0,494,
TAMIL NADU,TENKASI,2021-02-16,2,519,8,529,
TAMIL NADU,TENKASI,2021-02-17,5,506,4,515,
TAMIL NADU,TENKASI,2021-02-18,2,508,2,512,
TAMIL NADU,TENKASI,2021-02-19,5,388,2,395,
TAMIL NADU,TENKASI,2021-02-20,2,449,5,456,
TAMIL NADU,THANJAVUR,2021-02-16,11,766,0,777,
TAMIL NADU,THANJAVUR,2021-02-17,13,765,0,778,
TAMIL NADU,THANJAVUR,2021-02-18,21,973,0,994,
TAMIL NADU,THANJAVUR,2021-02-19,18,666,0,684,
TAMIL NADU,THANJAVUR,2021-02-20,16,426,0,442,
TAMIL NADU,THE NILGIRIS,2021-02-16,4,1009,3,1016,
TAMIL NADU,THE NILGIRIS,2021-02-17,12,982,0,994,
TAMIL NADU,THE NILGIRIS,2021-02-18,14,1054,0,1068,
TAMIL NADU,THE NILGIRIS,2021-02-19,7,972,0,979,
TAMIL NADU,THE NILGIRIS,2021-02-20,4,1014,0,1018,
TAMIL NADU,THENI,2021-02-16,1,417,0,418,
TAMIL NADU,THENI,2021-02-17,2,415,0,417,
TAMIL NADU,THENI,2021-02-18,1,268,0,269,
TAMIL NADU,THENI,2021-02-19,2,293,0,295,
TAMIL NADU,THENI,2021-02-20,2,533,0,535,
TAMIL NADU,THIRUVALLUR,2021-02-16,51,2168,4,2223,
TAMIL NADU,THIRUVALLUR,2021-02-17,28,1665,0,1693,
TAMIL NADU,THIRUVALLUR,2021-02-18,33,1796,8,1837,
TAMIL NADU,THIRUVALLUR,2021-02-19,21,1750,5,1776,
TAMIL NADU,THIRUVALLUR,2021-02-20,17,1773,3,1793,
TAMIL NADU,THIRUVARUR,2021-02-16,6,597,1,604,
TAMIL NADU,THIRUVARUR,2021-02-17,5,705,0,710,
TAMIL NADU,THIRUVARUR,2021-02-18,13,678,0,691,
TAMIL NADU,THIRUVARUR,2021-02-19,5,538,0,543,
TAMIL NADU,THIRUVARUR,2021-02-20,6,753,0,759,
TAMIL NADU,TIRUCHIRAPPALLI,2021-02-16,8,1450,5,1463,
TAMIL NADU,TIRUCHIRAPPALLI,2021-02-17,10,1440,0,1450,
TAMIL NADU,TIRUCHIRAPPALLI,2021-02-18,17,1571,1,1589,
TAMIL NADU,TIRUCHIRAPPALLI,2021-02-19,7,1483,0,1490,
TAMIL NADU,TIRUCHIRAPPALLI,2021-02-20,10,1223,0,1233,
TAMIL NADU,TIRUNELVELI,2021-02-16,5,1313,1,1319,
TAMIL NADU,TIRUNELVELI,2021-02-17,9,975,1,985,
TAMIL NADU,TIRUNELVELI,2021-02-18,8,738,3,749,
TAMIL NADU,TIRUNELVELI,2021-02-19,7,1156,8,1171,
TAMIL NADU,TIRUNELVELI,2021-02-20,5,862,2,869,
TAMIL NADU,TIRUPATHUR,2021-02-16,2,2561,2,2565,
TAMIL NADU,TIRUPATHUR,2021-02-17,2,2583,0,2585,
TAMIL NADU,TIRUPATHUR,2021-02-18,2,2327,2,2331,
TAMIL NADU,TIRUPATHUR,2021-02-19,1,2009,1,2011,
TAMIL NADU,TIRUPATHUR,2021-02-20,0,2164,0,2164,
TAMIL NADU,TIRUPPUR,2021-02-16,16,1730,0,1746,
TAMIL NADU,TIRUPPUR,2021-02-17,21,1756,0,1777,
TAMIL NADU,TIRUPPUR,2021-02-18,18,1758,5,1781,
TAMIL NADU,TIRUPPUR,2021-02-19,15,1853,1,1869,
TAMIL NADU,TIRUPPUR,2021-02-20,12,1771,0,1783,
TAMIL NADU,TIRUVANNAMALAI,2021-02-16,10,1565,0,1575,
TAMIL NADU,TIRUVANNAMALAI,2021-02-17,3,1456,0,1459,
TAMIL NADU,TIRUVANNAMALAI,2021-02-18,6,1017,0,1023,
TAMIL NADU,TIRUVANNAMALAI,2021-02-19,8,1128,0,1136,
TAMIL NADU,TIRUVANNAMALAI,2021-02-20,5,749,0,754,
TAMIL NADU,TUTICORIN,2021-02-16,3,902,6,911,
TAMIL NADU,TUTICORIN,2021-02-17,1,968,3,972,
TAMIL NADU,TUTICORIN,2021-02-18,2,819,7,828,
TAMIL NADU,TUTICORIN,2021-02-19,2,816,4,822,
TAMIL NADU,TUTICORIN,2021-02-20,3,740,0,743,
TAMIL NADU,VELLORE,2021-02-16,13,1299,0,1312,
TAMIL NADU,VELLORE,2021-02-17,9,1343,1,1353,
TAMIL NADU,VELLORE,2021-02-18,12,1091,0,1103,
TAMIL NADU,VELLORE,2021-02-19,8,1405,0,1413,
TAMIL NADU,VELLORE,2021-02-20,5,1440,1,1446,
TAMIL NADU,VILLUPURAM,2021-02-16,3,1646,0,1649,
TAMIL NADU,VILLUPURAM,2021-02-17,3,578,0,581,
TAMIL NADU,VILLUPURAM,2021-02-18,5,1107,5,1117,
TAMIL NADU,VILLUPURAM,2021-02-19,2,1133,2,1137,
TAMIL NADU,VILLUPURAM,2021-02-20,2,954,0,956,
TAMIL NADU,VIRUDHUNAGAR,2021-02-16,1,1148,1,1150,
TAMIL NADU,VIRUDHUNAGAR,2021-02-17,2,1326,1,1329,
TAMIL NADU,VIRUDHUNAGAR,2021-02-18,3,1121,0,1124,
TAMIL NADU,VIRUDHUNAGAR,2021-02-19,2,421,1,424,
TAMIL NADU,VIRUDHUNAGAR,2021-02-20,0,1198,0,1198,
TELANGANA,ADILABAD,2021-02-16,1,233,1,235,
TELANGANA,ADILABAD,2021-02-17,0,327,0,327,
TELANGANA,ADILABAD,2021-02-18,0,229,0,229,
TELANGANA,ADILABAD,2021-02-19,0,315,0,315,
TELANGANA,ADILABAD,2021-02-20,0,219,0,219,
TELANGANA,BHADRADRI KOTHAGUDEM,2021-02-16,0,368,0,368,
TELANGANA,BHADRADRI KOTHAGUDEM,2021-02-17,0,526,0,526,
TELANGANA,BHADRADRI KOTHAGUDEM,2021-02-18,0,518,0,518,
TELANGANA,BHADRADRI KOTHAGUDEM,2021-02-19,0,409,0,409,
TELANGANA,BHADRADRI KOTHAGUDEM,2021-02-20,0,321,0,321,
TELANGANA,HYDERABAD,2021-02-16,39,6405,1,6445,
TELANGANA,HYDERABAD,2021-02-17,24,5569,1,5594,
TELANGANA,HYDERABAD,2021-02-18,23,5114,2,5139,
TELANGANA,HYDERABAD,2021-02-19,11,5087,2,5100,
TELANGANA,HYDERABAD,2021-02-20,15,4921,5,4941,
TELANGANA,JAGITIAL,2021-02-16,0,321,0,321,
TELANGANA,JAGITIAL,2021-02-17,0,305,0,305,
TELANGANA,JAGITIAL,2021-02-18,0,286,0,286,
TELANGANA,JAGITIAL,2021-02-19,0,318,0,318,
TELANGANA,JAGITIAL,2021-02-20,0,473,0,473,
TELANGANA,JANGOAN,2021-02-16,0,450,0,450,
TELANGANA,JANGOAN,2021-02-17,0,453,0,453,
TELANGANA,JANGOAN,2021-02-18,0,442,0,442,
TELANGANA,JANGOAN,2021-02-19,0,473,0,473,
TELANGANA,JANGOAN,2021-02-20,1,507,0,508,
TELANGANA,JAYASHANKAR BHUPALAPALLY,2021-02-16,0,156,0,156,
TELANGANA,JAYASHANKAR BHUPALAPALLY,2021-02-17,0,107,0,107,
TELANGANA,JAYASHANKAR BHUPALAPALLY,2021-02-18,0,112,0,112,
TELANGANA,JAYASHANKAR BHUPALAPALLY,2021-02-19,0,139,0,139,
TELANGANA,JAYASHANKAR BHUPALAPALLY,2021-02-20,0,97,0,97,
TELANGANA,JOGULAMBA GADWAL,2021-02-16,0,387,0,387,
TELANGANA,JOGULAMBA GADWAL,2021-02-17,0,687,0,687,
TELANGANA,JOGULAMBA GADWAL,2021-02-18,0,409,0,409,
TELANGANA,JOGULAMBA GADWAL,2021-02-19,0,357,0,357,
TELANGANA,JOGULAMBA GADWAL,2021-02-20,0,309,0,309,
TELANGANA,KAMAREDDY,2021-02-16,0,261,0,261,
TELANGANA,KAMAREDDY,2021-02-17,0,285,0,285,
TELANGANA,KAMAREDDY,2021-02-18,0,309,0,309,
TELANGANA,KAMAREDDY,2021-02-19,0,205,0,205,
TELANGANA,KAMAREDDY,2021-02-20,0,293,0,293,
TELANGANA,KARIMNAGAR,2021-02-16,0,824,0,824,
TELANGANA,KARIMNAGAR,2021-02-17,0,857,0,857,
TELANGANA,KARIMNAGAR,2021-02-18,0,899,0,899,
TELANGANA,KARIMNAGAR,2021-02-19,0,874,0,874,
TELANGANA,KARIMNAGAR,2021-02-20,2,903,0,905,
TELANGANA,KHAMMAM,2021-02-16,2,573,0,575,
TELANGANA,KHAMMAM,2021-02-17,0,401,0,401,
TELANGANA,KHAMMAM,2021-02-18,0,442,0,442,
TELANGANA,KHAMMAM,2021-02-19,2,460,0,462,
TELANGANA,KHAMMAM,2021-02-20,5,379,0,384,
TELANGANA,KUMURAM BHEEM ASIFABAD,2021-02-16,0,326,0,326,
TELANGANA,KUMURAM BHEEM ASIFABAD,2021-02-17,0,363,0,363,
TELANGANA,KUMURAM BHEEM ASIFABAD,2021-02-18,0,364,0,364,
TELANGANA,KUMURAM BHEEM ASIFABAD,2021-02-19,0,350,0,350,
TELANGANA,KUMURAM BHEEM ASIFABAD,2021-02-20,0,424,0,424,
TELANGANA,MAHABUBABAD,2021-02-16,0,254,0,254,
TELANGANA,MAHABUBABAD,2021-02-17,0,305,0,305,
TELANGANA,MAHABUBABAD,2021-02-18,0,271,0,271,
TELANGANA,MAHABUBABAD,2021-02-19,0,213,0,213,
TELANGANA,MAHABUBABAD,2021-02-20,0,310,0,310,
TELANGANA,MAHABUBNAGAR,2021-02-16,0,428,0,428,
TELANGANA,MAHABUBNAGAR,2021-02-17,0,613,0,613,
TELANGANA,MAHABUBNAGAR,2021-02-18,0,391,0,391,
TELANGANA,MAHABUBNAGAR,2021-02-19,1,318,0,319,
TELANGANA,MAHABUBNAGAR,2021-02-20,0,415,0,415,
TELANGANA,MANCHERIAL,2021-02-16,0,488,0,488,
TELANGANA,MANCHERIAL,2021-02-17,0,405,0,405,
TELANGANA,MANCHERIAL,2021-02-18,0,405,0,405,
TELANGANA,MANCHERIAL,2021-02-19,0,376,0,376,
TELANGANA,MANCHERIAL,2021-02-20,1,438,0,439,
TELANGANA,MEDAK,2021-02-16,0,202,0,202,
TELANGANA,MEDAK,2021-02-17,0,175,0,175,
TELANGANA,MEDAK,2021-02-18,0,164,1,165,
TELANGANA,MEDAK,2021-02-19,0,194,0,194,
TELANGANA,MEDAK,2021-02-20,2,230,0,232,
TELANGANA,MEDCHAL MALKAJGIRI,2021-02-16,0,1136,0,1136,
TELANGANA,MEDCHAL MALKAJGIRI,2021-02-17,0,975,0,975,
TELANGANA,MEDCHAL MALKAJGIRI,2021-02-18,0,996,0,996,
TELANGANA,MEDCHAL MALKAJGIRI,2021-02-19,2,978,1,981,
TELANGANA,MEDCHAL MALKAJGIRI,2021-02-20,2,850,1,853,
TELANGANA,MULUGU,2021-02-16,0,98,0,98,
TELANGANA,MULUGU,2021-02-17,0,77,0,77,
TELANGANA,MULUGU,2021-02-18,0,80,0,80,
TELANGANA,MULUGU,2021-02-19,0,98,0,98,
TELANGANA,MULUGU,2021-02-20,0,93,0,93,
TELANGANA,NAGARKURNOOL,2021-02-16,0,785,0,785,
TELANGANA,NAGARKURNOOL,2021-02-17,0,842,0,842,
TELANGANA,NAGARKURNOOL,2021-02-18,0,699,0,699,
TELANGANA,NAGARKURNOOL,2021-02-19,0,551,0,551,
TELANGANA,NAGARKURNOOL,2021-02-20,0,590,0,590,
TELANGANA,NALGONDA,2021-02-16,0,665,0,665,
TELANGANA,NALGONDA,2021-02-17,0,572,0,572,
TELANGANA,NALGONDA,2021-02-18,0,619,0,619,
TELANGANA,NALGONDA,2021-02-19,0,478,0,478,
TELANGANA,NALGONDA,2021-02-20,0,504,0,504,
TELANGANA,NARAYANPET,2021-02-16,0,70,0,70,
TELANGANA,NARAYANPET,2021-02-17,0,106,0,106,
TELANGANA,NARAYANPET,2021-02-18,0,104,0,104,
TELANGANA,NARAYANPET,2021-02-19,0,60,0,60,
TELANGANA,NARAYANPET,2021-02-20,0,92,0,92,
TELANGANA,NIRMAL,2021-02-16,0,595,0,595,
TELANGANA,NIRMAL,2021-02-17,0,526,0,526,
TELANGANA,NIRMAL,2021-02-18,0,339,0,339,
TELANGANA,NIRMAL,2021-02-19,0,639,0,639,
TELANGANA,NIRMAL,2021-02-20,0,673,0,673,
TELANGANA,NIZAMABAD,2021-02-16,0,502,0,502,
TELANGANA,NIZAMABAD,2021-02-17,0,230,0,230,
TELANGANA,NIZAMABAD,2021-02-18,1,282,0,283,
TELANGANA,NIZAMABAD,2021-02-19,0,185,0,185,
TELANGANA,NIZAMABAD,2021-02-20,0,280,0,280,
TELANGANA,PEDDAPALLI,2021-02-16,0,689,0,689,
TELANGANA,PEDDAPALLI,2021-02-17,0,749,0,749,
TELANGANA,PEDDAPALLI,2021-02-18,0,457,0,457,
TELANGANA,PEDDAPALLI,2021-02-19,0,592,0,592,
TELANGANA,PEDDAPALLI,2021-02-20,0,650,0,650,
TELANGANA,RAJANNA SIRCILLA,2021-02-16,0,242,0,242,
TELANGANA,RAJANNA SIRCILLA,2021-02-17,0,193,0,193,
TELANGANA,RAJANNA SIRCILLA,2021-02-18,0,145,0,145,
TELANGANA,RAJANNA SIRCILLA,2021-02-19,0,216,0,216,
TELANGANA,RAJANNA SIRCILLA,2021-02-20,0,244,0,244,
TELANGANA,RANGA REDDY,2021-02-16,2,1867,0,1869,
TELANGANA,RANGA REDDY,2021-02-17,2,1761,0,1763,
TELANGANA,RANGA REDDY,2021-02-18,2,1714,1,1717,
TELANGANA,RANGA REDDY,2021-02-19,5,1237,0,1242,
TELANGANA,RANGA REDDY,2021-02-20,3,1900,0,1903,
TELANGANA,SANGAREDDY,2021-02-16,3,742,1,746,
TELANGANA,SANGAREDDY,2021-02-17,0,547,0,547,
TELANGANA,SANGAREDDY,2021-02-18,7,726,1,734,
TELANGANA,SANGAREDDY,2021-02-19,3,535,0,538,
TELANGANA,SANGAREDDY,2021-02-20,1,558,0,559,
TELANGANA,SIDDIPET,2021-02-16,0,526,0,526,
TELANGANA,SIDDIPET,2021-02-17,0,562,0,562,
TELANGANA,SIDDIPET,2021-02-18,0,477,0,477,
TELANGANA,SIDDIPET,2021-02-19,1,662,0,663,
TELANGANA,SIDDIPET,2021-02-20,0,420,0,420,
TELANGANA,SURYAPET,2021-02-16,0,651,0,651,
TELANGANA,SURYAPET,2021-02-17,1,637,0,638,
TELANGANA,SURYAPET,2021-02-18,0,907,0,907,
TELANGANA,SURYAPET,2021-02-19,0,617,0,617,
TELANGANA,SURYAPET,2021-02-20,0,617,0,617,
TELANGANA,VIKARABAD,2021-02-16,0,357,0,357,
TELANGANA,VIKARABAD,2021-02-17,0,312,0,312,
TELANGANA,VIKARABAD,2021-02-18,0,463,0,463,
TELANGANA,VIKARABAD,2021-02-19,1,327,0,328,
TELANGANA,VIKARABAD,2021-02-20,1,318,0,319,
TELANGANA,WANAPARTHY,2021-02-16,0,184,0,184,
TELANGANA,WANAPARTHY,2021-02-17,0,180,0,180,
TELANGANA,WANAPARTHY,2021-02-18,0,284,0,284,
TELANGANA,WANAPARTHY,2021-02-19,0,196,0,196,
TELANGANA,WANAPARTHY,2021-02-20,0,168,0,168,
TELANGANA,WARANGAL RURAL,2021-02-16,1,173,0,174,
TELANGANA,WARANGAL RURAL,2021-02-17,0,200,0,200,
TELANGANA,WARANGAL RURAL,2021-02-18,7,196,0,203,
TELANGANA,WARANGAL RURAL,2021-02-19,0,167,0,167,
TELANGANA,WARANGAL RURAL,2021-02-20,0,135,0,135,
TELANGANA,WARANGAL URBAN,2021-02-16,1,885,0,886,
TELANGANA,WARANGAL URBAN,2021-02-17,0,1044,0,1044,
TELANGANA,WARANGAL URBAN,2021-02-18,0,1112,0,1112,
TELANGANA,WARANGAL URBAN,2021-02-19,0,1093,0,1093,
TELANGANA,WARANGAL URBAN,2021-02-20,0,1033,0,1033,
TELANGANA,YADADRI BHUVANAGIRI,2021-02-16,0,269,0,269,
TELANGANA,YADADRI BHUVANAGIRI,2021-02-17,0,196,0,196,
TELANGANA,YADADRI BHUVANAGIRI,2021-02-18,0,286,0,286,
TELANGANA,YADADRI BHUVANAGIRI,2021-02-19,0,167,0,167,
TELANGANA,YADADRI BHUVANAGIRI,2021-02-20,0,400,0,400,
TRIPURA,DHALAI,2021-02-17,0,17,0,17,
TRIPURA,DHALAI,2021-02-18,0,48,0,48,
TRIPURA,DHALAI,2021-02-19,0,2,0,2,
TRIPURA,DHALAI,2021-02-20,0,10,0,10,
TRIPURA,GOMATI,2021-02-16,0,5,0,5,
TRIPURA,GOMATI,2021-02-17,0,74,0,74,
TRIPURA,GOMATI,2021-02-18,0,52,0,52,
TRIPURA,GOMATI,2021-02-19,0,43,0,43,
TRIPURA,GOMATI,2021-02-20,0,38,0,38,
TRIPURA,KHOWAI,2021-02-16,0,8,0,8,
TRIPURA,KHOWAI,2021-02-17,0,23,0,23,
TRIPURA,KHOWAI,2021-02-18,0,22,0,22,
TRIPURA,KHOWAI,2021-02-19,0,17,0,17,
TRIPURA,KHOWAI,2021-02-20,0,20,0,20,
TRIPURA,NORTH TRIPURA,2021-02-16,0,36,0,36,
TRIPURA,NORTH TRIPURA,2021-02-17,0,67,0,67,
TRIPURA,NORTH TRIPURA,2021-02-18,0,86,0,86,
TRIPURA,NORTH TRIPURA,2021-02-19,0,80,0,80,
TRIPURA,NORTH TRIPURA,2021-02-20,0,93,0,93,
TRIPURA,SEPAHIJALA,2021-02-16,0,1,0,1,
TRIPURA,SEPAHIJALA,2021-02-17,0,43,0,43,
TRIPURA,SEPAHIJALA,2021-02-18,0,32,0,32,
TRIPURA,SEPAHIJALA,2021-02-19,0,39,0,39,
TRIPURA,SEPAHIJALA,2021-02-20,0,36,0,36,
TRIPURA,SOUTH TRIPURA,2021-02-16,0,13,0,13,
TRIPURA,SOUTH TRIPURA,2021-02-17,0,72,0,72,
TRIPURA,SOUTH TRIPURA,2021-02-18,1,80,0,81,
TRIPURA,SOUTH TRIPURA,2021-02-19,0,49,0,49,
TRIPURA,SOUTH TRIPURA,2021-02-20,0,45,0,45,
TRIPURA,UNAKOTI,2021-02-17,0,5,0,5,
TRIPURA,UNAKOTI,2021-02-18,0,7,0,7,
TRIPURA,UNAKOTI,2021-02-19,0,6,0,6,
TRIPURA,UNAKOTI,2021-02-20,0,5,0,5,
TRIPURA,WEST TRIPURA,2021-02-16,0,42,0,42,
TRIPURA,WEST TRIPURA,2021-02-17,2,225,0,227,
TRIPURA,WEST TRIPURA,2021-02-18,7,271,0,278,
TRIPURA,WEST TRIPURA,2021-02-19,27,204,1,232,
TRIPURA,WEST TRIPURA,2021-02-20,4,218,1,223,
UTTAR PRADESH,AGRA,2021-02-16,0,2014,3,2017,
UTTAR PRADESH,AGRA,2021-02-17,5,2789,1,2795,
UTTAR PRADESH,AGRA,2021-02-18,2,2166,1,2169,
UTTAR PRADESH,AGRA,2021-02-19,4,2383,3,2390,
UTTAR PRADESH,AGRA,2021-02-20,0,1851,2,1853,
UTTAR PRADESH,ALIGARH,2021-02-16,6,2857,7,2870,
UTTAR PRADESH,ALIGARH,2021-02-17,0,2862,0,2862,
UTTAR PRADESH,ALIGARH,2021-02-18,5,3533,3,3541,
UTTAR PRADESH,ALIGARH,2021-02-19,3,4517,21,4541,
UTTAR PRADESH,ALIGARH,2021-02-20,2,5978,2,5982,
UTTAR PRADESH,AMBEDKAR NAGAR,2021-02-16,0,912,1,913,
UTTAR PRADESH,AMBEDKAR NAGAR,2021-02-17,0,956,7,963,
UTTAR PRADESH,AMBEDKAR NAGAR,2021-02-18,0,1044,0,1044,
UTTAR PRADESH,AMBEDKAR NAGAR,2021-02-19,0,961,0,961,
UTTAR PRADESH,AMBEDKAR NAGAR,2021-02-20,0,989,16,1005,
UTTAR PRADESH,AMETHI,2021-02-16,0,1556,0,1556,
UTTAR PRADESH,AMETHI,2021-02-17,0,761,1,762,
UTTAR PRADESH,AMETHI,2021-02-18,0,1479,0,1479,
UTTAR PRADESH,AMETHI,2021-02-19,0,974,2,976,
UTTAR PRADESH,AMETHI,2021-02-20,0,1152,0,1152,
UTTAR PRADESH,AMROHA,2021-02-16,2,1324,0,1326,
UTTAR PRADESH,AMROHA,2021-02-17,1,941,0,942,
UTTAR PRADESH,AMROHA,2021-02-18,0,493,0,493,
UTTAR PRADESH,AMROHA,2021-02-19,2,822,1,825,
UTTAR PRADESH,AMROHA,2021-02-20,0,890,0,890,
UTTAR PRADESH,AURAIYA,2021-02-16,0,747,18,765,
UTTAR PRADESH,AURAIYA,2021-02-17,0,585,105,690,
UTTAR PRADESH,AURAIYA,2021-02-18,1,1412,95,1508,
UTTAR PRADESH,AURAIYA,2021-02-19,1,609,101,711,
UTTAR PRADESH,AURAIYA,2021-02-20,0,950,119,1069,
UTTAR PRADESH,AYODHYA,2021-02-16,0,1425,1,1426,
UTTAR PRADESH,AYODHYA,2021-02-17,1,1520,1,1522,
UTTAR PRADESH,AYODHYA,2021-02-18,0,1403,6,1409,
UTTAR PRADESH,AYODHYA,2021-02-19,1,1288,0,1289,
UTTAR PRADESH,AYODHYA,2021-02-20,2,1806,0,1808,
UTTAR PRADESH,AZAMGARH,2021-02-16,0,756,7,763,
UTTAR PRADESH,AZAMGARH,2021-02-17,1,1139,4,1144,
UTTAR PRADESH,AZAMGARH,2021-02-18,0,1111,9,1120,
UTTAR PRADESH,AZAMGARH,2021-02-19,1,279,0,280,
UTTAR PRADESH,AZAMGARH,2021-02-20,0,1107,1,1108,
UTTAR PRADESH,BAGHPAT,2021-02-16,1,996,44,1041,
UTTAR PRADESH,BAGHPAT,2021-02-17,1,713,59,773,
UTTAR PRADESH,BAGHPAT,2021-02-18,0,1081,25,1106,
UTTAR PRADESH,BAGHPAT,2021-02-19,1,1365,11,1377,
UTTAR PRADESH,BAGHPAT,2021-02-20,0,990,54,1044,
UTTAR PRADESH,BAHRAICH,2021-02-16,0,1753,7,1760,
UTTAR PRADESH,BAHRAICH,2021-02-17,0,1702,38,1740,
UTTAR PRADESH,BAHRAICH,2021-02-18,2,1668,4,1674,
UTTAR PRADESH,BAHRAICH,2021-02-19,2,1788,33,1823,
UTTAR PRADESH,BAHRAICH,2021-02-20,0,1654,11,1665,
UTTAR PRADESH,BALLIA,2021-02-16,2,520,0,522,
UTTAR PRADESH,BALLIA,2021-02-17,0,700,0,700,
UTTAR PRADESH,BALLIA,2021-02-18,0,676,8,684,
UTTAR PRADESH,BALLIA,2021-02-19,0,778,1,779,
UTTAR PRADESH,BALLIA,2021-02-20,1,799,31,831,
UTTAR PRADESH,BALRAMPUR,2021-02-16,1,1077,3,1081,
UTTAR PRADESH,BALRAMPUR,2021-02-17,0,514,0,514,
UTTAR PRADESH,BALRAMPUR,2021-02-18,0,1318,0,1318,
UTTAR PRADESH,BALRAMPUR,2021-02-19,0,875,0,875,
UTTAR PRADESH,BALRAMPUR,2021-02-20,1,794,0,795,
UTTAR PRADESH,BANDA,2021-02-16,0,1837,62,1899,
UTTAR PRADESH,BANDA,2021-02-17,1,2241,5,2247,
UTTAR PRADESH,BANDA,2021-02-18,0,2056,30,2086,
UTTAR PRADESH,BANDA,2021-02-19,0,1832,10,1842,
UTTAR PRADESH,BANDA,2021-02-20,1,2301,25,2327,
UTTAR PRADESH,BARABANKI,2021-02-16,3,1813,0,1816,
UTTAR PRADESH,BARABANKI,2021-02-17,0,1373,39,1412,
UTTAR PRADESH,BARABANKI,2021-02-18,0,1761,19,1780,
UTTAR PRADESH,BARABANKI,2021-02-19,0,1488,6,1494,
UTTAR PRADESH,BARABANKI,2021-02-20,0,1755,1,1756,
UTTAR PRADESH,BAREILLY,2021-02-16,3,2959,8,2970,
UTTAR PRADESH,BAREILLY,2021-02-17,3,2233,3,2239,
UTTAR PRADESH,BAREILLY,2021-02-18,2,1535,0,1537,
UTTAR PRADESH,BAREILLY,2021-02-19,6,2862,5,2873,
UTTAR PRADESH,BAREILLY,2021-02-20,2,1828,2,1832,
UTTAR PRADESH,BASTI,2021-02-16,0,939,7,946,
UTTAR PRADESH,BASTI,2021-02-17,6,1069,57,1132,
UTTAR PRADESH,BASTI,2021-02-18,8,1106,44,1158,
UTTAR PRADESH,BASTI,2021-02-19,2,1161,46,1209,
UTTAR PRADESH,BASTI,2021-02-20,0,856,14,870,
UTTAR PRADESH,BHADOHI,2021-02-16,0,1568,0,1568,
UTTAR PRADESH,BHADOHI,2021-02-17,0,1505,0,1505,
UTTAR PRADESH,BHADOHI,2021-02-18,0,1506,5,1511,
UTTAR PRADESH,BHADOHI,2021-02-19,0,1499,1,1500,
UTTAR PRADESH,BHADOHI,2021-02-20,1,1486,1,1488,
UTTAR PRADESH,BIJNOR,2021-02-16,0,1315,2,1317,
UTTAR PRADESH,BIJNOR,2021-02-17,2,659,0,661,
UTTAR PRADESH,BIJNOR,2021-02-18,2,1935,0,1937,
UTTAR PRADESH,BIJNOR,2021-02-19,1,1448,0,1449,
UTTAR PRADESH,BIJNOR,2021-02-20,3,1288,1,1292,
UTTAR PRADESH,BUDAUN,2021-02-16,0,2102,7,2109,
UTTAR PRADESH,BUDAUN,2021-02-17,3,764,125,892,
UTTAR PRADESH,BUDAUN,2021-02-18,1,2083,17,2101,
UTTAR PRADESH,BUDAUN,2021-02-19,0,1891,41,1932,
UTTAR PRADESH,BUDAUN,2021-02-20,1,1675,30,1706,
UTTAR PRADESH,BULANDSHAHR,2021-02-16,0,1675,0,1675,
UTTAR PRADESH,BULANDSHAHR,2021-02-17,2,2151,28,2181,
UTTAR PRADESH,BULANDSHAHR,2021-02-18,1,2112,0,2113,
UTTAR PRADESH,BULANDSHAHR,2021-02-19,2,1997,12,2011,
UTTAR PRADESH,BULANDSHAHR,2021-02-20,0,1659,1,1660,
UTTAR PRADESH,CHANDAULI,2021-02-16,2,1024,8,1034,
UTTAR PRADESH,CHANDAULI,2021-02-17,0,281,1,282,
UTTAR PRADESH,CHANDAULI,2021-02-18,2,1619,63,1684,
UTTAR PRADESH,CHANDAULI,2021-02-19,1,1064,12,1077,
UTTAR PRADESH,CHANDAULI,2021-02-20,0,852,181,1033,
UTTAR PRADESH,CHITRAKOOT,2021-02-16,0,639,0,639,
UTTAR PRADESH,CHITRAKOOT,2021-02-17,0,501,5,506,
UTTAR PRADESH,CHITRAKOOT,2021-02-18,0,763,87,850,
UTTAR PRADESH,CHITRAKOOT,2021-02-19,0,825,0,825,
UTTAR PRADESH,CHITRAKOOT,2021-02-20,0,1249,11,1260,
UTTAR PRADESH,DEORIA,2021-02-16,0,160,1,161,
UTTAR PRADESH,DEORIA,2021-02-17,0,1467,73,1540,
UTTAR PRADESH,DEORIA,2021-02-18,1,962,48,1011,
UTTAR PRADESH,DEORIA,2021-02-19,1,699,24,724,
UTTAR PRADESH,DEORIA,2021-02-20,1,612,47,660,
UTTAR PRADESH,ETAH,2021-02-16,0,1114,11,1125,
UTTAR PRADESH,ETAH,2021-02-17,0,823,9,832,
UTTAR PRADESH,ETAH,2021-02-18,1,936,7,944,
UTTAR PRADESH,ETAH,2021-02-19,0,1788,2,1790,
UTTAR PRADESH,ETAH,2021-02-20,0,865,0,865,
UTTAR PRADESH,ETAWAH,2021-02-16,0,2056,128,2184,
UTTAR PRADESH,ETAWAH,2021-02-17,1,1293,86,1380,
UTTAR PRADESH,ETAWAH,2021-02-18,0,1626,62,1688,
UTTAR PRADESH,ETAWAH,2021-02-19,1,1618,83,1702,
UTTAR PRADESH,ETAWAH,2021-02-20,0,1812,104,1916,
UTTAR PRADESH,FARRUKHABAD,2021-02-16,0,1014,87,1101,
UTTAR PRADESH,FARRUKHABAD,2021-02-17,2,727,20,749,
UTTAR PRADESH,FARRUKHABAD,2021-02-18,0,1158,31,1189,
UTTAR PRADESH,FARRUKHABAD,2021-02-19,4,548,38,590,
UTTAR PRADESH,FARRUKHABAD,2021-02-20,0,1085,25,1110,
UTTAR PRADESH,FATEHPUR,2021-02-16,1,1174,82,1257,
UTTAR PRADESH,FATEHPUR,2021-02-17,0,1220,128,1348,
UTTAR PRADESH,FATEHPUR,2021-02-18,0,839,98,937,
UTTAR PRADESH,FATEHPUR,2021-02-19,0,1349,155,1504,
UTTAR PRADESH,FATEHPUR,2021-02-20,2,1547,149,1698,
UTTAR PRADESH,FIROZABAD,2021-02-16,0,1279,1,1280,
UTTAR PRADESH,FIROZABAD,2021-02-17,0,5386,3,5389,
UTTAR PRADESH,FIROZABAD,2021-02-18,3,6279,0,6282,
UTTAR PRADESH,FIROZABAD,2021-02-19,2,2923,0,2925,
UTTAR PRADESH,FIROZABAD,2021-02-20,2,1381,0,1383,
UTTAR PRADESH,GAUTAM BUDDHA NAGAR,2021-02-16,15,2651,46,2712,
UTTAR PRADESH,GAUTAM BUDDHA NAGAR,2021-02-17,21,2901,49,2971,
UTTAR PRADESH,GAUTAM BUDDHA NAGAR,2021-02-18,20,2432,11,2463,
UTTAR PRADESH,GAUTAM BUDDHA NAGAR,2021-02-19,15,2336,80,2431,
UTTAR PRADESH,GAUTAM BUDDHA NAGAR,2021-02-20,23,2304,41,2368,
UTTAR PRADESH,GHAZIABAD,2021-02-16,27,3103,61,3191,
UTTAR PRADESH,GHAZIABAD,2021-02-17,15,4185,7,4207,
UTTAR PRADESH,GHAZIABAD,2021-02-18,20,4133,53,4206,
UTTAR PRADESH,GHAZIABAD,2021-02-19,19,3716,103,3838,
UTTAR PRADESH,GHAZIABAD,2021-02-20,18,3768,136,3922,
UTTAR PRADESH,GHAZIPUR,2021-02-16,1,607,1,609,
UTTAR PRADESH,GHAZIPUR,2021-02-17,1,1433,5,1439,
UTTAR PRADESH,GHAZIPUR,2021-02-18,2,1054,18,1074,
UTTAR PRADESH,GHAZIPUR,2021-02-19,0,1042,6,1048,
UTTAR PRADESH,GHAZIPUR,2021-02-20,1,738,43,782,
UTTAR PRADESH,GONDA,2021-02-16,1,1349,185,1535,
UTTAR PRADESH,GONDA,2021-02-17,1,1339,42,1382,
UTTAR PRADESH,GONDA,2021-02-18,1,1451,118,1570,
UTTAR PRADESH,GONDA,2021-02-19,2,1616,17,1635,
UTTAR PRADESH,GONDA,2021-02-20,0,1478,0,1478,
UTTAR PRADESH,GORAKHPUR,2021-02-16,0,2195,17,2212,
UTTAR PRADESH,GORAKHPUR,2021-02-17,3,2598,51,2652,
UTTAR PRADESH,GORAKHPUR,2021-02-18,2,2700,85,2787,
UTTAR PRADESH,GORAKHPUR,2021-02-19,4,2566,49,2619,
UTTAR PRADESH,GORAKHPUR,2021-02-20,1,2122,53,2176,
UTTAR PRADESH,HAMIRPUR,2021-02-16,0,977,64,1041,
UTTAR PRADESH,HAMIRPUR,2021-02-17,0,990,31,1021,
UTTAR PRADESH,HAMIRPUR,2021-02-18,1,560,2,563,
UTTAR PRADESH,HAMIRPUR,2021-02-19,5,1316,36,1357,
UTTAR PRADESH,HAMIRPUR,2021-02-20,0,827,25,852,
UTTAR PRADESH,HAPUR,2021-02-16,3,2617,79,2699,
UTTAR PRADESH,HAPUR,2021-02-17,3,495,49,547,
UTTAR PRADESH,HAPUR,2021-02-18,1,588,2,591,
UTTAR PRADESH,HAPUR,2021-02-19,3,2025,5,2033,
UTTAR PRADESH,HAPUR,2021-02-20,2,908,0,910,
UTTAR PRADESH,HARDOI,2021-02-16,0,1201,6,1207,
UTTAR PRADESH,HARDOI,2021-02-17,4,1314,37,1355,
UTTAR PRADESH,HARDOI,2021-02-18,3,1551,235,1789,
UTTAR PRADESH,HARDOI,2021-02-19,2,1236,30,1268,
UTTAR PRADESH,HARDOI,2021-02-20,1,1183,269,1453,
UTTAR PRADESH,HATHRAS,2021-02-16,0,1558,0,1558,
UTTAR PRADESH,HATHRAS,2021-02-17,1,3363,0,3364,
UTTAR PRADESH,HATHRAS,2021-02-18,0,1570,0,1570,
UTTAR PRADESH,HATHRAS,2021-02-19,0,1299,0,1299,
UTTAR PRADESH,HATHRAS,2021-02-20,1,1132,0,1133,
UTTAR PRADESH,JALAUN,2021-02-16,0,1187,0,1187,
UTTAR PRADESH,JALAUN,2021-02-17,0,1214,0,1214,
UTTAR PRADESH,JALAUN,2021-02-18,0,1280,5,1285,
UTTAR PRADESH,JALAUN,2021-02-19,1,1175,0,1176,
UTTAR PRADESH,JALAUN,2021-02-20,0,1132,3,1135,
UTTAR PRADESH,JAUNPUR,2021-02-16,0,1606,0,1606,
UTTAR PRADESH,JAUNPUR,2021-02-17,0,1413,0,1413,
UTTAR PRADESH,JAUNPUR,2021-02-18,3,1066,9,1078,
UTTAR PRADESH,JAUNPUR,2021-02-19,1,2378,37,2416,
UTTAR PRADESH,JAUNPUR,2021-02-20,3,1606,8,1617,
UTTAR PRADESH,JHANSI,2021-02-16,0,1393,1,1394,
UTTAR PRADESH,JHANSI,2021-02-17,1,2975,0,2976,
UTTAR PRADESH,JHANSI,2021-02-18,0,3071,3,3074,
UTTAR PRADESH,JHANSI,2021-02-19,1,2588,0,2589,
UTTAR PRADESH,JHANSI,2021-02-20,0,2780,2,2782,
UTTAR PRADESH,KANNAUJ,2021-02-16,0,2006,1,2007,
UTTAR PRADESH,KANNAUJ,2021-02-17,0,1695,1,1696,
UTTAR PRADESH,KANNAUJ,2021-02-18,0,1891,0,1891,
UTTAR PRADESH,KANNAUJ,2021-02-19,0,1879,1,1880,
UTTAR PRADESH,KANNAUJ,2021-02-20,0,1916,0,1916,
UTTAR PRADESH,KANPUR DEHAT,2021-02-16,0,802,2,804,
UTTAR PRADESH,KANPUR DEHAT,2021-02-17,0,1046,0,1046,
UTTAR PRADESH,KANPUR DEHAT,2021-02-18,2,705,0,707,
UTTAR PRADESH,KANPUR DEHAT,2021-02-19,4,1474,1,1479,
UTTAR PRADESH,KANPUR DEHAT,2021-02-20,1,819,1,821,
UTTAR PRADESH,KANPUR NAGAR,2021-02-16,1,2797,14,2812,
UTTAR PRADESH,KANPUR NAGAR,2021-02-17,0,2520,5,2525,
UTTAR PRADESH,KANPUR NAGAR,2021-02-18,7,2591,5,2603,
UTTAR PRADESH,KANPUR NAGAR,2021-02-19,11,2454,0,2465,
UTTAR PRADESH,KANPUR NAGAR,2021-02-20,7,2924,0,2931,
UTTAR PRADESH,KASGANJ,2021-02-16,2,2008,2,2012,
UTTAR PRADESH,KASGANJ,2021-02-17,0,489,3,492,
UTTAR PRADESH,KASGANJ,2021-02-18,0,740,0,740,
UTTAR PRADESH,KASGANJ,2021-02-19,0,5116,0,5116,
UTTAR PRADESH,KASGANJ,2021-02-20,0,1144,2,1146,
UTTAR PRADESH,KAUSHAMBI,2021-02-16,0,1193,0,1193,
UTTAR PRADESH,KAUSHAMBI,2021-02-17,1,1380,0,1381,
UTTAR PRADESH,KAUSHAMBI,2021-02-18,0,2947,0,2947,
UTTAR PRADESH,KAUSHAMBI,2021-02-19,0,1530,0,1530,
UTTAR PRADESH,KAUSHAMBI,2021-02-20,0,1415,0,1415,
UTTAR PRADESH,KHERI,2021-02-16,1,1303,19,1323,
UTTAR PRADESH,KHERI,2021-02-17,0,1484,3,1487,
UTTAR PRADESH,KHERI,2021-02-18,0,1922,20,1942,
UTTAR PRADESH,KHERI,2021-02-19,1,1686,110,1797,
UTTAR PRADESH,KHERI,2021-02-20,0,1492,11,1503,
UTTAR PRADESH,KUSHI NAGAR,2021-02-16,0,785,12,797,
UTTAR PRADESH,KUSHI NAGAR,2021-02-17,0,279,2,281,
UTTAR PRADESH,KUSHI NAGAR,2021-02-18,0,869,14,883,
UTTAR PRADESH,KUSHI NAGAR,2021-02-19,1,1306,45,1352,
UTTAR PRADESH,KUSHI NAGAR,2021-02-20,0,570,35,605,
UTTAR PRADESH,LALITPUR,2021-02-16,0,1924,3,1927,
UTTAR PRADESH,LALITPUR,2021-02-17,0,1328,0,1328,
UTTAR PRADESH,LALITPUR,2021-02-18,3,2473,0,2476,
UTTAR PRADESH,LALITPUR,2021-02-19,1,1336,1,1338,
UTTAR PRADESH,LALITPUR,2021-02-20,2,2077,2,2081,
UTTAR PRADESH,LUCKNOW,2021-02-16,14,6853,67,6934,
UTTAR PRADESH,LUCKNOW,2021-02-17,7,5959,89,6055,
UTTAR PRADESH,LUCKNOW,2021-02-18,17,6900,52,6969,
UTTAR PRADESH,LUCKNOW,2021-02-19,24,6079,124,6227,
UTTAR PRADESH,LUCKNOW,2021-02-20,19,6221,137,6377,
UTTAR PRADESH,MAHARAJGANJ,2021-02-16,0,833,71,904,
UTTAR PRADESH,MAHARAJGANJ,2021-02-17,0,838,87,925,
UTTAR PRADESH,MAHARAJGANJ,2021-02-18,0,1165,77,1242,
UTTAR PRADESH,MAHARAJGANJ,2021-02-19,0,695,176,871,
UTTAR PRADESH,MAHARAJGANJ,2021-02-20,0,786,23,809,
UTTAR PRADESH,MAHOBA,2021-02-16,1,246,5,252,
UTTAR PRADESH,MAHOBA,2021-02-17,0,341,0,341,
UTTAR PRADESH,MAHOBA,2021-02-18,0,414,0,414,
UTTAR PRADESH,MAHOBA,2021-02-19,0,495,6,501,
UTTAR PRADESH,MAHOBA,2021-02-20,0,517,38,555,
UTTAR PRADESH,MAINPURI,2021-02-16,1,1588,10,1599,
UTTAR PRADESH,MAINPURI,2021-02-17,0,1508,0,1508,
UTTAR PRADESH,MAINPURI,2021-02-18,0,1532,0,1532,
UTTAR PRADESH,MAINPURI,2021-02-19,2,1693,8,1703,
UTTAR PRADESH,MAINPURI,2021-02-20,0,1723,0,1723,
UTTAR PRADESH,MATHURA,2021-02-16,1,2014,4,2019,
UTTAR PRADESH,MATHURA,2021-02-17,1,1885,6,1892,
UTTAR PRADESH,MATHURA,2021-02-18,2,1973,72,2047,
UTTAR PRADESH,MATHURA,2021-02-19,1,1588,2,1591,
UTTAR PRADESH,MATHURA,2021-02-20,1,1821,3,1825,
UTTAR PRADESH,MAU,2021-02-16,0,725,0,725,
UTTAR PRADESH,MAU,2021-02-17,0,661,82,743,
UTTAR PRADESH,MAU,2021-02-18,1,1541,39,1581,
UTTAR PRADESH,MAU,2021-02-19,0,1206,0,1206,
UTTAR PRADESH,MAU,2021-02-20,0,788,15,803,
UTTAR PRADESH,MEERUT,2021-02-16,5,3578,0,3583,
UTTAR PRADESH,MEERUT,2021-02-17,3,3514,0,3517,
UTTAR PRADESH,MEERUT,2021-02-18,5,4041,22,4068,
UTTAR PRADESH,MEERUT,2021-02-19,6,4690,161,4857,
UTTAR PRADESH,MEERUT,2021-02-20,11,4387,10,4408,
UTTAR PRADESH,MIRZAPUR,2021-02-16,0,1465,0,1465,
UTTAR PRADESH,MIRZAPUR,2021-02-17,0,1383,0,1383,
UTTAR PRADESH,MIRZAPUR,2021-02-18,1,1384,1,1386,
UTTAR PRADESH,MIRZAPUR,2021-02-19,0,1415,0,1415,
UTTAR PRADESH,MIRZAPUR,2021-02-20,0,1220,1,1221,
UTTAR PRADESH,MORADABAD,2021-02-16,0,1670,0,1670,
UTTAR PRADESH,MORADABAD,2021-02-17,0,1494,0,1494,
UTTAR PRADESH,MORADABAD,2021-02-18,2,2304,0,2306,
UTTAR PRADESH,MORADABAD,2021-02-19,1,2190,1,2192,
UTTAR PRADESH,MORADABAD,2021-02-20,1,1581,0,1582,
UTTAR PRADESH,MUZAFFARNAGAR,2021-02-16,3,1611,1,1615,
UTTAR PRADESH,MUZAFFARNAGAR,2021-02-17,0,1759,0,1759,
UTTAR PRADESH,MUZAFFARNAGAR,2021-02-18,1,1259,2,1262,
UTTAR PRADESH,MUZAFFARNAGAR,2021-02-19,1,1540,1,1542,
UTTAR PRADESH,MUZAFFARNAGAR,2021-02-20,1,1300,1,1302,
UTTAR PRADESH,PILIBHIT,2021-02-16,1,1342,1,1344,
UTTAR PRADESH,PILIBHIT,2021-02-17,0,1133,52,1185,
UTTAR PRADESH,PILIBHIT,2021-02-18,1,1156,0,1157,
UTTAR PRADESH,PILIBHIT,2021-02-19,0,1210,0,1210,
UTTAR PRADESH,PILIBHIT,2021-02-20,2,1049,0,1051,
UTTAR PRADESH,PRATAPGARH,2021-02-16,1,1564,57,1622,
UTTAR PRADESH,PRATAPGARH,2021-02-17,2,1470,6,1478,
UTTAR PRADESH,PRATAPGARH,2021-02-18,2,1571,11,1584,
UTTAR PRADESH,PRATAPGARH,2021-02-19,2,1415,32,1449,
UTTAR PRADESH,PRATAPGARH,2021-02-20,1,1501,33,1535,
UTTAR PRADESH,PRAYAGRAJ,2021-02-16,30,4498,1,4529,
UTTAR PRADESH,PRAYAGRAJ,2021-02-17,7,4281,2,4290,
UTTAR PRADESH,PRAYAGRAJ,2021-02-18,5,3689,1,3695,
UTTAR PRADESH,PRAYAGRAJ,2021-02-19,11,7433,2,7446,
UTTAR PRADESH,PRAYAGRAJ,2021-02-20,6,3290,2,3298,
UTTAR PRADESH,RAE BARELI,2021-02-16,2,2091,29,2122,
UTTAR PRADESH,RAE BARELI,2021-02-17,1,1565,6,1572,
UTTAR PRADESH,RAE BARELI,2021-02-18,1,2401,7,2409,
UTTAR PRADESH,RAE BARELI,2021-02-19,0,746,0,746,
UTTAR PRADESH,RAE BARELI,2021-02-20,0,1876,774,2650,
UTTAR PRADESH,RAMPUR,2021-02-16,1,1326,23,1350,
UTTAR PRADESH,RAMPUR,2021-02-17,1,1517,20,1538,
UTTAR PRADESH,RAMPUR,2021-02-18,0,1387,9,1396,
UTTAR PRADESH,RAMPUR,2021-02-19,0,1345,0,1345,
UTTAR PRADESH,RAMPUR,2021-02-20,1,1405,7,1413,
UTTAR PRADESH,SAHARANPUR,2021-02-16,0,2646,0,2646,
UTTAR PRADESH,SAHARANPUR,2021-02-17,2,2240,2,2244,
UTTAR PRADESH,SAHARANPUR,2021-02-18,3,2706,17,2726,
UTTAR PRADESH,SAHARANPUR,2021-02-19,1,2278,1,2280,
UTTAR PRADESH,SAHARANPUR,2021-02-20,5,2540,1,2546,
UTTAR PRADESH,SAMBHAL,2021-02-16,1,945,1,947,
UTTAR PRADESH,SAMBHAL,2021-02-17,2,1853,70,1925,
UTTAR PRADESH,SAMBHAL,2021-02-18,0,1718,73,1791,
UTTAR PRADESH,SAMBHAL,2021-02-19,1,1429,31,1461,
UTTAR PRADESH,SAMBHAL,2021-02-20,0,1407,16,1423,
UTTAR PRADESH,SANT KABEER NAGAR,2021-02-16,0,1137,0,1137,
UTTAR PRADESH,SANT KABEER NAGAR,2021-02-17,1,915,1,917,
UTTAR PRADESH,SANT KABEER NAGAR,2021-02-18,1,1675,76,1752,
UTTAR PRADESH,SANT KABEER NAGAR,2021-02-19,0,1404,0,1404,
UTTAR PRADESH,SANT KABEER NAGAR,2021-02-20,3,1402,8,1413,
UTTAR PRADESH,SHAHJAHANPUR,2021-02-16,0,537,34,571,
UTTAR PRADESH,SHAHJAHANPUR,2021-02-17,7,1272,8,1287,
UTTAR PRADESH,SHAHJAHANPUR,2021-02-18,1,1454,144,1599,
UTTAR PRADESH,SHAHJAHANPUR,2021-02-19,0,2252,3,2255,
UTTAR PRADESH,SHAHJAHANPUR,2021-02-20,0,707,87,794,
UTTAR PRADESH,SHAMLI,2021-02-16,0,1136,0,1136,
UTTAR PRADESH,SHAMLI,2021-02-17,0,607,0,607,
UTTAR PRADESH,SHAMLI,2021-02-18,0,2578,0,2578,
UTTAR PRADESH,SHAMLI,2021-02-19,1,1119,0,1120,
UTTAR PRADESH,SHAMLI,2021-02-20,0,1460,0,1460,
UTTAR PRADESH,SHRAVASTI,2021-02-16,0,801,0,801,
UTTAR PRADESH,SHRAVASTI,2021-02-17,0,668,1,669,
UTTAR PRADESH,SHRAVASTI,2021-02-18,0,752,1,753,
UTTAR PRADESH,SHRAVASTI,2021-02-19,0,675,0,675,
UTTAR PRADESH,SHRAVASTI,2021-02-20,0,665,0,665,
UTTAR PRADESH,SIDDHARTH NAGAR,2021-02-16,1,723,122,846,
UTTAR PRADESH,SIDDHARTH NAGAR,2021-02-17,0,702,110,812,
UTTAR PRADESH,SIDDHARTH NAGAR,2021-02-18,1,1031,83,1115,
UTTAR PRADESH,SIDDHARTH NAGAR,2021-02-19,1,1120,39,1160,
UTTAR PRADESH,SIDDHARTH NAGAR,2021-02-20,0,894,1,895,
UTTAR PRADESH,SITAPUR,2021-02-16,0,1415,6,1421,
UTTAR PRADESH,SITAPUR,2021-02-17,0,1370,103,1473,
UTTAR PRADESH,SITAPUR,2021-02-18,0,1801,37,1838,
UTTAR PRADESH,SITAPUR,2021-02-19,0,1738,12,1750,
UTTAR PRADESH,SITAPUR,2021-02-20,2,1406,23,1431,
UTTAR PRADESH,SONBHADRA,2021-02-16,0,1160,33,1193,
UTTAR PRADESH,SONBHADRA,2021-02-17,2,1343,45,1390,
UTTAR PRADESH,SONBHADRA,2021-02-18,1,1510,54,1565,
UTTAR PRADESH,SONBHADRA,2021-02-19,1,1429,17,1447,
UTTAR PRADESH,SONBHADRA,2021-02-20,0,1492,17,1509,
UTTAR PRADESH,SULTANPUR,2021-02-16,39,3925,32,3996,
UTTAR PRADESH,SULTANPUR,2021-02-17,3,4090,47,4140,
UTTAR PRADESH,SULTANPUR,2021-02-18,1,4115,27,4143,
UTTAR PRADESH,SULTANPUR,2021-02-19,2,3646,12,3660,
UTTAR PRADESH,SULTANPUR,2021-02-20,3,5109,10,5122,
UTTAR PRADESH,UNNAO,2021-02-16,0,1897,9,1906,
UTTAR PRADESH,UNNAO,2021-02-17,0,1800,66,1866,
UTTAR PRADESH,UNNAO,2021-02-18,2,1850,18,1870,
UTTAR PRADESH,UNNAO,2021-02-19,1,1769,98,1868,
UTTAR PRADESH,UNNAO,2021-02-20,1,1751,99,1851,
UTTAR PRADESH,VARANASI,2021-02-16,2,3470,77,3549,
UTTAR PRADESH,VARANASI,2021-02-17,2,2775,15,2792,
UTTAR PRADESH,VARANASI,2021-02-18,12,3278,112,3402,
UTTAR PRADESH,VARANASI,2021-02-19,4,1609,41,1654,
UTTAR PRADESH,VARANASI,2021-02-20,6,4109,52,4167,
UTTARAKHAND,ALMORA,2021-02-16,0,180,1,181,
UTTARAKHAND,ALMORA,2021-02-17,0,254,0,254,
UTTARAKHAND,ALMORA,2021-02-18,0,148,0,148,
UTTARAKHAND,ALMORA,2021-02-19,2,165,1,168,
UTTARAKHAND,ALMORA,2021-02-20,0,40,0,40,
UTTARAKHAND,BAGESHWAR,2021-02-16,0,115,2,117,
UTTARAKHAND,BAGESHWAR,2021-02-17,0,144,0,144,
UTTARAKHAND,BAGESHWAR,2021-02-18,0,191,4,195,
UTTARAKHAND,BAGESHWAR,2021-02-19,0,183,3,186,
UTTARAKHAND,BAGESHWAR,2021-02-20,0,295,0,295,
UTTARAKHAND,CHAMOLI,2021-02-16,0,199,0,199,
UTTARAKHAND,CHAMOLI,2021-02-17,0,18,0,18,
UTTARAKHAND,CHAMOLI,2021-02-18,3,240,1,244,
UTTARAKHAND,CHAMOLI,2021-02-19,1,33,0,34,
UTTARAKHAND,CHAMOLI,2021-02-20,0,150,3,153,
UTTARAKHAND,CHAMPAWAT,2021-02-16,0,25,0,25,
UTTARAKHAND,CHAMPAWAT,2021-02-17,0,152,0,152,
UTTARAKHAND,CHAMPAWAT,2021-02-18,0,68,0,68,
UTTARAKHAND,CHAMPAWAT,2021-02-19,0,267,0,267,
UTTARAKHAND,CHAMPAWAT,2021-02-20,2,428,0,430,
UTTARAKHAND,DEHRADUN,2021-02-16,26,1698,15,1739,
UTTARAKHAND,DEHRADUN,2021-02-17,7,1554,24,1585,
UTTARAKHAND,DEHRADUN,2021-02-18,19,1212,2,1233,
UTTARAKHAND,DEHRADUN,2021-02-19,21,2124,16,2161,
UTTARAKHAND,DEHRADUN,2021-02-20,14,1882,17,1913,
UTTARAKHAND,HARIDWAR,2021-02-16,10,8283,33,8326,
UTTARAKHAND,HARIDWAR,2021-02-17,8,10015,11,10034,
UTTARAKHAND,HARIDWAR,2021-02-18,8,2079,0,2087,
UTTARAKHAND,HARIDWAR,2021-02-19,7,2503,20,2530,
UTTARAKHAND,HARIDWAR,2021-02-20,6,2658,14,2678,
UTTARAKHAND,NAINITAL,2021-02-16,9,1035,5,1049,
UTTARAKHAND,NAINITAL,2021-02-17,10,1102,3,1115,
UTTARAKHAND,NAINITAL,2021-02-18,9,937,11,957,
UTTARAKHAND,NAINITAL,2021-02-19,4,950,4,958,
UTTARAKHAND,NAINITAL,2021-02-20,7,784,8,799,
UTTARAKHAND,PAURI GARHWAL,2021-02-16,3,308,0,311,
UTTARAKHAND,PAURI GARHWAL,2021-02-17,0,505,2,507,
UTTARAKHAND,PAURI GARHWAL,2021-02-18,0,354,0,354,
UTTARAKHAND,PAURI GARHWAL,2021-02-19,1,653,11,665,
UTTARAKHAND,PAURI GARHWAL,2021-02-20,0,342,0,342,
UTTARAKHAND,PITHORAGARH,2021-02-16,3,1237,0,1240,
UTTARAKHAND,PITHORAGARH,2021-02-17,0,1175,2,1177,
UTTARAKHAND,PITHORAGARH,2021-02-18,0,16,0,16,
UTTARAKHAND,PITHORAGARH,2021-02-19,0,14,0,14,
UTTARAKHAND,PITHORAGARH,2021-02-20,0,2219,0,2219,
UTTARAKHAND,RUDRA PRAYAG,2021-02-16,1,56,3,60,
UTTARAKHAND,RUDRA PRAYAG,2021-02-17,0,114,1,115,
UTTARAKHAND,RUDRA PRAYAG,2021-02-18,0,80,0,80,
UTTARAKHAND,RUDRA PRAYAG,2021-02-19,0,112,0,112,
UTTARAKHAND,RUDRA PRAYAG,2021-02-20,0,100,3,103,
UTTARAKHAND,TEHRI GARHWAL,2021-02-16,0,67,0,67,
UTTARAKHAND,TEHRI GARHWAL,2021-02-17,0,304,3,307,
UTTARAKHAND,TEHRI GARHWAL,2021-02-18,1,80,0,81,
UTTARAKHAND,TEHRI GARHWAL,2021-02-19,0,219,1,220,
UTTARAKHAND,TEHRI GARHWAL,2021-02-20,1,88,1,90,
UTTARAKHAND,UDAM SINGH NAGAR,2021-02-16,8,1049,13,1070,
UTTARAKHAND,UDAM SINGH NAGAR,2021-02-17,5,1401,75,1481,
UTTARAKHAND,UDAM SINGH NAGAR,2021-02-18,2,1037,85,1124,
UTTARAKHAND,UDAM SINGH NAGAR,2021-02-19,2,1520,103,1625,
UTTARAKHAND,UDAM SINGH NAGAR,2021-02-20,4,774,15,793,
UTTARAKHAND,UTTAR KASHI,2021-02-16,0,180,0,180,
UTTARAKHAND,UTTAR KASHI,2021-02-17,0,82,0,82,
UTTARAKHAND,UTTAR KASHI,2021-02-18,0,154,0,154,
UTTARAKHAND,UTTAR KASHI,2021-02-19,0,215,0,215,
UTTARAKHAND,UTTAR KASHI,2021-02-20,0,148,0,148,
WEST BENGAL,24 PARAGANAS NORTH,2021-02-16,25,2235,14,2274,
WEST BENGAL,24 PARAGANAS NORTH,2021-02-17,30,3025,15,3070,
WEST BENGAL,24 PARAGANAS NORTH,2021-02-18,60,3455,15,3530,
WEST BENGAL,24 PARAGANAS NORTH,2021-02-19,25,3132,8,3165,
WEST BENGAL,24 PARAGANAS NORTH,2021-02-20,51,2775,10,2836,
WEST BENGAL,24 PARAGANAS SOUTH,2021-02-16,3,2160,2,2165,
WEST BENGAL,24 PARAGANAS SOUTH,2021-02-17,18,2641,6,2665,
WEST BENGAL,24 PARAGANAS SOUTH,2021-02-18,9,2649,3,2661,
WEST BENGAL,24 PARAGANAS SOUTH,2021-02-19,12,2990,8,3010,
WEST BENGAL,24 PARAGANAS SOUTH,2021-02-20,8,2589,1,2598,
WEST BENGAL,ALIPURDUAR,2021-02-16,0,67,0,67,
WEST BENGAL,ALIPURDUAR,2021-02-17,0,123,0,123,
WEST BENGAL,ALIPURDUAR,2021-02-18,0,440,0,440,
WEST BENGAL,ALIPURDUAR,2021-02-19,1,140,0,141,
WEST BENGAL,ALIPURDUAR,2021-02-20,0,133,0,133,
WEST BENGAL,BANKURA,2021-02-16,1,350,4,355,
WEST BENGAL,BANKURA,2021-02-17,3,484,7,494,
WEST BENGAL,BANKURA,2021-02-18,5,663,0,668,
WEST BENGAL,BANKURA,2021-02-19,3,692,1,696,
WEST BENGAL,BANKURA,2021-02-20,11,375,0,386,
WEST BENGAL,BIRBHUM,2021-02-16,0,565,2,567,
WEST BENGAL,BIRBHUM,2021-02-17,1,413,7,421,
WEST BENGAL,BIRBHUM,2021-02-18,1,613,3,617,
WEST BENGAL,BIRBHUM,2021-02-19,3,718,7,728,
WEST BENGAL,BIRBHUM,2021-02-20,2,449,2,453,
WEST BENGAL,COOCHBEHAR,2021-02-16,1,951,0,952,
WEST BENGAL,COOCHBEHAR,2021-02-17,0,1557,0,1557,
WEST BENGAL,COOCHBEHAR,2021-02-18,1,860,0,861,
WEST BENGAL,COOCHBEHAR,2021-02-19,0,1284,0,1284,
WEST BENGAL,COOCHBEHAR,2021-02-20,0,939,0,939,
WEST BENGAL,DARJEELING,2021-02-16,4,92,0,96,
WEST BENGAL,DARJEELING,2021-02-17,3,418,0,421,
WEST BENGAL,DARJEELING,2021-02-18,1,412,2,415,
WEST BENGAL,DARJEELING,2021-02-19,8,603,0,611,
WEST BENGAL,DARJEELING,2021-02-20,2,423,0,425,
WEST BENGAL,DINAJPUR DAKSHIN,2021-02-16,0,618,3,621,
WEST BENGAL,DINAJPUR DAKSHIN,2021-02-17,0,575,0,575,
WEST BENGAL,DINAJPUR DAKSHIN,2021-02-18,0,536,1,537,
WEST BENGAL,DINAJPUR DAKSHIN,2021-02-19,0,586,2,588,
WEST BENGAL,DINAJPUR DAKSHIN,2021-02-20,0,584,1,585,
WEST BENGAL,DINAJPUR UTTAR,2021-02-16,1,99,0,100,
WEST BENGAL,DINAJPUR UTTAR,2021-02-17,9,316,0,325,
WEST BENGAL,DINAJPUR UTTAR,2021-02-18,1,196,0,197,
WEST BENGAL,DINAJPUR UTTAR,2021-02-19,4,208,0,212,
WEST BENGAL,DINAJPUR UTTAR,2021-02-20,2,212,0,214,
WEST BENGAL,HOOGHLY,2021-02-16,6,275,1,282,
WEST BENGAL,HOOGHLY,2021-02-17,7,454,8,469,
WEST BENGAL,HOOGHLY,2021-02-18,7,435,7,449,
WEST BENGAL,HOOGHLY,2021-02-19,4,389,0,393,
WEST BENGAL,HOOGHLY,2021-02-20,6,547,3,556,
WEST BENGAL,HOWRAH,2021-02-16,13,620,75,708,
WEST BENGAL,HOWRAH,2021-02-17,20,885,49,954,
WEST BENGAL,HOWRAH,2021-02-18,9,970,119,1098,
WEST BENGAL,HOWRAH,2021-02-19,19,1061,26,1106,
WEST BENGAL,HOWRAH,2021-02-20,13,1116,80,1209,
WEST BENGAL,JALPAIGURI,2021-02-16,1,89,0,90,
WEST BENGAL,JALPAIGURI,2021-02-17,0,307,0,307,
WEST BENGAL,JALPAIGURI,2021-02-18,1,465,0,466,
WEST BENGAL,JALPAIGURI,2021-02-19,1,458,0,459,
WEST BENGAL,JALPAIGURI,2021-02-20,0,441,0,441,
WEST BENGAL,JHARGRAM,2021-02-16,0,35,1,36,
WEST BENGAL,JHARGRAM,2021-02-17,0,63,1,64,
WEST BENGAL,JHARGRAM,2021-02-18,0,9,0,9,
WEST BENGAL,JHARGRAM,2021-02-19,0,48,0,48,
WEST BENGAL,JHARGRAM,2021-02-20,0,88,0,88,
WEST BENGAL,KALIMPONG,2021-02-16,0,46,0,46,
WEST BENGAL,KALIMPONG,2021-02-17,0,83,0,83,
WEST BENGAL,KALIMPONG,2021-02-18,0,91,0,91,
WEST BENGAL,KALIMPONG,2021-02-19,0,138,0,138,
WEST BENGAL,KALIMPONG,2021-02-20,0,67,0,67,
WEST BENGAL,KOLKATA,2021-02-16,72,2251,3,2326,
WEST BENGAL,KOLKATA,2021-02-17,93,2689,17,2799,
WEST BENGAL,KOLKATA,2021-02-18,88,3430,13,3531,
WEST BENGAL,KOLKATA,2021-02-19,98,3240,6,3344,
WEST BENGAL,KOLKATA,2021-02-20,77,2903,8,2988,
WEST BENGAL,MALDAH,2021-02-16,0,265,5,270,
WEST BENGAL,MALDAH,2021-02-17,1,436,2,439,
WEST BENGAL,MALDAH,2021-02-18,0,564,5,569,
WEST BENGAL,MALDAH,2021-02-19,2,561,2,565,
WEST BENGAL,MALDAH,2021-02-20,0,314,3,317,
WEST BENGAL,MEDINIPUR EAST,2021-02-16,1,316,2,319,
WEST BENGAL,MEDINIPUR EAST,2021-02-17,1,659,2,662,
WEST BENGAL,MEDINIPUR EAST,2021-02-18,2,516,2,520,
WEST BENGAL,MEDINIPUR EAST,2021-02-19,0,783,6,789,
WEST BENGAL,MEDINIPUR EAST,2021-02-20,2,887,2,891,
WEST BENGAL,MEDINIPUR WEST,2021-02-16,2,220,3,225,
WEST BENGAL,MEDINIPUR WEST,2021-02-17,1,435,3,439,
WEST BENGAL,MEDINIPUR WEST,2021-02-18,2,268,0,270,
WEST BENGAL,MEDINIPUR WEST,2021-02-19,4,356,7,367,
WEST BENGAL,MEDINIPUR WEST,2021-02-20,2,367,3,372,
WEST BENGAL,MURSHIDABAD,2021-02-16,1,1088,1,1090,
WEST BENGAL,MURSHIDABAD,2021-02-17,2,1000,1,1003,
WEST BENGAL,MURSHIDABAD,2021-02-18,5,1349,0,1354,
WEST BENGAL,MURSHIDABAD,2021-02-19,1,933,3,937,
WEST BENGAL,MURSHIDABAD,2021-02-20,2,1504,0,1506,
WEST BENGAL,NADIA,2021-02-16,2,409,5,416,
WEST BENGAL,NADIA,2021-02-17,3,549,43,595,
WEST BENGAL,NADIA,2021-02-18,4,555,9,568,
WEST BENGAL,NADIA,2021-02-19,3,563,7,573,
WEST BENGAL,NADIA,2021-02-20,2,703,10,715,
WEST BENGAL,PASCHIM BARDHAMAN,2021-02-16,5,591,0,596,
WEST BENGAL,PASCHIM BARDHAMAN,2021-02-17,4,714,1,719,
WEST BENGAL,PASCHIM BARDHAMAN,2021-02-18,5,691,2,698,
WEST BENGAL,PASCHIM BARDHAMAN,2021-02-19,8,580,2,590,
WEST BENGAL,PASCHIM BARDHAMAN,2021-02-20,7,784,1,792,
WEST BENGAL,PURBA BARDHAMAN,2021-02-16,2,302,0,304,
WEST BENGAL,PURBA BARDHAMAN,2021-02-17,3,605,0,608,
WEST BENGAL,PURBA BARDHAMAN,2021-02-18,5,520,0,525,
WEST BENGAL,PURBA BARDHAMAN,2021-02-19,3,578,0,581,
WEST BENGAL,PURBA BARDHAMAN,2021-02-20,3,536,0,539,
WEST BENGAL,PURULIA,2021-02-16,0,130,0,130,
WEST BENGAL,PURULIA,2021-02-17,1,197,0,198,
WEST BENGAL,PURULIA,2021-02-18,4,433,0,437,
WEST BENGAL,PURULIA,2021-02-19,20,191,0,211,
WEST BENGAL,PURULIA,2021-02-20,2,705,0,707,
ANDAMAN AND NICOBAR ISLANDS,NICOBARS,2021-02-21,0,7,0,7,
ANDAMAN AND NICOBAR ISLANDS,NICOBARS,2021-02-22,0,7,0,7,
ANDAMAN AND NICOBAR ISLANDS,NORTH AND MIDDLE ANDAMAN,2021-02-21,0,7,0,7,
ANDAMAN AND NICOBAR ISLANDS,NORTH AND MIDDLE ANDAMAN,2021-02-22,0,10,0,10,
ANDAMAN AND NICOBAR ISLANDS,SOUTH ANDAMANS,2021-02-21,1,493,0,494,
ANDAMAN AND NICOBAR ISLANDS,SOUTH ANDAMANS,2021-02-22,2,480,0,482,
ANDHRA PRADESH,ANANTAPUR,2021-02-21,0,17,1,18,
ANDHRA PRADESH,ANANTAPUR,2021-02-22,1,43,0,44,
ANDHRA PRADESH,CHITTOOR,2021-02-21,0,43,0,43,
ANDHRA PRADESH,CHITTOOR,2021-02-22,0,133,1,134,
ANDHRA PRADESH,EAST GODAVARI,2021-02-21,2,14,0,16,
ANDHRA PRADESH,EAST GODAVARI,2021-02-22,2,35,0,37,
ANDHRA PRADESH,GUNTUR,2021-02-21,0,5,0,5,
ANDHRA PRADESH,GUNTUR,2021-02-22,0,25,1,26,
ANDHRA PRADESH,KRISHNA,2021-02-21,1,2,0,3,
ANDHRA PRADESH,KRISHNA,2021-02-22,0,11,0,11,
ANDHRA PRADESH,KURNOOL,2021-02-21,0,2,0,2,
ANDHRA PRADESH,KURNOOL,2021-02-22,0,1,0,1,
ANDHRA PRADESH,PRAKASAM,2021-02-21,0,4,0,4,
ANDHRA PRADESH,PRAKASAM,2021-02-22,0,10,0,10,
ANDHRA PRADESH,SPSR NELLORE,2021-02-21,0,11,0,11,
ANDHRA PRADESH,SPSR NELLORE,2021-02-22,1,20,0,21,
ANDHRA PRADESH,SRIKAKULAM,2021-02-21,0,5,0,5,
ANDHRA PRADESH,SRIKAKULAM,2021-02-22,0,12,0,12,
ANDHRA PRADESH,VISAKHAPATANAM,2021-02-21,2,38,0,40,
ANDHRA PRADESH,VISAKHAPATANAM,2021-02-22,0,129,1,130,
ANDHRA PRADESH,VIZIANAGARAM,2021-02-21,0,5,0,5,
ANDHRA PRADESH,VIZIANAGARAM,2021-02-22,0,6,0,6,
ANDHRA PRADESH,WEST GODAVARI,2021-02-21,0,8,0,8,
ANDHRA PRADESH,WEST GODAVARI,2021-02-22,0,5,0,5,
ANDHRA PRADESH,Y.S.R.,2021-02-21,0,18,0,18,
ANDHRA PRADESH,Y.S.R.,2021-02-22,0,8,0,8,
ARUNACHAL PRADESH,ANJAW,2021-02-21,0,4,0,4,
ARUNACHAL PRADESH,CHANGLANG,2021-02-21,0,1,0,1,
ARUNACHAL PRADESH,EAST SIANG,2021-02-21,0,1,0,1,
ARUNACHAL PRADESH,EAST SIANG,2021-02-22,0,29,0,29,
ARUNACHAL PRADESH,KURUNG KUMEY,2021-02-21,0,1,0,1,
ARUNACHAL PRADESH,LEPARADA,2021-02-22,19,0,0,19,
ARUNACHAL PRADESH,LOHIT,2021-02-21,0,2,0,2,
ARUNACHAL PRADESH,LOHIT,2021-02-22,0,2,0,2,
ARUNACHAL PRADESH,LOWER DIBANG VALLEY,2021-02-22,0,1,0,1,
ARUNACHAL PRADESH,LOWER SIANG,2021-02-21,0,14,0,14,
ARUNACHAL PRADESH,LOWER SIANG,2021-02-22,0,17,0,17,
ARUNACHAL PRADESH,LOWER SUBANSIRI,2021-02-21,0,8,0,8,
ARUNACHAL PRADESH,LOWER SUBANSIRI,2021-02-22,0,10,0,10,
ARUNACHAL PRADESH,NAMSAI,2021-02-21,0,3,0,3,
ARUNACHAL PRADESH,NAMSAI,2021-02-22,0,2,0,2,
ARUNACHAL PRADESH,PAPUM PARE,2021-02-21,0,2,0,2,
ARUNACHAL PRADESH,PAPUM PARE,2021-02-22,0,42,0,42,
ARUNACHAL PRADESH,SHI YOMI,2021-02-21,0,1,0,1,
ARUNACHAL PRADESH,SIANG,2021-02-21,0,1,0,1,
ARUNACHAL PRADESH,TAWANG,2021-02-22,0,2,0,2,
ARUNACHAL PRADESH,TIRAP,2021-02-22,0,1,0,1,
ARUNACHAL PRADESH,UPPER SIANG,2021-02-22,0,3,0,3,
ARUNACHAL PRADESH,WEST KAMENG,2021-02-21,0,77,0,77,
ARUNACHAL PRADESH,WEST KAMENG,2021-02-22,0,33,0,33,
ARUNACHAL PRADESH,WEST SIANG,2021-02-22,0,1,0,1,
ASSAM,BAKSA,2021-02-21,0,9,0,9,
ASSAM,BAKSA,2021-02-22,0,21,0,21,
ASSAM,BARPETA,2021-02-21,0,5,0,5,
ASSAM,BARPETA,2021-02-22,1,139,0,140,
ASSAM,BISWANATH,2021-02-21,0,107,0,107,
ASSAM,BISWANATH,2021-02-22,0,71,0,71,
ASSAM,BONGAIGAON,2021-02-21,0,29,0,29,
ASSAM,BONGAIGAON,2021-02-22,0,274,0,274,
ASSAM,CACHAR,2021-02-21,0,57,0,57,
ASSAM,CACHAR,2021-02-22,0,152,59,211,
ASSAM,CHARAIDEO,2021-02-21,0,51,0,51,
ASSAM,CHARAIDEO,2021-02-22,0,133,0,133,
ASSAM,CHIRANG,2021-02-21,0,38,0,38,
ASSAM,CHIRANG,2021-02-22,0,50,0,50,
ASSAM,DARRANG,2021-02-21,0,91,0,91,
ASSAM,DARRANG,2021-02-22,0,386,0,386,
ASSAM,DHEMAJI,2021-02-21,0,38,0,38,
ASSAM,DHEMAJI,2021-02-22,0,77,0,77,
ASSAM,DHUBRI,2021-02-21,0,16,0,16,
ASSAM,DHUBRI,2021-02-22,3,312,0,315,
ASSAM,DIBRUGARH,2021-02-21,0,143,0,143,
ASSAM,DIBRUGARH,2021-02-22,5,650,0,655,
ASSAM,DIMA HASAO,2021-02-21,0,13,0,13,
ASSAM,DIMA HASAO,2021-02-22,0,30,0,30,
ASSAM,GOALPARA,2021-02-21,0,132,0,132,
ASSAM,GOALPARA,2021-02-22,0,365,0,365,
ASSAM,GOLAGHAT,2021-02-21,0,38,0,38,
ASSAM,GOLAGHAT,2021-02-22,0,128,0,128,
ASSAM,HAILAKANDI,2021-02-21,0,73,0,73,
ASSAM,HAILAKANDI,2021-02-22,0,217,6,223,
ASSAM,HOJAI,2021-02-21,0,31,0,31,
ASSAM,HOJAI,2021-02-22,0,343,0,343,
ASSAM,JORHAT,2021-02-21,1,186,0,187,
ASSAM,JORHAT,2021-02-22,1,423,0,424,
ASSAM,KAMRUP,2021-02-21,0,208,0,208,
ASSAM,KAMRUP,2021-02-22,0,878,0,878,
ASSAM,KAMRUP METRO,2021-02-21,9,719,0,728,
ASSAM,KAMRUP METRO,2021-02-22,11,1534,35,1580,
ASSAM,KARBI ANGLONG,2021-02-22,0,41,1,42,
ASSAM,KARIMGANJ,2021-02-21,0,45,0,45,
ASSAM,KARIMGANJ,2021-02-22,0,275,2,277,
ASSAM,KOKRAJHAR,2021-02-21,0,5,0,5,
ASSAM,KOKRAJHAR,2021-02-22,0,35,0,35,
ASSAM,LAKHIMPUR,2021-02-21,0,102,0,102,
ASSAM,LAKHIMPUR,2021-02-22,0,416,0,416,
ASSAM,MAJULI,2021-02-21,0,2,0,2,
ASSAM,MAJULI,2021-02-22,0,10,0,10,
ASSAM,MARIGAON,2021-02-21,0,158,0,158,
ASSAM,MARIGAON,2021-02-22,0,125,0,125,
ASSAM,NAGAON,2021-02-21,0,236,0,236,
ASSAM,NAGAON,2021-02-22,0,840,0,840,
ASSAM,NALBARI,2021-02-21,0,8,0,8,
ASSAM,NALBARI,2021-02-22,0,55,0,55,
ASSAM,SIVASAGAR,2021-02-21,0,6,0,6,
ASSAM,SIVASAGAR,2021-02-22,1,136,0,137,
ASSAM,SONITPUR,2021-02-21,0,44,0,44,
ASSAM,SONITPUR,2021-02-22,0,265,0,265,
ASSAM,SOUTH SALMARA MANCACHAR,2021-02-21,0,2,0,2,
ASSAM,SOUTH SALMARA MANCACHAR,2021-02-22,1,17,0,18,
ASSAM,TINSUKIA,2021-02-21,0,181,0,181,
ASSAM,TINSUKIA,2021-02-22,7,144,0,151,
ASSAM,UDALGURI,2021-02-22,0,11,0,11,
ASSAM,WEST KARBI ANGLONG,2021-02-21,0,20,0,20,
ASSAM,WEST KARBI ANGLONG,2021-02-22,0,10,0,10,
BIHAR,ARARIA,2021-02-21,0,5427,0,5427,
BIHAR,ARARIA,2021-02-22,3,3606,9,3618,
BIHAR,ARWAL,2021-02-21,0,141,0,141,
BIHAR,ARWAL,2021-02-22,0,790,6,796,
BIHAR,AURANGABAD,2021-02-21,36,14269,0,14305,
BIHAR,AURANGABAD,2021-02-22,15,8871,0,8886,
BIHAR,BANKA,2021-02-21,2,9836,48,9886,
BIHAR,BANKA,2021-02-22,1,3728,0,3729,
BIHAR,BEGUSARAI,2021-02-21,1,1953,0,1954,
BIHAR,BEGUSARAI,2021-02-22,1,1578,0,1579,
BIHAR,BHAGALPUR,2021-02-21,4,3146,111,3261,
BIHAR,BHAGALPUR,2021-02-22,3,909,18,930,
BIHAR,BHOJPUR,2021-02-21,7,7169,11,7187,
BIHAR,BHOJPUR,2021-02-22,1,5904,5,5910,
BIHAR,BUXAR,2021-02-21,0,1060,0,1060,
BIHAR,BUXAR,2021-02-22,1,915,0,916,
BIHAR,DARBHANGA,2021-02-21,1,688,6,695,
BIHAR,DARBHANGA,2021-02-22,1,774,0,775,
BIHAR,GAYA,2021-02-21,10,25784,0,25794,
BIHAR,GAYA,2021-02-22,2,9102,75,9179,
BIHAR,GOPALGANJ,2021-02-21,1,1075,9,1085,
BIHAR,GOPALGANJ,2021-02-22,0,890,0,890,
BIHAR,JAMUI,2021-02-21,0,361,0,361,
BIHAR,JAMUI,2021-02-22,1,478,0,479,
BIHAR,JEHANABAD,2021-02-21,4,13014,0,13018,
BIHAR,JEHANABAD,2021-02-22,0,4195,73,4268,
BIHAR,KAIMUR (BHABUA),2021-02-21,4,8008,0,8012,
BIHAR,KAIMUR (BHABUA),2021-02-22,1,5724,1,5726,
BIHAR,KATIHAR,2021-02-21,3,3478,0,3481,
BIHAR,KATIHAR,2021-02-22,0,4047,0,4047,
BIHAR,KHAGARIA,2021-02-21,10,6613,0,6623,
BIHAR,KHAGARIA,2021-02-22,3,2832,0,2835,
BIHAR,KISHANGANJ,2021-02-21,0,2673,0,2673,
BIHAR,KISHANGANJ,2021-02-22,0,1719,0,1719,
BIHAR,LAKHISARAI,2021-02-21,0,2206,0,2206,
BIHAR,LAKHISARAI,2021-02-22,0,1931,0,1931,
BIHAR,MADHEPURA,2021-02-21,2,2140,0,2142,
BIHAR,MADHEPURA,2021-02-22,0,2007,0,2007,
BIHAR,MADHUBANI,2021-02-21,5,3804,0,3809,
BIHAR,MADHUBANI,2021-02-22,3,3086,7,3096,
BIHAR,MUNGER,2021-02-21,58,15452,0,15510,
BIHAR,MUNGER,2021-02-22,25,10899,24,10948,
BIHAR,MUZAFFARPUR,2021-02-21,3,11519,0,11522,
BIHAR,MUZAFFARPUR,2021-02-22,1,4856,0,4857,
BIHAR,NALANDA,2021-02-21,3,1876,0,1879,
BIHAR,NALANDA,2021-02-22,0,1039,0,1039,
BIHAR,NAWADA,2021-02-21,29,55485,4,55518,
BIHAR,NAWADA,2021-02-22,28,26724,0,26752,
BIHAR,PASHCHIM CHAMPARAN,2021-02-21,1,9816,0,9817,
BIHAR,PASHCHIM CHAMPARAN,2021-02-22,4,4501,0,4505,
BIHAR,PATNA,2021-02-21,23,1643,1,1667,
BIHAR,PATNA,2021-02-22,8,2347,2,2357,
BIHAR,PURBI CHAMPARAN,2021-02-21,3,2120,12,2135,
BIHAR,PURBI CHAMPARAN,2021-02-22,0,1591,5,1596,
BIHAR,PURNIA,2021-02-21,6,8014,36,8056,
BIHAR,PURNIA,2021-02-22,4,8558,0,8562,
BIHAR,ROHTAS,2021-02-21,0,1399,0,1399,
BIHAR,ROHTAS,2021-02-22,1,2453,21,2475,
BIHAR,SAHARSA,2021-02-21,2,9077,0,9079,
BIHAR,SAHARSA,2021-02-22,5,2864,0,2869,
BIHAR,SAMASTIPUR,2021-02-21,1,5267,14,5282,
BIHAR,SAMASTIPUR,2021-02-22,1,5864,16,5881,
BIHAR,SARAN,2021-02-21,3,3421,0,3424,
BIHAR,SARAN,2021-02-22,3,2941,1,2945,
BIHAR,SHEIKHPURA,2021-02-21,0,416,0,416,
BIHAR,SHEIKHPURA,2021-02-22,0,406,5,411,
BIHAR,SHEOHAR,2021-02-21,0,1033,0,1033,
BIHAR,SHEOHAR,2021-02-22,0,1107,0,1107,
BIHAR,SITAMARHI,2021-02-21,4,2658,1,2663,
BIHAR,SITAMARHI,2021-02-22,2,1270,1,1273,
BIHAR,SIWAN,2021-02-21,4,7339,0,7343,
BIHAR,SIWAN,2021-02-22,8,5226,0,5234,
BIHAR,SUPAUL,2021-02-21,2,3365,0,3367,
BIHAR,SUPAUL,2021-02-22,1,2402,0,2403,
BIHAR,VAISHALI,2021-02-21,2,8252,32,8286,
BIHAR,VAISHALI,2021-02-22,1,6061,5,6067,
CHANDIGARH,CHANDIGARH,2021-02-21,35,582,6,623,
CHANDIGARH,CHANDIGARH,2021-02-22,44,1496,2,1542,
CHHATTISGARH,BALOD,2021-02-21,0,795,0,795,
CHHATTISGARH,BALOD,2021-02-22,2,878,0,880,
CHHATTISGARH,BALODA BAZAR,2021-02-21,1,90,2,93,
CHHATTISGARH,BALODA BAZAR,2021-02-22,9,246,5,260,
CHHATTISGARH,BALRAMPUR,2021-02-21,1,20,0,21,
CHHATTISGARH,BALRAMPUR,2021-02-22,2,282,0,284,
CHHATTISGARH,BASTAR,2021-02-21,2,475,0,477,
CHHATTISGARH,BASTAR,2021-02-22,9,737,0,746,
CHHATTISGARH,BEMETARA,2021-02-21,2,508,0,510,
CHHATTISGARH,BEMETARA,2021-02-22,0,541,0,541,
CHHATTISGARH,BIJAPUR,2021-02-21,0,67,0,67,
CHHATTISGARH,BIJAPUR,2021-02-22,0,157,0,157,
CHHATTISGARH,BILASPUR,2021-02-21,22,422,3,447,
CHHATTISGARH,BILASPUR,2021-02-22,24,984,10,1018,
CHHATTISGARH,DANTEWADA,2021-02-21,2,350,0,352,
CHHATTISGARH,DANTEWADA,2021-02-22,3,296,0,299,
CHHATTISGARH,DHAMTARI,2021-02-21,8,157,7,172,
CHHATTISGARH,DHAMTARI,2021-02-22,5,832,11,848,
CHHATTISGARH,DURG,2021-02-21,33,539,0,572,
CHHATTISGARH,DURG,2021-02-22,68,1248,1,1317,
CHHATTISGARH,GARIYABAND,2021-02-21,5,172,11,188,
CHHATTISGARH,GARIYABAND,2021-02-22,3,269,7,279,
CHHATTISGARH,GAURELLA PENDRA MARWAHI,2021-02-21,3,53,0,56,
CHHATTISGARH,GAURELLA PENDRA MARWAHI,2021-02-22,1,286,14,301,
CHHATTISGARH,JANJGIR CHAMPA,2021-02-21,3,944,0,947,
CHHATTISGARH,JANJGIR CHAMPA,2021-02-22,10,1627,0,1637,
CHHATTISGARH,JASHPUR,2021-02-21,2,95,0,97,
CHHATTISGARH,JASHPUR,2021-02-22,17,401,0,418,
CHHATTISGARH,KABIRDHAM,2021-02-21,0,24,0,24,
CHHATTISGARH,KABIRDHAM,2021-02-22,2,426,3,431,
CHHATTISGARH,KANKER,2021-02-21,2,290,0,292,
CHHATTISGARH,KANKER,2021-02-22,4,695,0,699,
CHHATTISGARH,KONDAGAON,2021-02-21,1,276,0,277,
CHHATTISGARH,KONDAGAON,2021-02-22,0,425,0,425,
CHHATTISGARH,KORBA,2021-02-21,6,465,0,471,
CHHATTISGARH,KORBA,2021-02-22,9,809,0,818,
CHHATTISGARH,KOREA,2021-02-21,8,351,2,361,
CHHATTISGARH,KOREA,2021-02-22,11,613,0,624,
CHHATTISGARH,MAHASAMUND,2021-02-21,7,641,14,662,
CHHATTISGARH,MAHASAMUND,2021-02-22,4,1224,9,1237,
CHHATTISGARH,MUNGELI,2021-02-21,1,317,0,318,
CHHATTISGARH,MUNGELI,2021-02-22,2,310,14,326,
CHHATTISGARH,NARAYANPUR,2021-02-21,0,188,0,188,
CHHATTISGARH,NARAYANPUR,2021-02-22,0,134,0,134,
CHHATTISGARH,RAIGARH,2021-02-21,11,506,2,519,
CHHATTISGARH,RAIGARH,2021-02-22,13,868,0,881,
CHHATTISGARH,RAIPUR,2021-02-21,62,1460,8,1530,
CHHATTISGARH,RAIPUR,2021-02-22,84,2462,3,2549,
CHHATTISGARH,RAJNANDGAON,2021-02-21,5,556,43,604,
CHHATTISGARH,RAJNANDGAON,2021-02-22,18,530,46,594,
CHHATTISGARH,SUKMA,2021-02-21,0,22,0,22,
CHHATTISGARH,SUKMA,2021-02-22,0,442,0,442,
CHHATTISGARH,SURAJPUR,2021-02-21,1,666,3,670,
CHHATTISGARH,SURAJPUR,2021-02-22,4,833,0,837,
CHHATTISGARH,SURGUJA,2021-02-21,3,373,0,376,
CHHATTISGARH,SURGUJA,2021-02-22,13,793,0,806,
DADRA AND NAGAR HAVELI,DADRA AND NAGAR HAVELI,2021-02-21,0,77,0,77,
DADRA AND NAGAR HAVELI,DADRA AND NAGAR HAVELI,2021-02-22,0,184,1,185,
DAMAN AND DIU,DAMAN,2021-02-21,0,79,0,79,
DAMAN AND DIU,DAMAN,2021-02-22,0,3,0,3,
DAMAN AND DIU,DIU,2021-02-21,0,36,0,36,
DAMAN AND DIU,DIU,2021-02-22,0,32,0,32,
DELHI,CENTRAL,2021-02-21,8,3474,4,3486,
DELHI,CENTRAL,2021-02-22,17,4455,8,4480,
DELHI,EAST,2021-02-21,8,1871,0,1879,
DELHI,EAST,2021-02-22,9,2928,30,2967,
DELHI,NEW DELHI,2021-02-21,16,3824,8,3848,
DELHI,NEW DELHI,2021-02-22,19,5440,5,5464,
DELHI,NORTH,2021-02-21,4,5751,35,5790,
DELHI,NORTH,2021-02-22,11,6894,105,7010,
DELHI,NORTH EAST,2021-02-21,4,1797,3,1804,
DELHI,NORTH EAST,2021-02-22,4,5321,0,5325,
DELHI,NORTH WEST,2021-02-21,11,3851,1,3863,
DELHI,NORTH WEST,2021-02-22,21,5698,65,5784,
DELHI,SHAHDARA,2021-02-21,1,3946,1,3948,
DELHI,SHAHDARA,2021-02-22,6,6432,2,6440,
DELHI,SOUTH,2021-02-21,36,3847,2,3885,
DELHI,SOUTH,2021-02-22,36,5959,45,6040,
DELHI,SOUTH EAST,2021-02-21,11,2895,13,2919,
DELHI,SOUTH EAST,2021-02-22,9,3705,141,3855,
DELHI,SOUTH WEST,2021-02-21,27,3022,1,3050,
DELHI,SOUTH WEST,2021-02-22,19,2843,2,2864,
DELHI,WEST,2021-02-21,22,7746,1,7769,
DELHI,WEST,2021-02-22,18,7980,3,8001,
GOA,NORTH GOA,2021-02-21,18,503,1,522,
GOA,NORTH GOA,2021-02-22,17,505,3,525,
GOA,SOUTH GOA,2021-02-21,19,375,2,396,
GOA,SOUTH GOA,2021-02-22,21,621,0,642,
GUJARAT,AHMADABAD,2021-02-21,313,3213,1,3527,
GUJARAT,AHMADABAD,2021-02-22,196,4104,76,4376,
GUJARAT,AMRELI,2021-02-21,2,34,0,36,
GUJARAT,AMRELI,2021-02-22,3,548,0,551,
GUJARAT,ANAND,2021-02-21,1,41,0,42,
GUJARAT,ANAND,2021-02-22,6,234,4,244,
GUJARAT,ARVALLI,2021-02-21,2,107,0,109,
GUJARAT,ARVALLI,2021-02-22,3,235,0,238,
GUJARAT,BANAS KANTHA,2021-02-21,1,22,0,23,
GUJARAT,BANAS KANTHA,2021-02-22,0,192,0,192,
GUJARAT,BHARUCH,2021-02-21,3,64,0,67,
GUJARAT,BHARUCH,2021-02-22,6,374,3,383,
GUJARAT,BHAVNAGAR,2021-02-21,1,327,0,328,
GUJARAT,BHAVNAGAR,2021-02-22,6,236,1,243,
GUJARAT,BOTAD,2021-02-21,1,111,0,112,
GUJARAT,BOTAD,2021-02-22,0,228,0,228,
GUJARAT,CHHOTAUDEPUR,2021-02-21,0,3,0,3,
GUJARAT,CHHOTAUDEPUR,2021-02-22,2,149,0,151,
GUJARAT,DANG,2021-02-21,0,21,0,21,
GUJARAT,DANG,2021-02-22,0,107,0,107,
GUJARAT,DEVBHUMI DWARKA,2021-02-21,4,52,0,56,
GUJARAT,DEVBHUMI DWARKA,2021-02-22,6,74,0,80,
GUJARAT,DOHAD,2021-02-21,1,237,0,238,
GUJARAT,DOHAD,2021-02-22,6,329,0,335,
GUJARAT,GANDHINAGAR,2021-02-21,5,514,0,519,
GUJARAT,GANDHINAGAR,2021-02-22,4,678,3,685,
GUJARAT,GIR SOMNATH,2021-02-21,3,25,0,28,
GUJARAT,GIR SOMNATH,2021-02-22,13,278,0,291,
GUJARAT,JAMNAGAR,2021-02-21,7,156,0,163,
GUJARAT,JAMNAGAR,2021-02-22,22,656,2,680,
GUJARAT,JUNAGADH,2021-02-21,2,107,0,109,
GUJARAT,JUNAGADH,2021-02-22,6,358,0,364,
GUJARAT,KACHCHH,2021-02-21,17,196,4,217,
GUJARAT,KACHCHH,2021-02-22,30,481,10,521,
GUJARAT,KHEDA,2021-02-21,6,201,3,210,
GUJARAT,KHEDA,2021-02-22,10,493,3,506,
GUJARAT,MAHESANA,2021-02-21,2,76,0,78,
GUJARAT,MAHESANA,2021-02-22,1,268,4,273,
GUJARAT,MAHISAGAR,2021-02-21,4,40,4,48,
GUJARAT,MAHISAGAR,2021-02-22,2,347,2,351,
GUJARAT,MORBI,2021-02-21,2,47,0,49,
GUJARAT,MORBI,2021-02-22,4,154,0,158,
GUJARAT,NARMADA,2021-02-21,8,14,0,22,
GUJARAT,NARMADA,2021-02-22,2,10,1,13,
GUJARAT,NAVSARI,2021-02-21,1,69,0,70,
GUJARAT,NAVSARI,2021-02-22,2,266,0,268,
GUJARAT,PANCH MAHALS,2021-02-21,2,148,1,151,
GUJARAT,PANCH MAHALS,2021-02-22,3,224,1,228,
GUJARAT,PATAN,2021-02-21,0,147,0,147,
GUJARAT,PATAN,2021-02-22,0,669,2,671,
GUJARAT,PORBANDAR,2021-02-21,0,321,0,321,
GUJARAT,PORBANDAR,2021-02-22,0,384,0,384,
GUJARAT,RAJKOT,2021-02-21,12,338,9,359,
GUJARAT,RAJKOT,2021-02-22,68,1545,11,1624,
GUJARAT,SABAR KANTHA,2021-02-21,7,84,1,92,
GUJARAT,SABAR KANTHA,2021-02-22,7,187,1,195,
GUJARAT,SURAT,2021-02-21,24,599,2,625,
GUJARAT,SURAT,2021-02-22,48,2048,7,2103,
GUJARAT,SURENDRANAGAR,2021-02-21,0,169,0,169,
GUJARAT,SURENDRANAGAR,2021-02-22,1,598,2,601,
GUJARAT,TAPI,2021-02-21,1,122,0,123,
GUJARAT,TAPI,2021-02-22,4,308,0,312,
GUJARAT,VADODARA,2021-02-21,38,389,24,451,
GUJARAT,VADODARA,2021-02-22,59,1344,55,1458,
GUJARAT,VALSAD,2021-02-21,1,165,0,166,
GUJARAT,VALSAD,2021-02-22,4,509,0,513,
HARYANA,AMBALA,2021-02-21,10,137,0,147,
HARYANA,AMBALA,2021-02-22,20,532,59,611,
HARYANA,BHIWANI,2021-02-21,0,479,0,479,
HARYANA,BHIWANI,2021-02-22,0,639,0,639,
HARYANA,CHARKI DADRI,2021-02-21,0,182,0,182,
HARYANA,CHARKI DADRI,2021-02-22,0,638,0,638,
HARYANA,FARIDABAD,2021-02-21,14,397,1,412,
HARYANA,FARIDABAD,2021-02-22,7,1060,17,1084,
HARYANA,FATEHABAD,2021-02-21,4,29,0,33,
HARYANA,FATEHABAD,2021-02-22,2,352,0,354,
HARYANA,GURUGRAM,2021-02-21,42,2527,2,2571,
HARYANA,GURUGRAM,2021-02-22,50,2203,25,2278,
HARYANA,HISAR,2021-02-21,2,1033,1,1036,
HARYANA,HISAR,2021-02-22,3,1580,1,1584,
HARYANA,JHAJJAR,2021-02-21,2,940,0,942,
HARYANA,JHAJJAR,2021-02-22,2,1417,0,1419,
HARYANA,JIND,2021-02-21,1,288,4,293,
HARYANA,JIND,2021-02-22,0,233,5,238,
HARYANA,KAITHAL,2021-02-21,2,36,4,42,
HARYANA,KAITHAL,2021-02-22,3,398,1,402,
HARYANA,KARNAL,2021-02-21,2,117,0,119,
HARYANA,KARNAL,2021-02-22,24,664,6,694,
HARYANA,KURUKSHETRA,2021-02-21,17,491,1,509,
HARYANA,KURUKSHETRA,2021-02-22,14,1338,0,1352,
HARYANA,MAHENDRAGARH,2021-02-21,0,364,2,366,
HARYANA,MAHENDRAGARH,2021-02-22,0,270,2,272,
HARYANA,NUH,2021-02-21,0,496,0,496,
HARYANA,NUH,2021-02-22,0,176,0,176,
HARYANA,PALWAL,2021-02-21,1,24,0,25,
HARYANA,PALWAL,2021-02-22,0,442,2,444,
HARYANA,PANCHKULA,2021-02-21,6,204,3,213,
HARYANA,PANCHKULA,2021-02-22,19,359,10,388,
HARYANA,PANIPAT,2021-02-21,7,494,0,501,
HARYANA,PANIPAT,2021-02-22,5,466,1,472,
HARYANA,REWARI,2021-02-21,0,235,0,235,
HARYANA,REWARI,2021-02-22,0,631,4,635,
HARYANA,ROHTAK,2021-02-21,1,767,0,768,
HARYANA,ROHTAK,2021-02-22,2,889,0,891,
HARYANA,SIRSA,2021-02-21,0,1213,29,1242,
HARYANA,SIRSA,2021-02-22,2,1174,11,1187,
HARYANA,SONIPAT,2021-02-21,8,795,1,804,
HARYANA,SONIPAT,2021-02-22,4,787,0,791,
HARYANA,YAMUNANAGAR,2021-02-21,12,638,3,653,
HARYANA,YAMUNANAGAR,2021-02-22,12,1206,3,1221,
HIMACHAL PRADESH,BILASPUR,2021-02-21,0,177,0,177,
HIMACHAL PRADESH,BILASPUR,2021-02-22,3,456,0,459,
HIMACHAL PRADESH,CHAMBA,2021-02-21,0,564,7,571,
HIMACHAL PRADESH,CHAMBA,2021-02-22,0,584,0,584,
HIMACHAL PRADESH,HAMIRPUR,2021-02-21,0,309,1,310,
HIMACHAL PRADESH,HAMIRPUR,2021-02-22,15,156,0,171,
HIMACHAL PRADESH,KANGRA,2021-02-21,6,594,0,600,
HIMACHAL PRADESH,KANGRA,2021-02-22,4,1268,3,1275,
HIMACHAL PRADESH,KINNAUR,2021-02-21,0,142,0,142,
HIMACHAL PRADESH,KINNAUR,2021-02-22,0,15,0,15,
HIMACHAL PRADESH,KULLU,2021-02-21,0,46,0,46,
HIMACHAL PRADESH,KULLU,2021-02-22,0,228,1,229,
HIMACHAL PRADESH,LAHUL AND SPITI,2021-02-21,0,1,0,1,
HIMACHAL PRADESH,LAHUL AND SPITI,2021-02-22,0,2,0,2,
HIMACHAL PRADESH,MANDI,2021-02-21,0,103,4,107,
HIMACHAL PRADESH,MANDI,2021-02-22,2,253,0,255,
HIMACHAL PRADESH,SHIMLA,2021-02-21,1,398,8,407,
HIMACHAL PRADESH,SHIMLA,2021-02-22,6,636,8,650,
HIMACHAL PRADESH,SIRMAUR,2021-02-21,1,365,1,367,
HIMACHAL PRADESH,SIRMAUR,2021-02-22,1,395,10,406,
HIMACHAL PRADESH,SOLAN,2021-02-21,1,291,0,292,
HIMACHAL PRADESH,SOLAN,2021-02-22,2,296,0,298,
HIMACHAL PRADESH,UNA,2021-02-21,3,297,1,301,
HIMACHAL PRADESH,UNA,2021-02-22,8,354,0,362,
INDIA,INDIA,2021-02-21,1,0,0,1,
INDIA,INDIA,2021-02-22,3,3,0,6,
JAMMU AND KASHMIR,ANANTNAG,2021-02-21,3,96,0,99,
JAMMU AND KASHMIR,ANANTNAG,2021-02-22,5,216,0,221,
JAMMU AND KASHMIR,BANDIPORA,2021-02-21,0,7,0,7,
JAMMU AND KASHMIR,BANDIPORA,2021-02-22,6,109,3,118,
JAMMU AND KASHMIR,BARAMULLA,2021-02-21,2,25,0,27,
JAMMU AND KASHMIR,BARAMULLA,2021-02-22,11,214,0,225,
JAMMU AND KASHMIR,BUDGAM,2021-02-21,1,214,0,215,
JAMMU AND KASHMIR,BUDGAM,2021-02-22,7,905,0,912,
JAMMU AND KASHMIR,DODA,2021-02-21,0,12,1,13,
JAMMU AND KASHMIR,DODA,2021-02-22,0,28,0,28,
JAMMU AND KASHMIR,GANDERBAL,2021-02-21,0,78,0,78,
JAMMU AND KASHMIR,GANDERBAL,2021-02-22,2,67,0,69,
JAMMU AND KASHMIR,JAMMU,2021-02-21,3,491,0,494,
JAMMU AND KASHMIR,JAMMU,2021-02-22,5,1170,0,1175,
JAMMU AND KASHMIR,KATHUA,2021-02-21,0,19,0,19,
JAMMU AND KASHMIR,KATHUA,2021-02-22,1,257,0,258,
JAMMU AND KASHMIR,KISHTWAR,2021-02-21,2,85,0,87,
JAMMU AND KASHMIR,KISHTWAR,2021-02-22,0,72,0,72,
JAMMU AND KASHMIR,KULGAM,2021-02-21,0,5,0,5,
JAMMU AND KASHMIR,KULGAM,2021-02-22,1,166,2,169,
JAMMU AND KASHMIR,KUPWARA,2021-02-21,2,9,0,11,
JAMMU AND KASHMIR,KUPWARA,2021-02-22,0,155,0,155,
JAMMU AND KASHMIR,POONCH,2021-02-21,0,117,0,117,
JAMMU AND KASHMIR,POONCH,2021-02-22,2,140,0,142,
JAMMU AND KASHMIR,PULWAMA,2021-02-21,0,112,0,112,
JAMMU AND KASHMIR,PULWAMA,2021-02-22,5,499,0,504,
JAMMU AND KASHMIR,RAJOURI,2021-02-21,0,58,0,58,
JAMMU AND KASHMIR,RAJOURI,2021-02-22,0,302,1,303,
JAMMU AND KASHMIR,RAMBAN,2021-02-21,0,181,0,181,
JAMMU AND KASHMIR,RAMBAN,2021-02-22,0,233,0,233,
JAMMU AND KASHMIR,REASI,2021-02-21,0,3,0,3,
JAMMU AND KASHMIR,REASI,2021-02-22,0,121,1,122,
JAMMU AND KASHMIR,SAMBA,2021-02-21,0,98,0,98,
JAMMU AND KASHMIR,SAMBA,2021-02-22,0,44,0,44,
JAMMU AND KASHMIR,SHOPIAN,2021-02-21,1,53,0,54,
JAMMU AND KASHMIR,SHOPIAN,2021-02-22,3,134,0,137,
JAMMU AND KASHMIR,SRINAGAR,2021-02-21,16,2356,3,2375,
JAMMU AND KASHMIR,SRINAGAR,2021-02-22,42,3304,2,3348,
JAMMU AND KASHMIR,UDHAMPUR,2021-02-21,0,155,0,155,
JAMMU AND KASHMIR,UDHAMPUR,2021-02-22,3,779,0,782,
JHARKHAND,BOKARO,2021-02-21,0,354,15,369,
JHARKHAND,BOKARO,2021-02-22,0,971,11,982,
JHARKHAND,CHATRA,2021-02-21,1,411,0,412,
JHARKHAND,CHATRA,2021-02-22,0,469,0,469,
JHARKHAND,DEOGHAR,2021-02-21,2,448,0,450,
JHARKHAND,DEOGHAR,2021-02-22,1,943,0,944,
JHARKHAND,DHANBAD,2021-02-21,1,53,0,54,
JHARKHAND,DHANBAD,2021-02-22,2,128,0,130,
JHARKHAND,DUMKA,2021-02-21,2,262,33,297,
JHARKHAND,DUMKA,2021-02-22,0,356,12,368,
JHARKHAND,EAST SINGHBUM,2021-02-21,6,1336,0,1342,
JHARKHAND,EAST SINGHBUM,2021-02-22,7,3045,1,3053,
JHARKHAND,GARHWA,2021-02-21,0,476,0,476,
JHARKHAND,GARHWA,2021-02-22,0,927,0,927,
JHARKHAND,GIRIDIH,2021-02-21,0,224,0,224,
JHARKHAND,GIRIDIH,2021-02-22,1,871,0,872,
JHARKHAND,GODDA,2021-02-21,0,406,0,406,
JHARKHAND,GODDA,2021-02-22,0,510,0,510,
JHARKHAND,GUMLA,2021-02-21,0,13,0,13,
JHARKHAND,GUMLA,2021-02-22,1,515,1,517,
JHARKHAND,HAZARIBAGH,2021-02-21,0,205,0,205,
JHARKHAND,HAZARIBAGH,2021-02-22,0,797,0,797,
JHARKHAND,JAMTARA,2021-02-21,1,218,1,220,
JHARKHAND,JAMTARA,2021-02-22,0,445,0,445,
JHARKHAND,KHUNTI,2021-02-21,0,9,0,9,
JHARKHAND,KHUNTI,2021-02-22,0,341,16,357,
JHARKHAND,KODERMA,2021-02-21,0,570,0,570,
JHARKHAND,KODERMA,2021-02-22,0,478,0,478,
JHARKHAND,LATEHAR,2021-02-21,0,441,10,451,
JHARKHAND,LATEHAR,2021-02-22,1,1432,11,1444,
JHARKHAND,LOHARDAGA,2021-02-21,0,107,0,107,
JHARKHAND,LOHARDAGA,2021-02-22,0,382,2,384,
JHARKHAND,PAKUR,2021-02-21,0,57,0,57,
JHARKHAND,PAKUR,2021-02-22,0,409,0,409,
JHARKHAND,PALAMU,2021-02-21,0,619,0,619,
JHARKHAND,PALAMU,2021-02-22,0,1748,3,1751,
JHARKHAND,RAMGARH,2021-02-21,0,51,0,51,
JHARKHAND,RAMGARH,2021-02-22,23,534,2,559,
JHARKHAND,RANCHI,2021-02-21,27,480,0,507,
JHARKHAND,RANCHI,2021-02-22,52,810,0,862,
JHARKHAND,SAHEBGANJ,2021-02-21,0,66,0,66,
JHARKHAND,SAHEBGANJ,2021-02-22,0,73,0,73,
JHARKHAND,SARAIKELA KHARSAWAN,2021-02-21,0,1,0,1,
JHARKHAND,SARAIKELA KHARSAWAN,2021-02-22,1,294,1,296,
JHARKHAND,SIMDEGA,2021-02-21,0,151,0,151,
JHARKHAND,SIMDEGA,2021-02-22,1,490,0,491,
JHARKHAND,WEST SINGHBHUM,2021-02-21,0,362,0,362,
JHARKHAND,WEST SINGHBHUM,2021-02-22,1,989,0,990,
KARNATAKA,BAGALKOTE,2021-02-21,0,757,3,760,
KARNATAKA,BAGALKOTE,2021-02-22,1,812,8,821,
KARNATAKA,BALLARI,2021-02-21,5,1251,25,1281,
KARNATAKA,BALLARI,2021-02-22,6,569,5,580,
KARNATAKA,BELAGAVI,2021-02-21,1,586,0,587,
KARNATAKA,BELAGAVI,2021-02-22,10,1537,1,1548,
KARNATAKA,BENGALURU RURAL,2021-02-21,7,363,0,370,
KARNATAKA,BENGALURU RURAL,2021-02-22,8,952,2,962,
KARNATAKA,BENGALURU URBAN,2021-02-21,205,18434,255,18894,
KARNATAKA,BENGALURU URBAN,2021-02-22,271,22967,171,23409,
KARNATAKA,BIDAR,2021-02-21,4,638,0,642,
KARNATAKA,BIDAR,2021-02-22,1,283,0,284,
KARNATAKA,CHAMARAJANAGARA,2021-02-21,2,647,0,649,
KARNATAKA,CHAMARAJANAGARA,2021-02-22,0,131,0,131,
KARNATAKA,CHIKKABALLAPURA,2021-02-21,4,1463,0,1467,
KARNATAKA,CHIKKABALLAPURA,2021-02-22,7,1172,4,1183,
KARNATAKA,CHIKKAMAGALURU,2021-02-21,1,795,3,799,
KARNATAKA,CHIKKAMAGALURU,2021-02-22,0,510,0,510,
KARNATAKA,CHITRADURGA,2021-02-21,10,958,0,968,
KARNATAKA,CHITRADURGA,2021-02-22,2,1043,0,1045,
KARNATAKA,DAKSHINA KANNADA,2021-02-21,13,1097,0,1110,
KARNATAKA,DAKSHINA KANNADA,2021-02-22,15,1470,0,1485,
KARNATAKA,DAVANGERE,2021-02-21,2,706,2,710,
KARNATAKA,DAVANGERE,2021-02-22,1,719,0,720,
KARNATAKA,DHARWAD,2021-02-21,7,1135,20,1162,
KARNATAKA,DHARWAD,2021-02-22,6,961,2,969,
KARNATAKA,GADAG,2021-02-21,0,797,16,813,
KARNATAKA,GADAG,2021-02-22,0,906,125,1031,
KARNATAKA,HASSAN,2021-02-21,6,989,0,995,
KARNATAKA,HASSAN,2021-02-22,8,1303,119,1430,
KARNATAKA,HAVERI,2021-02-21,1,435,0,436,
KARNATAKA,HAVERI,2021-02-22,0,918,0,918,
KARNATAKA,KALABURAGI,2021-02-21,4,868,0,872,
KARNATAKA,KALABURAGI,2021-02-22,11,937,1,949,
KARNATAKA,KODAGU,2021-02-21,0,16,0,16,
KARNATAKA,KODAGU,2021-02-22,5,461,12,478,
KARNATAKA,KOLAR,2021-02-21,5,1441,3,1449,
KARNATAKA,KOLAR,2021-02-22,1,920,6,927,
KARNATAKA,KOPPAL,2021-02-21,1,294,0,295,
KARNATAKA,KOPPAL,2021-02-22,1,572,1,574,
KARNATAKA,MANDYA,2021-02-21,4,1163,2,1169,
KARNATAKA,MANDYA,2021-02-22,2,1445,1,1448,
KARNATAKA,MYSURU,2021-02-21,27,2161,4,2192,
KARNATAKA,MYSURU,2021-02-22,30,1285,4,1319,
KARNATAKA,RAICHUR,2021-02-21,0,789,43,832,
KARNATAKA,RAICHUR,2021-02-22,1,593,1,595,
KARNATAKA,RAMANAGARA,2021-02-21,0,321,0,321,
KARNATAKA,RAMANAGARA,2021-02-22,1,613,1,615,
KARNATAKA,SHIVAMOGGA,2021-02-21,3,1401,0,1404,
KARNATAKA,SHIVAMOGGA,2021-02-22,12,730,1,743,
KARNATAKA,TUMAKURU,2021-02-21,15,1069,0,1084,
KARNATAKA,TUMAKURU,2021-02-22,12,1798,0,1810,
KARNATAKA,UDUPI,2021-02-21,12,1067,0,1079,
KARNATAKA,UDUPI,2021-02-22,12,1354,1,1367,
KARNATAKA,UTTARA KANNADA,2021-02-21,2,1397,136,1535,
KARNATAKA,UTTARA KANNADA,2021-02-22,12,1395,201,1608,
KARNATAKA,VIJAYAPURA,2021-02-21,5,1217,1,1223,
KARNATAKA,VIJAYAPURA,2021-02-22,2,752,0,754,
KARNATAKA,YADGIR,2021-02-21,0,804,0,804,
KARNATAKA,YADGIR,2021-02-22,2,628,0,630,
KERALA,ALAPPUZHA,2021-02-21,343,2581,19,2943,
KERALA,ALAPPUZHA,2021-02-22,246,2912,13,3171,
KERALA,ERNAKULAM,2021-02-21,386,3911,31,4328,
KERALA,ERNAKULAM,2021-02-22,437,5432,6,5875,
KERALA,IDUKKI,2021-02-21,50,858,0,908,
KERALA,IDUKKI,2021-02-22,95,1596,2,1693,
KERALA,KANNUR,2021-02-21,148,1749,4,1901,
KERALA,KANNUR,2021-02-22,177,2217,3,2397,
KERALA,KASARAGOD,2021-02-21,79,1203,3,1285,
KERALA,KASARAGOD,2021-02-22,117,1006,4,1127,
KERALA,KOLLAM,2021-02-21,222,2890,5,3117,
KERALA,KOLLAM,2021-02-22,394,3660,13,4067,
KERALA,KOTTAYAM,2021-02-21,284,2231,20,2535,
KERALA,KOTTAYAM,2021-02-22,249,2946,16,3211,
KERALA,KOZHIKODE,2021-02-21,591,5047,70,5708,
KERALA,KOZHIKODE,2021-02-22,381,3771,11,4163,
KERALA,MALAPPURAM,2021-02-21,276,2504,6,2786,
KERALA,MALAPPURAM,2021-02-22,394,3882,5,4281,
KERALA,PALAKKAD,2021-02-21,131,1767,0,1898,
KERALA,PALAKKAD,2021-02-22,133,2193,2,2328,
KERALA,PATHANAMTHITTA,2021-02-21,155,1127,3,1285,
KERALA,PATHANAMTHITTA,2021-02-22,374,2458,3,2835,
KERALA,THIRUVANANTHAPURAM,2021-02-21,279,3380,8,3667,
KERALA,THIRUVANANTHAPURAM,2021-02-22,323,3834,17,4174,
KERALA,THRISSUR,2021-02-21,264,3083,0,3347,
KERALA,THRISSUR,2021-02-22,275,4179,1,4455,
KERALA,WAYANAD,2021-02-21,77,519,6,602,
KERALA,WAYANAD,2021-02-22,90,1014,0,1104,
LADAKH,KARGIL,2021-02-21,0,30,0,30,
LADAKH,KARGIL,2021-02-22,0,114,0,114,
LADAKH,LEH LADAKH,2021-02-21,0,111,0,111,
LADAKH,LEH LADAKH,2021-02-22,1,174,1,176,
LAKSHADWEEP,LAKSHADWEEP DISTRICT,2021-02-21,0,30,0,30,
LAKSHADWEEP,LAKSHADWEEP DISTRICT,2021-02-22,0,380,0,380,
MADHYA PRADESH,AGAR MALWA,2021-02-21,0,69,0,69,
MADHYA PRADESH,AGAR MALWA,2021-02-22,2,243,0,245,
MADHYA PRADESH,ALIRAJPUR,2021-02-21,0,42,0,42,
MADHYA PRADESH,ALIRAJPUR,2021-02-22,1,182,0,183,
MADHYA PRADESH,ANUPPUR,2021-02-21,0,113,0,113,
MADHYA PRADESH,ANUPPUR,2021-02-22,5,104,8,117,
MADHYA PRADESH,ASHOKNAGAR,2021-02-21,0,110,0,110,
MADHYA PRADESH,ASHOKNAGAR,2021-02-22,0,59,0,59,
MADHYA PRADESH,BALAGHAT,2021-02-21,1,183,0,184,
MADHYA PRADESH,BALAGHAT,2021-02-22,7,216,0,223,
MADHYA PRADESH,BARWANI,2021-02-21,0,36,0,36,
MADHYA PRADESH,BARWANI,2021-02-22,2,315,0,317,
MADHYA PRADESH,BETUL,2021-02-21,4,192,0,196,
MADHYA PRADESH,BETUL,2021-02-22,15,298,2,315,
MADHYA PRADESH,BHIND,2021-02-21,0,127,0,127,
MADHYA PRADESH,BHIND,2021-02-22,0,166,0,166,
MADHYA PRADESH,BHOPAL,2021-02-21,66,921,8,995,
MADHYA PRADESH,BHOPAL,2021-02-22,62,1074,7,1143,
MADHYA PRADESH,BURHANPUR,2021-02-21,3,545,2,550,
MADHYA PRADESH,BURHANPUR,2021-02-22,2,132,2,136,
MADHYA PRADESH,CHHATARPUR,2021-02-21,0,229,2,231,
MADHYA PRADESH,CHHATARPUR,2021-02-22,1,213,0,214,
MADHYA PRADESH,CHHINDWARA,2021-02-21,24,248,0,272,
MADHYA PRADESH,CHHINDWARA,2021-02-22,19,442,8,469,
MADHYA PRADESH,DAMOH,2021-02-21,3,105,0,108,
MADHYA PRADESH,DAMOH,2021-02-22,1,152,0,153,
MADHYA PRADESH,DATIA,2021-02-21,0,4,3,7,
MADHYA PRADESH,DATIA,2021-02-22,0,293,9,302,
MADHYA PRADESH,DEWAS,2021-02-21,2,41,1,44,
MADHYA PRADESH,DEWAS,2021-02-22,0,92,0,92,
MADHYA PRADESH,DHAR,2021-02-21,0,80,0,80,
MADHYA PRADESH,DHAR,2021-02-22,9,113,0,122,
MADHYA PRADESH,DINDORI,2021-02-21,0,55,0,55,
MADHYA PRADESH,DINDORI,2021-02-22,2,442,0,444,
MADHYA PRADESH,EAST NIMAR,2021-02-21,6,285,4,295,
MADHYA PRADESH,EAST NIMAR,2021-02-22,2,200,0,202,
MADHYA PRADESH,GUNA,2021-02-21,3,186,0,189,
MADHYA PRADESH,GUNA,2021-02-22,0,256,0,256,
MADHYA PRADESH,GWALIOR,2021-02-21,3,370,1,374,
MADHYA PRADESH,GWALIOR,2021-02-22,6,669,1,676,
MADHYA PRADESH,HARDA,2021-02-21,0,206,0,206,
MADHYA PRADESH,HARDA,2021-02-22,1,207,0,208,
MADHYA PRADESH,HOSHANGABAD,2021-02-21,0,134,0,134,
MADHYA PRADESH,HOSHANGABAD,2021-02-22,1,186,0,187,
MADHYA PRADESH,INDORE,2021-02-21,154,952,2,1108,
MADHYA PRADESH,INDORE,2021-02-22,227,1532,1,1760,
MADHYA PRADESH,JABALPUR,2021-02-21,20,638,1,659,
MADHYA PRADESH,JABALPUR,2021-02-22,14,1364,0,1378,
MADHYA PRADESH,JHABUA,2021-02-21,1,118,0,119,
MADHYA PRADESH,JHABUA,2021-02-22,3,255,0,258,
MADHYA PRADESH,KATNI,2021-02-21,0,5,0,5,
MADHYA PRADESH,KATNI,2021-02-22,0,127,0,127,
MADHYA PRADESH,KHARGONE,2021-02-21,2,37,0,39,
MADHYA PRADESH,KHARGONE,2021-02-22,5,450,0,455,
MADHYA PRADESH,MANDLA,2021-02-21,0,170,0,170,
MADHYA PRADESH,MANDLA,2021-02-22,0,473,0,473,
MADHYA PRADESH,MANDSAUR,2021-02-21,1,41,0,42,
MADHYA PRADESH,MANDSAUR,2021-02-22,2,91,0,93,
MADHYA PRADESH,MORENA,2021-02-21,0,293,0,293,
MADHYA PRADESH,MORENA,2021-02-22,1,280,0,281,
MADHYA PRADESH,NARSINGHPUR,2021-02-21,0,58,0,58,
MADHYA PRADESH,NARSINGHPUR,2021-02-22,2,505,2,509,
MADHYA PRADESH,NEEMUCH,2021-02-21,0,26,0,26,
MADHYA PRADESH,NEEMUCH,2021-02-22,2,125,0,127,
MADHYA PRADESH,NIWARI,2021-02-21,0,10,0,10,
MADHYA PRADESH,NIWARI,2021-02-22,0,95,0,95,
MADHYA PRADESH,PANNA,2021-02-21,1,208,3,212,
MADHYA PRADESH,PANNA,2021-02-22,1,103,0,104,
MADHYA PRADESH,RAISEN,2021-02-21,0,25,0,25,
MADHYA PRADESH,RAISEN,2021-02-22,1,176,0,177,
MADHYA PRADESH,RAJGARH,2021-02-21,0,175,0,175,
MADHYA PRADESH,RAJGARH,2021-02-22,8,166,0,174,
MADHYA PRADESH,RATLAM,2021-02-21,1,94,3,98,
MADHYA PRADESH,RATLAM,2021-02-22,3,248,4,255,
MADHYA PRADESH,REWA,2021-02-21,6,451,3,460,
MADHYA PRADESH,REWA,2021-02-22,4,186,1,191,
MADHYA PRADESH,SAGAR,2021-02-21,3,554,0,557,
MADHYA PRADESH,SAGAR,2021-02-22,5,311,0,316,
MADHYA PRADESH,SATNA,2021-02-21,1,241,1,243,
MADHYA PRADESH,SATNA,2021-02-22,2,322,2,326,
MADHYA PRADESH,SEHORE,2021-02-21,3,225,0,228,
MADHYA PRADESH,SEHORE,2021-02-22,1,139,0,140,
MADHYA PRADESH,SEONI,2021-02-21,1,203,25,229,
MADHYA PRADESH,SEONI,2021-02-22,0,191,0,191,
MADHYA PRADESH,SHAHDOL,2021-02-21,0,9,1,10,
MADHYA PRADESH,SHAHDOL,2021-02-22,0,33,1,34,
MADHYA PRADESH,SHAJAPUR,2021-02-21,0,179,0,179,
MADHYA PRADESH,SHAJAPUR,2021-02-22,4,272,0,276,
MADHYA PRADESH,SHEOPUR,2021-02-21,2,235,1,238,
MADHYA PRADESH,SHEOPUR,2021-02-22,1,74,1,76,
MADHYA PRADESH,SHIVPURI,2021-02-21,0,74,0,74,
MADHYA PRADESH,SHIVPURI,2021-02-22,0,197,0,197,
MADHYA PRADESH,SIDHI,2021-02-21,0,27,0,27,
MADHYA PRADESH,SIDHI,2021-02-22,6,191,0,197,
MADHYA PRADESH,SINGRAULI,2021-02-21,1,104,0,105,
MADHYA PRADESH,SINGRAULI,2021-02-22,6,189,0,195,
MADHYA PRADESH,TIKAMGARH,2021-02-21,1,68,0,69,
MADHYA PRADESH,TIKAMGARH,2021-02-22,1,242,0,243,
MADHYA PRADESH,UJJAIN,2021-02-21,0,43,0,43,
MADHYA PRADESH,UJJAIN,2021-02-22,2,192,0,194,
MADHYA PRADESH,UMARIA,2021-02-21,0,108,73,181,
MADHYA PRADESH,UMARIA,2021-02-22,0,116,11,127,
MADHYA PRADESH,VIDISHA,2021-02-21,0,40,0,40,
MADHYA PRADESH,VIDISHA,2021-02-22,1,105,0,106,
MAHARASHTRA,AHMEDNAGAR,2021-02-21,132,727,0,859,
MAHARASHTRA,AHMEDNAGAR,2021-02-22,104,414,2,520,
MAHARASHTRA,AKOLA,2021-02-21,230,545,0,775,
MAHARASHTRA,AKOLA,2021-02-22,204,689,2,895,
MAHARASHTRA,AMRAVATI,2021-02-21,640,986,0,1626,
MAHARASHTRA,AMRAVATI,2021-02-22,979,924,1,1904,
MAHARASHTRA,AURANGABAD,2021-02-21,225,1555,0,1780,
MAHARASHTRA,AURANGABAD,2021-02-22,215,2339,2,2556,
MAHARASHTRA,BEED,2021-02-21,39,390,0,429,
MAHARASHTRA,BEED,2021-02-22,52,546,0,598,
MAHARASHTRA,BHANDARA,2021-02-21,18,567,1,586,
MAHARASHTRA,BHANDARA,2021-02-22,22,629,0,651,
MAHARASHTRA,BULDHANA,2021-02-21,139,555,8,702,
MAHARASHTRA,BULDHANA,2021-02-22,166,423,12,601,
MAHARASHTRA,CHANDRAPUR,2021-02-21,19,211,0,230,
MAHARASHTRA,CHANDRAPUR,2021-02-22,59,605,0,664,
MAHARASHTRA,DHULE,2021-02-21,39,199,0,238,
MAHARASHTRA,DHULE,2021-02-22,78,239,1,318,
MAHARASHTRA,GADCHIROLI,2021-02-21,14,186,3,203,
MAHARASHTRA,GADCHIROLI,2021-02-22,1,288,0,289,
MAHARASHTRA,GONDIA,2021-02-21,14,216,1,231,
MAHARASHTRA,GONDIA,2021-02-22,16,122,2,140,
MAHARASHTRA,HINGOLI,2021-02-21,18,205,0,223,
MAHARASHTRA,HINGOLI,2021-02-22,23,42,0,65,
MAHARASHTRA,JALGAON,2021-02-21,268,965,7,1240,
MAHARASHTRA,JALGAON,2021-02-22,283,1181,7,1471,
MAHARASHTRA,JALNA,2021-02-21,23,678,0,701,
MAHARASHTRA,JALNA,2021-02-22,137,674,0,811,
MAHARASHTRA,KOLHAPUR,2021-02-21,6,130,0,136,
MAHARASHTRA,KOLHAPUR,2021-02-22,21,368,5,394,
MAHARASHTRA,LATUR,2021-02-21,45,801,4,850,
MAHARASHTRA,LATUR,2021-02-22,38,780,4,822,
MAHARASHTRA,MUMBAI,2021-02-21,665,9636,27,10328,
MAHARASHTRA,MUMBAI,2021-02-22,568,14279,26,14873,
MAHARASHTRA,MUMBAI SUBURBAN,2021-02-21,189,1929,4,2122,
MAHARASHTRA,MUMBAI SUBURBAN,2021-02-22,200,2550,8,2758,
MAHARASHTRA,NAGPUR,2021-02-21,760,3306,24,4090,
MAHARASHTRA,NAGPUR,2021-02-22,790,4768,10,5568,
MAHARASHTRA,NANDED,2021-02-21,39,447,6,492,
MAHARASHTRA,NANDED,2021-02-22,61,583,4,648,
MAHARASHTRA,NANDURBAR,2021-02-21,6,130,0,136,
MAHARASHTRA,NANDURBAR,2021-02-22,52,283,0,335,
MAHARASHTRA,NASHIK,2021-02-21,202,964,17,1183,
MAHARASHTRA,NASHIK,2021-02-22,223,1268,0,1491,
MAHARASHTRA,OSMANABAD,2021-02-21,5,74,0,79,
MAHARASHTRA,OSMANABAD,2021-02-22,26,610,3,639,
MAHARASHTRA,PALGHAR,2021-02-21,43,433,0,476,
MAHARASHTRA,PALGHAR,2021-02-22,29,651,0,680,
MAHARASHTRA,PARBHANI,2021-02-21,23,191,1,215,
MAHARASHTRA,PARBHANI,2021-02-22,44,735,11,790,
MAHARASHTRA,PUNE,2021-02-21,720,3547,7,4274,
MAHARASHTRA,PUNE,2021-02-22,1288,6611,106,8005,
MAHARASHTRA,RAIGAD,2021-02-21,92,627,1,720,
MAHARASHTRA,RAIGAD,2021-02-22,87,881,2,970,
MAHARASHTRA,RATNAGIRI,2021-02-21,3,220,0,223,
MAHARASHTRA,RATNAGIRI,2021-02-22,57,610,0,667,
MAHARASHTRA,SANGLI,2021-02-21,11,259,1,271,
MAHARASHTRA,SANGLI,2021-02-22,32,950,1,983,
MAHARASHTRA,SATARA,2021-02-21,92,620,11,723,
MAHARASHTRA,SATARA,2021-02-22,36,1467,4,1507,
MAHARASHTRA,SINDHUDURG,2021-02-21,10,121,0,131,
MAHARASHTRA,SINDHUDURG,2021-02-22,6,433,0,439,
MAHARASHTRA,SOLAPUR,2021-02-21,79,4544,3,4626,
MAHARASHTRA,SOLAPUR,2021-02-22,73,3681,3,3757,
MAHARASHTRA,THANE,2021-02-21,512,5455,9,5976,
MAHARASHTRA,THANE,2021-02-22,579,6306,10,6895,
MAHARASHTRA,WARDHA,2021-02-21,63,190,0,253,
MAHARASHTRA,WARDHA,2021-02-22,161,883,9,1053,
MAHARASHTRA,WASHIM,2021-02-21,50,693,1,744,
MAHARASHTRA,WASHIM,2021-02-22,89,643,1,733,
MAHARASHTRA,YAVATMAL,2021-02-21,98,140,0,238,
MAHARASHTRA,YAVATMAL,2021-02-22,167,659,1,827,
MANIPUR,BISHNUPUR,2021-02-21,0,37,0,37,
MANIPUR,BISHNUPUR,2021-02-22,0,94,0,94,
MANIPUR,CHANDEL,2021-02-21,0,12,0,12,
MANIPUR,CHANDEL,2021-02-22,0,16,0,16,
MANIPUR,CHURACHANDPUR,2021-02-21,1,68,0,69,
MANIPUR,CHURACHANDPUR,2021-02-22,0,212,0,212,
MANIPUR,IMPHAL EAST,2021-02-21,1,139,0,140,
MANIPUR,IMPHAL EAST,2021-02-22,1,178,0,179,
MANIPUR,IMPHAL WEST,2021-02-21,1,362,0,363,
MANIPUR,IMPHAL WEST,2021-02-22,0,596,0,596,
MANIPUR,KAKCHING,2021-02-21,0,23,0,23,
MANIPUR,KAKCHING,2021-02-22,2,84,0,86,
MANIPUR,KAMJONG,2021-02-21,0,2,0,2,
MANIPUR,KAMJONG,2021-02-22,0,3,0,3,
MANIPUR,KANGPOKPI,2021-02-21,0,24,0,24,
MANIPUR,KANGPOKPI,2021-02-22,0,9,0,9,
MANIPUR,NONEY,2021-02-21,0,1,0,1,
MANIPUR,NONEY,2021-02-22,0,4,0,4,
MANIPUR,SENAPATI,2021-02-21,0,18,0,18,
MANIPUR,SENAPATI,2021-02-22,0,39,0,39,
MANIPUR,TAMENGLONG,2021-02-21,0,31,0,31,
MANIPUR,TAMENGLONG,2021-02-22,0,24,0,24,
MANIPUR,TENGNOUPAL,2021-02-21,0,5,0,5,
MANIPUR,TENGNOUPAL,2021-02-22,0,7,0,7,
MANIPUR,THOUBAL,2021-02-21,3,96,0,99,
MANIPUR,THOUBAL,2021-02-22,4,84,0,88,
MANIPUR,UKHRUL,2021-02-21,0,19,0,19,
MANIPUR,UKHRUL,2021-02-22,0,176,0,176,
MEGHALAYA,EAST GARO HILLS,2021-02-21,0,3,0,3,
MEGHALAYA,EAST GARO HILLS,2021-02-22,0,38,0,38,
MEGHALAYA,EAST JAINTIA HILLS,2021-02-21,0,22,0,22,
MEGHALAYA,EAST JAINTIA HILLS,2021-02-22,0,20,0,20,
MEGHALAYA,EAST KHASI HILLS,2021-02-21,2,416,0,418,
MEGHALAYA,EAST KHASI HILLS,2021-02-22,2,937,0,939,
MEGHALAYA,NORTH GARO HILLS,2021-02-21,0,5,0,5,
MEGHALAYA,NORTH GARO HILLS,2021-02-22,1,4,0,5,
MEGHALAYA,RI BHOI,2021-02-21,0,23,0,23,
MEGHALAYA,RI BHOI,2021-02-22,1,64,0,65,
MEGHALAYA,SOUTH GARO HILLS,2021-02-22,0,3,0,3,
MEGHALAYA,SOUTH WEST GARO HILLS,2021-02-21,0,12,0,12,
MEGHALAYA,SOUTH WEST GARO HILLS,2021-02-22,1,44,0,45,
MEGHALAYA,SOUTH WEST KHASI HILLS,2021-02-21,0,2,0,2,
MEGHALAYA,SOUTH WEST KHASI HILLS,2021-02-22,0,14,0,14,
MEGHALAYA,WEST GARO HILLS,2021-02-22,0,88,0,88,
MEGHALAYA,WEST JAINTIA HILLS,2021-02-21,0,35,0,35,
MEGHALAYA,WEST JAINTIA HILLS,2021-02-22,0,82,0,82,
MEGHALAYA,WEST KHASI HILLS,2021-02-21,0,4,0,4,
MEGHALAYA,WEST KHASI HILLS,2021-02-22,0,153,0,153,
MIZORAM,AIZAWL,2021-02-21,0,110,0,110,
MIZORAM,AIZAWL,2021-02-22,2,676,0,678,
MIZORAM,CHAMPHAI,2021-02-21,0,4,0,4,
MIZORAM,CHAMPHAI,2021-02-22,0,109,0,109,
MIZORAM,HNAHTHIAL,2021-02-21,0,1,0,1,
MIZORAM,HNAHTHIAL,2021-02-22,0,7,0,7,
MIZORAM,KOLASIB,2021-02-21,0,78,0,78,
MIZORAM,KOLASIB,2021-02-22,0,95,0,95,
MIZORAM,LAWNGTLAI,2021-02-22,0,69,0,69,
MIZORAM,LUNGLEI,2021-02-22,0,100,0,100,
MIZORAM,MAMIT,2021-02-21,0,19,0,19,
MIZORAM,MAMIT,2021-02-22,0,57,0,57,
MIZORAM,SAIHA,2021-02-21,0,19,0,19,
MIZORAM,SAIHA,2021-02-22,0,31,0,31,
MIZORAM,SAITUAL,2021-02-22,0,31,0,31,
MIZORAM,SERCHHIP,2021-02-22,0,47,0,47,
NAGALAND,DIMAPUR,2021-02-21,0,106,0,106,
NAGALAND,DIMAPUR,2021-02-22,0,162,0,162,
NAGALAND,KIPHIRE,2021-02-21,0,3,0,3,
NAGALAND,KIPHIRE,2021-02-22,0,7,0,7,
NAGALAND,KOHIMA,2021-02-21,0,3,0,3,
NAGALAND,KOHIMA,2021-02-22,0,101,0,101,
NAGALAND,LONGLENG,2021-02-21,0,1,0,1,
NAGALAND,LONGLENG,2021-02-22,0,1,0,1,
NAGALAND,MOKOKCHUNG,2021-02-21,3,17,0,20,
NAGALAND,MOKOKCHUNG,2021-02-22,0,8,0,8,
NAGALAND,MON,2021-02-22,0,6,0,6,
NAGALAND,PEREN,2021-02-22,0,2,0,2,
NAGALAND,PHEK,2021-02-22,0,19,0,19,
ODISHA,ANUGUL,2021-02-21,1,258,0,259,
ODISHA,ANUGUL,2021-02-22,2,493,0,495,
ODISHA,BALANGIR,2021-02-21,4,906,7,917,
ODISHA,BALANGIR,2021-02-22,1,982,1,984,
ODISHA,BALESHWAR,2021-02-21,7,2088,0,2095,
ODISHA,BALESHWAR,2021-02-22,6,2616,0,2622,
ODISHA,BARGARH,2021-02-21,1,286,0,287,
ODISHA,BARGARH,2021-02-22,3,432,0,435,
ODISHA,BHADRAK,2021-02-21,1,394,0,395,
ODISHA,BHADRAK,2021-02-22,0,709,0,709,
ODISHA,BOUDH,2021-02-21,1,247,0,248,
ODISHA,BOUDH,2021-02-22,0,362,0,362,
ODISHA,CUTTACK,2021-02-21,3,329,0,332,
ODISHA,CUTTACK,2021-02-22,11,1807,0,1818,
ODISHA,DEOGARH,2021-02-21,2,62,0,64,
ODISHA,DEOGARH,2021-02-22,0,129,0,129,
ODISHA,DHENKANAL,2021-02-21,0,381,0,381,
ODISHA,DHENKANAL,2021-02-22,0,628,0,628,
ODISHA,GAJAPATI,2021-02-21,0,229,0,229,
ODISHA,GAJAPATI,2021-02-22,1,141,0,142,
ODISHA,GANJAM,2021-02-21,0,659,0,659,
ODISHA,GANJAM,2021-02-22,1,1190,6,1197,
ODISHA,JAGATSINGHAPUR,2021-02-21,0,200,0,200,
ODISHA,JAGATSINGHAPUR,2021-02-22,0,738,1,739,
ODISHA,JAJAPUR,2021-02-21,0,178,0,178,
ODISHA,JAJAPUR,2021-02-22,4,521,0,525,
ODISHA,JHARSUGUDA,2021-02-21,4,191,1,196,
ODISHA,JHARSUGUDA,2021-02-22,3,286,0,289,
ODISHA,KALAHANDI,2021-02-21,1,149,0,150,
ODISHA,KALAHANDI,2021-02-22,0,294,0,294,
ODISHA,KANDHAMAL,2021-02-21,0,595,0,595,
ODISHA,KANDHAMAL,2021-02-22,0,646,0,646,
ODISHA,KENDRAPARA,2021-02-21,0,592,0,592,
ODISHA,KENDRAPARA,2021-02-22,1,1169,1,1171,
ODISHA,KENDUJHAR,2021-02-21,1,406,0,407,
ODISHA,KENDUJHAR,2021-02-22,0,535,0,535,
ODISHA,KHORDHA,2021-02-21,3,986,1,990,
ODISHA,KHORDHA,2021-02-22,12,1836,1,1849,
ODISHA,KORAPUT,2021-02-21,0,1032,0,1032,
ODISHA,KORAPUT,2021-02-22,0,1235,0,1235,
ODISHA,MALKANGIRI,2021-02-21,0,88,0,88,
ODISHA,MALKANGIRI,2021-02-22,0,383,0,383,
ODISHA,MAYURBHANJ,2021-02-21,0,1136,0,1136,
ODISHA,MAYURBHANJ,2021-02-22,3,1513,0,1516,
ODISHA,NABARANGPUR,2021-02-21,0,388,0,388,
ODISHA,NABARANGPUR,2021-02-22,0,1078,0,1078,
ODISHA,NAYAGARH,2021-02-21,0,223,0,223,
ODISHA,NAYAGARH,2021-02-22,0,870,0,870,
ODISHA,NUAPADA,2021-02-21,3,114,0,117,
ODISHA,NUAPADA,2021-02-22,0,182,0,182,
ODISHA,PURI,2021-02-21,1,663,0,664,
ODISHA,PURI,2021-02-22,3,790,0,793,
ODISHA,RAYAGADA,2021-02-21,0,182,0,182,
ODISHA,RAYAGADA,2021-02-22,3,662,0,665,
ODISHA,SAMBALPUR,2021-02-21,12,282,0,294,
ODISHA,SAMBALPUR,2021-02-22,34,497,0,531,
ODISHA,SONEPUR,2021-02-21,0,187,0,187,
ODISHA,SONEPUR,2021-02-22,0,296,0,296,
ODISHA,SUNDARGARH,2021-02-21,0,124,0,124,
ODISHA,SUNDARGARH,2021-02-22,6,589,0,595,
PUDUCHERRY,KARAIKAL,2021-02-21,3,110,0,113,
PUDUCHERRY,KARAIKAL,2021-02-22,2,176,0,178,
PUDUCHERRY,MAHE,2021-02-21,3,209,0,212,
PUDUCHERRY,MAHE,2021-02-22,7,262,0,269,
PUDUCHERRY,PONDICHERRY,2021-02-21,3,151,0,154,
PUDUCHERRY,PONDICHERRY,2021-02-22,16,372,2,390,
PUDUCHERRY,YANAM,2021-02-21,0,24,0,24,
PUDUCHERRY,YANAM,2021-02-22,1,17,0,18,
PUNJAB,AMRITSAR,2021-02-21,25,1743,11,1779,
PUNJAB,AMRITSAR,2021-02-22,30,891,16,937,
PUNJAB,BARNALA,2021-02-21,0,142,0,142,
PUNJAB,BARNALA,2021-02-22,0,105,1,106,
PUNJAB,BATHINDA,2021-02-21,2,518,6,526,
PUNJAB,BATHINDA,2021-02-22,20,433,5,458,
PUNJAB,FARIDKOT,2021-02-21,5,134,12,151,
PUNJAB,FARIDKOT,2021-02-22,3,110,1,114,
PUNJAB,FATEHGARH SAHIB,2021-02-21,7,248,0,255,
PUNJAB,FATEHGARH SAHIB,2021-02-22,2,370,0,372,
PUNJAB,FAZILKA,2021-02-21,1,18,0,19,
PUNJAB,FAZILKA,2021-02-22,3,264,1,268,
PUNJAB,FIROZEPUR,2021-02-21,3,158,0,161,
PUNJAB,FIROZEPUR,2021-02-22,10,88,0,98,
PUNJAB,GURDASPUR,2021-02-21,3,260,0,263,
PUNJAB,GURDASPUR,2021-02-22,18,1294,56,1368,
PUNJAB,HOSHIARPUR,2021-02-21,22,531,12,565,
PUNJAB,HOSHIARPUR,2021-02-22,67,1023,10,1100,
PUNJAB,JALANDHAR,2021-02-21,25,2044,155,2224,
PUNJAB,JALANDHAR,2021-02-22,83,1946,5,2034,
PUNJAB,KAPURTHALA,2021-02-21,2,925,2,929,
PUNJAB,KAPURTHALA,2021-02-22,23,425,1,449,
PUNJAB,LUDHIANA,2021-02-21,48,2219,12,2279,
PUNJAB,LUDHIANA,2021-02-22,78,2003,6,2087,
PUNJAB,MANSA,2021-02-21,2,444,0,446,
PUNJAB,MANSA,2021-02-22,1,33,0,34,
PUNJAB,MOGA,2021-02-21,8,79,0,87,
PUNJAB,MOGA,2021-02-22,9,183,0,192,
PUNJAB,PATHANKOT,2021-02-21,0,734,2,736,
PUNJAB,PATHANKOT,2021-02-22,2,576,3,581,
PUNJAB,PATIALA,2021-02-21,48,776,1,825,
PUNJAB,PATIALA,2021-02-22,22,1077,0,1099,
PUNJAB,RUPNAGAR,2021-02-21,14,465,2,481,
PUNJAB,RUPNAGAR,2021-02-22,5,382,0,387,
PUNJAB,S.A.S NAGAR,2021-02-21,40,423,6,469,
PUNJAB,S.A.S NAGAR,2021-02-22,82,1001,10,1093,
PUNJAB,SANGRUR,2021-02-21,4,808,3,815,
PUNJAB,SANGRUR,2021-02-22,9,883,0,892,
PUNJAB,SHAHID BHAGAT SINGH NAGAR,2021-02-21,72,871,1,944,
PUNJAB,SHAHID BHAGAT SINGH NAGAR,2021-02-22,42,289,0,331,
PUNJAB,SRI MUKTSAR SAHIB,2021-02-21,0,226,14,240,
PUNJAB,SRI MUKTSAR SAHIB,2021-02-22,6,90,0,96,
PUNJAB,TARN TARAN,2021-02-21,4,529,2,535,
PUNJAB,TARN TARAN,2021-02-22,1,292,0,293,
RAJASTHAN,AJMER,2021-02-21,6,86,259,351,
RAJASTHAN,AJMER,2021-02-22,2,97,707,806,
RAJASTHAN,ALWAR,2021-02-21,2,3020,335,3357,
RAJASTHAN,ALWAR,2021-02-22,1,2727,160,2888,
RAJASTHAN,BANSWARA,2021-02-21,1,82,0,83,
RAJASTHAN,BANSWARA,2021-02-22,3,71,0,74,
RAJASTHAN,BARAN,2021-02-21,1,118,0,119,
RAJASTHAN,BARAN,2021-02-22,0,165,0,165,
RAJASTHAN,BARMER,2021-02-21,0,24,1,25,
RAJASTHAN,BARMER,2021-02-22,0,272,1,273,
RAJASTHAN,BHARATPUR,2021-02-21,5,391,4,400,
RAJASTHAN,BHARATPUR,2021-02-22,2,461,3,466,
RAJASTHAN,BHILWARA,2021-02-21,11,379,2,392,
RAJASTHAN,BHILWARA,2021-02-22,5,191,1,197,
RAJASTHAN,BIKANER,2021-02-21,1,1055,1,1057,
RAJASTHAN,BIKANER,2021-02-22,16,1800,3,1819,
RAJASTHAN,BUNDI,2021-02-21,0,126,0,126,
RAJASTHAN,BUNDI,2021-02-22,0,97,1,98,
RAJASTHAN,CHITTORGARH,2021-02-21,1,399,1,401,
RAJASTHAN,CHITTORGARH,2021-02-22,3,1050,4,1057,
RAJASTHAN,CHURU,2021-02-21,0,301,1,302,
RAJASTHAN,CHURU,2021-02-22,0,88,1,89,
RAJASTHAN,DAUSA,2021-02-21,1,244,3,248,
RAJASTHAN,DAUSA,2021-02-22,0,163,8,171,
RAJASTHAN,DHOLPUR,2021-02-21,7,262,6,275,
RAJASTHAN,DHOLPUR,2021-02-22,2,339,1,342,
RAJASTHAN,DUNGARPUR,2021-02-21,2,153,0,155,
RAJASTHAN,DUNGARPUR,2021-02-22,4,178,0,182,
RAJASTHAN,GANGANAGAR,2021-02-21,119,216,6,341,
RAJASTHAN,GANGANAGAR,2021-02-22,187,339,32,558,
RAJASTHAN,HANUMANGARH,2021-02-21,1,665,2,668,
RAJASTHAN,HANUMANGARH,2021-02-22,0,49,2,51,
RAJASTHAN,JAIPUR,2021-02-21,51,1813,323,2187,
RAJASTHAN,JAIPUR,2021-02-22,93,1741,249,2083,
RAJASTHAN,JAISALMER,2021-02-21,0,100,0,100,
RAJASTHAN,JAISALMER,2021-02-22,3,43,0,46,
RAJASTHAN,JALORE,2021-02-21,0,351,3,354,
RAJASTHAN,JALORE,2021-02-22,0,650,5,655,
RAJASTHAN,JHALAWAR,2021-02-21,3,217,3,223,
RAJASTHAN,JHALAWAR,2021-02-22,2,383,5,390,
RAJASTHAN,JHUNJHUNU,2021-02-21,2,76,4,82,
RAJASTHAN,JHUNJHUNU,2021-02-22,0,78,5,83,
RAJASTHAN,JODHPUR,2021-02-21,6,503,3,512,
RAJASTHAN,JODHPUR,2021-02-22,7,541,3,551,
RAJASTHAN,KARAULI,2021-02-21,0,223,2,225,
RAJASTHAN,KARAULI,2021-02-22,0,214,3,217,
RAJASTHAN,KOTA,2021-02-21,1,780,0,781,
RAJASTHAN,KOTA,2021-02-22,26,973,3,1002,
RAJASTHAN,NAGAUR,2021-02-21,0,235,243,478,
RAJASTHAN,NAGAUR,2021-02-22,9,82,441,532,
RAJASTHAN,PALI,2021-02-21,0,11,3,14,
RAJASTHAN,PALI,2021-02-22,0,49,1,50,
RAJASTHAN,PRATAPGARH,2021-02-21,2,1,0,3,
RAJASTHAN,PRATAPGARH,2021-02-22,0,4,0,4,
RAJASTHAN,RAJSAMAND,2021-02-21,29,315,0,344,
RAJASTHAN,RAJSAMAND,2021-02-22,45,435,0,480,
RAJASTHAN,SAWAI MADHOPUR,2021-02-21,0,197,4,201,
RAJASTHAN,SAWAI MADHOPUR,2021-02-22,0,148,15,163,
RAJASTHAN,SIKAR,2021-02-21,0,442,20,462,
RAJASTHAN,SIKAR,2021-02-22,2,175,7,184,
RAJASTHAN,SIROHI,2021-02-22,6,283,0,289,
RAJASTHAN,TONK,2021-02-21,0,296,19,315,
RAJASTHAN,TONK,2021-02-22,1,384,25,410,
RAJASTHAN,UDAIPUR,2021-02-21,29,476,1,506,
RAJASTHAN,UDAIPUR,2021-02-22,31,510,0,541,
SIKKIM,EAST DISTRICT,2021-02-21,0,3,0,3,
SIKKIM,EAST DISTRICT,2021-02-22,0,157,0,157,
SIKKIM,NORTH DISTRICT,2021-02-21,0,1,0,1,
SIKKIM,NORTH DISTRICT,2021-02-22,0,2,0,2,
SIKKIM,SOUTH DISTRICT,2021-02-21,0,3,0,3,
SIKKIM,SOUTH DISTRICT,2021-02-22,0,10,0,10,
SIKKIM,WEST DISTRICT,2021-02-21,0,1,0,1,
SIKKIM,WEST DISTRICT,2021-02-22,0,6,0,6,
TAMIL NADU,ARIYALUR,2021-02-21,2,50,0,52,
TAMIL NADU,ARIYALUR,2021-02-22,0,462,0,462,
TAMIL NADU,CHENGALPATTU,2021-02-21,24,2027,0,2051,
TAMIL NADU,CHENGALPATTU,2021-02-22,27,2292,0,2319,
TAMIL NADU,CHENNAI,2021-02-21,218,9485,5,9708,
TAMIL NADU,CHENNAI,2021-02-22,171,8797,7,8975,
TAMIL NADU,COIMBATORE,2021-02-21,33,1304,1,1338,
TAMIL NADU,COIMBATORE,2021-02-22,28,897,0,925,
TAMIL NADU,CUDDALORE,2021-02-21,2,399,0,401,
TAMIL NADU,CUDDALORE,2021-02-22,5,1556,0,1561,
TAMIL NADU,DHARMAPURI,2021-02-21,1,503,0,504,
TAMIL NADU,DHARMAPURI,2021-02-22,3,475,0,478,
TAMIL NADU,DINDIGUL,2021-02-21,9,442,0,451,
TAMIL NADU,DINDIGUL,2021-02-22,7,103,2,112,
TAMIL NADU,ERODE,2021-02-21,11,1214,0,1225,
TAMIL NADU,ERODE,2021-02-22,15,581,0,596,
TAMIL NADU,KALLAKURICHI,2021-02-21,0,310,0,310,
TAMIL NADU,KALLAKURICHI,2021-02-22,0,245,2,247,
TAMIL NADU,KANCHIPURAM,2021-02-21,9,2018,0,2027,
TAMIL NADU,KANCHIPURAM,2021-02-22,15,2898,1,2914,
TAMIL NADU,KANNIYAKUMARI,2021-02-21,3,1919,2,1924,
TAMIL NADU,KANNIYAKUMARI,2021-02-22,12,1291,7,1310,
TAMIL NADU,KARUR,2021-02-21,2,994,1,997,
TAMIL NADU,KARUR,2021-02-22,2,908,0,910,
TAMIL NADU,KRISHNAGIRI,2021-02-21,4,833,3,840,
TAMIL NADU,KRISHNAGIRI,2021-02-22,2,785,0,787,
TAMIL NADU,MADURAI,2021-02-21,8,1621,0,1629,
TAMIL NADU,MADURAI,2021-02-22,4,2122,9,2135,
TAMIL NADU,NAGAPATTINAM,2021-02-21,4,461,0,465,
TAMIL NADU,NAGAPATTINAM,2021-02-22,3,134,0,137,
TAMIL NADU,NAMAKKAL,2021-02-21,4,499,0,503,
TAMIL NADU,NAMAKKAL,2021-02-22,1,904,4,909,
TAMIL NADU,PERAMBALUR,2021-02-21,1,145,0,146,
TAMIL NADU,PERAMBALUR,2021-02-22,0,165,1,166,
TAMIL NADU,PUDUKKOTTAI,2021-02-21,2,577,0,579,
TAMIL NADU,PUDUKKOTTAI,2021-02-22,0,113,0,113,
TAMIL NADU,RAMANATHAPURAM,2021-02-21,1,699,0,700,
TAMIL NADU,RAMANATHAPURAM,2021-02-22,2,966,0,968,
TAMIL NADU,RANIPET,2021-02-21,4,99,0,103,
TAMIL NADU,RANIPET,2021-02-22,1,329,0,330,
TAMIL NADU,SALEM,2021-02-21,0,167,0,167,
TAMIL NADU,SALEM,2021-02-22,6,183,18,207,
TAMIL NADU,SIVAGANGA,2021-02-21,7,283,0,290,
TAMIL NADU,SIVAGANGA,2021-02-22,3,464,0,467,
TAMIL NADU,TENKASI,2021-02-21,1,412,0,413,
TAMIL NADU,TENKASI,2021-02-22,3,370,0,373,
TAMIL NADU,THANJAVUR,2021-02-21,16,175,1,192,
TAMIL NADU,THANJAVUR,2021-02-22,10,492,0,502,
TAMIL NADU,THE NILGIRIS,2021-02-21,4,965,0,969,
TAMIL NADU,THE NILGIRIS,2021-02-22,3,1043,0,1046,
TAMIL NADU,THENI,2021-02-21,3,409,0,412,
TAMIL NADU,THENI,2021-02-22,1,89,0,90,
TAMIL NADU,THIRUVALLUR,2021-02-21,29,1460,4,1493,
TAMIL NADU,THIRUVALLUR,2021-02-22,26,1372,9,1407,
TAMIL NADU,THIRUVARUR,2021-02-21,6,320,0,326,
TAMIL NADU,THIRUVARUR,2021-02-22,4,848,0,852,
TAMIL NADU,TIRUCHIRAPPALLI,2021-02-21,4,1242,0,1246,
TAMIL NADU,TIRUCHIRAPPALLI,2021-02-22,13,1317,0,1330,
TAMIL NADU,TIRUNELVELI,2021-02-21,7,324,1,332,
TAMIL NADU,TIRUNELVELI,2021-02-22,9,998,0,1007,
TAMIL NADU,TIRUPATHUR,2021-02-21,2,1920,1,1923,
TAMIL NADU,TIRUPATHUR,2021-02-22,3,1873,2,1878,
TAMIL NADU,TIRUPPUR,2021-02-21,8,712,0,720,
TAMIL NADU,TIRUPPUR,2021-02-22,8,999,2,1009,
TAMIL NADU,TIRUVANNAMALAI,2021-02-21,1,370,0,371,
TAMIL NADU,TIRUVANNAMALAI,2021-02-22,1,1040,2,1043,
TAMIL NADU,TUTICORIN,2021-02-21,1,722,3,726,
TAMIL NADU,TUTICORIN,2021-02-22,1,381,3,385,
TAMIL NADU,VELLORE,2021-02-21,11,575,0,586,
TAMIL NADU,VELLORE,2021-02-22,3,1316,0,1319,
TAMIL NADU,VILLUPURAM,2021-02-21,4,939,1,944,
TAMIL NADU,VILLUPURAM,2021-02-22,1,702,1,704,
TAMIL NADU,VIRUDHUNAGAR,2021-02-21,2,716,0,718,
TAMIL NADU,VIRUDHUNAGAR,2021-02-22,0,1295,1,1296,
TELANGANA,ADILABAD,2021-02-21,0,147,1,148,
TELANGANA,ADILABAD,2021-02-22,0,241,0,241,
TELANGANA,BHADRADRI KOTHAGUDEM,2021-02-21,0,133,0,133,
TELANGANA,BHADRADRI KOTHAGUDEM,2021-02-22,0,459,0,459,
TELANGANA,HYDERABAD,2021-02-21,11,3512,0,3523,
TELANGANA,HYDERABAD,2021-02-22,20,5158,0,5178,
TELANGANA,JAGITIAL,2021-02-21,0,159,0,159,
TELANGANA,JAGITIAL,2021-02-22,0,418,0,418,
TELANGANA,JANGOAN,2021-02-21,0,294,0,294,
TELANGANA,JANGOAN,2021-02-22,0,537,0,537,
TELANGANA,JAYASHANKAR BHUPALAPALLY,2021-02-21,0,15,0,15,
TELANGANA,JAYASHANKAR BHUPALAPALLY,2021-02-22,0,168,0,168,
TELANGANA,JOGULAMBA GADWAL,2021-02-21,0,267,0,267,
TELANGANA,JOGULAMBA GADWAL,2021-02-22,0,496,0,496,
TELANGANA,KAMAREDDY,2021-02-21,0,13,0,13,
TELANGANA,KAMAREDDY,2021-02-22,0,427,0,427,
TELANGANA,KARIMNAGAR,2021-02-21,0,627,0,627,
TELANGANA,KARIMNAGAR,2021-02-22,0,992,0,992,
TELANGANA,KHAMMAM,2021-02-21,5,80,0,85,
TELANGANA,KHAMMAM,2021-02-22,0,468,0,468,
TELANGANA,KUMURAM BHEEM ASIFABAD,2021-02-21,0,226,0,226,
TELANGANA,KUMURAM BHEEM ASIFABAD,2021-02-22,0,261,0,261,
TELANGANA,MAHABUBABAD,2021-02-21,0,179,0,179,
TELANGANA,MAHABUBABAD,2021-02-22,0,295,0,295,
TELANGANA,MAHABUBNAGAR,2021-02-21,0,83,0,83,
TELANGANA,MAHABUBNAGAR,2021-02-22,0,309,0,309,
TELANGANA,MANCHERIAL,2021-02-21,0,408,0,408,
TELANGANA,MANCHERIAL,2021-02-22,0,715,0,715,
TELANGANA,MEDAK,2021-02-21,0,57,0,57,
TELANGANA,MEDAK,2021-02-22,0,297,0,297,
TELANGANA,MEDCHAL MALKAJGIRI,2021-02-21,1,279,0,280,
TELANGANA,MEDCHAL MALKAJGIRI,2021-02-22,2,1517,0,1519,
TELANGANA,MULUGU,2021-02-21,0,25,0,25,
TELANGANA,MULUGU,2021-02-22,0,183,0,183,
TELANGANA,NAGARKURNOOL,2021-02-21,0,309,0,309,
TELANGANA,NAGARKURNOOL,2021-02-22,0,986,0,986,
TELANGANA,NALGONDA,2021-02-21,0,34,0,34,
TELANGANA,NALGONDA,2021-02-22,0,751,0,751,
TELANGANA,NARAYANPET,2021-02-21,0,59,0,59,
TELANGANA,NARAYANPET,2021-02-22,0,156,0,156,
TELANGANA,NIRMAL,2021-02-21,0,98,0,98,
TELANGANA,NIRMAL,2021-02-22,0,1039,0,1039,
TELANGANA,NIZAMABAD,2021-02-21,3,57,0,60,
TELANGANA,NIZAMABAD,2021-02-22,0,370,0,370,
TELANGANA,PEDDAPALLI,2021-02-21,0,208,0,208,
TELANGANA,PEDDAPALLI,2021-02-22,0,888,0,888,
TELANGANA,RAJANNA SIRCILLA,2021-02-21,0,57,0,57,
TELANGANA,RAJANNA SIRCILLA,2021-02-22,0,155,0,155,
TELANGANA,RANGA REDDY,2021-02-21,5,816,1,822,
TELANGANA,RANGA REDDY,2021-02-22,1,1593,1,1595,
TELANGANA,SANGAREDDY,2021-02-21,0,255,0,255,
TELANGANA,SANGAREDDY,2021-02-22,0,635,0,635,
TELANGANA,SIDDIPET,2021-02-21,0,368,0,368,
TELANGANA,SIDDIPET,2021-02-22,0,433,0,433,
TELANGANA,SURYAPET,2021-02-21,0,321,0,321,
TELANGANA,SURYAPET,2021-02-22,0,763,0,763,
TELANGANA,VIKARABAD,2021-02-21,0,122,0,122,
TELANGANA,VIKARABAD,2021-02-22,0,346,0,346,
TELANGANA,WANAPARTHY,2021-02-21,0,63,0,63,
TELANGANA,WANAPARTHY,2021-02-22,0,193,0,193,
TELANGANA,WARANGAL RURAL,2021-02-21,1,32,0,33,
TELANGANA,WARANGAL RURAL,2021-02-22,0,254,0,254,
TELANGANA,WARANGAL URBAN,2021-02-21,0,610,0,610,
TELANGANA,WARANGAL URBAN,2021-02-22,0,1010,0,1010,
TELANGANA,YADADRI BHUVANAGIRI,2021-02-21,0,55,0,55,
TELANGANA,YADADRI BHUVANAGIRI,2021-02-22,0,545,0,545,
TRIPURA,DHALAI,2021-02-21,0,7,0,7,
TRIPURA,DHALAI,2021-02-22,0,9,0,9,
TRIPURA,GOMATI,2021-02-21,0,42,0,42,
TRIPURA,GOMATI,2021-02-22,0,30,0,30,
TRIPURA,KHOWAI,2021-02-21,0,15,0,15,
TRIPURA,KHOWAI,2021-02-22,0,20,0,20,
TRIPURA,NORTH TRIPURA,2021-02-21,0,37,0,37,
TRIPURA,NORTH TRIPURA,2021-02-22,0,54,0,54,
TRIPURA,SEPAHIJALA,2021-02-21,0,47,0,47,
TRIPURA,SEPAHIJALA,2021-02-22,0,54,0,54,
TRIPURA,SOUTH TRIPURA,2021-02-21,0,32,0,32,
TRIPURA,SOUTH TRIPURA,2021-02-22,2,73,0,75,
TRIPURA,UNAKOTI,2021-02-21,0,4,0,4,
TRIPURA,UNAKOTI,2021-02-22,0,4,0,4,
TRIPURA,WEST TRIPURA,2021-02-21,1,253,0,254,
TRIPURA,WEST TRIPURA,2021-02-22,4,252,0,256,
UTTAR PRADESH,AGRA,2021-02-21,4,1741,3,1748,
UTTAR PRADESH,AGRA,2021-02-22,1,2163,13,2177,
UTTAR PRADESH,ALIGARH,2021-02-21,3,5981,38,6022,
UTTAR PRADESH,ALIGARH,2021-02-22,1,5594,329,5924,
UTTAR PRADESH,AMBEDKAR NAGAR,2021-02-21,0,1061,8,1069,
UTTAR PRADESH,AMBEDKAR NAGAR,2021-02-22,1,752,4,757,
UTTAR PRADESH,AMETHI,2021-02-21,1,1307,0,1308,
UTTAR PRADESH,AMETHI,2021-02-22,1,550,1,552,
UTTAR PRADESH,AMROHA,2021-02-21,0,663,0,663,
UTTAR PRADESH,AMROHA,2021-02-22,0,778,0,778,
UTTAR PRADESH,AURAIYA,2021-02-21,1,608,120,729,
UTTAR PRADESH,AURAIYA,2021-02-22,1,890,125,1016,
UTTAR PRADESH,AYODHYA,2021-02-21,0,1137,1,1138,
UTTAR PRADESH,AYODHYA,2021-02-22,0,1044,0,1044,
UTTAR PRADESH,AZAMGARH,2021-02-21,0,305,0,305,
UTTAR PRADESH,AZAMGARH,2021-02-22,0,147,1,148,
UTTAR PRADESH,BAGHPAT,2021-02-21,0,1878,44,1922,
UTTAR PRADESH,BAGHPAT,2021-02-22,0,1168,5,1173,
UTTAR PRADESH,BAHRAICH,2021-02-21,0,1824,11,1835,
UTTAR PRADESH,BAHRAICH,2021-02-22,0,1777,35,1812,
UTTAR PRADESH,BALLIA,2021-02-21,0,855,0,855,
UTTAR PRADESH,BALLIA,2021-02-22,0,820,0,820,
UTTAR PRADESH,BALRAMPUR,2021-02-21,3,896,0,899,
UTTAR PRADESH,BALRAMPUR,2021-02-22,2,798,1,801,
UTTAR PRADESH,BANDA,2021-02-21,0,2057,9,2066,
UTTAR PRADESH,BANDA,2021-02-22,0,1896,36,1932,
UTTAR PRADESH,BARABANKI,2021-02-21,2,1483,0,1485,
UTTAR PRADESH,BARABANKI,2021-02-22,0,1232,21,1253,
UTTAR PRADESH,BAREILLY,2021-02-21,3,1711,0,1714,
UTTAR PRADESH,BAREILLY,2021-02-22,0,2638,28,2666,
UTTAR PRADESH,BASTI,2021-02-21,1,779,91,871,
UTTAR PRADESH,BASTI,2021-02-22,0,803,53,856,
UTTAR PRADESH,BHADOHI,2021-02-21,0,1563,10,1573,
UTTAR PRADESH,BHADOHI,2021-02-22,0,1510,0,1510,
UTTAR PRADESH,BIJNOR,2021-02-21,1,1116,2,1119,
UTTAR PRADESH,BIJNOR,2021-02-22,0,1237,2,1239,
UTTAR PRADESH,BUDAUN,2021-02-21,0,748,9,757,
UTTAR PRADESH,BUDAUN,2021-02-22,0,543,13,556,
UTTAR PRADESH,BULANDSHAHR,2021-02-21,2,845,0,847,
UTTAR PRADESH,BULANDSHAHR,2021-02-22,3,3210,0,3213,
UTTAR PRADESH,CHANDAULI,2021-02-21,1,441,9,451,
UTTAR PRADESH,CHANDAULI,2021-02-22,0,638,50,688,
UTTAR PRADESH,CHITRAKOOT,2021-02-21,0,733,6,739,
UTTAR PRADESH,CHITRAKOOT,2021-02-22,0,939,5,944,
UTTAR PRADESH,DEORIA,2021-02-21,1,935,2,938,
UTTAR PRADESH,DEORIA,2021-02-22,1,1081,71,1153,
UTTAR PRADESH,ETAH,2021-02-21,0,1311,4,1315,
UTTAR PRADESH,ETAH,2021-02-22,0,1018,0,1018,
UTTAR PRADESH,ETAWAH,2021-02-21,0,2143,88,2231,
UTTAR PRADESH,ETAWAH,2021-02-22,0,1360,30,1390,
UTTAR PRADESH,FARRUKHABAD,2021-02-21,1,871,67,939,
UTTAR PRADESH,FARRUKHABAD,2021-02-22,0,1051,43,1094,
UTTAR PRADESH,FATEHPUR,2021-02-21,1,1001,76,1078,
UTTAR PRADESH,FATEHPUR,2021-02-22,0,1275,34,1309,
UTTAR PRADESH,FIROZABAD,2021-02-21,1,703,6,710,
UTTAR PRADESH,FIROZABAD,2021-02-22,1,2258,16,2275,
UTTAR PRADESH,GAUTAM BUDDHA NAGAR,2021-02-21,15,2666,0,2681,
UTTAR PRADESH,GAUTAM BUDDHA NAGAR,2021-02-22,19,2992,118,3129,
UTTAR PRADESH,GHAZIABAD,2021-02-21,15,3078,58,3151,
UTTAR PRADESH,GHAZIABAD,2021-02-22,23,2974,141,3138,
UTTAR PRADESH,GHAZIPUR,2021-02-21,0,672,35,707,
UTTAR PRADESH,GHAZIPUR,2021-02-22,2,744,80,826,
UTTAR PRADESH,GONDA,2021-02-21,1,1348,95,1444,
UTTAR PRADESH,GONDA,2021-02-22,0,1159,0,1159,
UTTAR PRADESH,GORAKHPUR,2021-02-21,0,2042,256,2298,
UTTAR PRADESH,GORAKHPUR,2021-02-22,3,1323,83,1409,
UTTAR PRADESH,HAMIRPUR,2021-02-21,0,1010,60,1070,
UTTAR PRADESH,HAMIRPUR,2021-02-22,0,855,20,875,
UTTAR PRADESH,HAPUR,2021-02-21,0,2371,0,2371,
UTTAR PRADESH,HAPUR,2021-02-22,4,1567,35,1606,
UTTAR PRADESH,HARDOI,2021-02-21,0,1329,9,1338,
UTTAR PRADESH,HARDOI,2021-02-22,0,1001,279,1280,
UTTAR PRADESH,HATHRAS,2021-02-21,0,1218,0,1218,
UTTAR PRADESH,HATHRAS,2021-02-22,0,1079,0,1079,
UTTAR PRADESH,JALAUN,2021-02-21,0,748,1,749,
UTTAR PRADESH,JALAUN,2021-02-22,0,1066,3,1069,
UTTAR PRADESH,JAUNPUR,2021-02-21,0,1092,18,1110,
UTTAR PRADESH,JAUNPUR,2021-02-22,0,932,2,934,
UTTAR PRADESH,JHANSI,2021-02-21,0,1896,0,1896,
UTTAR PRADESH,JHANSI,2021-02-22,0,4088,1,4089,
UTTAR PRADESH,KANNAUJ,2021-02-21,0,1730,0,1730,
UTTAR PRADESH,KANNAUJ,2021-02-22,0,1435,1,1436,
UTTAR PRADESH,KANPUR DEHAT,2021-02-21,1,790,0,791,
UTTAR PRADESH,KANPUR DEHAT,2021-02-22,4,492,25,521,
UTTAR PRADESH,KANPUR NAGAR,2021-02-21,4,2402,0,2406,
UTTAR PRADESH,KANPUR NAGAR,2021-02-22,4,2217,0,2221,
UTTAR PRADESH,KASGANJ,2021-02-21,0,1059,5,1064,
UTTAR PRADESH,KASGANJ,2021-02-22,0,2550,1,2551,
UTTAR PRADESH,KAUSHAMBI,2021-02-21,0,936,0,936,
UTTAR PRADESH,KAUSHAMBI,2021-02-22,0,1761,0,1761,
UTTAR PRADESH,KHERI,2021-02-21,3,1256,8,1267,
UTTAR PRADESH,KHERI,2021-02-22,1,1617,31,1649,
UTTAR PRADESH,KUSHI NAGAR,2021-02-21,0,1331,4,1335,
UTTAR PRADESH,KUSHI NAGAR,2021-02-22,0,603,8,611,
UTTAR PRADESH,LALITPUR,2021-02-21,2,956,3,961,
UTTAR PRADESH,LALITPUR,2021-02-22,4,1301,2,1307,
UTTAR PRADESH,LUCKNOW,2021-02-21,24,5651,162,5837,
UTTAR PRADESH,LUCKNOW,2021-02-22,13,5152,127,5292,
UTTAR PRADESH,MAHARAJGANJ,2021-02-21,0,757,263,1020,
UTTAR PRADESH,MAHARAJGANJ,2021-02-22,0,587,2,589,
UTTAR PRADESH,MAHOBA,2021-02-21,0,404,20,424,
UTTAR PRADESH,MAHOBA,2021-02-22,0,456,44,500,
UTTAR PRADESH,MAINPURI,2021-02-21,0,1285,0,1285,
UTTAR PRADESH,MAINPURI,2021-02-22,2,1744,0,1746,
UTTAR PRADESH,MATHURA,2021-02-21,1,1829,3,1833,
UTTAR PRADESH,MATHURA,2021-02-22,0,1666,1,1667,
UTTAR PRADESH,MAU,2021-02-21,0,722,0,722,
UTTAR PRADESH,MAU,2021-02-22,0,997,22,1019,
UTTAR PRADESH,MEERUT,2021-02-21,4,3224,3,3231,
UTTAR PRADESH,MEERUT,2021-02-22,12,3916,14,3942,
UTTAR PRADESH,MIRZAPUR,2021-02-21,0,1284,0,1284,
UTTAR PRADESH,MIRZAPUR,2021-02-22,2,1387,0,1389,
UTTAR PRADESH,MORADABAD,2021-02-21,0,1727,0,1727,
UTTAR PRADESH,MORADABAD,2021-02-22,0,2101,1,2102,
UTTAR PRADESH,MUZAFFARNAGAR,2021-02-21,1,861,1,863,
UTTAR PRADESH,MUZAFFARNAGAR,2021-02-22,1,868,1,870,
UTTAR PRADESH,PILIBHIT,2021-02-21,0,997,4,1001,
UTTAR PRADESH,PILIBHIT,2021-02-22,1,2022,0,2023,
UTTAR PRADESH,PRATAPGARH,2021-02-21,0,1323,287,1610,
UTTAR PRADESH,PRATAPGARH,2021-02-22,0,4529,129,4658,
UTTAR PRADESH,PRAYAGRAJ,2021-02-21,23,2312,1,2336,
UTTAR PRADESH,PRAYAGRAJ,2021-02-22,20,3628,1,3649,
UTTAR PRADESH,RAE BARELI,2021-02-21,0,1361,2,1363,
UTTAR PRADESH,RAE BARELI,2021-02-22,1,1321,2,1324,
UTTAR PRADESH,RAMPUR,2021-02-21,0,1319,18,1337,
UTTAR PRADESH,RAMPUR,2021-02-22,0,1379,24,1403,
UTTAR PRADESH,SAHARANPUR,2021-02-21,5,2419,11,2435,
UTTAR PRADESH,SAHARANPUR,2021-02-22,4,2531,12,2547,
UTTAR PRADESH,SAMBHAL,2021-02-21,0,1594,76,1670,
UTTAR PRADESH,SAMBHAL,2021-02-22,1,1344,50,1395,
UTTAR PRADESH,SANT KABEER NAGAR,2021-02-21,0,1361,0,1361,
UTTAR PRADESH,SANT KABEER NAGAR,2021-02-22,5,1625,0,1630,
UTTAR PRADESH,SHAHJAHANPUR,2021-02-21,0,1800,27,1827,
UTTAR PRADESH,SHAHJAHANPUR,2021-02-22,0,1730,1,1731,
UTTAR PRADESH,SHAMLI,2021-02-21,0,1282,0,1282,
UTTAR PRADESH,SHAMLI,2021-02-22,2,998,1,1001,
UTTAR PRADESH,SHRAVASTI,2021-02-21,2,762,0,764,
UTTAR PRADESH,SHRAVASTI,2021-02-22,2,682,0,684,
UTTAR PRADESH,SIDDHARTH NAGAR,2021-02-21,2,802,44,848,
UTTAR PRADESH,SIDDHARTH NAGAR,2021-02-22,0,794,0,794,
UTTAR PRADESH,SITAPUR,2021-02-21,0,1344,6,1350,
UTTAR PRADESH,SITAPUR,2021-02-22,1,1739,13,1753,
UTTAR PRADESH,SONBHADRA,2021-02-21,3,538,2,543,
UTTAR PRADESH,SONBHADRA,2021-02-22,1,1219,65,1285,
UTTAR PRADESH,SULTANPUR,2021-02-21,2,5285,42,5329,
UTTAR PRADESH,SULTANPUR,2021-02-22,0,4543,30,4573,
UTTAR PRADESH,UNNAO,2021-02-21,0,1737,117,1854,
UTTAR PRADESH,UNNAO,2021-02-22,1,1603,90,1694,
UTTAR PRADESH,VARANASI,2021-02-21,2,2828,6,2836,
UTTAR PRADESH,VARANASI,2021-02-22,5,2658,6,2669,
UTTARAKHAND,ALMORA,2021-02-21,0,10,0,10,
UTTARAKHAND,ALMORA,2021-02-22,0,49,0,49,
UTTARAKHAND,BAGESHWAR,2021-02-21,0,28,0,28,
UTTARAKHAND,BAGESHWAR,2021-02-22,0,264,2,266,
UTTARAKHAND,CHAMOLI,2021-02-21,1,5,0,6,
UTTARAKHAND,CHAMOLI,2021-02-22,0,14,0,14,
UTTARAKHAND,CHAMPAWAT,2021-02-21,0,4,0,4,
UTTARAKHAND,CHAMPAWAT,2021-02-22,1,252,0,253,
UTTARAKHAND,DEHRADUN,2021-02-21,12,836,19,867,
UTTARAKHAND,DEHRADUN,2021-02-22,21,1540,2,1563,
UTTARAKHAND,HARIDWAR,2021-02-21,3,1770,6,1779,
UTTARAKHAND,HARIDWAR,2021-02-22,8,2102,1,2111,
UTTARAKHAND,NAINITAL,2021-02-21,0,270,0,270,
UTTARAKHAND,NAINITAL,2021-02-22,2,833,7,842,
UTTARAKHAND,PAURI GARHWAL,2021-02-21,2,312,12,326,
UTTARAKHAND,PAURI GARHWAL,2021-02-22,5,259,0,264,
UTTARAKHAND,PITHORAGARH,2021-02-21,0,13,0,13,
UTTARAKHAND,PITHORAGARH,2021-02-22,0,20,0,20,
UTTARAKHAND,RUDRA PRAYAG,2021-02-21,0,43,2,45,
UTTARAKHAND,RUDRA PRAYAG,2021-02-22,0,20,0,20,
UTTARAKHAND,TEHRI GARHWAL,2021-02-21,3,181,2,186,
UTTARAKHAND,TEHRI GARHWAL,2021-02-22,1,146,0,147,
UTTARAKHAND,UDAM SINGH NAGAR,2021-02-21,5,395,42,442,
UTTARAKHAND,UDAM SINGH NAGAR,2021-02-22,5,1510,115,1630,
UTTARAKHAND,UTTAR KASHI,2021-02-21,0,271,0,271,
UTTARAKHAND,UTTAR KASHI,2021-02-22,0,51,0,51,
WEST BENGAL,24 PARAGANAS NORTH,2021-02-21,39,1811,5,1855,
WEST BENGAL,24 PARAGANAS NORTH,2021-02-22,47,3107,23,3177,
WEST BENGAL,24 PARAGANAS SOUTH,2021-02-21,14,2438,3,2455,
WEST BENGAL,24 PARAGANAS SOUTH,2021-02-22,8,2394,98,2500,
WEST BENGAL,ALIPURDUAR,2021-02-21,0,110,0,110,
WEST BENGAL,ALIPURDUAR,2021-02-22,1,148,0,149,
WEST BENGAL,BANKURA,2021-02-21,2,362,2,366,
WEST BENGAL,BANKURA,2021-02-22,4,1066,2,1072,
WEST BENGAL,BIRBHUM,2021-02-21,9,403,6,418,
WEST BENGAL,BIRBHUM,2021-02-22,7,306,5,318,
WEST BENGAL,COOCHBEHAR,2021-02-21,1,890,0,891,
WEST BENGAL,COOCHBEHAR,2021-02-22,1,1310,0,1311,
WEST BENGAL,DARJEELING,2021-02-21,5,601,0,606,
WEST BENGAL,DARJEELING,2021-02-22,3,169,0,172,
WEST BENGAL,DINAJPUR DAKSHIN,2021-02-21,3,574,4,581,
WEST BENGAL,DINAJPUR DAKSHIN,2021-02-22,0,441,12,453,
WEST BENGAL,DINAJPUR UTTAR,2021-02-21,2,134,0,136,
WEST BENGAL,DINAJPUR UTTAR,2021-02-22,4,134,0,138,
WEST BENGAL,HOOGHLY,2021-02-21,5,590,0,595,
WEST BENGAL,HOOGHLY,2021-02-22,4,295,1,300,
WEST BENGAL,HOWRAH,2021-02-21,7,889,73,969,
WEST BENGAL,HOWRAH,2021-02-22,13,1014,40,1067,
WEST BENGAL,JALPAIGURI,2021-02-21,0,111,1,112,
WEST BENGAL,JALPAIGURI,2021-02-22,4,296,1,301,
WEST BENGAL,JHARGRAM,2021-02-21,3,15,1,19,
WEST BENGAL,JHARGRAM,2021-02-22,2,143,0,145,
WEST BENGAL,KALIMPONG,2021-02-21,2,33,0,35,
WEST BENGAL,KALIMPONG,2021-02-22,1,43,0,44,
WEST BENGAL,KOLKATA,2021-02-21,51,2380,14,2445,
WEST BENGAL,KOLKATA,2021-02-22,73,2720,8,2801,
WEST BENGAL,MALDAH,2021-02-21,1,45,2,48,
WEST BENGAL,MALDAH,2021-02-22,1,546,5,552,
WEST BENGAL,MEDINIPUR EAST,2021-02-21,2,528,2,532,
WEST BENGAL,MEDINIPUR EAST,2021-02-22,0,676,0,676,
WEST BENGAL,MEDINIPUR WEST,2021-02-21,1,296,7,304,
WEST BENGAL,MEDINIPUR WEST,2021-02-22,0,297,1,298,
WEST BENGAL,MURSHIDABAD,2021-02-21,1,732,4,737,
WEST BENGAL,MURSHIDABAD,2021-02-22,1,1056,1,1058,
WEST BENGAL,NADIA,2021-02-21,0,434,68,502,
WEST BENGAL,NADIA,2021-02-22,4,462,10,476,
WEST BENGAL,PASCHIM BARDHAMAN,2021-02-21,4,564,0,568,
WEST BENGAL,PASCHIM BARDHAMAN,2021-02-22,1,382,1,384,
WEST BENGAL,PURBA BARDHAMAN,2021-02-21,4,567,0,571,
WEST BENGAL,PURBA BARDHAMAN,2021-02-22,1,512,0,513,
WEST BENGAL,PURULIA,2021-02-21,1,17,0,18,
WEST BENGAL,PURULIA,2021-02-22,1,393,0,394,
ANDAMAN AND NICOBAR ISLANDS,NICOBARS,2021-02-26,0,15,0,15,
ANDAMAN AND NICOBAR ISLANDS,NICOBARS,2021-02-27,0,20,0,20,
ANDAMAN AND NICOBAR ISLANDS,NICOBARS,2021-02-28,0,10,0,10,
ANDAMAN AND NICOBAR ISLANDS,NORTH AND MIDDLE ANDAMAN,2021-02-26,0,5,0,5,
ANDAMAN AND NICOBAR ISLANDS,NORTH AND MIDDLE ANDAMAN,2021-02-27,0,20,0,20,
ANDAMAN AND NICOBAR ISLANDS,NORTH AND MIDDLE ANDAMAN,2021-02-28,0,3,0,3,
ANDAMAN AND NICOBAR ISLANDS,SOUTH ANDAMANS,2021-02-26,0,310,1,311,
ANDAMAN AND NICOBAR ISLANDS,SOUTH ANDAMANS,2021-02-27,1,314,0,315,
ANDAMAN AND NICOBAR ISLANDS,SOUTH ANDAMANS,2021-02-28,0,100,0,100,
ANDHRA PRADESH,ANANTAPUR,2021-02-26,2,49,1,52,
ANDHRA PRADESH,ANANTAPUR,2021-02-27,5,2748,1,2754,
ANDHRA PRADESH,ANANTAPUR,2021-02-28,17,7153,0,7170,
ANDHRA PRADESH,CHITTOOR,2021-02-26,2,80,1,83,
ANDHRA PRADESH,CHITTOOR,2021-02-27,66,3856,0,3922,
ANDHRA PRADESH,CHITTOOR,2021-02-28,77,6458,1,6536,
ANDHRA PRADESH,EAST GODAVARI,2021-02-26,0,25,0,25,
ANDHRA PRADESH,EAST GODAVARI,2021-02-27,4,745,0,749,
ANDHRA PRADESH,EAST GODAVARI,2021-02-28,31,5367,0,5398,
ANDHRA PRADESH,GUNTUR,2021-02-26,39,656,0,695,
ANDHRA PRADESH,GUNTUR,2021-02-27,16,3265,1,3282,
ANDHRA PRADESH,GUNTUR,2021-02-28,42,6084,0,6126,
ANDHRA PRADESH,KRISHNA,2021-02-26,0,6,0,6,
ANDHRA PRADESH,KRISHNA,2021-02-27,21,2040,0,2061,
ANDHRA PRADESH,KRISHNA,2021-02-28,64,4824,0,4888,
ANDHRA PRADESH,KURNOOL,2021-02-26,0,7,0,7,
ANDHRA PRADESH,KURNOOL,2021-02-27,9,1493,0,1502,
ANDHRA PRADESH,KURNOOL,2021-02-28,24,4064,0,4088,
ANDHRA PRADESH,PRAKASAM,2021-02-26,0,14,0,14,
ANDHRA PRADESH,PRAKASAM,2021-02-27,2,3988,0,3990,
ANDHRA PRADESH,PRAKASAM,2021-02-28,13,6820,0,6833,
ANDHRA PRADESH,SPSR NELLORE,2021-02-26,0,19,0,19,
ANDHRA PRADESH,SPSR NELLORE,2021-02-27,9,2014,1,2024,
ANDHRA PRADESH,SPSR NELLORE,2021-02-28,22,7541,0,7563,
ANDHRA PRADESH,SRIKAKULAM,2021-02-26,0,15,0,15,
ANDHRA PRADESH,SRIKAKULAM,2021-02-27,4,2400,0,2404,
ANDHRA PRADESH,SRIKAKULAM,2021-02-28,27,5838,0,5865,
ANDHRA PRADESH,VISAKHAPATANAM,2021-02-26,4,157,0,161,
ANDHRA PRADESH,VISAKHAPATANAM,2021-02-27,12,1435,0,1447,
ANDHRA PRADESH,VISAKHAPATANAM,2021-02-28,32,4765,0,4797,
ANDHRA PRADESH,VIZIANAGARAM,2021-02-26,0,12,0,12,
ANDHRA PRADESH,VIZIANAGARAM,2021-02-27,2,1911,0,1913,
ANDHRA PRADESH,VIZIANAGARAM,2021-02-28,7,4705,0,4712,
ANDHRA PRADESH,WEST GODAVARI,2021-02-26,1,10,1,12,
ANDHRA PRADESH,WEST GODAVARI,2021-02-27,9,1632,0,1641,
ANDHRA PRADESH,WEST GODAVARI,2021-02-28,16,4145,0,4161,
ANDHRA PRADESH,Y.S.R.,2021-02-26,1,9,0,10,
ANDHRA PRADESH,Y.S.R.,2021-02-27,14,3567,0,3581,
ANDHRA PRADESH,Y.S.R.,2021-02-28,27,7597,0,7624,
ARUNACHAL PRADESH,ANJAW,2021-02-26,0,13,0,13,
ARUNACHAL PRADESH,ANJAW,2021-02-27,0,1,0,1,
ARUNACHAL PRADESH,ANJAW,2021-02-28,0,2,0,2,
ARUNACHAL PRADESH,CHANGLANG,2021-02-27,0,2,0,2,
ARUNACHAL PRADESH,CHANGLANG,2021-02-28,0,1,0,1,
ARUNACHAL PRADESH,DIBANG VALLEY,2021-02-26,0,1,0,1,
ARUNACHAL PRADESH,DIBANG VALLEY,2021-02-27,0,2,0,2,
ARUNACHAL PRADESH,EAST SIANG,2021-02-26,0,34,0,34,
ARUNACHAL PRADESH,EAST SIANG,2021-02-27,0,27,0,27,
ARUNACHAL PRADESH,KAMLE,2021-02-27,0,1,0,1,
ARUNACHAL PRADESH,KURUNG KUMEY,2021-02-26,0,2,0,2,
ARUNACHAL PRADESH,LEPARADA,2021-02-27,7,5,0,12,
ARUNACHAL PRADESH,LEPARADA,2021-02-28,0,4,0,4,
ARUNACHAL PRADESH,LOHIT,2021-02-26,0,2,0,2,
ARUNACHAL PRADESH,LOHIT,2021-02-28,0,5,0,5,
ARUNACHAL PRADESH,LOWER DIBANG VALLEY,2021-02-26,0,1,0,1,
ARUNACHAL PRADESH,LOWER DIBANG VALLEY,2021-02-28,0,1,0,1,
ARUNACHAL PRADESH,LOWER SIANG,2021-02-26,0,13,1,14,
ARUNACHAL PRADESH,LOWER SIANG,2021-02-27,0,9,0,9,
ARUNACHAL PRADESH,LOWER SUBANSIRI,2021-02-27,0,2,0,2,
ARUNACHAL PRADESH,LOWER SUBANSIRI,2021-02-28,0,26,0,26,
ARUNACHAL PRADESH,NAMSAI,2021-02-26,0,2,0,2,
ARUNACHAL PRADESH,NAMSAI,2021-02-28,0,1,0,1,
ARUNACHAL PRADESH,PAKKE KESSANG,2021-02-27,0,1,0,1,
ARUNACHAL PRADESH,PAPUM PARE,2021-02-26,0,7,0,7,
ARUNACHAL PRADESH,PAPUM PARE,2021-02-27,0,19,0,19,
ARUNACHAL PRADESH,TAWANG,2021-02-28,0,1,0,1,
ARUNACHAL PRADESH,UPPER SUBANSIRI,2021-02-26,0,1,0,1,
ARUNACHAL PRADESH,WEST KAMENG,2021-02-26,0,10,0,10,
ARUNACHAL PRADESH,WEST KAMENG,2021-02-27,0,7,0,7,
ARUNACHAL PRADESH,WEST KAMENG,2021-02-28,0,2,0,2,
ARUNACHAL PRADESH,WEST SIANG,2021-02-27,0,1,0,1,
ASSAM,BAKSA,2021-02-26,0,12,0,12,
ASSAM,BAKSA,2021-02-27,0,36,0,36,
ASSAM,BAKSA,2021-02-28,0,9,0,9,
ASSAM,BARPETA,2021-02-26,0,106,0,106,
ASSAM,BARPETA,2021-02-27,0,64,0,64,
ASSAM,BARPETA,2021-02-28,0,26,0,26,
ASSAM,BISWANATH,2021-02-26,0,46,0,46,
ASSAM,BISWANATH,2021-02-27,0,62,0,62,
ASSAM,BISWANATH,2021-02-28,0,26,0,26,
ASSAM,BONGAIGAON,2021-02-26,0,97,0,97,
ASSAM,BONGAIGAON,2021-02-27,0,122,0,122,
ASSAM,BONGAIGAON,2021-02-28,0,26,0,26,
ASSAM,CACHAR,2021-02-26,1,111,36,148,
ASSAM,CACHAR,2021-02-27,0,181,29,210,
ASSAM,CACHAR,2021-02-28,1,156,0,157,
ASSAM,CHARAIDEO,2021-02-26,0,85,0,85,
ASSAM,CHARAIDEO,2021-02-27,0,98,0,98,
ASSAM,CHARAIDEO,2021-02-28,0,76,0,76,
ASSAM,CHIRANG,2021-02-26,0,31,0,31,
ASSAM,CHIRANG,2021-02-27,0,50,0,50,
ASSAM,CHIRANG,2021-02-28,0,1,0,1,
ASSAM,DARRANG,2021-02-26,0,258,0,258,
ASSAM,DARRANG,2021-02-27,0,288,0,288,
ASSAM,DARRANG,2021-02-28,0,103,0,103,
ASSAM,DHEMAJI,2021-02-26,0,24,0,24,
ASSAM,DHEMAJI,2021-02-27,0,23,0,23,
ASSAM,DHEMAJI,2021-02-28,0,44,0,44,
ASSAM,DHUBRI,2021-02-26,0,155,0,155,
ASSAM,DHUBRI,2021-02-27,0,146,0,146,
ASSAM,DHUBRI,2021-02-28,0,31,0,31,
ASSAM,DIBRUGARH,2021-02-26,3,326,0,329,
ASSAM,DIBRUGARH,2021-02-27,4,421,0,425,
ASSAM,DIBRUGARH,2021-02-28,4,131,0,135,
ASSAM,DIMA HASAO,2021-02-26,0,18,0,18,
ASSAM,DIMA HASAO,2021-02-27,0,27,0,27,
ASSAM,DIMA HASAO,2021-02-28,0,24,0,24,
ASSAM,GOALPARA,2021-02-26,0,238,0,238,
ASSAM,GOALPARA,2021-02-27,1,358,0,359,
ASSAM,GOALPARA,2021-02-28,0,117,0,117,
ASSAM,GOLAGHAT,2021-02-26,0,91,0,91,
ASSAM,GOLAGHAT,2021-02-27,0,128,0,128,
ASSAM,GOLAGHAT,2021-02-28,0,52,0,52,
ASSAM,HAILAKANDI,2021-02-26,0,178,0,178,
ASSAM,HAILAKANDI,2021-02-27,0,141,0,141,
ASSAM,HAILAKANDI,2021-02-28,0,30,0,30,
ASSAM,HOJAI,2021-02-26,0,126,0,126,
ASSAM,HOJAI,2021-02-27,0,111,0,111,
ASSAM,HOJAI,2021-02-28,1,9,0,10,
ASSAM,JORHAT,2021-02-26,8,193,0,201,
ASSAM,JORHAT,2021-02-27,4,172,0,176,
ASSAM,JORHAT,2021-02-28,1,96,0,97,
ASSAM,KAMRUP,2021-02-26,0,654,0,654,
ASSAM,KAMRUP,2021-02-27,1,505,0,506,
ASSAM,KAMRUP,2021-02-28,0,290,0,290,
ASSAM,KAMRUP METRO,2021-02-26,7,1524,4,1535,
ASSAM,KAMRUP METRO,2021-02-27,7,1092,0,1099,
ASSAM,KAMRUP METRO,2021-02-28,5,793,0,798,
ASSAM,KARBI ANGLONG,2021-02-26,0,27,0,27,
ASSAM,KARBI ANGLONG,2021-02-27,0,5,0,5,
ASSAM,KARBI ANGLONG,2021-02-28,0,3,0,3,
ASSAM,KARIMGANJ,2021-02-26,0,153,34,187,
ASSAM,KARIMGANJ,2021-02-27,0,168,0,168,
ASSAM,KARIMGANJ,2021-02-28,0,71,0,71,
ASSAM,KOKRAJHAR,2021-02-26,0,25,0,25,
ASSAM,KOKRAJHAR,2021-02-27,0,13,0,13,
ASSAM,KOKRAJHAR,2021-02-28,0,2,0,2,
ASSAM,LAKHIMPUR,2021-02-26,0,150,0,150,
ASSAM,LAKHIMPUR,2021-02-27,0,164,0,164,
ASSAM,LAKHIMPUR,2021-02-28,0,71,0,71,
ASSAM,MAJULI,2021-02-26,0,16,0,16,
ASSAM,MAJULI,2021-02-27,0,4,0,4,
ASSAM,MAJULI,2021-02-28,0,1,0,1,
ASSAM,MARIGAON,2021-02-26,0,119,0,119,
ASSAM,MARIGAON,2021-02-27,0,66,0,66,
ASSAM,MARIGAON,2021-02-28,0,245,0,245,
ASSAM,NAGAON,2021-02-26,0,296,0,296,
ASSAM,NAGAON,2021-02-27,2,241,0,243,
ASSAM,NAGAON,2021-02-28,0,92,0,92,
ASSAM,NALBARI,2021-02-26,0,43,0,43,
ASSAM,NALBARI,2021-02-27,0,22,0,22,
ASSAM,NALBARI,2021-02-28,0,8,0,8,
ASSAM,SIVASAGAR,2021-02-26,0,97,0,97,
ASSAM,SIVASAGAR,2021-02-27,0,51,0,51,
ASSAM,SIVASAGAR,2021-02-28,0,30,0,30,
ASSAM,SONITPUR,2021-02-26,0,143,0,143,
ASSAM,SONITPUR,2021-02-27,0,153,0,153,
ASSAM,SONITPUR,2021-02-28,0,52,0,52,
ASSAM,SOUTH SALMARA MANCACHAR,2021-02-26,0,31,0,31,
ASSAM,SOUTH SALMARA MANCACHAR,2021-02-27,0,27,0,27,
ASSAM,TINSUKIA,2021-02-26,13,271,2,286,
ASSAM,TINSUKIA,2021-02-27,2,263,4,269,
ASSAM,TINSUKIA,2021-02-28,1,153,0,154,
ASSAM,UDALGURI,2021-02-26,0,12,0,12,
ASSAM,UDALGURI,2021-02-27,0,7,0,7,
ASSAM,UDALGURI,2021-02-28,0,3,0,3,
ASSAM,WEST KARBI ANGLONG,2021-02-26,0,4,0,4,
ASSAM,WEST KARBI ANGLONG,2021-02-27,0,16,0,16,
BIHAR,ARARIA,2021-02-26,1,2392,0,2393,
BIHAR,ARARIA,2021-02-27,0,1093,0,1093,
BIHAR,ARARIA,2021-02-28,1,1065,0,1066,
BIHAR,ARWAL,2021-02-26,0,1192,0,1192,
BIHAR,ARWAL,2021-02-27,0,427,12,439,
BIHAR,ARWAL,2021-02-28,0,15,0,15,
BIHAR,AURANGABAD,2021-02-26,3,7626,0,7629,
BIHAR,AURANGABAD,2021-02-27,3,2004,1,2008,
BIHAR,AURANGABAD,2021-02-28,0,1052,0,1052,
BIHAR,BANKA,2021-02-26,0,778,0,778,
BIHAR,BANKA,2021-02-27,0,475,0,475,
BIHAR,BANKA,2021-02-28,0,986,211,1197,
BIHAR,BEGUSARAI,2021-02-26,5,948,0,953,
BIHAR,BEGUSARAI,2021-02-27,3,701,0,704,
BIHAR,BEGUSARAI,2021-02-28,0,523,0,523,
BIHAR,BHAGALPUR,2021-02-26,0,348,0,348,
BIHAR,BHAGALPUR,2021-02-27,0,309,0,309,
BIHAR,BHAGALPUR,2021-02-28,0,111,1,112,
BIHAR,BHOJPUR,2021-02-26,9,10778,10,10797,
BIHAR,BHOJPUR,2021-02-27,39,12814,9,12862,
BIHAR,BHOJPUR,2021-02-28,1,6642,1,6644,
BIHAR,BUXAR,2021-02-26,0,3749,30,3779,
BIHAR,BUXAR,2021-02-27,2,2964,2,2968,
BIHAR,BUXAR,2021-02-28,0,1497,0,1497,
BIHAR,DARBHANGA,2021-02-26,0,848,16,864,
BIHAR,DARBHANGA,2021-02-27,4,754,0,758,
BIHAR,DARBHANGA,2021-02-28,2,584,0,586,
BIHAR,GAYA,2021-02-26,6,3961,46,4013,
BIHAR,GAYA,2021-02-27,1,3094,3,3098,
BIHAR,GAYA,2021-02-28,1,1384,2,1387,
BIHAR,GOPALGANJ,2021-02-26,0,513,0,513,
BIHAR,GOPALGANJ,2021-02-27,2,955,0,957,
BIHAR,GOPALGANJ,2021-02-28,0,726,20,746,
BIHAR,JAMUI,2021-02-26,2,2465,1,2468,
BIHAR,JAMUI,2021-02-27,0,2093,0,2093,
BIHAR,JAMUI,2021-02-28,1,1593,0,1594,
BIHAR,JEHANABAD,2021-02-26,0,231,5,236,
BIHAR,JEHANABAD,2021-02-27,0,162,0,162,
BIHAR,JEHANABAD,2021-02-28,1,141,0,142,
BIHAR,KAIMUR (BHABUA),2021-02-26,0,1618,0,1618,
BIHAR,KAIMUR (BHABUA),2021-02-27,0,1120,0,1120,
BIHAR,KAIMUR (BHABUA),2021-02-28,0,621,0,621,
BIHAR,KATIHAR,2021-02-26,0,1795,0,1795,
BIHAR,KATIHAR,2021-02-27,0,1327,0,1327,
BIHAR,KATIHAR,2021-02-28,0,896,0,896,
BIHAR,KHAGARIA,2021-02-26,0,689,0,689,
BIHAR,KHAGARIA,2021-02-27,0,1143,0,1143,
BIHAR,KHAGARIA,2021-02-28,0,570,0,570,
BIHAR,KISHANGANJ,2021-02-26,0,248,0,248,
BIHAR,KISHANGANJ,2021-02-27,0,312,0,312,
BIHAR,KISHANGANJ,2021-02-28,0,115,0,115,
BIHAR,LAKHISARAI,2021-02-26,1,2106,0,2107,
BIHAR,LAKHISARAI,2021-02-27,0,1842,0,1842,
BIHAR,LAKHISARAI,2021-02-28,6,1815,7,1828,
BIHAR,MADHEPURA,2021-02-26,0,3392,0,3392,
BIHAR,MADHEPURA,2021-02-27,0,1410,0,1410,
BIHAR,MADHEPURA,2021-02-28,0,1357,0,1357,
BIHAR,MADHUBANI,2021-02-26,0,4258,3,4261,
BIHAR,MADHUBANI,2021-02-27,0,3625,1,3626,
BIHAR,MADHUBANI,2021-02-28,1,433,1,435,
BIHAR,MUNGER,2021-02-26,5,6062,6,6073,
BIHAR,MUNGER,2021-02-27,2,3318,1,3321,
BIHAR,MUNGER,2021-02-28,1,1787,0,1788,
BIHAR,MUZAFFARPUR,2021-02-26,4,3650,1,3655,
BIHAR,MUZAFFARPUR,2021-02-27,2,2600,0,2602,
BIHAR,MUZAFFARPUR,2021-02-28,2,1443,0,1445,
BIHAR,NALANDA,2021-02-26,3,1870,0,1873,
BIHAR,NALANDA,2021-02-27,0,1969,0,1969,
BIHAR,NALANDA,2021-02-28,1,1199,0,1200,
BIHAR,NAWADA,2021-02-26,0,991,1,992,
BIHAR,NAWADA,2021-02-27,0,591,0,591,
BIHAR,NAWADA,2021-02-28,0,227,0,227,
BIHAR,PASHCHIM CHAMPARAN,2021-02-26,1,5877,408,6286,
BIHAR,PASHCHIM CHAMPARAN,2021-02-27,0,2244,0,2244,
BIHAR,PASHCHIM CHAMPARAN,2021-02-28,0,1065,0,1065,
BIHAR,PATNA,2021-02-26,21,2845,5,2871,
BIHAR,PATNA,2021-02-27,14,2630,1,2645,
BIHAR,PATNA,2021-02-28,16,1275,0,1291,
BIHAR,PURBI CHAMPARAN,2021-02-26,2,1805,0,1807,
BIHAR,PURBI CHAMPARAN,2021-02-27,2,894,0,896,
BIHAR,PURBI CHAMPARAN,2021-02-28,0,999,4,1003,
BIHAR,PURNIA,2021-02-26,3,1736,102,1841,
BIHAR,PURNIA,2021-02-27,0,585,0,585,
BIHAR,PURNIA,2021-02-28,0,292,0,292,
BIHAR,ROHTAS,2021-02-26,0,2291,1,2292,
BIHAR,ROHTAS,2021-02-27,1,1588,0,1589,
BIHAR,ROHTAS,2021-02-28,1,1329,1,1331,
BIHAR,SAHARSA,2021-02-26,0,1727,0,1727,
BIHAR,SAHARSA,2021-02-27,0,1223,0,1223,
BIHAR,SAHARSA,2021-02-28,0,597,0,597,
BIHAR,SAMASTIPUR,2021-02-26,4,1523,181,1708,
BIHAR,SAMASTIPUR,2021-02-27,1,882,10,893,
BIHAR,SAMASTIPUR,2021-02-28,1,1701,19,1721,
BIHAR,SARAN,2021-02-26,0,1427,1,1428,
BIHAR,SARAN,2021-02-27,0,814,1,815,
BIHAR,SARAN,2021-02-28,0,524,0,524,
BIHAR,SHEIKHPURA,2021-02-26,0,529,1,530,
BIHAR,SHEIKHPURA,2021-02-27,0,389,0,389,
BIHAR,SHEIKHPURA,2021-02-28,0,42,0,42,
BIHAR,SHEOHAR,2021-02-26,0,417,0,417,
BIHAR,SHEOHAR,2021-02-27,0,698,0,698,
BIHAR,SHEOHAR,2021-02-28,0,350,0,350,
BIHAR,SITAMARHI,2021-02-26,2,7311,3,7316,
BIHAR,SITAMARHI,2021-02-27,1,3813,4,3818,
BIHAR,SITAMARHI,2021-02-28,2,2553,4,2559,
BIHAR,SIWAN,2021-02-26,2,9621,1,9624,
BIHAR,SIWAN,2021-02-27,12,10324,0,10336,
BIHAR,SIWAN,2021-02-28,3,8468,0,8471,
BIHAR,SUPAUL,2021-02-26,0,1052,1,1053,
BIHAR,SUPAUL,2021-02-27,0,957,0,957,
BIHAR,SUPAUL,2021-02-28,1,707,8,716,
BIHAR,VAISHALI,2021-02-26,6,3357,1,3364,
BIHAR,VAISHALI,2021-02-27,2,2688,100,2790,
BIHAR,VAISHALI,2021-02-28,3,1220,97,1320,
CHANDIGARH,CHANDIGARH,2021-02-26,66,1942,9,2017,
CHANDIGARH,CHANDIGARH,2021-02-27,71,1263,12,1346,
CHANDIGARH,CHANDIGARH,2021-02-28,48,766,9,823,
CHHATTISGARH,BALOD,2021-02-26,0,1017,0,1017,
CHHATTISGARH,BALOD,2021-02-27,0,966,1,967,
CHHATTISGARH,BALOD,2021-02-28,1,736,0,737,
CHHATTISGARH,BALODA BAZAR,2021-02-26,1,257,0,258,
CHHATTISGARH,BALODA BAZAR,2021-02-27,17,649,8,674,
CHHATTISGARH,BALODA BAZAR,2021-02-28,2,256,2,260,
CHHATTISGARH,BALRAMPUR,2021-02-26,2,194,0,196,
CHHATTISGARH,BALRAMPUR,2021-02-27,0,180,0,180,
CHHATTISGARH,BALRAMPUR,2021-02-28,1,402,0,403,
CHHATTISGARH,BASTAR,2021-02-26,3,1281,0,1284,
CHHATTISGARH,BASTAR,2021-02-27,5,1700,0,1705,
CHHATTISGARH,BASTAR,2021-02-28,3,705,2,710,
CHHATTISGARH,BEMETARA,2021-02-26,2,773,0,775,
CHHATTISGARH,BEMETARA,2021-02-27,1,642,0,643,
CHHATTISGARH,BEMETARA,2021-02-28,4,708,0,712,
CHHATTISGARH,BIJAPUR,2021-02-26,0,143,0,143,
CHHATTISGARH,BIJAPUR,2021-02-27,0,155,0,155,
CHHATTISGARH,BIJAPUR,2021-02-28,0,53,0,53,
CHHATTISGARH,BILASPUR,2021-02-26,24,785,6,815,
CHHATTISGARH,BILASPUR,2021-02-27,40,1002,14,1056,
CHHATTISGARH,BILASPUR,2021-02-28,20,1101,11,1132,
CHHATTISGARH,DANTEWADA,2021-02-26,1,155,0,156,
CHHATTISGARH,DANTEWADA,2021-02-27,5,442,0,447,
CHHATTISGARH,DANTEWADA,2021-02-28,2,512,0,514,
CHHATTISGARH,DHAMTARI,2021-02-26,11,1047,12,1070,
CHHATTISGARH,DHAMTARI,2021-02-27,1,885,11,897,
CHHATTISGARH,DHAMTARI,2021-02-28,1,265,12,278,
CHHATTISGARH,DURG,2021-02-26,61,1281,4,1346,
CHHATTISGARH,DURG,2021-02-27,58,1089,0,1147,
CHHATTISGARH,DURG,2021-02-28,29,690,2,721,
CHHATTISGARH,GARIYABAND,2021-02-26,4,305,4,313,
CHHATTISGARH,GARIYABAND,2021-02-27,5,207,3,215,
CHHATTISGARH,GARIYABAND,2021-02-28,3,151,6,160,
CHHATTISGARH,GAURELLA PENDRA MARWAHI,2021-02-26,4,104,0,108,
CHHATTISGARH,GAURELLA PENDRA MARWAHI,2021-02-27,1,29,1,31,
CHHATTISGARH,GAURELLA PENDRA MARWAHI,2021-02-28,0,195,0,195,
CHHATTISGARH,JANJGIR CHAMPA,2021-02-26,3,1504,0,1507,
CHHATTISGARH,JANJGIR CHAMPA,2021-02-27,6,1460,0,1466,
CHHATTISGARH,JANJGIR CHAMPA,2021-02-28,3,1035,0,1038,
CHHATTISGARH,JASHPUR,2021-02-26,17,351,0,368,
CHHATTISGARH,JASHPUR,2021-02-27,5,272,0,277,
CHHATTISGARH,JASHPUR,2021-02-28,12,190,0,202,
CHHATTISGARH,KABIRDHAM,2021-02-26,2,581,0,583,
CHHATTISGARH,KABIRDHAM,2021-02-27,0,490,0,490,
CHHATTISGARH,KABIRDHAM,2021-02-28,0,421,0,421,
CHHATTISGARH,KANKER,2021-02-26,3,516,0,519,
CHHATTISGARH,KANKER,2021-02-27,4,659,0,663,
CHHATTISGARH,KANKER,2021-02-28,2,144,0,146,
CHHATTISGARH,KONDAGAON,2021-02-26,1,623,0,624,
CHHATTISGARH,KONDAGAON,2021-02-27,2,403,0,405,
CHHATTISGARH,KONDAGAON,2021-02-28,0,617,0,617,
CHHATTISGARH,KORBA,2021-02-26,5,748,0,753,
CHHATTISGARH,KORBA,2021-02-27,5,750,0,755,
CHHATTISGARH,KORBA,2021-02-28,5,522,0,527,
CHHATTISGARH,KOREA,2021-02-26,22,587,0,609,
CHHATTISGARH,KOREA,2021-02-27,5,482,1,488,
CHHATTISGARH,KOREA,2021-02-28,8,238,0,246,
CHHATTISGARH,MAHASAMUND,2021-02-26,9,1757,23,1789,
CHHATTISGARH,MAHASAMUND,2021-02-27,2,1116,4,1122,
CHHATTISGARH,MAHASAMUND,2021-02-28,2,736,7,745,
CHHATTISGARH,MUNGELI,2021-02-26,2,428,0,430,
CHHATTISGARH,MUNGELI,2021-02-27,0,186,0,186,
CHHATTISGARH,MUNGELI,2021-02-28,2,379,0,381,
CHHATTISGARH,NARAYANPUR,2021-02-26,0,259,0,259,
CHHATTISGARH,NARAYANPUR,2021-02-27,0,387,0,387,
CHHATTISGARH,NARAYANPUR,2021-02-28,0,162,0,162,
CHHATTISGARH,RAIGARH,2021-02-26,6,1048,2,1056,
CHHATTISGARH,RAIGARH,2021-02-27,17,1359,5,1381,
CHHATTISGARH,RAIGARH,2021-02-28,4,858,2,864,
CHHATTISGARH,RAIPUR,2021-02-26,90,2181,17,2288,
CHHATTISGARH,RAIPUR,2021-02-27,88,2665,20,2773,
CHHATTISGARH,RAIPUR,2021-02-28,84,1433,33,1550,
CHHATTISGARH,RAJNANDGAON,2021-02-26,14,1365,12,1391,
CHHATTISGARH,RAJNANDGAON,2021-02-27,5,1438,34,1477,
CHHATTISGARH,RAJNANDGAON,2021-02-28,9,726,0,735,
CHHATTISGARH,SUKMA,2021-02-26,1,312,0,313,
CHHATTISGARH,SUKMA,2021-02-27,0,112,0,112,
CHHATTISGARH,SUKMA,2021-02-28,0,55,0,55,
CHHATTISGARH,SURAJPUR,2021-02-26,6,835,0,841,
CHHATTISGARH,SURAJPUR,2021-02-27,6,868,0,874,
CHHATTISGARH,SURAJPUR,2021-02-28,3,262,0,265,
CHHATTISGARH,SURGUJA,2021-02-26,17,823,1,841,
CHHATTISGARH,SURGUJA,2021-02-27,11,820,1,832,
CHHATTISGARH,SURGUJA,2021-02-28,5,456,1,462,
DADRA AND NAGAR HAVELI,DADRA AND NAGAR HAVELI,2021-02-26,0,484,0,484,
DADRA AND NAGAR HAVELI,DADRA AND NAGAR HAVELI,2021-02-27,0,249,0,249,
DADRA AND NAGAR HAVELI,DADRA AND NAGAR HAVELI,2021-02-28,0,275,0,275,
DAMAN AND DIU,DAMAN,2021-02-26,0,241,0,241,
DAMAN AND DIU,DAMAN,2021-02-27,0,181,0,181,
DAMAN AND DIU,DAMAN,2021-02-28,0,25,0,25,
DAMAN AND DIU,DIU,2021-02-26,0,28,0,28,
DAMAN AND DIU,DIU,2021-02-27,1,52,0,53,
DAMAN AND DIU,DIU,2021-02-28,0,6,0,6,
DELHI,CENTRAL,2021-02-26,17,5109,6,5132,
DELHI,CENTRAL,2021-02-27,16,4194,13,4223,
DELHI,CENTRAL,2021-02-28,10,3825,7,3842,
DELHI,EAST,2021-02-26,11,3635,8,3654,
DELHI,EAST,2021-02-27,14,3500,5,3519,
DELHI,EAST,2021-02-28,19,2518,2,2539,
DELHI,NEW DELHI,2021-02-26,40,6010,6,6056,
DELHI,NEW DELHI,2021-02-27,19,4735,19,4773,
DELHI,NEW DELHI,2021-02-28,33,2304,5,2342,
DELHI,NORTH,2021-02-26,6,7664,4,7674,
DELHI,NORTH,2021-02-27,12,7012,6,7030,
DELHI,NORTH,2021-02-28,1,4157,1,4159,
DELHI,NORTH EAST,2021-02-26,5,5939,0,5944,
DELHI,NORTH EAST,2021-02-27,6,4074,0,4080,
DELHI,NORTH EAST,2021-02-28,0,2787,0,2787,
DELHI,NORTH WEST,2021-02-26,32,6183,34,6249,
DELHI,NORTH WEST,2021-02-27,26,5029,1,5056,
DELHI,NORTH WEST,2021-02-28,28,3169,46,3243,
DELHI,SHAHDARA,2021-02-26,8,6752,2,6762,
DELHI,SHAHDARA,2021-02-27,5,6171,4,6180,
DELHI,SHAHDARA,2021-02-28,2,2727,1,2730,
DELHI,SOUTH,2021-02-26,63,7509,34,7606,
DELHI,SOUTH,2021-02-27,62,5001,11,5074,
DELHI,SOUTH,2021-02-28,36,4918,2,4956,
DELHI,SOUTH EAST,2021-02-26,6,5914,54,5974,
DELHI,SOUTH EAST,2021-02-27,10,4432,32,4474,
DELHI,SOUTH EAST,2021-02-28,3,3733,3,3739,
DELHI,SOUTH WEST,2021-02-26,32,3549,2,3583,
DELHI,SOUTH WEST,2021-02-27,19,4418,3,4440,
DELHI,SOUTH WEST,2021-02-28,23,2856,1,2880,
DELHI,WEST,2021-02-26,31,8806,1,8838,
DELHI,WEST,2021-02-27,36,8876,1,8913,
DELHI,WEST,2021-02-28,29,6477,7,6513,
GOA,NORTH GOA,2021-02-26,33,896,0,929,
GOA,NORTH GOA,2021-02-27,26,710,1,737,
GOA,NORTH GOA,2021-02-28,18,567,0,585,
GOA,SOUTH GOA,2021-02-26,69,847,2,918,
GOA,SOUTH GOA,2021-02-27,42,726,0,768,
GOA,SOUTH GOA,2021-02-28,16,521,0,537,
GUJARAT,AHMADABAD,2021-02-26,150,4164,79,4393,
GUJARAT,AHMADABAD,2021-02-27,106,3718,82,3906,
GUJARAT,AHMADABAD,2021-02-28,109,1365,40,1514,
GUJARAT,AMRELI,2021-02-26,5,962,4,971,
GUJARAT,AMRELI,2021-02-27,5,546,0,551,
GUJARAT,AMRELI,2021-02-28,8,219,1,228,
GUJARAT,ANAND,2021-02-26,18,380,5,403,
GUJARAT,ANAND,2021-02-27,18,230,19,267,
GUJARAT,ANAND,2021-02-28,11,123,0,134,
GUJARAT,ARVALLI,2021-02-26,1,174,0,175,
GUJARAT,ARVALLI,2021-02-27,2,175,0,177,
GUJARAT,ARVALLI,2021-02-28,1,153,0,154,
GUJARAT,BANAS KANTHA,2021-02-26,4,235,0,239,
GUJARAT,BANAS KANTHA,2021-02-27,7,290,0,297,
GUJARAT,BANAS KANTHA,2021-02-28,0,39,0,39,
GUJARAT,BHARUCH,2021-02-26,18,404,2,424,
GUJARAT,BHARUCH,2021-02-27,14,554,2,570,
GUJARAT,BHARUCH,2021-02-28,13,90,0,103,
GUJARAT,BHAVNAGAR,2021-02-26,14,666,1,681,
GUJARAT,BHAVNAGAR,2021-02-27,15,622,1,638,
GUJARAT,BHAVNAGAR,2021-02-28,7,734,1,742,
GUJARAT,BOTAD,2021-02-26,1,112,1,114,
GUJARAT,BOTAD,2021-02-27,1,164,0,165,
GUJARAT,BOTAD,2021-02-28,0,94,1,95,
GUJARAT,CHHOTAUDEPUR,2021-02-26,1,192,1,194,
GUJARAT,CHHOTAUDEPUR,2021-02-27,5,58,0,63,
GUJARAT,CHHOTAUDEPUR,2021-02-28,2,6,0,8,
GUJARAT,DANG,2021-02-26,0,252,1,253,
GUJARAT,DANG,2021-02-27,0,68,0,68,
GUJARAT,DANG,2021-02-28,0,64,0,64,
GUJARAT,DEVBHUMI DWARKA,2021-02-26,7,222,2,231,
GUJARAT,DEVBHUMI DWARKA,2021-02-27,2,127,1,130,
GUJARAT,DEVBHUMI DWARKA,2021-02-28,1,157,0,158,
GUJARAT,DOHAD,2021-02-26,4,334,0,338,
GUJARAT,DOHAD,2021-02-27,4,400,2,406,
GUJARAT,DOHAD,2021-02-28,2,379,0,381,
GUJARAT,GANDHINAGAR,2021-02-26,11,697,3,711,
GUJARAT,GANDHINAGAR,2021-02-27,10,492,16,518,
GUJARAT,GANDHINAGAR,2021-02-28,17,188,8,213,
GUJARAT,GIR SOMNATH,2021-02-26,5,277,1,283,
GUJARAT,GIR SOMNATH,2021-02-27,9,238,0,247,
GUJARAT,GIR SOMNATH,2021-02-28,6,21,0,27,
GUJARAT,JAMNAGAR,2021-02-26,14,803,9,826,
GUJARAT,JAMNAGAR,2021-02-27,11,709,6,726,
GUJARAT,JAMNAGAR,2021-02-28,12,414,5,431,
GUJARAT,JUNAGADH,2021-02-26,4,552,0,556,
GUJARAT,JUNAGADH,2021-02-27,8,510,2,520,
GUJARAT,JUNAGADH,2021-02-28,19,535,0,554,
GUJARAT,KACHCHH,2021-02-26,28,604,26,658,
GUJARAT,KACHCHH,2021-02-27,15,573,32,620,
GUJARAT,KACHCHH,2021-02-28,16,298,16,330,
GUJARAT,KHEDA,2021-02-26,13,569,1,583,
GUJARAT,KHEDA,2021-02-27,13,416,32,461,
GUJARAT,KHEDA,2021-02-28,26,423,11,460,
GUJARAT,MAHESANA,2021-02-26,4,587,9,600,
GUJARAT,MAHESANA,2021-02-27,4,575,0,579,
GUJARAT,MAHESANA,2021-02-28,5,151,1,157,
GUJARAT,MAHISAGAR,2021-02-26,17,401,0,418,
GUJARAT,MAHISAGAR,2021-02-27,3,262,1,266,
GUJARAT,MAHISAGAR,2021-02-28,2,257,0,259,
GUJARAT,MORBI,2021-02-26,3,242,31,276,
GUJARAT,MORBI,2021-02-27,4,220,20,244,
GUJARAT,MORBI,2021-02-28,5,184,13,202,
GUJARAT,NARMADA,2021-02-26,1,53,0,54,
GUJARAT,NARMADA,2021-02-27,4,84,0,88,
GUJARAT,NARMADA,2021-02-28,3,44,0,47,
GUJARAT,NAVSARI,2021-02-26,5,573,1,579,
GUJARAT,NAVSARI,2021-02-27,5,244,1,250,
GUJARAT,NAVSARI,2021-02-28,0,177,2,179,
GUJARAT,PANCH MAHALS,2021-02-26,17,412,0,429,
GUJARAT,PANCH MAHALS,2021-02-27,9,273,6,288,
GUJARAT,PANCH MAHALS,2021-02-28,15,269,0,284,
GUJARAT,PATAN,2021-02-26,0,553,2,555,
GUJARAT,PATAN,2021-02-27,0,357,2,359,
GUJARAT,PATAN,2021-02-28,0,89,0,89,
GUJARAT,PORBANDAR,2021-02-26,0,306,0,306,
GUJARAT,PORBANDAR,2021-02-27,1,271,0,272,
GUJARAT,PORBANDAR,2021-02-28,0,139,0,139,
GUJARAT,RAJKOT,2021-02-26,26,1416,44,1486,
GUJARAT,RAJKOT,2021-02-27,47,1277,19,1343,
GUJARAT,RAJKOT,2021-02-28,32,490,9,531,
GUJARAT,SABAR KANTHA,2021-02-26,7,197,3,207,
GUJARAT,SABAR KANTHA,2021-02-27,15,138,1,154,
GUJARAT,SABAR KANTHA,2021-02-28,8,107,0,115,
GUJARAT,SURAT,2021-02-26,78,1679,2,1759,
GUJARAT,SURAT,2021-02-27,67,1933,7,2007,
GUJARAT,SURAT,2021-02-28,21,896,7,924,
GUJARAT,SURENDRANAGAR,2021-02-26,2,916,1,919,
GUJARAT,SURENDRANAGAR,2021-02-27,2,424,0,426,
GUJARAT,SURENDRANAGAR,2021-02-28,0,327,0,327,
GUJARAT,TAPI,2021-02-26,7,393,0,400,
GUJARAT,TAPI,2021-02-27,5,175,0,180,
GUJARAT,TAPI,2021-02-28,0,136,0,136,
GUJARAT,VADODARA,2021-02-26,76,2096,81,2253,
GUJARAT,VADODARA,2021-02-27,67,1368,94,1529,
GUJARAT,VADODARA,2021-02-28,75,663,51,789,
GUJARAT,VALSAD,2021-02-26,1,630,1,632,
GUJARAT,VALSAD,2021-02-27,5,287,1,293,
GUJARAT,VALSAD,2021-02-28,1,268,0,269,
HARYANA,AMBALA,2021-02-26,17,1310,37,1364,
HARYANA,AMBALA,2021-02-27,39,950,60,1049,
HARYANA,AMBALA,2021-02-28,13,374,16,403,
HARYANA,BHIWANI,2021-02-26,2,459,0,461,
HARYANA,BHIWANI,2021-02-27,1,400,1,402,
HARYANA,BHIWANI,2021-02-28,3,362,0,365,
HARYANA,CHARKI DADRI,2021-02-26,0,118,0,118,
HARYANA,CHARKI DADRI,2021-02-27,0,93,0,93,
HARYANA,CHARKI DADRI,2021-02-28,1,143,0,144,
HARYANA,FARIDABAD,2021-02-26,10,759,4,773,
HARYANA,FARIDABAD,2021-02-27,18,902,6,926,
HARYANA,FARIDABAD,2021-02-28,12,476,4,492,
HARYANA,FATEHABAD,2021-02-26,1,410,0,411,
HARYANA,FATEHABAD,2021-02-27,3,435,1,439,
HARYANA,FATEHABAD,2021-02-28,0,106,1,107,
HARYANA,GURUGRAM,2021-02-26,69,3982,21,4072,
HARYANA,GURUGRAM,2021-02-27,53,3774,4,3831,
HARYANA,GURUGRAM,2021-02-28,53,3483,5,3541,
HARYANA,HISAR,2021-02-26,3,1130,0,1133,
HARYANA,HISAR,2021-02-27,7,775,0,782,
HARYANA,HISAR,2021-02-28,6,547,0,553,
HARYANA,JHAJJAR,2021-02-26,1,1044,0,1045,
HARYANA,JHAJJAR,2021-02-27,1,367,0,368,
HARYANA,JHAJJAR,2021-02-28,0,915,0,915,
HARYANA,JIND,2021-02-26,5,1455,7,1467,
HARYANA,JIND,2021-02-27,1,776,11,788,
HARYANA,JIND,2021-02-28,2,364,9,375,
HARYANA,KAITHAL,2021-02-26,3,321,8,332,
HARYANA,KAITHAL,2021-02-27,8,535,15,558,
HARYANA,KAITHAL,2021-02-28,3,485,32,520,
HARYANA,KARNAL,2021-02-26,54,619,1,674,
HARYANA,KARNAL,2021-02-27,12,222,0,234,
HARYANA,KARNAL,2021-02-28,3,103,0,106,
HARYANA,KURUKSHETRA,2021-02-26,33,1195,1,1229,
HARYANA,KURUKSHETRA,2021-02-27,35,495,71,601,
HARYANA,KURUKSHETRA,2021-02-28,14,316,19,349,
HARYANA,MAHENDRAGARH,2021-02-26,0,133,1,134,
HARYANA,MAHENDRAGARH,2021-02-27,0,195,2,197,
HARYANA,MAHENDRAGARH,2021-02-28,0,29,0,29,
HARYANA,NUH,2021-02-26,0,271,0,271,
HARYANA,NUH,2021-02-27,0,42,0,42,
HARYANA,NUH,2021-02-28,0,8,0,8,
HARYANA,PALWAL,2021-02-26,2,314,0,316,
HARYANA,PALWAL,2021-02-27,0,57,0,57,
HARYANA,PALWAL,2021-02-28,0,29,0,29,
HARYANA,PANCHKULA,2021-02-26,19,951,5,975,
HARYANA,PANCHKULA,2021-02-27,22,791,3,816,
HARYANA,PANCHKULA,2021-02-28,18,200,5,223,
HARYANA,PANIPAT,2021-02-26,6,385,7,398,
HARYANA,PANIPAT,2021-02-27,17,455,1,473,
HARYANA,PANIPAT,2021-02-28,20,467,1,488,
HARYANA,REWARI,2021-02-26,0,331,2,333,
HARYANA,REWARI,2021-02-27,1,610,0,611,
HARYANA,REWARI,2021-02-28,1,809,1,811,
HARYANA,ROHTAK,2021-02-26,0,789,1,790,
HARYANA,ROHTAK,2021-02-27,5,533,4,542,
HARYANA,ROHTAK,2021-02-28,1,334,1,336,
HARYANA,SIRSA,2021-02-26,0,1330,30,1360,
HARYANA,SIRSA,2021-02-27,8,897,6,911,
HARYANA,SIRSA,2021-02-28,0,901,4,905,
HARYANA,SONIPAT,2021-02-26,7,871,0,878,
HARYANA,SONIPAT,2021-02-27,3,200,0,203,
HARYANA,SONIPAT,2021-02-28,3,148,0,151,
HARYANA,YAMUNANAGAR,2021-02-26,14,1134,5,1153,
HARYANA,YAMUNANAGAR,2021-02-27,9,569,0,578,
HARYANA,YAMUNANAGAR,2021-02-28,9,671,2,682,
HIMACHAL PRADESH,BILASPUR,2021-02-26,2,582,1,585,
HIMACHAL PRADESH,BILASPUR,2021-02-27,0,86,0,86,
HIMACHAL PRADESH,BILASPUR,2021-02-28,0,27,1,28,
HIMACHAL PRADESH,CHAMBA,2021-02-26,0,556,5,561,
HIMACHAL PRADESH,CHAMBA,2021-02-27,0,149,1,150,
HIMACHAL PRADESH,CHAMBA,2021-02-28,0,40,0,40,
HIMACHAL PRADESH,HAMIRPUR,2021-02-26,2,345,0,347,
HIMACHAL PRADESH,HAMIRPUR,2021-02-27,1,361,0,362,
HIMACHAL PRADESH,HAMIRPUR,2021-02-28,2,41,2,45,
HIMACHAL PRADESH,KANGRA,2021-02-26,31,1056,2,1089,
HIMACHAL PRADESH,KANGRA,2021-02-27,26,688,1,715,
HIMACHAL PRADESH,KANGRA,2021-02-28,5,472,0,477,
HIMACHAL PRADESH,KINNAUR,2021-02-26,0,49,0,49,
HIMACHAL PRADESH,KINNAUR,2021-02-27,0,11,0,11,
HIMACHAL PRADESH,KINNAUR,2021-02-28,0,4,0,4,
HIMACHAL PRADESH,KULLU,2021-02-26,4,109,7,120,
HIMACHAL PRADESH,KULLU,2021-02-27,0,65,11,76,
HIMACHAL PRADESH,KULLU,2021-02-28,0,30,2,32,
HIMACHAL PRADESH,LAHUL AND SPITI,2021-02-26,0,3,0,3,
HIMACHAL PRADESH,LAHUL AND SPITI,2021-02-27,0,2,0,2,
HIMACHAL PRADESH,MANDI,2021-02-26,11,977,62,1050,
HIMACHAL PRADESH,MANDI,2021-02-27,3,700,16,719,
HIMACHAL PRADESH,MANDI,2021-02-28,1,394,0,395,
HIMACHAL PRADESH,SHIMLA,2021-02-26,17,496,3,516,
HIMACHAL PRADESH,SHIMLA,2021-02-27,2,302,8,312,
HIMACHAL PRADESH,SHIMLA,2021-02-28,0,150,1,151,
HIMACHAL PRADESH,SIRMAUR,2021-02-26,5,613,8,626,
HIMACHAL PRADESH,SIRMAUR,2021-02-27,2,354,7,363,
HIMACHAL PRADESH,SIRMAUR,2021-02-28,2,39,0,41,
HIMACHAL PRADESH,SOLAN,2021-02-26,6,538,1,545,
HIMACHAL PRADESH,SOLAN,2021-02-27,9,387,2,398,
HIMACHAL PRADESH,SOLAN,2021-02-28,3,99,0,102,
HIMACHAL PRADESH,UNA,2021-02-26,7,405,5,417,
HIMACHAL PRADESH,UNA,2021-02-27,8,729,4,741,
HIMACHAL PRADESH,UNA,2021-02-28,9,340,0,349,
INDIA,INDIA,2021-02-26,2,2,0,4,
INDIA,INDIA,2021-02-27,7,3,0,10,
INDIA,INDIA,2021-02-28,0,1,0,1,
JAMMU AND KASHMIR,ANANTNAG,2021-02-26,7,296,0,303,
JAMMU AND KASHMIR,ANANTNAG,2021-02-27,7,327,0,334,
JAMMU AND KASHMIR,ANANTNAG,2021-02-28,5,54,1,60,
JAMMU AND KASHMIR,BANDIPORA,2021-02-26,0,18,0,18,
JAMMU AND KASHMIR,BANDIPORA,2021-02-27,1,69,1,71,
JAMMU AND KASHMIR,BANDIPORA,2021-02-28,1,0,0,1,
JAMMU AND KASHMIR,BARAMULLA,2021-02-26,4,211,0,215,
JAMMU AND KASHMIR,BARAMULLA,2021-02-27,1,132,0,133,
JAMMU AND KASHMIR,BARAMULLA,2021-02-28,3,36,0,39,
JAMMU AND KASHMIR,BUDGAM,2021-02-26,1,603,0,604,
JAMMU AND KASHMIR,BUDGAM,2021-02-27,5,652,1,658,
JAMMU AND KASHMIR,BUDGAM,2021-02-28,0,153,0,153,
JAMMU AND KASHMIR,DODA,2021-02-26,0,26,0,26,
JAMMU AND KASHMIR,DODA,2021-02-27,0,25,0,25,
JAMMU AND KASHMIR,DODA,2021-02-28,0,4,0,4,
JAMMU AND KASHMIR,GANDERBAL,2021-02-26,0,86,0,86,
JAMMU AND KASHMIR,GANDERBAL,2021-02-27,0,94,0,94,
JAMMU AND KASHMIR,GANDERBAL,2021-02-28,2,14,0,16,
JAMMU AND KASHMIR,JAMMU,2021-02-26,6,703,1,710,
JAMMU AND KASHMIR,JAMMU,2021-02-27,1,406,1,408,
JAMMU AND KASHMIR,JAMMU,2021-02-28,3,207,1,211,
JAMMU AND KASHMIR,KATHUA,2021-02-26,0,53,0,53,
JAMMU AND KASHMIR,KATHUA,2021-02-27,0,39,0,39,
JAMMU AND KASHMIR,KATHUA,2021-02-28,1,52,0,53,
JAMMU AND KASHMIR,KISHTWAR,2021-02-26,0,141,0,141,
JAMMU AND KASHMIR,KISHTWAR,2021-02-27,0,30,0,30,
JAMMU AND KASHMIR,KISHTWAR,2021-02-28,0,1,0,1,
JAMMU AND KASHMIR,KULGAM,2021-02-26,2,181,0,183,
JAMMU AND KASHMIR,KULGAM,2021-02-27,0,106,0,106,
JAMMU AND KASHMIR,KULGAM,2021-02-28,2,5,0,7,
JAMMU AND KASHMIR,KUPWARA,2021-02-26,0,130,0,130,
JAMMU AND KASHMIR,KUPWARA,2021-02-27,1,285,0,286,
JAMMU AND KASHMIR,KUPWARA,2021-02-28,4,132,0,136,
JAMMU AND KASHMIR,POONCH,2021-02-26,0,409,0,409,
JAMMU AND KASHMIR,POONCH,2021-02-27,1,177,0,178,
JAMMU AND KASHMIR,POONCH,2021-02-28,0,275,0,275,
JAMMU AND KASHMIR,PULWAMA,2021-02-26,2,419,0,421,
JAMMU AND KASHMIR,PULWAMA,2021-02-27,2,418,1,421,
JAMMU AND KASHMIR,PULWAMA,2021-02-28,3,63,0,66,
JAMMU AND KASHMIR,RAJOURI,2021-02-26,0,201,0,201,
JAMMU AND KASHMIR,RAJOURI,2021-02-27,0,137,0,137,
JAMMU AND KASHMIR,RAJOURI,2021-02-28,0,13,0,13,
JAMMU AND KASHMIR,RAMBAN,2021-02-26,0,165,0,165,
JAMMU AND KASHMIR,RAMBAN,2021-02-27,0,101,0,101,
JAMMU AND KASHMIR,RAMBAN,2021-02-28,0,44,0,44,
JAMMU AND KASHMIR,REASI,2021-02-26,1,103,1,105,
JAMMU AND KASHMIR,REASI,2021-02-27,1,36,1,38,
JAMMU AND KASHMIR,REASI,2021-02-28,0,2,0,2,
JAMMU AND KASHMIR,SAMBA,2021-02-26,1,238,0,239,
JAMMU AND KASHMIR,SAMBA,2021-02-27,0,179,0,179,
JAMMU AND KASHMIR,SAMBA,2021-02-28,0,185,0,185,
JAMMU AND KASHMIR,SHOPIAN,2021-02-26,0,149,0,149,
JAMMU AND KASHMIR,SHOPIAN,2021-02-27,2,169,0,171,
JAMMU AND KASHMIR,SHOPIAN,2021-02-28,0,102,0,102,
JAMMU AND KASHMIR,SRINAGAR,2021-02-26,50,3287,5,3342,
JAMMU AND KASHMIR,SRINAGAR,2021-02-27,30,3120,2,3152,
JAMMU AND KASHMIR,SRINAGAR,2021-02-28,26,2100,1,2127,
JAMMU AND KASHMIR,UDHAMPUR,2021-02-26,0,635,0,635,
JAMMU AND KASHMIR,UDHAMPUR,2021-02-27,0,208,0,208,
JAMMU AND KASHMIR,UDHAMPUR,2021-02-28,1,174,0,175,
JHARKHAND,BOKARO,2021-02-26,0,1073,6,1079,
JHARKHAND,BOKARO,2021-02-27,6,737,38,781,
JHARKHAND,BOKARO,2021-02-28,0,97,0,97,
JHARKHAND,CHATRA,2021-02-26,0,608,1,609,
JHARKHAND,CHATRA,2021-02-27,3,541,0,544,
JHARKHAND,CHATRA,2021-02-28,1,397,0,398,
JHARKHAND,DEOGHAR,2021-02-26,0,847,0,847,
JHARKHAND,DEOGHAR,2021-02-27,1,1006,6,1013,
JHARKHAND,DEOGHAR,2021-02-28,3,706,0,709,
JHARKHAND,DHANBAD,2021-02-26,2,303,0,305,
JHARKHAND,DHANBAD,2021-02-27,3,229,0,232,
JHARKHAND,DHANBAD,2021-02-28,0,61,0,61,
JHARKHAND,DUMKA,2021-02-26,1,219,27,247,
JHARKHAND,DUMKA,2021-02-27,0,177,13,190,
JHARKHAND,DUMKA,2021-02-28,0,76,7,83,
JHARKHAND,EAST SINGHBUM,2021-02-26,16,1701,1,1718,
JHARKHAND,EAST SINGHBUM,2021-02-27,3,1750,2,1755,
JHARKHAND,EAST SINGHBUM,2021-02-28,6,1408,2,1416,
JHARKHAND,GARHWA,2021-02-26,0,1318,0,1318,
JHARKHAND,GARHWA,2021-02-27,0,599,0,599,
JHARKHAND,GARHWA,2021-02-28,0,498,0,498,
JHARKHAND,GIRIDIH,2021-02-26,2,952,0,954,
JHARKHAND,GIRIDIH,2021-02-27,2,166,0,168,
JHARKHAND,GIRIDIH,2021-02-28,0,171,0,171,
JHARKHAND,GODDA,2021-02-26,0,239,0,239,
JHARKHAND,GODDA,2021-02-27,0,158,0,158,
JHARKHAND,GODDA,2021-02-28,0,423,2,425,
JHARKHAND,GUMLA,2021-02-26,0,822,0,822,
JHARKHAND,GUMLA,2021-02-27,1,476,0,477,
JHARKHAND,GUMLA,2021-02-28,0,17,0,17,
JHARKHAND,HAZARIBAGH,2021-02-26,0,360,0,360,
JHARKHAND,HAZARIBAGH,2021-02-27,2,482,0,484,
JHARKHAND,HAZARIBAGH,2021-02-28,2,379,1,382,
JHARKHAND,JAMTARA,2021-02-26,0,764,0,764,
JHARKHAND,JAMTARA,2021-02-27,0,68,0,68,
JHARKHAND,JAMTARA,2021-02-28,0,51,0,51,
JHARKHAND,KHUNTI,2021-02-26,0,308,5,313,
JHARKHAND,KHUNTI,2021-02-27,5,114,0,119,
JHARKHAND,KHUNTI,2021-02-28,1,3,0,4,
JHARKHAND,KODERMA,2021-02-26,0,806,1,807,
JHARKHAND,KODERMA,2021-02-27,1,136,0,137,
JHARKHAND,KODERMA,2021-02-28,0,343,0,343,
JHARKHAND,LATEHAR,2021-02-26,3,910,4,917,
JHARKHAND,LATEHAR,2021-02-27,0,284,1,285,
JHARKHAND,LATEHAR,2021-02-28,0,281,1,282,
JHARKHAND,LOHARDAGA,2021-02-26,0,93,0,93,
JHARKHAND,LOHARDAGA,2021-02-27,0,60,0,60,
JHARKHAND,LOHARDAGA,2021-02-28,0,33,0,33,
JHARKHAND,PAKUR,2021-02-26,0,373,3,376,
JHARKHAND,PAKUR,2021-02-27,0,237,2,239,
JHARKHAND,PAKUR,2021-02-28,0,47,0,47,
JHARKHAND,PALAMU,2021-02-26,0,1126,2,1128,
JHARKHAND,PALAMU,2021-02-27,0,1421,1,1422,
JHARKHAND,PALAMU,2021-02-28,0,1250,1,1251,
JHARKHAND,RAMGARH,2021-02-26,2,79,0,81,
JHARKHAND,RAMGARH,2021-02-27,1,220,0,221,
JHARKHAND,RAMGARH,2021-02-28,0,41,0,41,
JHARKHAND,RANCHI,2021-02-26,52,703,5,760,
JHARKHAND,RANCHI,2021-02-27,58,593,0,651,
JHARKHAND,RANCHI,2021-02-28,28,469,1,498,
JHARKHAND,SAHEBGANJ,2021-02-26,0,648,1,649,
JHARKHAND,SAHEBGANJ,2021-02-27,0,31,0,31,
JHARKHAND,SAHEBGANJ,2021-02-28,0,34,0,34,
JHARKHAND,SARAIKELA KHARSAWAN,2021-02-26,0,166,0,166,
JHARKHAND,SARAIKELA KHARSAWAN,2021-02-27,0,25,0,25,
JHARKHAND,SARAIKELA KHARSAWAN,2021-02-28,2,84,0,86,
JHARKHAND,SIMDEGA,2021-02-26,1,1038,2,1041,
JHARKHAND,SIMDEGA,2021-02-27,0,195,0,195,
JHARKHAND,SIMDEGA,2021-02-28,2,172,0,174,
JHARKHAND,WEST SINGHBHUM,2021-02-26,0,215,0,215,
JHARKHAND,WEST SINGHBHUM,2021-02-27,0,979,0,979,
JHARKHAND,WEST SINGHBHUM,2021-02-28,0,1257,0,1257,
KARNATAKA,BAGALKOTE,2021-02-26,0,1150,5,1155,
KARNATAKA,BAGALKOTE,2021-02-27,1,914,7,922,
KARNATAKA,BAGALKOTE,2021-02-28,0,1397,1,1398,
KARNATAKA,BALLARI,2021-02-26,11,1831,52,1894,
KARNATAKA,BALLARI,2021-02-27,10,2394,8,2412,
KARNATAKA,BALLARI,2021-02-28,11,2141,46,2198,
KARNATAKA,BELAGAVI,2021-02-26,9,1960,6,1975,
KARNATAKA,BELAGAVI,2021-02-27,16,2066,0,2082,
KARNATAKA,BELAGAVI,2021-02-28,4,157,1,162,
KARNATAKA,BENGALURU RURAL,2021-02-26,8,970,0,978,
KARNATAKA,BENGALURU RURAL,2021-02-27,12,941,7,960,
KARNATAKA,BENGALURU RURAL,2021-02-28,2,217,1,220,
KARNATAKA,BENGALURU URBAN,2021-02-26,357,28859,479,29695,
KARNATAKA,BENGALURU URBAN,2021-02-27,367,37146,214,37727,
KARNATAKA,BENGALURU URBAN,2021-02-28,251,30093,103,30447,
KARNATAKA,BIDAR,2021-02-26,9,956,1,966,
KARNATAKA,BIDAR,2021-02-27,15,1139,0,1154,
KARNATAKA,BIDAR,2021-02-28,15,792,0,807,
KARNATAKA,CHAMARAJANAGARA,2021-02-26,5,1000,1,1006,
KARNATAKA,CHAMARAJANAGARA,2021-02-27,3,619,0,622,
KARNATAKA,CHAMARAJANAGARA,2021-02-28,4,494,1,499,
KARNATAKA,CHIKKABALLAPURA,2021-02-26,9,1060,3,1072,
KARNATAKA,CHIKKABALLAPURA,2021-02-27,5,1763,7,1775,
KARNATAKA,CHIKKABALLAPURA,2021-02-28,5,1005,1,1011,
KARNATAKA,CHIKKAMAGALURU,2021-02-26,3,858,4,865,
KARNATAKA,CHIKKAMAGALURU,2021-02-27,2,1072,5,1079,
KARNATAKA,CHIKKAMAGALURU,2021-02-28,1,378,3,382,
KARNATAKA,CHITRADURGA,2021-02-26,5,1001,4,1010,
KARNATAKA,CHITRADURGA,2021-02-27,7,1084,1,1092,
KARNATAKA,CHITRADURGA,2021-02-28,8,1095,0,1103,
KARNATAKA,DAKSHINA KANNADA,2021-02-26,30,1596,3,1629,
KARNATAKA,DAKSHINA KANNADA,2021-02-27,33,1458,3,1494,
KARNATAKA,DAKSHINA KANNADA,2021-02-28,3,1113,1,1117,
KARNATAKA,DAVANGERE,2021-02-26,1,1533,163,1697,
KARNATAKA,DAVANGERE,2021-02-27,5,1125,58,1188,
KARNATAKA,DAVANGERE,2021-02-28,2,1929,65,1996,
KARNATAKA,DHARWAD,2021-02-26,5,2103,8,2116,
KARNATAKA,DHARWAD,2021-02-27,6,2543,28,2577,
KARNATAKA,DHARWAD,2021-02-28,11,658,8,677,
KARNATAKA,GADAG,2021-02-26,2,833,86,921,
KARNATAKA,GADAG,2021-02-27,2,979,20,1001,
KARNATAKA,GADAG,2021-02-28,3,907,126,1036,
KARNATAKA,HASSAN,2021-02-26,8,4117,70,4195,
KARNATAKA,HASSAN,2021-02-27,11,5392,218,5621,
KARNATAKA,HASSAN,2021-02-28,1,1746,107,1854,
KARNATAKA,HAVERI,2021-02-26,1,1221,1,1223,
KARNATAKA,HAVERI,2021-02-27,0,245,0,245,
KARNATAKA,HAVERI,2021-02-28,0,40,0,40,
KARNATAKA,KALABURAGI,2021-02-26,23,2412,5,2440,
KARNATAKA,KALABURAGI,2021-02-27,19,1372,3,1394,
KARNATAKA,KALABURAGI,2021-02-28,16,1541,4,1561,
KARNATAKA,KODAGU,2021-02-26,3,798,37,838,
KARNATAKA,KODAGU,2021-02-27,8,1223,14,1245,
KARNATAKA,KODAGU,2021-02-28,0,25,0,25,
KARNATAKA,KOLAR,2021-02-26,6,1738,9,1753,
KARNATAKA,KOLAR,2021-02-27,6,1706,2,1714,
KARNATAKA,KOLAR,2021-02-28,0,1340,4,1344,
KARNATAKA,KOPPAL,2021-02-26,0,1173,1,1174,
KARNATAKA,KOPPAL,2021-02-27,1,1141,5,1147,
KARNATAKA,KOPPAL,2021-02-28,0,662,3,665,
KARNATAKA,MANDYA,2021-02-26,7,1715,8,1730,
KARNATAKA,MANDYA,2021-02-27,1,1456,3,1460,
KARNATAKA,MANDYA,2021-02-28,0,907,0,907,
KARNATAKA,MYSURU,2021-02-26,36,2240,1,2277,
KARNATAKA,MYSURU,2021-02-27,22,3048,10,3080,
KARNATAKA,MYSURU,2021-02-28,23,1779,2,1804,
KARNATAKA,RAICHUR,2021-02-26,0,1062,2,1064,
KARNATAKA,RAICHUR,2021-02-27,6,814,7,827,
KARNATAKA,RAICHUR,2021-02-28,0,902,0,902,
KARNATAKA,RAMANAGARA,2021-02-26,1,988,1,990,
KARNATAKA,RAMANAGARA,2021-02-27,0,456,1,457,
KARNATAKA,RAMANAGARA,2021-02-28,0,41,0,41,
KARNATAKA,SHIVAMOGGA,2021-02-26,3,1173,12,1188,
KARNATAKA,SHIVAMOGGA,2021-02-27,5,1685,12,1702,
KARNATAKA,SHIVAMOGGA,2021-02-28,2,1239,16,1257,
KARNATAKA,TUMAKURU,2021-02-26,16,2142,3,2161,
KARNATAKA,TUMAKURU,2021-02-27,15,3296,45,3356,
KARNATAKA,TUMAKURU,2021-02-28,27,1990,3,2020,
KARNATAKA,UDUPI,2021-02-26,19,1245,1,1265,
KARNATAKA,UDUPI,2021-02-27,19,1498,2,1519,
KARNATAKA,UDUPI,2021-02-28,5,813,0,818,
KARNATAKA,UTTARA KANNADA,2021-02-26,1,1468,86,1555,
KARNATAKA,UTTARA KANNADA,2021-02-27,4,1232,114,1350,
KARNATAKA,UTTARA KANNADA,2021-02-28,1,1157,136,1294,
KARNATAKA,VIJAYAPURA,2021-02-26,7,1820,0,1827,
KARNATAKA,VIJAYAPURA,2021-02-27,18,1695,1,1714,
KARNATAKA,VIJAYAPURA,2021-02-28,5,1296,4,1305,
KARNATAKA,YADGIR,2021-02-26,2,840,0,842,
KARNATAKA,YADGIR,2021-02-27,7,1178,1,1186,
KARNATAKA,YADGIR,2021-02-28,1,1301,0,1302,
KERALA,ALAPPUZHA,2021-02-26,252,5531,20,5803,
KERALA,ALAPPUZHA,2021-02-27,337,5270,19,5626,
KERALA,ALAPPUZHA,2021-02-28,205,3098,19,3322,
KERALA,ERNAKULAM,2021-02-26,451,6413,35,6899,
KERALA,ERNAKULAM,2021-02-27,454,6991,29,7474,
KERALA,ERNAKULAM,2021-02-28,373,5838,70,6281,
KERALA,IDUKKI,2021-02-26,96,1816,8,1920,
KERALA,IDUKKI,2021-02-27,130,2026,3,2159,
KERALA,IDUKKI,2021-02-28,72,1289,3,1364,
KERALA,KANNUR,2021-02-26,211,3258,16,3485,
KERALA,KANNUR,2021-02-27,197,3108,2,3307,
KERALA,KANNUR,2021-02-28,217,1921,12,2150,
KERALA,KASARAGOD,2021-02-26,178,2365,0,2543,
KERALA,KASARAGOD,2021-02-27,171,2309,6,2486,
KERALA,KASARAGOD,2021-02-28,98,1542,1,1641,
KERALA,KOLLAM,2021-02-26,469,5001,16,5486,
KERALA,KOLLAM,2021-02-27,474,6159,57,6690,
KERALA,KOLLAM,2021-02-28,293,5863,26,6182,
KERALA,KOTTAYAM,2021-02-26,265,3869,35,4169,
KERALA,KOTTAYAM,2021-02-27,344,4996,28,5368,
KERALA,KOTTAYAM,2021-02-28,256,3336,38,3630,
KERALA,KOZHIKODE,2021-02-26,577,4506,56,5139,
KERALA,KOZHIKODE,2021-02-27,542,6359,77,6978,
KERALA,KOZHIKODE,2021-02-28,478,3999,62,4539,
KERALA,MALAPPURAM,2021-02-26,395,4058,2,4455,
KERALA,MALAPPURAM,2021-02-27,320,4075,6,4401,
KERALA,MALAPPURAM,2021-02-28,329,3720,12,4061,
KERALA,PALAKKAD,2021-02-26,159,2918,2,3079,
KERALA,PALAKKAD,2021-02-27,122,2878,0,3000,
KERALA,PALAKKAD,2021-02-28,90,2419,3,2512,
KERALA,PATHANAMTHITTA,2021-02-26,354,4461,4,4819,
KERALA,PATHANAMTHITTA,2021-02-27,277,3997,4,4278,
KERALA,PATHANAMTHITTA,2021-02-28,153,1763,3,1919,
KERALA,THIRUVANANTHAPURAM,2021-02-26,304,4454,39,4797,
KERALA,THIRUVANANTHAPURAM,2021-02-27,298,5092,26,5416,
KERALA,THIRUVANANTHAPURAM,2021-02-28,188,3797,19,4004,
KERALA,THRISSUR,2021-02-26,667,4776,0,5443,
KERALA,THRISSUR,2021-02-27,322,4238,4,4564,
KERALA,THRISSUR,2021-02-28,185,3002,14,3201,
KERALA,WAYANAD,2021-02-26,141,1151,13,1305,
KERALA,WAYANAD,2021-02-27,123,1897,17,2037,
KERALA,WAYANAD,2021-02-28,64,732,1,797,
LADAKH,KARGIL,2021-02-26,0,113,1,114,
LADAKH,KARGIL,2021-02-27,1,41,1,43,
LADAKH,KARGIL,2021-02-28,0,31,0,31,
LADAKH,LEH LADAKH,2021-02-26,3,148,0,151,
LADAKH,LEH LADAKH,2021-02-27,2,235,1,238,
LADAKH,LEH LADAKH,2021-02-28,0,127,0,127,
LAKSHADWEEP,LAKSHADWEEP DISTRICT,2021-02-26,10,164,0,174,
LAKSHADWEEP,LAKSHADWEEP DISTRICT,2021-02-27,1,125,0,126,
LAKSHADWEEP,LAKSHADWEEP DISTRICT,2021-02-28,0,55,0,55,
MADHYA PRADESH,AGAR MALWA,2021-02-26,2,104,0,106,
MADHYA PRADESH,AGAR MALWA,2021-02-27,0,148,0,148,
MADHYA PRADESH,AGAR MALWA,2021-02-28,2,127,0,129,
MADHYA PRADESH,ALIRAJPUR,2021-02-26,4,130,0,134,
MADHYA PRADESH,ALIRAJPUR,2021-02-27,0,80,0,80,
MADHYA PRADESH,ALIRAJPUR,2021-02-28,0,36,0,36,
MADHYA PRADESH,ANUPPUR,2021-02-26,4,60,2,66,
MADHYA PRADESH,ANUPPUR,2021-02-27,0,39,2,41,
MADHYA PRADESH,ANUPPUR,2021-02-28,0,73,83,156,
MADHYA PRADESH,ASHOKNAGAR,2021-02-26,0,78,0,78,
MADHYA PRADESH,ASHOKNAGAR,2021-02-27,0,21,0,21,
MADHYA PRADESH,ASHOKNAGAR,2021-02-28,2,112,0,114,
MADHYA PRADESH,BALAGHAT,2021-02-26,2,248,0,250,
MADHYA PRADESH,BALAGHAT,2021-02-27,5,353,1,359,
MADHYA PRADESH,BALAGHAT,2021-02-28,2,322,2,326,
MADHYA PRADESH,BARWANI,2021-02-26,1,112,0,113,
MADHYA PRADESH,BARWANI,2021-02-27,2,173,0,175,
MADHYA PRADESH,BARWANI,2021-02-28,3,59,0,62,
MADHYA PRADESH,BETUL,2021-02-26,21,303,6,330,
MADHYA PRADESH,BETUL,2021-02-27,7,289,0,296,
MADHYA PRADESH,BETUL,2021-02-28,5,233,1,239,
MADHYA PRADESH,BHIND,2021-02-26,1,268,0,269,
MADHYA PRADESH,BHIND,2021-02-27,0,231,0,231,
MADHYA PRADESH,BHIND,2021-02-28,0,258,0,258,
MADHYA PRADESH,BHOPAL,2021-02-26,78,1310,6,1394,
MADHYA PRADESH,BHOPAL,2021-02-27,81,1582,8,1671,
MADHYA PRADESH,BHOPAL,2021-02-28,87,1482,2,1571,
MADHYA PRADESH,BURHANPUR,2021-02-26,9,235,0,244,
MADHYA PRADESH,BURHANPUR,2021-02-27,16,360,5,381,
MADHYA PRADESH,BURHANPUR,2021-02-28,3,278,0,281,
MADHYA PRADESH,CHHATARPUR,2021-02-26,0,206,0,206,
MADHYA PRADESH,CHHATARPUR,2021-02-27,1,251,0,252,
MADHYA PRADESH,CHHATARPUR,2021-02-28,0,100,0,100,
MADHYA PRADESH,CHHINDWARA,2021-02-26,21,534,3,558,
MADHYA PRADESH,CHHINDWARA,2021-02-27,27,365,0,392,
MADHYA PRADESH,CHHINDWARA,2021-02-28,17,246,1,264,
MADHYA PRADESH,DAMOH,2021-02-26,18,252,0,270,
MADHYA PRADESH,DAMOH,2021-02-27,9,113,0,122,
MADHYA PRADESH,DAMOH,2021-02-28,9,173,3,185,
MADHYA PRADESH,DATIA,2021-02-26,0,151,13,164,
MADHYA PRADESH,DATIA,2021-02-27,0,173,13,186,
MADHYA PRADESH,DATIA,2021-02-28,0,47,0,47,
MADHYA PRADESH,DEWAS,2021-02-26,1,265,0,266,
MADHYA PRADESH,DEWAS,2021-02-27,14,550,1,565,
MADHYA PRADESH,DEWAS,2021-02-28,2,158,0,160,
MADHYA PRADESH,DHAR,2021-02-26,3,211,0,214,
MADHYA PRADESH,DHAR,2021-02-27,2,111,1,114,
MADHYA PRADESH,DHAR,2021-02-28,4,195,0,199,
MADHYA PRADESH,DINDORI,2021-02-26,1,324,1,326,
MADHYA PRADESH,DINDORI,2021-02-27,0,364,1,365,
MADHYA PRADESH,DINDORI,2021-02-28,0,136,0,136,
MADHYA PRADESH,EAST NIMAR,2021-02-26,4,333,4,341,
MADHYA PRADESH,EAST NIMAR,2021-02-27,10,207,3,220,
MADHYA PRADESH,EAST NIMAR,2021-02-28,2,254,4,260,
MADHYA PRADESH,GUNA,2021-02-26,2,311,1,314,
MADHYA PRADESH,GUNA,2021-02-27,0,231,1,232,
MADHYA PRADESH,GUNA,2021-02-28,1,241,0,242,
MADHYA PRADESH,GWALIOR,2021-02-26,7,825,1,833,
MADHYA PRADESH,GWALIOR,2021-02-27,6,698,0,704,
MADHYA PRADESH,GWALIOR,2021-02-28,5,652,1,658,
MADHYA PRADESH,HARDA,2021-02-26,1,201,0,202,
MADHYA PRADESH,HARDA,2021-02-27,0,176,0,176,
MADHYA PRADESH,HARDA,2021-02-28,10,140,0,150,
MADHYA PRADESH,HOSHANGABAD,2021-02-26,3,240,0,243,
MADHYA PRADESH,HOSHANGABAD,2021-02-27,6,269,1,276,
MADHYA PRADESH,HOSHANGABAD,2021-02-28,2,224,1,227,
MADHYA PRADESH,INDORE,2021-02-26,259,1480,0,1739,
MADHYA PRADESH,INDORE,2021-02-27,233,1677,1,1911,
MADHYA PRADESH,INDORE,2021-02-28,139,1265,1,1405,
MADHYA PRADESH,JABALPUR,2021-02-26,42,575,0,617,
MADHYA PRADESH,JABALPUR,2021-02-27,7,259,1,267,
MADHYA PRADESH,JABALPUR,2021-02-28,15,589,0,604,
MADHYA PRADESH,JHABUA,2021-02-26,4,188,0,192,
MADHYA PRADESH,JHABUA,2021-02-27,0,137,0,137,
MADHYA PRADESH,JHABUA,2021-02-28,7,154,0,161,
MADHYA PRADESH,KATNI,2021-02-26,9,146,1,156,
MADHYA PRADESH,KATNI,2021-02-27,4,319,15,338,
MADHYA PRADESH,KATNI,2021-02-28,1,132,0,133,
MADHYA PRADESH,KHARGONE,2021-02-26,11,362,0,373,
MADHYA PRADESH,KHARGONE,2021-02-27,3,116,0,119,
MADHYA PRADESH,KHARGONE,2021-02-28,4,288,0,292,
MADHYA PRADESH,MANDLA,2021-02-26,0,622,0,622,
MADHYA PRADESH,MANDLA,2021-02-27,0,300,0,300,
MADHYA PRADESH,MANDLA,2021-02-28,0,124,0,124,
MADHYA PRADESH,MANDSAUR,2021-02-26,6,84,1,91,
MADHYA PRADESH,MANDSAUR,2021-02-27,8,87,0,95,
MADHYA PRADESH,MANDSAUR,2021-02-28,5,47,0,52,
MADHYA PRADESH,MORENA,2021-02-26,3,307,0,310,
MADHYA PRADESH,MORENA,2021-02-27,0,279,0,279,
MADHYA PRADESH,MORENA,2021-02-28,1,251,0,252,
MADHYA PRADESH,NARSINGHPUR,2021-02-26,5,487,0,492,
MADHYA PRADESH,NARSINGHPUR,2021-02-27,1,433,0,434,
MADHYA PRADESH,NARSINGHPUR,2021-02-28,0,391,1,392,
MADHYA PRADESH,NEEMUCH,2021-02-26,2,51,2,55,
MADHYA PRADESH,NEEMUCH,2021-02-27,2,124,0,126,
MADHYA PRADESH,NEEMUCH,2021-02-28,1,15,0,16,
MADHYA PRADESH,NIWARI,2021-02-26,0,60,0,60,
MADHYA PRADESH,NIWARI,2021-02-27,0,22,0,22,
MADHYA PRADESH,NIWARI,2021-02-28,0,16,0,16,
MADHYA PRADESH,PANNA,2021-02-26,0,167,0,167,
MADHYA PRADESH,PANNA,2021-02-27,0,40,0,40,
MADHYA PRADESH,PANNA,2021-02-28,0,20,0,20,
MADHYA PRADESH,RAISEN,2021-02-26,3,115,0,118,
MADHYA PRADESH,RAISEN,2021-02-27,3,71,0,74,
MADHYA PRADESH,RAISEN,2021-02-28,2,45,0,47,
MADHYA PRADESH,RAJGARH,2021-02-26,5,176,0,181,
MADHYA PRADESH,RAJGARH,2021-02-27,1,200,2,203,
MADHYA PRADESH,RAJGARH,2021-02-28,0,153,0,153,
MADHYA PRADESH,RATLAM,2021-02-26,5,215,0,220,
MADHYA PRADESH,RATLAM,2021-02-27,2,109,6,117,
MADHYA PRADESH,RATLAM,2021-02-28,1,43,0,44,
MADHYA PRADESH,REWA,2021-02-26,4,651,2,657,
MADHYA PRADESH,REWA,2021-02-27,3,206,0,209,
MADHYA PRADESH,REWA,2021-02-28,4,682,0,686,
MADHYA PRADESH,SAGAR,2021-02-26,2,698,1,701,
MADHYA PRADESH,SAGAR,2021-02-27,4,664,0,668,
MADHYA PRADESH,SAGAR,2021-02-28,5,476,0,481,
MADHYA PRADESH,SATNA,2021-02-26,2,181,0,183,
MADHYA PRADESH,SATNA,2021-02-27,1,410,0,411,
MADHYA PRADESH,SATNA,2021-02-28,4,140,0,144,
MADHYA PRADESH,SEHORE,2021-02-26,6,236,1,243,
MADHYA PRADESH,SEHORE,2021-02-27,6,170,0,176,
MADHYA PRADESH,SEHORE,2021-02-28,0,335,15,350,
MADHYA PRADESH,SEONI,2021-02-26,0,250,2,252,
MADHYA PRADESH,SEONI,2021-02-27,0,206,2,208,
MADHYA PRADESH,SEONI,2021-02-28,0,131,5,136,
MADHYA PRADESH,SHAHDOL,2021-02-26,0,51,0,51,
MADHYA PRADESH,SHAHDOL,2021-02-27,0,27,0,27,
MADHYA PRADESH,SHAHDOL,2021-02-28,0,30,0,30,
MADHYA PRADESH,SHAJAPUR,2021-02-26,5,144,0,149,
MADHYA PRADESH,SHAJAPUR,2021-02-27,0,79,0,79,
MADHYA PRADESH,SHAJAPUR,2021-02-28,0,155,0,155,
MADHYA PRADESH,SHEOPUR,2021-02-26,2,168,1,171,
MADHYA PRADESH,SHEOPUR,2021-02-27,4,226,0,230,
MADHYA PRADESH,SHEOPUR,2021-02-28,1,62,0,63,
MADHYA PRADESH,SHIVPURI,2021-02-26,0,224,1,225,
MADHYA PRADESH,SHIVPURI,2021-02-27,1,242,0,243,
MADHYA PRADESH,SHIVPURI,2021-02-28,0,146,2,148,
MADHYA PRADESH,SIDHI,2021-02-26,1,57,0,58,
MADHYA PRADESH,SIDHI,2021-02-27,1,254,0,255,
MADHYA PRADESH,SIDHI,2021-02-28,12,112,0,124,
MADHYA PRADESH,SINGRAULI,2021-02-26,7,206,31,244,
MADHYA PRADESH,SINGRAULI,2021-02-27,1,122,0,123,
MADHYA PRADESH,SINGRAULI,2021-02-28,2,4,0,6,
MADHYA PRADESH,TIKAMGARH,2021-02-26,4,175,0,179,
MADHYA PRADESH,TIKAMGARH,2021-02-27,1,230,0,231,
MADHYA PRADESH,TIKAMGARH,2021-02-28,1,145,0,146,
MADHYA PRADESH,UJJAIN,2021-02-26,5,336,0,341,
MADHYA PRADESH,UJJAIN,2021-02-27,22,110,0,132,
MADHYA PRADESH,UJJAIN,2021-02-28,6,58,0,64,
MADHYA PRADESH,UMARIA,2021-02-26,0,214,72,286,
MADHYA PRADESH,UMARIA,2021-02-27,0,37,9,46,
MADHYA PRADESH,UMARIA,2021-02-28,0,174,36,210,
MADHYA PRADESH,VIDISHA,2021-02-26,5,131,7,143,
MADHYA PRADESH,VIDISHA,2021-02-27,1,52,2,55,
MADHYA PRADESH,VIDISHA,2021-02-28,7,43,4,54,
MAHARASHTRA,AHMEDNAGAR,2021-02-26,279,2038,1,2318,
MAHARASHTRA,AHMEDNAGAR,2021-02-27,163,1315,2,1480,
MAHARASHTRA,AHMEDNAGAR,2021-02-28,218,1759,1,1978,
MAHARASHTRA,AKOLA,2021-02-26,268,1029,1,1298,
MAHARASHTRA,AKOLA,2021-02-27,299,978,0,1277,
MAHARASHTRA,AKOLA,2021-02-28,279,522,0,801,
MAHARASHTRA,AMRAVATI,2021-02-26,641,1704,4,2349,
MAHARASHTRA,AMRAVATI,2021-02-27,832,2119,4,2955,
MAHARASHTRA,AMRAVATI,2021-02-28,531,2170,2,2703,
MAHARASHTRA,AURANGABAD,2021-02-26,273,858,6,1137,
MAHARASHTRA,AURANGABAD,2021-02-27,301,683,8,992,
MAHARASHTRA,AURANGABAD,2021-02-28,245,694,0,939,
MAHARASHTRA,BEED,2021-02-26,80,699,0,779,
MAHARASHTRA,BEED,2021-02-27,48,1144,0,1192,
MAHARASHTRA,BEED,2021-02-28,54,740,0,794,
MAHARASHTRA,BHANDARA,2021-02-26,40,759,1,800,
MAHARASHTRA,BHANDARA,2021-02-27,20,721,0,741,
MAHARASHTRA,BHANDARA,2021-02-28,26,538,0,564,
MAHARASHTRA,BULDHANA,2021-02-26,232,701,7,940,
MAHARASHTRA,BULDHANA,2021-02-27,64,57,0,121,
MAHARASHTRA,BULDHANA,2021-02-28,16,67,0,83,
MAHARASHTRA,CHANDRAPUR,2021-02-26,77,926,2,1005,
MAHARASHTRA,CHANDRAPUR,2021-02-27,50,544,2,596,
MAHARASHTRA,CHANDRAPUR,2021-02-28,32,434,0,466,
MAHARASHTRA,DHULE,2021-02-26,86,287,0,373,
MAHARASHTRA,DHULE,2021-02-27,72,437,4,513,
MAHARASHTRA,DHULE,2021-02-28,73,57,0,130,
MAHARASHTRA,GADCHIROLI,2021-02-26,18,374,3,395,
MAHARASHTRA,GADCHIROLI,2021-02-27,34,572,1,607,
MAHARASHTRA,GADCHIROLI,2021-02-28,14,142,1,157,
MAHARASHTRA,GONDIA,2021-02-26,23,389,0,412,
MAHARASHTRA,GONDIA,2021-02-27,12,304,0,316,
MAHARASHTRA,GONDIA,2021-02-28,10,157,0,167,
MAHARASHTRA,HINGOLI,2021-02-26,16,183,0,199,
MAHARASHTRA,HINGOLI,2021-02-27,54,387,0,441,
MAHARASHTRA,HINGOLI,2021-02-28,12,27,1,40,
MAHARASHTRA,JALGAON,2021-02-26,372,1866,7,2245,
MAHARASHTRA,JALGAON,2021-02-27,433,1975,4,2412,
MAHARASHTRA,JALGAON,2021-02-28,310,509,0,819,
MAHARASHTRA,JALNA,2021-02-26,105,577,1,683,
MAHARASHTRA,JALNA,2021-02-27,37,563,0,600,
MAHARASHTRA,JALNA,2021-02-28,53,288,0,341,
MAHARASHTRA,KOLHAPUR,2021-02-26,37,1449,1,1487,
MAHARASHTRA,KOLHAPUR,2021-02-27,53,1375,2,1430,
MAHARASHTRA,KOLHAPUR,2021-02-28,51,1077,4,1132,
MAHARASHTRA,LATUR,2021-02-26,98,1632,1,1731,
MAHARASHTRA,LATUR,2021-02-27,65,1516,3,1584,
MAHARASHTRA,LATUR,2021-02-28,45,708,0,753,
MAHARASHTRA,MUMBAI,2021-02-26,879,17779,57,18715,
MAHARASHTRA,MUMBAI,2021-02-27,882,17345,52,18279,
MAHARASHTRA,MUMBAI,2021-02-28,759,12539,29,13327,
MAHARASHTRA,MUMBAI SUBURBAN,2021-02-26,269,3332,6,3607,
MAHARASHTRA,MUMBAI SUBURBAN,2021-02-27,267,3438,2,3707,
MAHARASHTRA,MUMBAI SUBURBAN,2021-02-28,257,2933,3,3193,
MAHARASHTRA,NAGPUR,2021-02-26,1122,6779,56,7957,
MAHARASHTRA,NAGPUR,2021-02-27,1238,6748,74,8060,
MAHARASHTRA,NAGPUR,2021-02-28,1038,5023,33,6094,
MAHARASHTRA,NANDED,2021-02-26,93,1230,3,1326,
MAHARASHTRA,NANDED,2021-02-27,108,1527,3,1638,
MAHARASHTRA,NANDED,2021-02-28,95,721,4,820,
MAHARASHTRA,NANDURBAR,2021-02-26,57,26,1,84,
MAHARASHTRA,NANDURBAR,2021-02-27,16,23,1,40,
MAHARASHTRA,NANDURBAR,2021-02-28,2,2,0,4,
MAHARASHTRA,NASHIK,2021-02-26,748,2323,18,3089,
MAHARASHTRA,NASHIK,2021-02-27,233,1553,5,1791,
MAHARASHTRA,NASHIK,2021-02-28,269,1144,12,1425,
MAHARASHTRA,OSMANABAD,2021-02-26,16,409,4,429,
MAHARASHTRA,OSMANABAD,2021-02-27,34,132,4,170,
MAHARASHTRA,OSMANABAD,2021-02-28,7,80,0,87,
MAHARASHTRA,PALGHAR,2021-02-26,71,877,5,953,
MAHARASHTRA,PALGHAR,2021-02-27,69,797,3,869,
MAHARASHTRA,PALGHAR,2021-02-28,57,726,7,790,
MAHARASHTRA,PARBHANI,2021-02-26,46,939,0,985,
MAHARASHTRA,PARBHANI,2021-02-27,51,1418,3,1472,
MAHARASHTRA,PARBHANI,2021-02-28,29,814,0,843,
MAHARASHTRA,PUNE,2021-02-26,1580,8254,110,9944,
MAHARASHTRA,PUNE,2021-02-27,1628,7939,103,9670,
MAHARASHTRA,PUNE,2021-02-28,831,5535,63,6429,
MAHARASHTRA,RAIGAD,2021-02-26,127,1583,4,1714,
MAHARASHTRA,RAIGAD,2021-02-27,133,1389,2,1524,
MAHARASHTRA,RAIGAD,2021-02-28,116,1076,0,1192,
MAHARASHTRA,RATNAGIRI,2021-02-26,43,94,0,137,
MAHARASHTRA,RATNAGIRI,2021-02-27,17,59,0,76,
MAHARASHTRA,RATNAGIRI,2021-02-28,5,36,0,41,
MAHARASHTRA,SANGLI,2021-02-26,23,1297,1,1321,
MAHARASHTRA,SANGLI,2021-02-27,27,1252,0,1279,
MAHARASHTRA,SANGLI,2021-02-28,20,736,2,758,
MAHARASHTRA,SATARA,2021-02-26,182,1461,11,1654,
MAHARASHTRA,SATARA,2021-02-27,119,1458,13,1590,
MAHARASHTRA,SATARA,2021-02-28,194,679,3,876,
MAHARASHTRA,SINDHUDURG,2021-02-26,9,310,1,320,
MAHARASHTRA,SINDHUDURG,2021-02-27,14,363,0,377,
MAHARASHTRA,SINDHUDURG,2021-02-28,5,396,0,401,
MAHARASHTRA,SOLAPUR,2021-02-26,95,1503,8,1606,
MAHARASHTRA,SOLAPUR,2021-02-27,96,1501,2,1599,
MAHARASHTRA,SOLAPUR,2021-02-28,78,1310,7,1395,
MAHARASHTRA,THANE,2021-02-26,723,8722,40,9485,
MAHARASHTRA,THANE,2021-02-27,772,9075,24,9871,
MAHARASHTRA,THANE,2021-02-28,682,6856,13,7551,
MAHARASHTRA,WARDHA,2021-02-26,159,954,2,1115,
MAHARASHTRA,WARDHA,2021-02-27,222,962,8,1192,
MAHARASHTRA,WARDHA,2021-02-28,52,393,3,448,
MAHARASHTRA,WASHIM,2021-02-26,128,1063,11,1202,
MAHARASHTRA,WASHIM,2021-02-27,86,581,2,669,
MAHARASHTRA,WASHIM,2021-02-28,173,970,12,1155,
MAHARASHTRA,YAVATMAL,2021-02-26,186,925,1,1112,
MAHARASHTRA,YAVATMAL,2021-02-27,177,1615,8,1800,
MAHARASHTRA,YAVATMAL,2021-02-28,94,621,2,717,
MANIPUR,BISHNUPUR,2021-02-26,0,91,0,91,
MANIPUR,BISHNUPUR,2021-02-27,0,144,0,144,
MANIPUR,BISHNUPUR,2021-02-28,0,36,0,36,
MANIPUR,CHANDEL,2021-02-26,0,10,0,10,
MANIPUR,CHANDEL,2021-02-27,0,15,0,15,
MANIPUR,CHANDEL,2021-02-28,0,33,0,33,
MANIPUR,CHURACHANDPUR,2021-02-26,1,110,0,111,
MANIPUR,CHURACHANDPUR,2021-02-27,2,109,0,111,
MANIPUR,CHURACHANDPUR,2021-02-28,0,23,0,23,
MANIPUR,IMPHAL EAST,2021-02-26,0,136,0,136,
MANIPUR,IMPHAL EAST,2021-02-27,3,145,0,148,
MANIPUR,IMPHAL EAST,2021-02-28,1,215,0,216,
MANIPUR,IMPHAL WEST,2021-02-26,6,356,0,362,
MANIPUR,IMPHAL WEST,2021-02-27,5,517,0,522,
MANIPUR,IMPHAL WEST,2021-02-28,2,328,0,330,
MANIPUR,JIRIBAM,2021-02-26,0,4,0,4,
MANIPUR,JIRIBAM,2021-02-27,0,2,0,2,
MANIPUR,KAKCHING,2021-02-26,0,19,0,19,
MANIPUR,KAKCHING,2021-02-27,0,40,0,40,
MANIPUR,KAKCHING,2021-02-28,0,26,1,27,
MANIPUR,KAMJONG,2021-02-26,0,3,0,3,
MANIPUR,KAMJONG,2021-02-27,0,5,0,5,
MANIPUR,KAMJONG,2021-02-28,0,5,0,5,
MANIPUR,KANGPOKPI,2021-02-26,0,9,0,9,
MANIPUR,KANGPOKPI,2021-02-27,0,19,0,19,
MANIPUR,KANGPOKPI,2021-02-28,0,8,0,8,
MANIPUR,NONEY,2021-02-26,0,2,0,2,
MANIPUR,NONEY,2021-02-27,0,1,0,1,
MANIPUR,NONEY,2021-02-28,0,2,0,2,
MANIPUR,SENAPATI,2021-02-26,0,18,0,18,
MANIPUR,SENAPATI,2021-02-27,1,17,0,18,
MANIPUR,SENAPATI,2021-02-28,0,15,0,15,
MANIPUR,TAMENGLONG,2021-02-26,0,54,0,54,
MANIPUR,TAMENGLONG,2021-02-27,0,111,0,111,
MANIPUR,TAMENGLONG,2021-02-28,0,28,0,28,
MANIPUR,TENGNOUPAL,2021-02-26,0,20,0,20,
MANIPUR,TENGNOUPAL,2021-02-27,0,7,0,7,
MANIPUR,TENGNOUPAL,2021-02-28,0,5,0,5,
MANIPUR,THOUBAL,2021-02-26,0,114,0,114,
MANIPUR,THOUBAL,2021-02-27,5,168,0,173,
MANIPUR,THOUBAL,2021-02-28,5,101,0,106,
MANIPUR,UKHRUL,2021-02-26,0,35,0,35,
MANIPUR,UKHRUL,2021-02-27,0,112,0,112,
MANIPUR,UKHRUL,2021-02-28,0,13,0,13,
MEGHALAYA,EAST GARO HILLS,2021-02-26,0,20,0,20,
MEGHALAYA,EAST GARO HILLS,2021-02-27,0,4,0,4,
MEGHALAYA,EAST GARO HILLS,2021-02-28,0,4,0,4,
MEGHALAYA,EAST JAINTIA HILLS,2021-02-26,0,105,0,105,
MEGHALAYA,EAST JAINTIA HILLS,2021-02-27,0,21,0,21,
MEGHALAYA,EAST JAINTIA HILLS,2021-02-28,0,26,0,26,
MEGHALAYA,EAST KHASI HILLS,2021-02-26,0,772,0,772,
MEGHALAYA,EAST KHASI HILLS,2021-02-27,2,699,0,701,
MEGHALAYA,EAST KHASI HILLS,2021-02-28,0,299,0,299,
MEGHALAYA,NORTH GARO HILLS,2021-02-26,0,8,0,8,
MEGHALAYA,NORTH GARO HILLS,2021-02-27,0,2,0,2,
MEGHALAYA,NORTH GARO HILLS,2021-02-28,0,5,0,5,
MEGHALAYA,RI BHOI,2021-02-26,0,48,0,48,
MEGHALAYA,RI BHOI,2021-02-27,0,44,0,44,
MEGHALAYA,RI BHOI,2021-02-28,0,24,0,24,
MEGHALAYA,SOUTH GARO HILLS,2021-02-26,0,5,0,5,
MEGHALAYA,SOUTH GARO HILLS,2021-02-27,0,3,0,3,
MEGHALAYA,SOUTH WEST GARO HILLS,2021-02-26,0,16,0,16,
MEGHALAYA,SOUTH WEST GARO HILLS,2021-02-27,0,1,0,1,
MEGHALAYA,SOUTH WEST GARO HILLS,2021-02-28,0,3,0,3,
MEGHALAYA,SOUTH WEST KHASI HILLS,2021-02-26,0,8,0,8,
MEGHALAYA,SOUTH WEST KHASI HILLS,2021-02-27,0,3,0,3,
MEGHALAYA,SOUTH WEST KHASI HILLS,2021-02-28,0,1,0,1,
MEGHALAYA,WEST GARO HILLS,2021-02-26,0,39,0,39,
MEGHALAYA,WEST GARO HILLS,2021-02-27,0,15,0,15,
MEGHALAYA,WEST GARO HILLS,2021-02-28,0,5,0,5,
MEGHALAYA,WEST JAINTIA HILLS,2021-02-26,0,79,0,79,
MEGHALAYA,WEST JAINTIA HILLS,2021-02-27,0,54,0,54,
MEGHALAYA,WEST JAINTIA HILLS,2021-02-28,0,34,0,34,
MEGHALAYA,WEST KHASI HILLS,2021-02-26,0,43,0,43,
MEGHALAYA,WEST KHASI HILLS,2021-02-27,0,43,0,43,
MEGHALAYA,WEST KHASI HILLS,2021-02-28,0,90,0,90,
MIZORAM,AIZAWL,2021-02-26,2,573,0,575,
MIZORAM,AIZAWL,2021-02-27,0,533,0,533,
MIZORAM,AIZAWL,2021-02-28,1,95,0,96,
MIZORAM,CHAMPHAI,2021-02-26,0,112,0,112,
MIZORAM,CHAMPHAI,2021-02-27,1,40,0,41,
MIZORAM,CHAMPHAI,2021-02-28,0,1,0,1,
MIZORAM,HNAHTHIAL,2021-02-26,0,7,0,7,
MIZORAM,HNAHTHIAL,2021-02-27,0,6,0,6,
MIZORAM,HNAHTHIAL,2021-02-28,0,15,0,15,
MIZORAM,KHAWZAWL,2021-02-26,0,8,0,8,
MIZORAM,KHAWZAWL,2021-02-27,0,4,0,4,
MIZORAM,KOLASIB,2021-02-26,0,42,0,42,
MIZORAM,KOLASIB,2021-02-27,0,63,0,63,
MIZORAM,KOLASIB,2021-02-28,0,184,0,184,
MIZORAM,LAWNGTLAI,2021-02-26,0,32,0,32,
MIZORAM,LAWNGTLAI,2021-02-27,0,12,0,12,
MIZORAM,LUNGLEI,2021-02-26,0,26,0,26,
MIZORAM,LUNGLEI,2021-02-27,0,18,0,18,
MIZORAM,MAMIT,2021-02-26,1,8,0,9,
MIZORAM,MAMIT,2021-02-27,0,113,0,113,
MIZORAM,MAMIT,2021-02-28,0,10,0,10,
MIZORAM,SAIHA,2021-02-26,0,12,0,12,
MIZORAM,SAIHA,2021-02-27,0,2,0,2,
MIZORAM,SAIHA,2021-02-28,0,10,0,10,
MIZORAM,SAITUAL,2021-02-26,0,41,0,41,
MIZORAM,SAITUAL,2021-02-27,0,111,0,111,
MIZORAM,SAITUAL,2021-02-28,0,1,0,1,
MIZORAM,SERCHHIP,2021-02-26,0,18,0,18,
MIZORAM,SERCHHIP,2021-02-27,0,2,0,2,
NAGALAND,DIMAPUR,2021-02-26,10,111,0,121,
NAGALAND,DIMAPUR,2021-02-27,2,75,0,77,
NAGALAND,DIMAPUR,2021-02-28,0,57,0,57,
NAGALAND,KOHIMA,2021-02-26,4,118,0,122,
NAGALAND,KOHIMA,2021-02-27,1,91,1,93,
NAGALAND,KOHIMA,2021-02-28,1,2,0,3,
NAGALAND,LONGLENG,2021-02-26,0,2,0,2,
NAGALAND,LONGLENG,2021-02-27,0,1,0,1,
NAGALAND,LONGLENG,2021-02-28,0,2,0,2,
NAGALAND,MOKOKCHUNG,2021-02-26,0,8,0,8,
NAGALAND,MOKOKCHUNG,2021-02-27,0,8,0,8,
NAGALAND,MOKOKCHUNG,2021-02-28,0,11,0,11,
NAGALAND,MON,2021-02-27,0,1,0,1,
NAGALAND,PEREN,2021-02-27,0,3,0,3,
NAGALAND,PHEK,2021-02-26,0,3,0,3,
NAGALAND,PHEK,2021-02-27,0,1,0,1,
NAGALAND,PHEK,2021-02-28,0,8,0,8,
NAGALAND,TUENSANG,2021-02-26,0,1,0,1,
NAGALAND,WOKHA,2021-02-26,0,2,0,2,
NAGALAND,WOKHA,2021-02-28,0,1,0,1,
ODISHA,ANUGUL,2021-02-26,2,531,0,533,
ODISHA,ANUGUL,2021-02-27,2,656,1,659,
ODISHA,ANUGUL,2021-02-28,1,343,0,344,
ODISHA,BALANGIR,2021-02-26,2,983,0,985,
ODISHA,BALANGIR,2021-02-27,8,917,0,925,
ODISHA,BALANGIR,2021-02-28,3,904,0,907,
ODISHA,BALESHWAR,2021-02-26,13,2168,0,2181,
ODISHA,BALESHWAR,2021-02-27,13,2654,1,2668,
ODISHA,BALESHWAR,2021-02-28,4,1681,0,1685,
ODISHA,BARGARH,2021-02-26,2,337,0,339,
ODISHA,BARGARH,2021-02-27,0,324,0,324,
ODISHA,BARGARH,2021-02-28,0,335,0,335,
ODISHA,BHADRAK,2021-02-26,1,781,8,790,
ODISHA,BHADRAK,2021-02-27,3,852,0,855,
ODISHA,BHADRAK,2021-02-28,1,790,0,791,
ODISHA,BOUDH,2021-02-26,0,198,0,198,
ODISHA,BOUDH,2021-02-27,0,204,1,205,
ODISHA,BOUDH,2021-02-28,0,253,0,253,
ODISHA,CUTTACK,2021-02-26,3,1467,2,1472,
ODISHA,CUTTACK,2021-02-27,12,1669,2,1683,
ODISHA,CUTTACK,2021-02-28,1,685,1,687,
ODISHA,DEOGARH,2021-02-26,0,158,0,158,
ODISHA,DEOGARH,2021-02-27,1,223,0,224,
ODISHA,DEOGARH,2021-02-28,3,89,0,92,
ODISHA,DHENKANAL,2021-02-26,0,833,0,833,
ODISHA,DHENKANAL,2021-02-27,0,355,0,355,
ODISHA,DHENKANAL,2021-02-28,0,326,0,326,
ODISHA,GAJAPATI,2021-02-26,0,305,0,305,
ODISHA,GAJAPATI,2021-02-27,0,148,0,148,
ODISHA,GAJAPATI,2021-02-28,1,228,0,229,
ODISHA,GANJAM,2021-02-26,2,921,6,929,
ODISHA,GANJAM,2021-02-27,0,955,11,966,
ODISHA,GANJAM,2021-02-28,0,388,0,388,
ODISHA,JAGATSINGHAPUR,2021-02-26,0,634,1,635,
ODISHA,JAGATSINGHAPUR,2021-02-27,1,527,0,528,
ODISHA,JAGATSINGHAPUR,2021-02-28,0,221,0,221,
ODISHA,JAJAPUR,2021-02-26,6,647,0,653,
ODISHA,JAJAPUR,2021-02-27,3,348,0,351,
ODISHA,JAJAPUR,2021-02-28,8,192,0,200,
ODISHA,JHARSUGUDA,2021-02-26,11,410,0,421,
ODISHA,JHARSUGUDA,2021-02-27,3,353,0,356,
ODISHA,JHARSUGUDA,2021-02-28,0,297,1,298,
ODISHA,KALAHANDI,2021-02-26,1,335,0,336,
ODISHA,KALAHANDI,2021-02-27,0,154,0,154,
ODISHA,KALAHANDI,2021-02-28,0,333,0,333,
ODISHA,KANDHAMAL,2021-02-26,2,588,0,590,
ODISHA,KANDHAMAL,2021-02-27,0,727,0,727,
ODISHA,KANDHAMAL,2021-02-28,0,606,0,606,
ODISHA,KENDRAPARA,2021-02-26,0,1205,0,1205,
ODISHA,KENDRAPARA,2021-02-27,3,1248,1,1252,
ODISHA,KENDRAPARA,2021-02-28,1,729,0,730,
ODISHA,KENDUJHAR,2021-02-26,0,685,0,685,
ODISHA,KENDUJHAR,2021-02-27,1,616,0,617,
ODISHA,KENDUJHAR,2021-02-28,1,528,0,529,
ODISHA,KHORDHA,2021-02-26,13,1889,0,1902,
ODISHA,KHORDHA,2021-02-27,7,1577,0,1584,
ODISHA,KHORDHA,2021-02-28,10,1041,2,1053,
ODISHA,KORAPUT,2021-02-26,1,1179,0,1180,
ODISHA,KORAPUT,2021-02-27,0,1246,0,1246,
ODISHA,KORAPUT,2021-02-28,0,1155,0,1155,
ODISHA,MALKANGIRI,2021-02-26,0,257,0,257,
ODISHA,MALKANGIRI,2021-02-27,0,218,0,218,
ODISHA,MALKANGIRI,2021-02-28,0,141,0,141,
ODISHA,MAYURBHANJ,2021-02-26,4,1426,0,1430,
ODISHA,MAYURBHANJ,2021-02-27,5,1443,0,1448,
ODISHA,MAYURBHANJ,2021-02-28,8,1121,0,1129,
ODISHA,NABARANGPUR,2021-02-26,2,1064,3,1069,
ODISHA,NABARANGPUR,2021-02-27,0,972,0,972,
ODISHA,NABARANGPUR,2021-02-28,1,507,0,508,
ODISHA,NAYAGARH,2021-02-26,0,1042,0,1042,
ODISHA,NAYAGARH,2021-02-27,0,502,1,503,
ODISHA,NAYAGARH,2021-02-28,0,386,0,386,
ODISHA,NUAPADA,2021-02-26,0,164,0,164,
ODISHA,NUAPADA,2021-02-27,1,121,0,122,
ODISHA,NUAPADA,2021-02-28,1,100,0,101,
ODISHA,PURI,2021-02-26,6,795,0,801,
ODISHA,PURI,2021-02-27,12,815,0,827,
ODISHA,PURI,2021-02-28,3,635,0,638,
ODISHA,RAYAGADA,2021-02-26,3,307,1,311,
ODISHA,RAYAGADA,2021-02-27,0,600,0,600,
ODISHA,RAYAGADA,2021-02-28,0,224,0,224,
ODISHA,SAMBALPUR,2021-02-26,35,498,0,533,
ODISHA,SAMBALPUR,2021-02-27,28,350,0,378,
ODISHA,SAMBALPUR,2021-02-28,9,375,0,384,
ODISHA,SONEPUR,2021-02-26,0,367,0,367,
ODISHA,SONEPUR,2021-02-27,0,179,0,179,
ODISHA,SONEPUR,2021-02-28,0,228,0,228,
ODISHA,SUNDARGARH,2021-02-26,9,604,0,613,
ODISHA,SUNDARGARH,2021-02-27,4,608,0,612,
ODISHA,SUNDARGARH,2021-02-28,0,172,0,172,
PUDUCHERRY,KARAIKAL,2021-02-26,4,352,1,357,
PUDUCHERRY,KARAIKAL,2021-02-27,5,303,0,308,
PUDUCHERRY,KARAIKAL,2021-02-28,3,189,1,193,
PUDUCHERRY,MAHE,2021-02-26,0,201,0,201,
PUDUCHERRY,MAHE,2021-02-27,0,32,0,32,
PUDUCHERRY,MAHE,2021-02-28,9,85,0,94,
PUDUCHERRY,PONDICHERRY,2021-02-26,11,328,2,341,
PUDUCHERRY,PONDICHERRY,2021-02-27,13,255,7,275,
PUDUCHERRY,PONDICHERRY,2021-02-28,12,177,5,194,
PUDUCHERRY,YANAM,2021-02-26,2,132,0,134,
PUDUCHERRY,YANAM,2021-02-27,0,52,0,52,
PUDUCHERRY,YANAM,2021-02-28,0,5,0,5,
PUNJAB,AMRITSAR,2021-02-26,58,1453,7,1518,
PUNJAB,AMRITSAR,2021-02-27,86,1230,46,1362,
PUNJAB,AMRITSAR,2021-02-28,35,1890,3,1928,
PUNJAB,BARNALA,2021-02-26,0,91,0,91,
PUNJAB,BARNALA,2021-02-27,1,138,5,144,
PUNJAB,BARNALA,2021-02-28,3,23,0,26,
PUNJAB,BATHINDA,2021-02-26,22,452,20,494,
PUNJAB,BATHINDA,2021-02-27,19,751,12,782,
PUNJAB,BATHINDA,2021-02-28,18,269,7,294,
PUNJAB,FARIDKOT,2021-02-26,4,352,0,356,
PUNJAB,FARIDKOT,2021-02-27,5,252,6,263,
PUNJAB,FARIDKOT,2021-02-28,9,207,1,217,
PUNJAB,FATEHGARH SAHIB,2021-02-26,19,460,2,481,
PUNJAB,FATEHGARH SAHIB,2021-02-27,4,691,0,695,
PUNJAB,FATEHGARH SAHIB,2021-02-28,17,83,1,101,
PUNJAB,FAZILKA,2021-02-26,4,327,0,331,
PUNJAB,FAZILKA,2021-02-27,2,801,0,803,
PUNJAB,FAZILKA,2021-02-28,3,223,1,227,
PUNJAB,FIROZEPUR,2021-02-26,6,372,0,378,
PUNJAB,FIROZEPUR,2021-02-27,5,708,1,714,
PUNJAB,FIROZEPUR,2021-02-28,6,492,0,498,
PUNJAB,GURDASPUR,2021-02-26,6,473,0,479,
PUNJAB,GURDASPUR,2021-02-27,24,300,0,324,
PUNJAB,GURDASPUR,2021-02-28,15,835,8,858,
PUNJAB,HOSHIARPUR,2021-02-26,83,883,1,967,
PUNJAB,HOSHIARPUR,2021-02-27,49,2083,164,2296,
PUNJAB,HOSHIARPUR,2021-02-28,64,498,2,564,
PUNJAB,JALANDHAR,2021-02-26,114,2973,8,3095,
PUNJAB,JALANDHAR,2021-02-27,105,1359,20,1484,
PUNJAB,JALANDHAR,2021-02-28,132,2148,127,2407,
PUNJAB,KAPURTHALA,2021-02-26,92,1328,13,1433,
PUNJAB,KAPURTHALA,2021-02-27,18,1007,3,1028,
PUNJAB,KAPURTHALA,2021-02-28,125,1212,11,1348,
PUNJAB,LUDHIANA,2021-02-26,65,3395,12,3472,
PUNJAB,LUDHIANA,2021-02-27,88,3582,17,3687,
PUNJAB,LUDHIANA,2021-02-28,102,2259,10,2371,
PUNJAB,MANSA,2021-02-26,2,570,0,572,
PUNJAB,MANSA,2021-02-27,2,841,0,843,
PUNJAB,MANSA,2021-02-28,2,327,1,330,
PUNJAB,MOGA,2021-02-26,7,123,0,130,
PUNJAB,MOGA,2021-02-27,16,165,0,181,
PUNJAB,MOGA,2021-02-28,24,528,10,562,
PUNJAB,PATHANKOT,2021-02-26,2,306,1,309,
PUNJAB,PATHANKOT,2021-02-27,3,165,0,168,
PUNJAB,PATHANKOT,2021-02-28,1,151,1,153,
PUNJAB,PATIALA,2021-02-26,52,2004,2,2058,
PUNJAB,PATIALA,2021-02-27,76,1525,1,1602,
PUNJAB,PATIALA,2021-02-28,68,768,1,837,
PUNJAB,RUPNAGAR,2021-02-26,9,865,3,877,
PUNJAB,RUPNAGAR,2021-02-27,28,1958,2,1988,
PUNJAB,RUPNAGAR,2021-02-28,10,694,5,709,
PUNJAB,S.A.S NAGAR,2021-02-26,87,1388,9,1484,
PUNJAB,S.A.S NAGAR,2021-02-27,80,1465,9,1554,
PUNJAB,S.A.S NAGAR,2021-02-28,103,1501,10,1614,
PUNJAB,SANGRUR,2021-02-26,40,1320,1,1361,
PUNJAB,SANGRUR,2021-02-27,10,971,0,981,
PUNJAB,SANGRUR,2021-02-28,12,983,0,995,
PUNJAB,SHAHID BHAGAT SINGH NAGAR,2021-02-26,87,981,3,1071,
PUNJAB,SHAHID BHAGAT SINGH NAGAR,2021-02-27,82,860,1,943,
PUNJAB,SHAHID BHAGAT SINGH NAGAR,2021-02-28,64,775,1,840,
PUNJAB,SRI MUKTSAR SAHIB,2021-02-26,3,554,0,557,
PUNJAB,SRI MUKTSAR SAHIB,2021-02-27,6,54,9,69,
PUNJAB,SRI MUKTSAR SAHIB,2021-02-28,1,408,1,410,
PUNJAB,TARN TARAN,2021-02-26,7,753,0,760,
PUNJAB,TARN TARAN,2021-02-27,3,493,1,497,
PUNJAB,TARN TARAN,2021-02-28,6,845,0,851,
RAJASTHAN,AJMER,2021-02-26,3,94,600,697,
RAJASTHAN,AJMER,2021-02-27,4,94,534,632,
RAJASTHAN,AJMER,2021-02-28,4,92,187,283,
RAJASTHAN,ALWAR,2021-02-26,4,2952,18,2974,
RAJASTHAN,ALWAR,2021-02-27,1,3431,89,3521,
RAJASTHAN,ALWAR,2021-02-28,5,3246,57,3308,
RAJASTHAN,BANSWARA,2021-02-26,0,37,1,38,
RAJASTHAN,BANSWARA,2021-02-27,3,88,0,91,
RAJASTHAN,BANSWARA,2021-02-28,6,61,0,67,
RAJASTHAN,BARAN,2021-02-26,2,202,0,204,
RAJASTHAN,BARAN,2021-02-27,0,84,0,84,
RAJASTHAN,BARAN,2021-02-28,0,156,0,156,
RAJASTHAN,BARMER,2021-02-26,0,199,0,199,
RAJASTHAN,BARMER,2021-02-27,0,193,1,194,
RAJASTHAN,BARMER,2021-02-28,1,130,0,131,
RAJASTHAN,BHARATPUR,2021-02-26,0,473,4,477,
RAJASTHAN,BHARATPUR,2021-02-27,1,370,4,375,
RAJASTHAN,BHARATPUR,2021-02-28,1,367,5,373,
RAJASTHAN,BHILWARA,2021-02-26,6,480,2,488,
RAJASTHAN,BHILWARA,2021-02-27,6,434,2,442,
RAJASTHAN,BHILWARA,2021-02-28,5,308,0,313,
RAJASTHAN,BIKANER,2021-02-26,1,981,1,983,
RAJASTHAN,BIKANER,2021-02-27,2,1037,0,1039,
RAJASTHAN,BIKANER,2021-02-28,0,934,0,934,
RAJASTHAN,BUNDI,2021-02-26,0,360,0,360,
RAJASTHAN,BUNDI,2021-02-27,0,170,0,170,
RAJASTHAN,BUNDI,2021-02-28,1,94,1,96,
RAJASTHAN,CHITTORGARH,2021-02-26,1,517,2,520,
RAJASTHAN,CHITTORGARH,2021-02-27,0,656,1,657,
RAJASTHAN,CHITTORGARH,2021-02-28,0,213,1,214,
RAJASTHAN,CHURU,2021-02-26,3,375,4,382,
RAJASTHAN,CHURU,2021-02-27,0,213,3,216,
RAJASTHAN,CHURU,2021-02-28,1,164,2,167,
RAJASTHAN,DAUSA,2021-02-26,1,334,12,347,
RAJASTHAN,DAUSA,2021-02-27,0,216,10,226,
RAJASTHAN,DAUSA,2021-02-28,0,232,5,237,
RAJASTHAN,DHOLPUR,2021-02-26,1,145,0,146,
RAJASTHAN,DHOLPUR,2021-02-27,2,99,0,101,
RAJASTHAN,DHOLPUR,2021-02-28,6,125,7,138,
RAJASTHAN,DUNGARPUR,2021-02-26,17,153,1,171,
RAJASTHAN,DUNGARPUR,2021-02-27,9,190,0,199,
RAJASTHAN,DUNGARPUR,2021-02-28,10,132,0,142,
RAJASTHAN,GANGANAGAR,2021-02-26,152,252,32,436,
RAJASTHAN,GANGANAGAR,2021-02-27,172,246,18,436,
RAJASTHAN,GANGANAGAR,2021-02-28,129,164,37,330,
RAJASTHAN,HANUMANGARH,2021-02-26,2,603,2,607,
RAJASTHAN,HANUMANGARH,2021-02-27,8,678,0,686,
RAJASTHAN,HANUMANGARH,2021-02-28,2,403,3,408,
RAJASTHAN,JAIPUR,2021-02-26,83,2428,320,2831,
RAJASTHAN,JAIPUR,2021-02-27,45,1990,329,2364,
RAJASTHAN,JAIPUR,2021-02-28,80,2100,413,2593,
RAJASTHAN,JAISALMER,2021-02-26,1,110,0,111,
RAJASTHAN,JAISALMER,2021-02-27,1,68,5,74,
RAJASTHAN,JAISALMER,2021-02-28,0,99,1,100,
RAJASTHAN,JALORE,2021-02-26,4,982,1,987,
RAJASTHAN,JALORE,2021-02-27,0,61,0,61,
RAJASTHAN,JALORE,2021-02-28,0,76,0,76,
RAJASTHAN,JHALAWAR,2021-02-26,0,129,0,129,
RAJASTHAN,JHALAWAR,2021-02-27,5,236,1,242,
RAJASTHAN,JHALAWAR,2021-02-28,0,276,0,276,
RAJASTHAN,JHUNJHUNU,2021-02-26,1,86,3,90,
RAJASTHAN,JHUNJHUNU,2021-02-27,0,59,4,63,
RAJASTHAN,JHUNJHUNU,2021-02-28,1,68,1,70,
RAJASTHAN,JODHPUR,2021-02-26,10,775,2,787,
RAJASTHAN,JODHPUR,2021-02-27,8,529,2,539,
RAJASTHAN,JODHPUR,2021-02-28,15,761,5,781,
RAJASTHAN,KARAULI,2021-02-26,0,28,1,29,
RAJASTHAN,KARAULI,2021-02-27,1,282,1,284,
RAJASTHAN,KARAULI,2021-02-28,2,107,3,112,
RAJASTHAN,KOTA,2021-02-26,48,882,0,930,
RAJASTHAN,KOTA,2021-02-27,1,920,0,921,
RAJASTHAN,KOTA,2021-02-28,45,696,0,741,
RAJASTHAN,NAGAUR,2021-02-26,0,59,117,176,
RAJASTHAN,NAGAUR,2021-02-27,0,200,212,412,
RAJASTHAN,NAGAUR,2021-02-28,2,131,41,174,
RAJASTHAN,PALI,2021-02-26,1,25,0,26,
RAJASTHAN,PALI,2021-02-27,3,199,3,205,
RAJASTHAN,PALI,2021-02-28,3,607,3,613,
RAJASTHAN,PRATAPGARH,2021-02-26,2,6,2,10,
RAJASTHAN,PRATAPGARH,2021-02-27,0,7,0,7,
RAJASTHAN,PRATAPGARH,2021-02-28,1,5,0,6,
RAJASTHAN,RAJSAMAND,2021-02-26,2,78,0,80,
RAJASTHAN,RAJSAMAND,2021-02-27,4,195,0,199,
RAJASTHAN,RAJSAMAND,2021-02-28,10,206,2,218,
RAJASTHAN,SAWAI MADHOPUR,2021-02-26,1,325,3,329,
RAJASTHAN,SAWAI MADHOPUR,2021-02-27,1,868,7,876,
RAJASTHAN,SAWAI MADHOPUR,2021-02-28,3,377,14,394,
RAJASTHAN,SIKAR,2021-02-26,2,333,12,347,
RAJASTHAN,SIKAR,2021-02-27,2,296,9,307,
RAJASTHAN,SIKAR,2021-02-28,0,308,5,313,
RAJASTHAN,SIROHI,2021-02-26,2,381,0,383,
RAJASTHAN,SIROHI,2021-02-27,1,310,1,312,
RAJASTHAN,SIROHI,2021-02-28,0,54,0,54,
RAJASTHAN,TONK,2021-02-26,0,185,6,191,
RAJASTHAN,TONK,2021-02-27,0,219,14,233,
RAJASTHAN,TONK,2021-02-28,1,15,1,17,
RAJASTHAN,UDAIPUR,2021-02-26,48,653,4,705,
RAJASTHAN,UDAIPUR,2021-02-27,46,840,4,890,
RAJASTHAN,UDAIPUR,2021-02-28,48,527,1,576,
SIKKIM,EAST DISTRICT,2021-02-26,2,114,0,116,
SIKKIM,EAST DISTRICT,2021-02-27,3,81,0,84,
SIKKIM,EAST DISTRICT,2021-02-28,0,5,0,5,
SIKKIM,NORTH DISTRICT,2021-02-26,0,2,0,2,
SIKKIM,NORTH DISTRICT,2021-02-28,0,2,0,2,
SIKKIM,SOUTH DISTRICT,2021-02-26,0,6,0,6,
SIKKIM,SOUTH DISTRICT,2021-02-27,5,52,0,57,
SIKKIM,SOUTH DISTRICT,2021-02-28,0,1,0,1,
SIKKIM,WEST DISTRICT,2021-02-26,0,4,0,4,
SIKKIM,WEST DISTRICT,2021-02-27,0,1,0,1,
SIKKIM,WEST DISTRICT,2021-02-28,0,4,0,4,
TAMIL NADU,ARIYALUR,2021-02-26,1,353,1,355,
TAMIL NADU,ARIYALUR,2021-02-27,0,286,0,286,
TAMIL NADU,ARIYALUR,2021-02-28,1,303,0,304,
TAMIL NADU,CHENGALPATTU,2021-02-26,32,3752,0,3784,
TAMIL NADU,CHENGALPATTU,2021-02-27,46,3144,0,3190,
TAMIL NADU,CHENGALPATTU,2021-02-28,18,2331,0,2349,
TAMIL NADU,CHENNAI,2021-02-26,225,11633,14,11872,
TAMIL NADU,CHENNAI,2021-02-27,222,10119,4,10345,
TAMIL NADU,CHENNAI,2021-02-28,198,9013,12,9223,
TAMIL NADU,COIMBATORE,2021-02-26,39,1686,3,1728,
TAMIL NADU,COIMBATORE,2021-02-27,49,1595,0,1644,
TAMIL NADU,COIMBATORE,2021-02-28,29,1417,0,1446,
TAMIL NADU,CUDDALORE,2021-02-26,5,1346,1,1352,
TAMIL NADU,CUDDALORE,2021-02-27,8,1032,2,1042,
TAMIL NADU,CUDDALORE,2021-02-28,15,614,0,629,
TAMIL NADU,DHARMAPURI,2021-02-26,0,725,1,726,
TAMIL NADU,DHARMAPURI,2021-02-27,0,602,1,603,
TAMIL NADU,DHARMAPURI,2021-02-28,3,441,0,444,
TAMIL NADU,DINDIGUL,2021-02-26,10,182,0,192,
TAMIL NADU,DINDIGUL,2021-02-27,11,375,0,386,
TAMIL NADU,DINDIGUL,2021-02-28,8,316,0,324,
TAMIL NADU,ERODE,2021-02-26,9,1106,0,1115,
TAMIL NADU,ERODE,2021-02-27,8,1004,0,1012,
TAMIL NADU,ERODE,2021-02-28,10,962,1,973,
TAMIL NADU,KALLAKURICHI,2021-02-26,2,305,0,307,
TAMIL NADU,KALLAKURICHI,2021-02-27,0,333,0,333,
TAMIL NADU,KALLAKURICHI,2021-02-28,0,265,1,266,
TAMIL NADU,KANCHIPURAM,2021-02-26,16,2466,0,2482,
TAMIL NADU,KANCHIPURAM,2021-02-27,15,1846,0,1861,
TAMIL NADU,KANCHIPURAM,2021-02-28,12,1499,2,1513,
TAMIL NADU,KANNIYAKUMARI,2021-02-26,5,1142,2,1149,
TAMIL NADU,KANNIYAKUMARI,2021-02-27,6,1646,2,1654,
TAMIL NADU,KANNIYAKUMARI,2021-02-28,10,745,1,756,
TAMIL NADU,KARUR,2021-02-26,4,929,0,933,
TAMIL NADU,KARUR,2021-02-27,3,843,0,846,
TAMIL NADU,KARUR,2021-02-28,1,1013,0,1014,
TAMIL NADU,KRISHNAGIRI,2021-02-26,5,725,3,733,
TAMIL NADU,KRISHNAGIRI,2021-02-27,7,531,3,541,
TAMIL NADU,KRISHNAGIRI,2021-02-28,2,288,0,290,
TAMIL NADU,MADURAI,2021-02-26,12,2833,1,2846,
TAMIL NADU,MADURAI,2021-02-27,7,2098,2,2107,
TAMIL NADU,MADURAI,2021-02-28,10,1544,0,1554,
TAMIL NADU,NAGAPATTINAM,2021-02-26,3,421,0,424,
TAMIL NADU,NAGAPATTINAM,2021-02-27,4,435,0,439,
TAMIL NADU,NAGAPATTINAM,2021-02-28,1,198,0,199,
TAMIL NADU,NAMAKKAL,2021-02-26,6,888,0,894,
TAMIL NADU,NAMAKKAL,2021-02-27,4,654,0,658,
TAMIL NADU,NAMAKKAL,2021-02-28,3,1516,10,1529,
TAMIL NADU,PERAMBALUR,2021-02-26,1,255,0,256,
TAMIL NADU,PERAMBALUR,2021-02-27,0,224,0,224,
TAMIL NADU,PERAMBALUR,2021-02-28,0,225,0,225,
TAMIL NADU,PUDUKKOTTAI,2021-02-26,1,549,1,551,
TAMIL NADU,PUDUKKOTTAI,2021-02-27,7,491,0,498,
TAMIL NADU,PUDUKKOTTAI,2021-02-28,2,505,0,507,
TAMIL NADU,RAMANATHAPURAM,2021-02-26,1,843,0,844,
TAMIL NADU,RAMANATHAPURAM,2021-02-27,3,810,0,813,
TAMIL NADU,RAMANATHAPURAM,2021-02-28,0,367,0,367,
TAMIL NADU,RANIPET,2021-02-26,3,258,0,261,
TAMIL NADU,RANIPET,2021-02-27,2,308,0,310,
TAMIL NADU,RANIPET,2021-02-28,3,231,0,234,
TAMIL NADU,SALEM,2021-02-26,6,247,2,255,
TAMIL NADU,SALEM,2021-02-27,7,571,7,585,
TAMIL NADU,SALEM,2021-02-28,5,285,6,296,
TAMIL NADU,SIVAGANGA,2021-02-26,2,458,0,460,
TAMIL NADU,SIVAGANGA,2021-02-27,8,515,0,523,
TAMIL NADU,SIVAGANGA,2021-02-28,5,305,0,310,
TAMIL NADU,TENKASI,2021-02-26,5,434,2,441,
TAMIL NADU,TENKASI,2021-02-27,2,415,3,420,
TAMIL NADU,TENKASI,2021-02-28,2,304,0,306,
TAMIL NADU,THANJAVUR,2021-02-26,25,464,0,489,
TAMIL NADU,THANJAVUR,2021-02-27,22,595,2,619,
TAMIL NADU,THANJAVUR,2021-02-28,15,441,2,458,
TAMIL NADU,THE NILGIRIS,2021-02-26,6,778,2,786,
TAMIL NADU,THE NILGIRIS,2021-02-27,7,937,36,980,
TAMIL NADU,THE NILGIRIS,2021-02-28,6,614,0,620,
TAMIL NADU,THENI,2021-02-26,3,465,0,468,
TAMIL NADU,THENI,2021-02-27,5,530,0,535,
TAMIL NADU,THENI,2021-02-28,6,443,0,449,
TAMIL NADU,THIRUVALLUR,2021-02-26,39,2120,10,2169,
TAMIL NADU,THIRUVALLUR,2021-02-27,30,1762,3,1795,
TAMIL NADU,THIRUVALLUR,2021-02-28,32,1335,3,1370,
TAMIL NADU,THIRUVARUR,2021-02-26,7,896,0,903,
TAMIL NADU,THIRUVARUR,2021-02-27,5,859,0,864,
TAMIL NADU,THIRUVARUR,2021-02-28,7,466,0,473,
TAMIL NADU,TIRUCHIRAPPALLI,2021-02-26,9,1446,0,1455,
TAMIL NADU,TIRUCHIRAPPALLI,2021-02-27,8,1409,2,1419,
TAMIL NADU,TIRUCHIRAPPALLI,2021-02-28,6,1228,0,1234,
TAMIL NADU,TIRUNELVELI,2021-02-26,6,881,1,888,
TAMIL NADU,TIRUNELVELI,2021-02-27,3,781,4,788,
TAMIL NADU,TIRUNELVELI,2021-02-28,2,317,1,320,
TAMIL NADU,TIRUPATHUR,2021-02-26,1,2022,0,2023,
TAMIL NADU,TIRUPATHUR,2021-02-27,2,2169,3,2174,
TAMIL NADU,TIRUPATHUR,2021-02-28,3,2006,0,2009,
TAMIL NADU,TIRUPPUR,2021-02-26,15,1401,1,1417,
TAMIL NADU,TIRUPPUR,2021-02-27,10,1779,1,1790,
TAMIL NADU,TIRUPPUR,2021-02-28,15,815,0,830,
TAMIL NADU,TIRUVANNAMALAI,2021-02-26,19,466,0,485,
TAMIL NADU,TIRUVANNAMALAI,2021-02-27,3,374,0,377,
TAMIL NADU,TIRUVANNAMALAI,2021-02-28,1,566,0,567,
TAMIL NADU,TUTICORIN,2021-02-26,1,768,1,770,
TAMIL NADU,TUTICORIN,2021-02-27,1,466,0,467,
TAMIL NADU,TUTICORIN,2021-02-28,1,316,1,318,
TAMIL NADU,VELLORE,2021-02-26,10,1506,1,1517,
TAMIL NADU,VELLORE,2021-02-27,10,1399,0,1409,
TAMIL NADU,VELLORE,2021-02-28,8,803,1,812,
TAMIL NADU,VILLUPURAM,2021-02-26,5,818,1,824,
TAMIL NADU,VILLUPURAM,2021-02-27,5,854,1,860,
TAMIL NADU,VILLUPURAM,2021-02-28,1,772,6,779,
TAMIL NADU,VIRUDHUNAGAR,2021-02-26,2,1461,1,1464,
TAMIL NADU,VIRUDHUNAGAR,2021-02-27,3,1406,3,1412,
TAMIL NADU,VIRUDHUNAGAR,2021-02-28,2,487,0,489,
TELANGANA,ADILABAD,2021-02-26,1,512,0,513,
TELANGANA,ADILABAD,2021-02-27,1,358,0,359,
TELANGANA,ADILABAD,2021-02-28,0,104,0,104,
TELANGANA,BHADRADRI KOTHAGUDEM,2021-02-26,0,359,0,359,
TELANGANA,BHADRADRI KOTHAGUDEM,2021-02-27,0,482,0,482,
TELANGANA,BHADRADRI KOTHAGUDEM,2021-02-28,0,130,0,130,
TELANGANA,HYDERABAD,2021-02-26,33,7960,2,7995,
TELANGANA,HYDERABAD,2021-02-27,20,8060,5,8085,
TELANGANA,HYDERABAD,2021-02-28,14,3711,4,3729,
TELANGANA,JAGITIAL,2021-02-26,0,1040,0,1040,
TELANGANA,JAGITIAL,2021-02-27,0,900,0,900,
TELANGANA,JAGITIAL,2021-02-28,0,369,0,369,
TELANGANA,JANGOAN,2021-02-26,0,719,0,719,
TELANGANA,JANGOAN,2021-02-27,0,635,0,635,
TELANGANA,JANGOAN,2021-02-28,0,299,0,299,
TELANGANA,JAYASHANKAR BHUPALAPALLY,2021-02-26,0,256,0,256,
TELANGANA,JAYASHANKAR BHUPALAPALLY,2021-02-27,0,399,0,399,
TELANGANA,JAYASHANKAR BHUPALAPALLY,2021-02-28,0,104,0,104,
TELANGANA,JOGULAMBA GADWAL,2021-02-26,0,626,0,626,
TELANGANA,JOGULAMBA GADWAL,2021-02-27,0,400,0,400,
TELANGANA,JOGULAMBA GADWAL,2021-02-28,0,540,0,540,
TELANGANA,KAMAREDDY,2021-02-26,0,624,0,624,
TELANGANA,KAMAREDDY,2021-02-27,1,564,0,565,
TELANGANA,KAMAREDDY,2021-02-28,0,20,0,20,
TELANGANA,KARIMNAGAR,2021-02-26,2,1424,0,1426,
TELANGANA,KARIMNAGAR,2021-02-27,0,1445,1,1446,
TELANGANA,KARIMNAGAR,2021-02-28,0,479,0,479,
TELANGANA,KHAMMAM,2021-02-26,0,538,0,538,
TELANGANA,KHAMMAM,2021-02-27,0,852,0,852,
TELANGANA,KHAMMAM,2021-02-28,0,133,0,133,
TELANGANA,KUMURAM BHEEM ASIFABAD,2021-02-26,0,275,0,275,
TELANGANA,KUMURAM BHEEM ASIFABAD,2021-02-27,0,292,0,292,
TELANGANA,KUMURAM BHEEM ASIFABAD,2021-02-28,0,178,0,178,
TELANGANA,MAHABUBABAD,2021-02-26,0,583,0,583,
TELANGANA,MAHABUBABAD,2021-02-27,0,478,0,478,
TELANGANA,MAHABUBABAD,2021-02-28,0,423,0,423,
TELANGANA,MAHABUBNAGAR,2021-02-26,0,777,0,777,
TELANGANA,MAHABUBNAGAR,2021-02-27,0,710,0,710,
TELANGANA,MAHABUBNAGAR,2021-02-28,0,222,0,222,
TELANGANA,MANCHERIAL,2021-02-26,0,915,0,915,
TELANGANA,MANCHERIAL,2021-02-27,0,935,0,935,
TELANGANA,MANCHERIAL,2021-02-28,0,502,0,502,
TELANGANA,MEDAK,2021-02-26,2,569,0,571,
TELANGANA,MEDAK,2021-02-27,2,572,0,574,
TELANGANA,MEDAK,2021-02-28,1,142,0,143,
TELANGANA,MEDCHAL MALKAJGIRI,2021-02-26,0,2045,0,2045,
TELANGANA,MEDCHAL MALKAJGIRI,2021-02-27,10,1932,1,1943,
TELANGANA,MEDCHAL MALKAJGIRI,2021-02-28,0,498,0,498,
TELANGANA,MULUGU,2021-02-26,0,170,0,170,
TELANGANA,MULUGU,2021-02-27,0,223,0,223,
TELANGANA,MULUGU,2021-02-28,0,68,0,68,
TELANGANA,NAGARKURNOOL,2021-02-26,0,1761,0,1761,
TELANGANA,NAGARKURNOOL,2021-02-27,0,1725,0,1725,
TELANGANA,NAGARKURNOOL,2021-02-28,0,1062,0,1062,
TELANGANA,NALGONDA,2021-02-26,0,1432,0,1432,
TELANGANA,NALGONDA,2021-02-27,1,1488,0,1489,
TELANGANA,NALGONDA,2021-02-28,0,66,0,66,
TELANGANA,NARAYANPET,2021-02-26,0,389,0,389,
TELANGANA,NARAYANPET,2021-02-27,0,217,0,217,
TELANGANA,NARAYANPET,2021-02-28,0,40,0,40,
TELANGANA,NIRMAL,2021-02-26,0,546,0,546,
TELANGANA,NIRMAL,2021-02-27,0,584,0,584,
TELANGANA,NIRMAL,2021-02-28,0,190,0,190,
TELANGANA,NIZAMABAD,2021-02-26,1,695,0,696,
TELANGANA,NIZAMABAD,2021-02-27,0,734,0,734,
TELANGANA,NIZAMABAD,2021-02-28,0,121,0,121,
TELANGANA,PEDDAPALLI,2021-02-26,0,1160,0,1160,
TELANGANA,PEDDAPALLI,2021-02-27,0,1146,0,1146,
TELANGANA,PEDDAPALLI,2021-02-28,0,207,0,207,
TELANGANA,RAJANNA SIRCILLA,2021-02-26,0,387,0,387,
TELANGANA,RAJANNA SIRCILLA,2021-02-27,0,373,0,373,
TELANGANA,RAJANNA SIRCILLA,2021-02-28,0,61,0,61,
TELANGANA,RANGA REDDY,2021-02-26,3,2986,3,2992,
TELANGANA,RANGA REDDY,2021-02-27,2,2673,3,2678,
TELANGANA,RANGA REDDY,2021-02-28,2,1057,1,1060,
TELANGANA,SANGAREDDY,2021-02-26,0,796,0,796,
TELANGANA,SANGAREDDY,2021-02-27,1,1035,0,1036,
TELANGANA,SANGAREDDY,2021-02-28,0,436,0,436,
TELANGANA,SIDDIPET,2021-02-26,0,1492,0,1492,
TELANGANA,SIDDIPET,2021-02-27,0,1863,0,1863,
TELANGANA,SIDDIPET,2021-02-28,1,757,0,758,
TELANGANA,SURYAPET,2021-02-26,0,827,0,827,
TELANGANA,SURYAPET,2021-02-27,0,871,0,871,
TELANGANA,SURYAPET,2021-02-28,0,285,0,285,
TELANGANA,VIKARABAD,2021-02-26,0,736,0,736,
TELANGANA,VIKARABAD,2021-02-27,0,612,0,612,
TELANGANA,VIKARABAD,2021-02-28,0,166,0,166,
TELANGANA,WANAPARTHY,2021-02-26,0,382,0,382,
TELANGANA,WANAPARTHY,2021-02-27,0,368,0,368,
TELANGANA,WANAPARTHY,2021-02-28,0,145,0,145,
TELANGANA,WARANGAL RURAL,2021-02-26,0,385,0,385,
TELANGANA,WARANGAL RURAL,2021-02-27,4,422,0,426,
TELANGANA,WARANGAL RURAL,2021-02-28,0,67,0,67,
TELANGANA,WARANGAL URBAN,2021-02-26,0,1975,0,1975,
TELANGANA,WARANGAL URBAN,2021-02-27,0,2123,0,2123,
TELANGANA,WARANGAL URBAN,2021-02-28,1,789,0,790,
TELANGANA,YADADRI BHUVANAGIRI,2021-02-26,0,490,0,490,
TELANGANA,YADADRI BHUVANAGIRI,2021-02-27,0,299,0,299,
TELANGANA,YADADRI BHUVANAGIRI,2021-02-28,0,22,0,22,
TRIPURA,DHALAI,2021-02-26,0,18,0,18,
TRIPURA,DHALAI,2021-02-27,0,3,0,3,
TRIPURA,DHALAI,2021-02-28,0,3,0,3,
TRIPURA,GOMATI,2021-02-26,0,37,0,37,
TRIPURA,GOMATI,2021-02-27,1,28,0,29,
TRIPURA,GOMATI,2021-02-28,0,9,0,9,
TRIPURA,KHOWAI,2021-02-26,0,29,0,29,
TRIPURA,KHOWAI,2021-02-27,0,15,0,15,
TRIPURA,KHOWAI,2021-02-28,0,12,0,12,
TRIPURA,NORTH TRIPURA,2021-02-26,0,70,0,70,
TRIPURA,NORTH TRIPURA,2021-02-27,0,122,0,122,
TRIPURA,NORTH TRIPURA,2021-02-28,0,38,0,38,
TRIPURA,SEPAHIJALA,2021-02-26,0,38,0,38,
TRIPURA,SEPAHIJALA,2021-02-27,3,32,0,35,
TRIPURA,SEPAHIJALA,2021-02-28,0,26,0,26,
TRIPURA,SOUTH TRIPURA,2021-02-26,0,43,0,43,
TRIPURA,SOUTH TRIPURA,2021-02-27,1,59,0,60,
TRIPURA,SOUTH TRIPURA,2021-02-28,0,41,0,41,
TRIPURA,UNAKOTI,2021-02-26,0,6,0,6,
TRIPURA,UNAKOTI,2021-02-27,0,13,0,13,
TRIPURA,UNAKOTI,2021-02-28,0,1,0,1,
TRIPURA,WEST TRIPURA,2021-02-26,0,263,0,263,
TRIPURA,WEST TRIPURA,2021-02-27,7,162,0,169,
TRIPURA,WEST TRIPURA,2021-02-28,1,108,0,109,
UTTAR PRADESH,AGRA,2021-02-26,5,1362,7,1374,
UTTAR PRADESH,AGRA,2021-02-27,6,2232,2,2240,
UTTAR PRADESH,AGRA,2021-02-28,7,3128,1,3136,
UTTAR PRADESH,ALIGARH,2021-02-26,1,2987,4,2992,
UTTAR PRADESH,ALIGARH,2021-02-27,4,1821,9,1834,
UTTAR PRADESH,ALIGARH,2021-02-28,3,1985,1,1989,
UTTAR PRADESH,AMBEDKAR NAGAR,2021-02-26,0,1186,18,1204,
UTTAR PRADESH,AMBEDKAR NAGAR,2021-02-27,0,1068,25,1093,
UTTAR PRADESH,AMBEDKAR NAGAR,2021-02-28,1,704,2,707,
UTTAR PRADESH,AMETHI,2021-02-26,0,515,1,516,
UTTAR PRADESH,AMETHI,2021-02-27,1,1440,1,1442,
UTTAR PRADESH,AMETHI,2021-02-28,0,843,0,843,
UTTAR PRADESH,AMROHA,2021-02-26,0,776,0,776,
UTTAR PRADESH,AMROHA,2021-02-27,0,806,1,807,
UTTAR PRADESH,AMROHA,2021-02-28,1,441,0,442,
UTTAR PRADESH,AURAIYA,2021-02-26,0,1097,105,1202,
UTTAR PRADESH,AURAIYA,2021-02-27,1,672,82,755,
UTTAR PRADESH,AURAIYA,2021-02-28,0,707,40,747,
UTTAR PRADESH,AYODHYA,2021-02-26,1,919,1,921,
UTTAR PRADESH,AYODHYA,2021-02-27,6,1403,1,1410,
UTTAR PRADESH,AYODHYA,2021-02-28,6,1056,1,1063,
UTTAR PRADESH,AZAMGARH,2021-02-26,0,782,3,785,
UTTAR PRADESH,AZAMGARH,2021-02-27,0,751,15,766,
UTTAR PRADESH,AZAMGARH,2021-02-28,0,1324,9,1333,
UTTAR PRADESH,BAGHPAT,2021-02-26,1,1226,25,1252,
UTTAR PRADESH,BAGHPAT,2021-02-27,1,1241,40,1282,
UTTAR PRADESH,BAGHPAT,2021-02-28,0,1013,34,1047,
UTTAR PRADESH,BAHRAICH,2021-02-26,0,1493,46,1539,
UTTAR PRADESH,BAHRAICH,2021-02-27,0,1566,12,1578,
UTTAR PRADESH,BAHRAICH,2021-02-28,1,1800,36,1837,
UTTAR PRADESH,BALLIA,2021-02-26,2,3238,22,3262,
UTTAR PRADESH,BALLIA,2021-02-27,3,2152,11,2166,
UTTAR PRADESH,BALLIA,2021-02-28,3,1216,4,1223,
UTTAR PRADESH,BALRAMPUR,2021-02-26,0,783,0,783,
UTTAR PRADESH,BALRAMPUR,2021-02-27,0,767,0,767,
UTTAR PRADESH,BALRAMPUR,2021-02-28,0,810,0,810,
UTTAR PRADESH,BANDA,2021-02-26,2,1999,25,2026,
UTTAR PRADESH,BANDA,2021-02-27,0,1603,0,1603,
UTTAR PRADESH,BANDA,2021-02-28,0,1691,0,1691,
UTTAR PRADESH,BARABANKI,2021-02-26,1,2117,12,2130,
UTTAR PRADESH,BARABANKI,2021-02-27,0,1168,0,1168,
UTTAR PRADESH,BARABANKI,2021-02-28,0,1088,1,1089,
UTTAR PRADESH,BAREILLY,2021-02-26,0,2258,2,2260,
UTTAR PRADESH,BAREILLY,2021-02-27,3,2214,1,2218,
UTTAR PRADESH,BAREILLY,2021-02-28,4,706,5,715,
UTTAR PRADESH,BASTI,2021-02-26,0,536,42,578,
UTTAR PRADESH,BASTI,2021-02-27,1,992,0,993,
UTTAR PRADESH,BASTI,2021-02-28,4,1356,4,1364,
UTTAR PRADESH,BHADOHI,2021-02-26,0,1409,10,1419,
UTTAR PRADESH,BHADOHI,2021-02-27,3,1424,11,1438,
UTTAR PRADESH,BHADOHI,2021-02-28,0,1159,0,1159,
UTTAR PRADESH,BIJNOR,2021-02-26,5,1547,0,1552,
UTTAR PRADESH,BIJNOR,2021-02-27,3,1380,1,1384,
UTTAR PRADESH,BIJNOR,2021-02-28,1,950,0,951,
UTTAR PRADESH,BUDAUN,2021-02-26,1,1592,25,1618,
UTTAR PRADESH,BUDAUN,2021-02-27,0,725,61,786,
UTTAR PRADESH,BUDAUN,2021-02-28,0,390,48,438,
UTTAR PRADESH,BULANDSHAHR,2021-02-26,0,673,40,713,
UTTAR PRADESH,BULANDSHAHR,2021-02-27,0,438,0,438,
UTTAR PRADESH,BULANDSHAHR,2021-02-28,1,489,16,506,
UTTAR PRADESH,CHANDAULI,2021-02-26,1,1005,0,1006,
UTTAR PRADESH,CHANDAULI,2021-02-27,1,695,8,704,
UTTAR PRADESH,CHANDAULI,2021-02-28,0,572,18,590,
UTTAR PRADESH,CHITRAKOOT,2021-02-26,0,754,11,765,
UTTAR PRADESH,CHITRAKOOT,2021-02-27,0,882,10,892,
UTTAR PRADESH,CHITRAKOOT,2021-02-28,0,631,0,631,
UTTAR PRADESH,DEORIA,2021-02-26,2,1370,34,1406,
UTTAR PRADESH,DEORIA,2021-02-27,0,729,57,786,
UTTAR PRADESH,DEORIA,2021-02-28,1,305,13,319,
UTTAR PRADESH,ETAH,2021-02-26,0,825,4,829,
UTTAR PRADESH,ETAH,2021-02-27,0,1149,1,1150,
UTTAR PRADESH,ETAH,2021-02-28,0,626,82,708,
UTTAR PRADESH,ETAWAH,2021-02-26,0,1070,149,1219,
UTTAR PRADESH,ETAWAH,2021-02-27,0,1473,65,1538,
UTTAR PRADESH,ETAWAH,2021-02-28,2,1098,150,1250,
UTTAR PRADESH,FARRUKHABAD,2021-02-26,4,484,0,488,
UTTAR PRADESH,FARRUKHABAD,2021-02-27,0,730,80,810,
UTTAR PRADESH,FARRUKHABAD,2021-02-28,0,412,59,471,
UTTAR PRADESH,FATEHPUR,2021-02-26,1,1700,33,1734,
UTTAR PRADESH,FATEHPUR,2021-02-27,1,992,96,1089,
UTTAR PRADESH,FATEHPUR,2021-02-28,0,1073,48,1121,
UTTAR PRADESH,FIROZABAD,2021-02-26,8,2386,3,2397,
UTTAR PRADESH,FIROZABAD,2021-02-27,0,2577,5,2582,
UTTAR PRADESH,FIROZABAD,2021-02-28,0,2115,0,2115,
UTTAR PRADESH,GAUTAM BUDDHA NAGAR,2021-02-26,37,2750,72,2859,
UTTAR PRADESH,GAUTAM BUDDHA NAGAR,2021-02-27,34,1499,14,1547,
UTTAR PRADESH,GAUTAM BUDDHA NAGAR,2021-02-28,38,2294,23,2355,
UTTAR PRADESH,GHAZIABAD,2021-02-26,18,2200,121,2339,
UTTAR PRADESH,GHAZIABAD,2021-02-27,30,3052,49,3131,
UTTAR PRADESH,GHAZIABAD,2021-02-28,25,1158,25,1208,
UTTAR PRADESH,GHAZIPUR,2021-02-26,1,612,0,613,
UTTAR PRADESH,GHAZIPUR,2021-02-27,1,553,13,567,
UTTAR PRADESH,GHAZIPUR,2021-02-28,2,366,10,378,
UTTAR PRADESH,GONDA,2021-02-26,0,1310,1,1311,
UTTAR PRADESH,GONDA,2021-02-27,0,1416,0,1416,
UTTAR PRADESH,GONDA,2021-02-28,0,1089,1,1090,
UTTAR PRADESH,GORAKHPUR,2021-02-26,0,2603,30,2633,
UTTAR PRADESH,GORAKHPUR,2021-02-27,2,1946,43,1991,
UTTAR PRADESH,GORAKHPUR,2021-02-28,5,2106,116,2227,
UTTAR PRADESH,HAMIRPUR,2021-02-26,0,452,53,505,
UTTAR PRADESH,HAMIRPUR,2021-02-27,0,1231,80,1311,
UTTAR PRADESH,HAMIRPUR,2021-02-28,0,731,23,754,
UTTAR PRADESH,HAPUR,2021-02-26,1,981,66,1048,
UTTAR PRADESH,HAPUR,2021-02-27,0,1999,31,2030,
UTTAR PRADESH,HAPUR,2021-02-28,0,995,25,1020,
UTTAR PRADESH,HARDOI,2021-02-26,1,1154,8,1163,
UTTAR PRADESH,HARDOI,2021-02-27,2,983,3,988,
UTTAR PRADESH,HARDOI,2021-02-28,0,1064,4,1068,
UTTAR PRADESH,HATHRAS,2021-02-26,0,964,0,964,
UTTAR PRADESH,HATHRAS,2021-02-27,0,1524,0,1524,
UTTAR PRADESH,HATHRAS,2021-02-28,0,1066,0,1066,
UTTAR PRADESH,JALAUN,2021-02-26,1,784,0,785,
UTTAR PRADESH,JALAUN,2021-02-27,0,688,0,688,
UTTAR PRADESH,JALAUN,2021-02-28,4,569,2,575,
UTTAR PRADESH,JAUNPUR,2021-02-26,2,727,0,729,
UTTAR PRADESH,JAUNPUR,2021-02-27,0,1171,1,1172,
UTTAR PRADESH,JAUNPUR,2021-02-28,0,2628,23,2651,
UTTAR PRADESH,JHANSI,2021-02-26,5,2177,1,2183,
UTTAR PRADESH,JHANSI,2021-02-27,2,2984,0,2986,
UTTAR PRADESH,JHANSI,2021-02-28,2,2823,0,2825,
UTTAR PRADESH,KANNAUJ,2021-02-26,0,1248,61,1309,
UTTAR PRADESH,KANNAUJ,2021-02-27,0,1512,2,1514,
UTTAR PRADESH,KANNAUJ,2021-02-28,0,1280,0,1280,
UTTAR PRADESH,KANPUR DEHAT,2021-02-26,0,1501,0,1501,
UTTAR PRADESH,KANPUR DEHAT,2021-02-27,0,1523,0,1523,
UTTAR PRADESH,KANPUR DEHAT,2021-02-28,0,1070,0,1070,
UTTAR PRADESH,KANPUR NAGAR,2021-02-26,3,2165,12,2180,
UTTAR PRADESH,KANPUR NAGAR,2021-02-27,2,2409,20,2431,
UTTAR PRADESH,KANPUR NAGAR,2021-02-28,5,2432,5,2442,
UTTAR PRADESH,KASGANJ,2021-02-26,0,756,49,805,
UTTAR PRADESH,KASGANJ,2021-02-27,0,3011,7,3018,
UTTAR PRADESH,KASGANJ,2021-02-28,0,868,5,873,
UTTAR PRADESH,KAUSHAMBI,2021-02-26,0,1773,0,1773,
UTTAR PRADESH,KAUSHAMBI,2021-02-27,0,1203,0,1203,
UTTAR PRADESH,KAUSHAMBI,2021-02-28,0,1776,0,1776,
UTTAR PRADESH,KHERI,2021-02-26,1,2078,39,2118,
UTTAR PRADESH,KHERI,2021-02-27,1,1985,2,1988,
UTTAR PRADESH,KHERI,2021-02-28,0,1790,76,1866,
UTTAR PRADESH,KUSHI NAGAR,2021-02-26,3,577,1,581,
UTTAR PRADESH,KUSHI NAGAR,2021-02-27,0,1127,13,1140,
UTTAR PRADESH,KUSHI NAGAR,2021-02-28,2,405,9,416,
UTTAR PRADESH,LALITPUR,2021-02-26,1,1305,2,1308,
UTTAR PRADESH,LALITPUR,2021-02-27,0,1526,4,1530,
UTTAR PRADESH,LALITPUR,2021-02-28,0,1249,1,1250,
UTTAR PRADESH,LUCKNOW,2021-02-26,18,6829,240,7087,
UTTAR PRADESH,LUCKNOW,2021-02-27,15,6865,96,6976,
UTTAR PRADESH,LUCKNOW,2021-02-28,14,6301,111,6426,
UTTAR PRADESH,MAHARAJGANJ,2021-02-26,0,547,144,691,
UTTAR PRADESH,MAHARAJGANJ,2021-02-27,0,664,78,742,
UTTAR PRADESH,MAHARAJGANJ,2021-02-28,0,767,62,829,
UTTAR PRADESH,MAHOBA,2021-02-26,0,449,15,464,
UTTAR PRADESH,MAHOBA,2021-02-27,0,445,40,485,
UTTAR PRADESH,MAHOBA,2021-02-28,0,469,6,475,
UTTAR PRADESH,MAINPURI,2021-02-26,0,1499,5,1504,
UTTAR PRADESH,MAINPURI,2021-02-27,0,1551,0,1551,
UTTAR PRADESH,MAINPURI,2021-02-28,0,1525,2,1527,
UTTAR PRADESH,MATHURA,2021-02-26,2,5980,29,6011,
UTTAR PRADESH,MATHURA,2021-02-27,2,2010,4,2016,
UTTAR PRADESH,MATHURA,2021-02-28,4,5086,23,5113,
UTTAR PRADESH,MAU,2021-02-26,0,1320,0,1320,
UTTAR PRADESH,MAU,2021-02-27,0,956,3,959,
UTTAR PRADESH,MAU,2021-02-28,0,1051,34,1085,
UTTAR PRADESH,MEERUT,2021-02-26,8,3244,14,3266,
UTTAR PRADESH,MEERUT,2021-02-27,5,3172,3,3180,
UTTAR PRADESH,MEERUT,2021-02-28,2,2694,1,2697,
UTTAR PRADESH,MIRZAPUR,2021-02-26,1,1161,0,1162,
UTTAR PRADESH,MIRZAPUR,2021-02-27,0,1424,9,1433,
UTTAR PRADESH,MIRZAPUR,2021-02-28,0,1549,0,1549,
UTTAR PRADESH,MORADABAD,2021-02-26,0,2032,0,2032,
UTTAR PRADESH,MORADABAD,2021-02-27,1,1587,0,1588,
UTTAR PRADESH,MORADABAD,2021-02-28,1,1903,48,1952,
UTTAR PRADESH,MUZAFFARNAGAR,2021-02-26,1,1232,0,1233,
UTTAR PRADESH,MUZAFFARNAGAR,2021-02-27,0,840,0,840,
UTTAR PRADESH,MUZAFFARNAGAR,2021-02-28,2,973,0,975,
UTTAR PRADESH,PILIBHIT,2021-02-26,0,1168,0,1168,
UTTAR PRADESH,PILIBHIT,2021-02-27,0,1292,38,1330,
UTTAR PRADESH,PILIBHIT,2021-02-28,1,1097,0,1098,
UTTAR PRADESH,PRATAPGARH,2021-02-26,0,1452,74,1526,
UTTAR PRADESH,PRATAPGARH,2021-02-27,0,1590,37,1627,
UTTAR PRADESH,PRATAPGARH,2021-02-28,0,1454,43,1497,
UTTAR PRADESH,PRAYAGRAJ,2021-02-26,3,2621,0,2624,
UTTAR PRADESH,PRAYAGRAJ,2021-02-27,0,5761,1,5762,
UTTAR PRADESH,PRAYAGRAJ,2021-02-28,7,7843,0,7850,
UTTAR PRADESH,RAE BARELI,2021-02-26,1,1387,0,1388,
UTTAR PRADESH,RAE BARELI,2021-02-27,1,2573,7,2581,
UTTAR PRADESH,RAE BARELI,2021-02-28,2,1712,5,1719,
UTTAR PRADESH,RAMPUR,2021-02-26,0,1209,18,1227,
UTTAR PRADESH,RAMPUR,2021-02-27,0,1308,10,1318,
UTTAR PRADESH,RAMPUR,2021-02-28,0,1379,58,1437,
UTTAR PRADESH,SAHARANPUR,2021-02-26,2,2281,66,2349,
UTTAR PRADESH,SAHARANPUR,2021-02-27,3,1598,6,1607,
UTTAR PRADESH,SAHARANPUR,2021-02-28,1,1710,126,1837,
UTTAR PRADESH,SAMBHAL,2021-02-26,0,2719,72,2791,
UTTAR PRADESH,SAMBHAL,2021-02-27,0,1353,61,1414,
UTTAR PRADESH,SAMBHAL,2021-02-28,0,1096,0,1096,
UTTAR PRADESH,SANT KABEER NAGAR,2021-02-26,1,1427,0,1428,
UTTAR PRADESH,SANT KABEER NAGAR,2021-02-27,4,1610,0,1614,
UTTAR PRADESH,SANT KABEER NAGAR,2021-02-28,0,1206,1,1207,
UTTAR PRADESH,SHAHJAHANPUR,2021-02-26,1,2541,100,2642,
UTTAR PRADESH,SHAHJAHANPUR,2021-02-27,2,1453,10,1465,
UTTAR PRADESH,SHAHJAHANPUR,2021-02-28,0,1172,6,1178,
UTTAR PRADESH,SHAMLI,2021-02-26,2,1313,0,1315,
UTTAR PRADESH,SHAMLI,2021-02-27,1,1195,2,1198,
UTTAR PRADESH,SHAMLI,2021-02-28,1,2029,1,2031,
UTTAR PRADESH,SHRAVASTI,2021-02-26,0,741,0,741,
UTTAR PRADESH,SHRAVASTI,2021-02-27,0,631,0,631,
UTTAR PRADESH,SHRAVASTI,2021-02-28,0,647,30,677,
UTTAR PRADESH,SIDDHARTH NAGAR,2021-02-26,1,895,28,924,
UTTAR PRADESH,SIDDHARTH NAGAR,2021-02-27,0,772,45,817,
UTTAR PRADESH,SIDDHARTH NAGAR,2021-02-28,0,838,75,913,
UTTAR PRADESH,SITAPUR,2021-02-26,3,1648,9,1660,
UTTAR PRADESH,SITAPUR,2021-02-27,1,1449,15,1465,
UTTAR PRADESH,SITAPUR,2021-02-28,1,1214,20,1235,
UTTAR PRADESH,SONBHADRA,2021-02-26,1,1556,31,1588,
UTTAR PRADESH,SONBHADRA,2021-02-27,0,1435,4,1439,
UTTAR PRADESH,SONBHADRA,2021-02-28,3,1436,29,1468,
UTTAR PRADESH,SULTANPUR,2021-02-26,1,2364,11,2376,
UTTAR PRADESH,SULTANPUR,2021-02-27,2,1374,9,1385,
UTTAR PRADESH,SULTANPUR,2021-02-28,0,1064,11,1075,
UTTAR PRADESH,UNNAO,2021-02-26,2,1330,2,1334,
UTTAR PRADESH,UNNAO,2021-02-27,3,934,53,990,
UTTAR PRADESH,UNNAO,2021-02-28,1,2418,37,2456,
UTTAR PRADESH,VARANASI,2021-02-26,6,2353,0,2359,
UTTAR PRADESH,VARANASI,2021-02-27,8,3144,92,3244,
UTTAR PRADESH,VARANASI,2021-02-28,2,2397,0,2399,
UTTARAKHAND,ALMORA,2021-02-26,0,98,0,98,
UTTARAKHAND,ALMORA,2021-02-27,0,99,0,99,
UTTARAKHAND,ALMORA,2021-02-28,1,8,1,10,
UTTARAKHAND,BAGESHWAR,2021-02-26,0,145,0,145,
UTTARAKHAND,BAGESHWAR,2021-02-27,0,384,2,386,
UTTARAKHAND,BAGESHWAR,2021-02-28,0,119,0,119,
UTTARAKHAND,CHAMOLI,2021-02-26,0,798,12,810,
UTTARAKHAND,CHAMOLI,2021-02-27,0,635,4,639,
UTTARAKHAND,CHAMOLI,2021-02-28,0,123,0,123,
UTTARAKHAND,CHAMPAWAT,2021-02-26,0,151,0,151,
UTTARAKHAND,CHAMPAWAT,2021-02-27,0,89,0,89,
UTTARAKHAND,CHAMPAWAT,2021-02-28,1,5,0,6,
UTTARAKHAND,DEHRADUN,2021-02-26,51,2130,11,2192,
UTTARAKHAND,DEHRADUN,2021-02-27,19,1827,9,1855,
UTTARAKHAND,DEHRADUN,2021-02-28,17,2089,1,2107,
UTTARAKHAND,HARIDWAR,2021-02-26,14,5744,2,5760,
UTTARAKHAND,HARIDWAR,2021-02-27,22,13753,16,13791,
UTTARAKHAND,HARIDWAR,2021-02-28,10,12466,13,12489,
UTTARAKHAND,NAINITAL,2021-02-26,10,919,4,933,
UTTARAKHAND,NAINITAL,2021-02-27,7,903,5,915,
UTTARAKHAND,NAINITAL,2021-02-28,2,199,0,201,
UTTARAKHAND,PAURI GARHWAL,2021-02-26,0,642,13,655,
UTTARAKHAND,PAURI GARHWAL,2021-02-27,0,655,2,657,
UTTARAKHAND,PAURI GARHWAL,2021-02-28,0,389,3,392,
UTTARAKHAND,PITHORAGARH,2021-02-26,0,328,2,330,
UTTARAKHAND,PITHORAGARH,2021-02-27,0,41,0,41,
UTTARAKHAND,PITHORAGARH,2021-02-28,0,10,0,10,
UTTARAKHAND,RUDRA PRAYAG,2021-02-26,0,106,0,106,
UTTARAKHAND,RUDRA PRAYAG,2021-02-27,0,279,9,288,
UTTARAKHAND,RUDRA PRAYAG,2021-02-28,0,96,0,96,
UTTARAKHAND,TEHRI GARHWAL,2021-02-26,1,369,0,370,
UTTARAKHAND,TEHRI GARHWAL,2021-02-27,4,150,0,154,
UTTARAKHAND,TEHRI GARHWAL,2021-02-28,0,75,0,75,
UTTARAKHAND,UDAM SINGH NAGAR,2021-02-26,5,1333,61,1399,
UTTARAKHAND,UDAM SINGH NAGAR,2021-02-27,4,1031,86,1121,
UTTARAKHAND,UDAM SINGH NAGAR,2021-02-28,5,946,0,951,
UTTARAKHAND,UTTAR KASHI,2021-02-26,0,290,1,291,
UTTARAKHAND,UTTAR KASHI,2021-02-27,0,171,0,171,
UTTARAKHAND,UTTAR KASHI,2021-02-28,0,331,0,331,
WEST BENGAL,24 PARAGANAS NORTH,2021-02-26,51,3198,6,3255,
WEST BENGAL,24 PARAGANAS NORTH,2021-02-27,62,3535,8,3605,
WEST BENGAL,24 PARAGANAS NORTH,2021-02-28,48,2186,0,2234,
WEST BENGAL,24 PARAGANAS SOUTH,2021-02-26,16,2536,7,2559,
WEST BENGAL,24 PARAGANAS SOUTH,2021-02-27,12,2799,3,2814,
WEST BENGAL,24 PARAGANAS SOUTH,2021-02-28,8,2186,2,2196,
WEST BENGAL,ALIPURDUAR,2021-02-26,0,118,0,118,
WEST BENGAL,ALIPURDUAR,2021-02-27,0,1224,0,1224,
WEST BENGAL,ALIPURDUAR,2021-02-28,1,705,1,707,
WEST BENGAL,BANKURA,2021-02-26,0,323,0,323,
WEST BENGAL,BANKURA,2021-02-27,2,473,1,476,
WEST BENGAL,BANKURA,2021-02-28,9,158,0,167,
WEST BENGAL,BIRBHUM,2021-02-26,0,451,6,457,
WEST BENGAL,BIRBHUM,2021-02-27,3,467,5,475,
WEST BENGAL,BIRBHUM,2021-02-28,1,487,7,495,
WEST BENGAL,COOCHBEHAR,2021-02-26,2,1187,0,1189,
WEST BENGAL,COOCHBEHAR,2021-02-27,2,1322,0,1324,
WEST BENGAL,COOCHBEHAR,2021-02-28,0,1066,0,1066,
WEST BENGAL,DARJEELING,2021-02-26,5,244,0,249,
WEST BENGAL,DARJEELING,2021-02-27,10,247,1,258,
WEST BENGAL,DARJEELING,2021-02-28,7,549,4,560,
WEST BENGAL,DINAJPUR DAKSHIN,2021-02-26,0,651,1,652,
WEST BENGAL,DINAJPUR DAKSHIN,2021-02-27,0,608,1,609,
WEST BENGAL,DINAJPUR DAKSHIN,2021-02-28,0,541,26,567,
WEST BENGAL,DINAJPUR UTTAR,2021-02-26,3,199,0,202,
WEST BENGAL,DINAJPUR UTTAR,2021-02-27,6,242,0,248,
WEST BENGAL,DINAJPUR UTTAR,2021-02-28,1,66,0,67,
WEST BENGAL,HOOGHLY,2021-02-26,9,486,0,495,
WEST BENGAL,HOOGHLY,2021-02-27,6,593,0,599,
WEST BENGAL,HOOGHLY,2021-02-28,4,650,7,661,
WEST BENGAL,HOWRAH,2021-02-26,20,1036,5,1061,
WEST BENGAL,HOWRAH,2021-02-27,11,1164,71,1246,
WEST BENGAL,HOWRAH,2021-02-28,12,797,35,844,
WEST BENGAL,JALPAIGURI,2021-02-26,1,340,0,341,
WEST BENGAL,JALPAIGURI,2021-02-27,0,520,0,520,
WEST BENGAL,JALPAIGURI,2021-02-28,2,88,2,92,
WEST BENGAL,JHARGRAM,2021-02-26,0,93,0,93,
WEST BENGAL,JHARGRAM,2021-02-27,0,31,0,31,
WEST BENGAL,JHARGRAM,2021-02-28,1,10,0,11,
WEST BENGAL,KALIMPONG,2021-02-26,0,369,0,369,
WEST BENGAL,KALIMPONG,2021-02-27,0,186,0,186,
WEST BENGAL,KALIMPONG,2021-02-28,0,63,0,63,
WEST BENGAL,KOLKATA,2021-02-26,105,3429,9,3543,
WEST BENGAL,KOLKATA,2021-02-27,112,3301,12,3425,
WEST BENGAL,KOLKATA,2021-02-28,79,2269,3,2351,
WEST BENGAL,MALDAH,2021-02-26,0,506,0,506,
WEST BENGAL,MALDAH,2021-02-27,5,280,2,287,
WEST BENGAL,MALDAH,2021-02-28,0,76,1,77,
WEST BENGAL,MEDINIPUR EAST,2021-02-26,3,732,1,736,
WEST BENGAL,MEDINIPUR EAST,2021-02-27,6,718,0,724,
WEST BENGAL,MEDINIPUR EAST,2021-02-28,5,376,0,381,
WEST BENGAL,MEDINIPUR WEST,2021-02-26,1,325,5,331,
WEST BENGAL,MEDINIPUR WEST,2021-02-27,1,325,2,328,
WEST BENGAL,MEDINIPUR WEST,2021-02-28,4,298,4,306,
WEST BENGAL,MURSHIDABAD,2021-02-26,2,823,3,828,
WEST BENGAL,MURSHIDABAD,2021-02-27,0,1142,6,1148,
WEST BENGAL,MURSHIDABAD,2021-02-28,3,618,2,623,
WEST BENGAL,NADIA,2021-02-26,3,714,15,732,
WEST BENGAL,NADIA,2021-02-27,3,516,4,523,
WEST BENGAL,NADIA,2021-02-28,1,395,6,402,
WEST BENGAL,PASCHIM BARDHAMAN,2021-02-26,14,764,0,778,
WEST BENGAL,PASCHIM BARDHAMAN,2021-02-27,7,687,0,694,
WEST BENGAL,PASCHIM BARDHAMAN,2021-02-28,16,539,3,558,
WEST BENGAL,PURBA BARDHAMAN,2021-02-26,1,618,0,619,
WEST BENGAL,PURBA BARDHAMAN,2021-02-27,1,685,0,686,
WEST BENGAL,PURBA BARDHAMAN,2021-02-28,0,658,2,660,
WEST BENGAL,PURULIA,2021-02-26,0,395,0,395,
WEST BENGAL,PURULIA,2021-02-27,1,431,0,432,
WEST BENGAL,PURULIA,2021-02-28,3,565,0,568,
ANDAMAN AND NICOBAR ISLANDS,NICOBARS,2021-02-23,0,16,0,16,
ANDAMAN AND NICOBAR ISLANDS,NICOBARS,2021-02-24,1,15,0,16,
ANDAMAN AND NICOBAR ISLANDS,NICOBARS,2021-02-25,0,10,0,10,
ANDAMAN AND NICOBAR ISLANDS,NORTH AND MIDDLE ANDAMAN,2021-02-23,0,11,0,11,
ANDAMAN AND NICOBAR ISLANDS,NORTH AND MIDDLE ANDAMAN,2021-02-24,0,7,0,7,
ANDAMAN AND NICOBAR ISLANDS,NORTH AND MIDDLE ANDAMAN,2021-02-25,0,14,0,14,
ANDAMAN AND NICOBAR ISLANDS,SOUTH ANDAMANS,2021-02-23,0,640,0,640,
ANDAMAN AND NICOBAR ISLANDS,SOUTH ANDAMANS,2021-02-24,1,314,0,315,
ANDAMAN AND NICOBAR ISLANDS,SOUTH ANDAMANS,2021-02-25,0,442,0,442,
ANDHRA PRADESH,ANANTAPUR,2021-02-23,0,57,1,58,
ANDHRA PRADESH,ANANTAPUR,2021-02-24,2,51,0,53,
ANDHRA PRADESH,ANANTAPUR,2021-02-25,3,38,0,41,
ANDHRA PRADESH,CHITTOOR,2021-02-23,6,73,2,81,
ANDHRA PRADESH,CHITTOOR,2021-02-24,5,162,0,167,
ANDHRA PRADESH,CHITTOOR,2021-02-25,3,126,0,129,
ANDHRA PRADESH,EAST GODAVARI,2021-02-23,1,18,0,19,
ANDHRA PRADESH,EAST GODAVARI,2021-02-24,1,18,1,20,
ANDHRA PRADESH,EAST GODAVARI,2021-02-25,3,36,0,39,
ANDHRA PRADESH,GUNTUR,2021-02-23,1,633,1,635,
ANDHRA PRADESH,GUNTUR,2021-02-24,0,1046,0,1046,
ANDHRA PRADESH,GUNTUR,2021-02-25,0,828,0,828,
ANDHRA PRADESH,KRISHNA,2021-02-23,0,22,0,22,
ANDHRA PRADESH,KRISHNA,2021-02-24,2,21,0,23,
ANDHRA PRADESH,KRISHNA,2021-02-25,0,19,1,20,
ANDHRA PRADESH,KURNOOL,2021-02-23,0,7,0,7,
ANDHRA PRADESH,KURNOOL,2021-02-24,0,11,0,11,
ANDHRA PRADESH,KURNOOL,2021-02-25,0,11,0,11,
ANDHRA PRADESH,PRAKASAM,2021-02-23,1,9,0,10,
ANDHRA PRADESH,PRAKASAM,2021-02-24,0,3,0,3,
ANDHRA PRADESH,PRAKASAM,2021-02-25,0,8,0,8,
ANDHRA PRADESH,SPSR NELLORE,2021-02-23,0,16,0,16,
ANDHRA PRADESH,SPSR NELLORE,2021-02-24,0,19,0,19,
ANDHRA PRADESH,SPSR NELLORE,2021-02-25,0,17,0,17,
ANDHRA PRADESH,SRIKAKULAM,2021-02-23,0,13,0,13,
ANDHRA PRADESH,SRIKAKULAM,2021-02-24,0,15,0,15,
ANDHRA PRADESH,SRIKAKULAM,2021-02-25,0,17,0,17,
ANDHRA PRADESH,VISAKHAPATANAM,2021-02-23,1,153,1,155,
ANDHRA PRADESH,VISAKHAPATANAM,2021-02-24,1,167,2,170,
ANDHRA PRADESH,VISAKHAPATANAM,2021-02-25,4,147,0,151,
ANDHRA PRADESH,VIZIANAGARAM,2021-02-23,0,13,0,13,
ANDHRA PRADESH,VIZIANAGARAM,2021-02-24,0,9,0,9,
ANDHRA PRADESH,VIZIANAGARAM,2021-02-25,2,9,0,11,
ANDHRA PRADESH,WEST GODAVARI,2021-02-23,0,19,0,19,
ANDHRA PRADESH,WEST GODAVARI,2021-02-24,0,14,0,14,
ANDHRA PRADESH,WEST GODAVARI,2021-02-25,0,4,0,4,
ANDHRA PRADESH,Y.S.R.,2021-02-23,0,13,0,13,
ANDHRA PRADESH,Y.S.R.,2021-02-24,0,25,0,25,
ANDHRA PRADESH,Y.S.R.,2021-02-25,1,13,0,14,
ARUNACHAL PRADESH,ANJAW,2021-02-25,0,1,0,1,
ARUNACHAL PRADESH,CHANGLANG,2021-02-23,0,3,0,3,
ARUNACHAL PRADESH,EAST KAMENG,2021-02-24,0,2,0,2,
ARUNACHAL PRADESH,EAST SIANG,2021-02-23,0,20,0,20,
ARUNACHAL PRADESH,EAST SIANG,2021-02-24,0,25,0,25,
ARUNACHAL PRADESH,EAST SIANG,2021-02-25,1,22,0,23,
ARUNACHAL PRADESH,KAMLE,2021-02-24,0,1,0,1,
ARUNACHAL PRADESH,LEPARADA,2021-02-23,17,0,0,17,
ARUNACHAL PRADESH,LEPARADA,2021-02-24,40,0,0,40,
ARUNACHAL PRADESH,LEPARADA,2021-02-25,21,1,0,22,
ARUNACHAL PRADESH,LOHIT,2021-02-23,0,1,0,1,
ARUNACHAL PRADESH,LOHIT,2021-02-24,0,2,0,2,
ARUNACHAL PRADESH,LOHIT,2021-02-25,1,1,0,2,
ARUNACHAL PRADESH,LOWER DIBANG VALLEY,2021-02-23,0,1,0,1,
ARUNACHAL PRADESH,LOWER SIANG,2021-02-23,0,16,0,16,
ARUNACHAL PRADESH,LOWER SIANG,2021-02-24,0,1,0,1,
ARUNACHAL PRADESH,LOWER SIANG,2021-02-25,0,4,0,4,
ARUNACHAL PRADESH,LOWER SUBANSIRI,2021-02-23,0,38,0,38,
ARUNACHAL PRADESH,LOWER SUBANSIRI,2021-02-24,0,24,0,24,
ARUNACHAL PRADESH,LOWER SUBANSIRI,2021-02-25,0,19,0,19,
ARUNACHAL PRADESH,NAMSAI,2021-02-23,0,1,0,1,
ARUNACHAL PRADESH,NAMSAI,2021-02-25,0,1,0,1,
ARUNACHAL PRADESH,PAPUM PARE,2021-02-23,0,19,0,19,
ARUNACHAL PRADESH,PAPUM PARE,2021-02-24,0,16,0,16,
ARUNACHAL PRADESH,PAPUM PARE,2021-02-25,0,19,0,19,
ARUNACHAL PRADESH,SHI YOMI,2021-02-23,0,1,0,1,
ARUNACHAL PRADESH,SHI YOMI,2021-02-24,0,1,0,1,
ARUNACHAL PRADESH,SIANG,2021-02-23,0,3,0,3,
ARUNACHAL PRADESH,SIANG,2021-02-25,0,2,0,2,
ARUNACHAL PRADESH,TAWANG,2021-02-25,0,2,0,2,
ARUNACHAL PRADESH,TIRAP,2021-02-23,0,1,0,1,
ARUNACHAL PRADESH,WEST KAMENG,2021-02-23,1,4,0,5,
ARUNACHAL PRADESH,WEST KAMENG,2021-02-24,0,4,0,4,
ARUNACHAL PRADESH,WEST KAMENG,2021-02-25,0,19,0,19,
ARUNACHAL PRADESH,WEST SIANG,2021-02-23,0,2,0,2,
ARUNACHAL PRADESH,WEST SIANG,2021-02-24,0,1,0,1,
ARUNACHAL PRADESH,WEST SIANG,2021-02-25,0,4,0,4,
ASSAM,BAKSA,2021-02-23,0,36,0,36,
ASSAM,BAKSA,2021-02-24,0,49,0,49,
ASSAM,BAKSA,2021-02-25,0,36,0,36,
ASSAM,BARPETA,2021-02-23,0,153,0,153,
ASSAM,BARPETA,2021-02-24,0,125,0,125,
ASSAM,BARPETA,2021-02-25,0,131,0,131,
ASSAM,BISWANATH,2021-02-23,0,80,0,80,
ASSAM,BISWANATH,2021-02-24,0,69,0,69,
ASSAM,BISWANATH,2021-02-25,0,31,0,31,
ASSAM,BONGAIGAON,2021-02-23,0,162,0,162,
ASSAM,BONGAIGAON,2021-02-24,0,132,0,132,
ASSAM,BONGAIGAON,2021-02-25,0,98,0,98,
ASSAM,CACHAR,2021-02-23,0,575,39,614,
ASSAM,CACHAR,2021-02-24,0,1846,0,1846,
ASSAM,CACHAR,2021-02-25,0,1764,46,1810,
ASSAM,CHARAIDEO,2021-02-23,0,34,0,34,
ASSAM,CHARAIDEO,2021-02-24,0,62,0,62,
ASSAM,CHARAIDEO,2021-02-25,0,101,0,101,
ASSAM,CHIRANG,2021-02-23,0,75,0,75,
ASSAM,CHIRANG,2021-02-24,0,32,0,32,
ASSAM,CHIRANG,2021-02-25,0,166,0,166,
ASSAM,DARRANG,2021-02-23,0,352,0,352,
ASSAM,DARRANG,2021-02-24,0,334,0,334,
ASSAM,DARRANG,2021-02-25,0,383,0,383,
ASSAM,DHEMAJI,2021-02-23,0,39,0,39,
ASSAM,DHEMAJI,2021-02-24,0,36,0,36,
ASSAM,DHEMAJI,2021-02-25,0,25,0,25,
ASSAM,DHUBRI,2021-02-23,0,217,0,217,
ASSAM,DHUBRI,2021-02-24,0,174,0,174,
ASSAM,DHUBRI,2021-02-25,0,179,0,179,
ASSAM,DIBRUGARH,2021-02-23,6,572,1,579,
ASSAM,DIBRUGARH,2021-02-24,1,231,0,232,
ASSAM,DIBRUGARH,2021-02-25,3,521,0,524,
ASSAM,DIMA HASAO,2021-02-23,0,20,0,20,
ASSAM,DIMA HASAO,2021-02-24,0,38,0,38,
ASSAM,DIMA HASAO,2021-02-25,0,34,0,34,
ASSAM,GOALPARA,2021-02-23,0,247,0,247,
ASSAM,GOALPARA,2021-02-24,0,367,0,367,
ASSAM,GOALPARA,2021-02-25,0,253,0,253,
ASSAM,GOLAGHAT,2021-02-23,0,217,0,217,
ASSAM,GOLAGHAT,2021-02-24,1,199,0,200,
ASSAM,GOLAGHAT,2021-02-25,0,179,0,179,
ASSAM,HAILAKANDI,2021-02-23,0,179,1,180,
ASSAM,HAILAKANDI,2021-02-24,0,243,0,243,
ASSAM,HAILAKANDI,2021-02-25,0,206,2,208,
ASSAM,HOJAI,2021-02-23,0,142,0,142,
ASSAM,HOJAI,2021-02-24,0,140,0,140,
ASSAM,HOJAI,2021-02-25,0,144,0,144,
ASSAM,JORHAT,2021-02-23,2,373,0,375,
ASSAM,JORHAT,2021-02-24,0,566,0,566,
ASSAM,JORHAT,2021-02-25,0,194,0,194,
ASSAM,KAMRUP,2021-02-23,1,693,0,694,
ASSAM,KAMRUP,2021-02-24,1,518,0,519,
ASSAM,KAMRUP,2021-02-25,0,631,0,631,
ASSAM,KAMRUP METRO,2021-02-23,17,1453,4,1474,
ASSAM,KAMRUP METRO,2021-02-24,21,1527,1,1549,
ASSAM,KAMRUP METRO,2021-02-25,3,1368,1,1372,
ASSAM,KARBI ANGLONG,2021-02-23,0,21,0,21,
ASSAM,KARBI ANGLONG,2021-02-24,0,72,0,72,
ASSAM,KARBI ANGLONG,2021-02-25,0,12,0,12,
ASSAM,KARIMGANJ,2021-02-23,0,248,2,250,
ASSAM,KARIMGANJ,2021-02-24,0,140,0,140,
ASSAM,KARIMGANJ,2021-02-25,0,197,3,200,
ASSAM,KOKRAJHAR,2021-02-23,0,27,0,27,
ASSAM,KOKRAJHAR,2021-02-24,5,40,0,45,
ASSAM,KOKRAJHAR,2021-02-25,1,18,0,19,
ASSAM,LAKHIMPUR,2021-02-23,0,249,0,249,
ASSAM,LAKHIMPUR,2021-02-24,0,174,0,174,
ASSAM,LAKHIMPUR,2021-02-25,0,220,0,220,
ASSAM,MAJULI,2021-02-23,0,3,0,3,
ASSAM,MAJULI,2021-02-24,0,9,0,9,
ASSAM,MAJULI,2021-02-25,0,9,0,9,
ASSAM,MARIGAON,2021-02-23,0,167,0,167,
ASSAM,MARIGAON,2021-02-24,0,195,0,195,
ASSAM,MARIGAON,2021-02-25,0,159,0,159,
ASSAM,NAGAON,2021-02-23,0,331,0,331,
ASSAM,NAGAON,2021-02-24,4,535,0,539,
ASSAM,NAGAON,2021-02-25,1,300,0,301,
ASSAM,NALBARI,2021-02-23,0,49,0,49,
ASSAM,NALBARI,2021-02-24,0,65,0,65,
ASSAM,NALBARI,2021-02-25,0,34,0,34,
ASSAM,SIVASAGAR,2021-02-23,0,194,0,194,
ASSAM,SIVASAGAR,2021-02-24,0,126,0,126,
ASSAM,SIVASAGAR,2021-02-25,0,119,0,119,
ASSAM,SONITPUR,2021-02-23,0,485,0,485,
ASSAM,SONITPUR,2021-02-24,1,284,0,285,
ASSAM,SONITPUR,2021-02-25,1,176,0,177,
ASSAM,SOUTH SALMARA MANCACHAR,2021-02-23,0,21,0,21,
ASSAM,SOUTH SALMARA MANCACHAR,2021-02-24,0,12,0,12,
ASSAM,SOUTH SALMARA MANCACHAR,2021-02-25,0,29,0,29,
ASSAM,TINSUKIA,2021-02-23,7,175,0,182,
ASSAM,TINSUKIA,2021-02-24,10,354,0,364,
ASSAM,TINSUKIA,2021-02-25,17,294,22,333,
ASSAM,UDALGURI,2021-02-23,0,29,0,29,
ASSAM,UDALGURI,2021-02-24,0,9,0,9,
ASSAM,UDALGURI,2021-02-25,0,5,0,5,
ASSAM,WEST KARBI ANGLONG,2021-02-23,0,11,0,11,
ASSAM,WEST KARBI ANGLONG,2021-02-24,0,10,0,10,
ASSAM,WEST KARBI ANGLONG,2021-02-25,0,12,0,12,
BIHAR,ARARIA,2021-02-23,6,5814,0,5820,
BIHAR,ARARIA,2021-02-24,1,4074,1,4076,
BIHAR,ARARIA,2021-02-25,2,1949,4,1955,
BIHAR,ARWAL,2021-02-23,0,596,0,596,
BIHAR,ARWAL,2021-02-24,0,567,0,567,
BIHAR,ARWAL,2021-02-25,0,257,1,258,
BIHAR,AURANGABAD,2021-02-23,15,9366,1,9382,
BIHAR,AURANGABAD,2021-02-24,7,6704,1,6712,
BIHAR,AURANGABAD,2021-02-25,1,5724,1,5726,
BIHAR,BANKA,2021-02-23,3,6370,0,6373,
BIHAR,BANKA,2021-02-24,4,10446,116,10566,
BIHAR,BANKA,2021-02-25,8,10659,0,10667,
BIHAR,BEGUSARAI,2021-02-23,1,1772,1,1774,
BIHAR,BEGUSARAI,2021-02-24,2,748,0,750,
BIHAR,BEGUSARAI,2021-02-25,0,838,0,838,
BIHAR,BHAGALPUR,2021-02-23,1,952,0,953,
BIHAR,BHAGALPUR,2021-02-24,1,305,0,306,
BIHAR,BHAGALPUR,2021-02-25,4,428,3,435,
BIHAR,BHOJPUR,2021-02-23,3,7597,2,7602,
BIHAR,BHOJPUR,2021-02-24,4,8227,2,8233,
BIHAR,BHOJPUR,2021-02-25,2,8232,1,8235,
BIHAR,BUXAR,2021-02-23,1,2288,0,2289,
BIHAR,BUXAR,2021-02-24,0,3817,1,3818,
BIHAR,BUXAR,2021-02-25,3,4861,0,4864,
BIHAR,DARBHANGA,2021-02-23,2,833,8,843,
BIHAR,DARBHANGA,2021-02-24,1,670,0,671,
BIHAR,DARBHANGA,2021-02-25,2,650,16,668,
BIHAR,GAYA,2021-02-23,4,8184,17,8205,
BIHAR,GAYA,2021-02-24,4,4875,3,4882,
BIHAR,GAYA,2021-02-25,6,4306,1,4313,
BIHAR,GOPALGANJ,2021-02-23,0,235,0,235,
BIHAR,GOPALGANJ,2021-02-24,0,696,7,703,
BIHAR,GOPALGANJ,2021-02-25,0,660,1,661,
BIHAR,JAMUI,2021-02-23,0,2121,1,2122,
BIHAR,JAMUI,2021-02-24,1,3760,0,3761,
BIHAR,JAMUI,2021-02-25,1,3102,1,3104,
BIHAR,JEHANABAD,2021-02-23,1,6750,225,6976,
BIHAR,JEHANABAD,2021-02-24,0,966,1,967,
BIHAR,JEHANABAD,2021-02-25,0,193,0,193,
BIHAR,KAIMUR (BHABUA),2021-02-23,3,3074,0,3077,
BIHAR,KAIMUR (BHABUA),2021-02-24,1,3760,0,3761,
BIHAR,KAIMUR (BHABUA),2021-02-25,0,2886,0,2886,
BIHAR,KATIHAR,2021-02-23,0,1982,4,1986,
BIHAR,KATIHAR,2021-02-24,7,2256,0,2263,
BIHAR,KATIHAR,2021-02-25,2,4442,0,4444,
BIHAR,KHAGARIA,2021-02-23,1,4302,0,4303,
BIHAR,KHAGARIA,2021-02-24,0,3409,0,3409,
BIHAR,KHAGARIA,2021-02-25,2,2342,0,2344,
BIHAR,KISHANGANJ,2021-02-23,0,1546,1,1547,
BIHAR,KISHANGANJ,2021-02-24,2,1505,0,1507,
BIHAR,KISHANGANJ,2021-02-25,0,441,0,441,
BIHAR,LAKHISARAI,2021-02-23,2,1276,0,1278,
BIHAR,LAKHISARAI,2021-02-24,5,2491,0,2496,
BIHAR,LAKHISARAI,2021-02-25,1,3593,0,3594,
BIHAR,MADHEPURA,2021-02-23,1,3729,0,3730,
BIHAR,MADHEPURA,2021-02-24,8,6564,0,6572,
BIHAR,MADHEPURA,2021-02-25,5,5204,0,5209,
BIHAR,MADHUBANI,2021-02-23,0,4075,34,4109,
BIHAR,MADHUBANI,2021-02-24,10,6235,1,6246,
BIHAR,MADHUBANI,2021-02-25,1,4556,9,4566,
BIHAR,MUNGER,2021-02-23,0,6213,3,6216,
BIHAR,MUNGER,2021-02-24,7,8265,18,8290,
BIHAR,MUNGER,2021-02-25,2,10080,18,10100,
BIHAR,MUZAFFARPUR,2021-02-23,1,6356,0,6357,
BIHAR,MUZAFFARPUR,2021-02-24,5,7160,0,7165,
BIHAR,MUZAFFARPUR,2021-02-25,1,7094,0,7095,
BIHAR,NALANDA,2021-02-23,4,2336,0,2340,
BIHAR,NALANDA,2021-02-24,0,1965,0,1965,
BIHAR,NALANDA,2021-02-25,2,1617,0,1619,
BIHAR,NAWADA,2021-02-23,14,29193,7,29214,
BIHAR,NAWADA,2021-02-24,12,11013,0,11025,
BIHAR,NAWADA,2021-02-25,2,2522,0,2524,
BIHAR,PASHCHIM CHAMPARAN,2021-02-23,4,6851,0,6855,
BIHAR,PASHCHIM CHAMPARAN,2021-02-24,1,6463,0,6464,
BIHAR,PASHCHIM CHAMPARAN,2021-02-25,4,6103,27,6134,
BIHAR,PATNA,2021-02-23,24,3080,1,3105,
BIHAR,PATNA,2021-02-24,27,2403,2,2432,
BIHAR,PATNA,2021-02-25,19,2739,0,2758,
BIHAR,PURBI CHAMPARAN,2021-02-23,0,2156,1,2157,
BIHAR,PURBI CHAMPARAN,2021-02-24,0,1244,1,1245,
BIHAR,PURBI CHAMPARAN,2021-02-25,0,1529,2,1531,
BIHAR,PURNIA,2021-02-23,2,9613,31,9646,
BIHAR,PURNIA,2021-02-24,9,8703,1,8713,
BIHAR,PURNIA,2021-02-25,1,8147,16,8164,
BIHAR,ROHTAS,2021-02-23,2,3328,25,3355,
BIHAR,ROHTAS,2021-02-24,0,3340,3,3343,
BIHAR,ROHTAS,2021-02-25,1,2449,2,2452,
BIHAR,SAHARSA,2021-02-23,1,1638,0,1639,
BIHAR,SAHARSA,2021-02-24,1,2030,0,2031,
BIHAR,SAHARSA,2021-02-25,0,1460,1,1461,
BIHAR,SAMASTIPUR,2021-02-23,0,3879,16,3895,
BIHAR,SAMASTIPUR,2021-02-24,1,1835,19,1855,
BIHAR,SAMASTIPUR,2021-02-25,2,2333,26,2361,
BIHAR,SARAN,2021-02-23,1,1666,3,1670,
BIHAR,SARAN,2021-02-24,4,2894,0,2898,
BIHAR,SARAN,2021-02-25,1,2702,1,2704,
BIHAR,SHEIKHPURA,2021-02-23,0,1659,0,1659,
BIHAR,SHEIKHPURA,2021-02-24,1,3069,5,3075,
BIHAR,SHEIKHPURA,2021-02-25,2,3359,1,3362,
BIHAR,SHEOHAR,2021-02-23,0,684,0,684,
BIHAR,SHEOHAR,2021-02-24,0,154,0,154,
BIHAR,SHEOHAR,2021-02-25,0,526,0,526,
BIHAR,SITAMARHI,2021-02-23,4,5242,3,5249,
BIHAR,SITAMARHI,2021-02-24,1,5201,1,5203,
BIHAR,SITAMARHI,2021-02-25,2,6980,1,6983,
BIHAR,SIWAN,2021-02-23,2,3591,2,3595,
BIHAR,SIWAN,2021-02-24,6,3907,0,3913,
BIHAR,SIWAN,2021-02-25,5,6695,0,6700,
BIHAR,SUPAUL,2021-02-23,0,807,0,807,
BIHAR,SUPAUL,2021-02-24,0,1194,65,1259,
BIHAR,SUPAUL,2021-02-25,0,995,45,1040,
BIHAR,VAISHALI,2021-02-23,3,6180,177,6360,
BIHAR,VAISHALI,2021-02-24,7,5817,83,5907,
BIHAR,VAISHALI,2021-02-25,6,4536,7,4549,
CHANDIGARH,CHANDIGARH,2021-02-23,66,1703,10,1779,
CHANDIGARH,CHANDIGARH,2021-02-24,42,1698,8,1748,
CHANDIGARH,CHANDIGARH,2021-02-25,59,1775,7,1841,
CHHATTISGARH,BALOD,2021-02-23,2,903,0,905,
CHHATTISGARH,BALOD,2021-02-24,2,1095,0,1097,
CHHATTISGARH,BALOD,2021-02-25,4,1067,0,1071,
CHHATTISGARH,BALODA BAZAR,2021-02-23,11,668,2,681,
CHHATTISGARH,BALODA BAZAR,2021-02-24,8,954,11,973,
CHHATTISGARH,BALODA BAZAR,2021-02-25,7,499,4,510,
CHHATTISGARH,BALRAMPUR,2021-02-23,1,154,0,155,
CHHATTISGARH,BALRAMPUR,2021-02-24,0,247,0,247,
CHHATTISGARH,BALRAMPUR,2021-02-25,0,296,0,296,
CHHATTISGARH,BASTAR,2021-02-23,12,1569,0,1581,
CHHATTISGARH,BASTAR,2021-02-24,4,1498,0,1502,
CHHATTISGARH,BASTAR,2021-02-25,6,978,0,984,
CHHATTISGARH,BEMETARA,2021-02-23,2,803,1,806,
CHHATTISGARH,BEMETARA,2021-02-24,2,834,0,836,
CHHATTISGARH,BEMETARA,2021-02-25,3,740,0,743,
CHHATTISGARH,BIJAPUR,2021-02-23,2,131,0,133,
CHHATTISGARH,BIJAPUR,2021-02-24,1,106,0,107,
CHHATTISGARH,BIJAPUR,2021-02-25,1,260,0,261,
CHHATTISGARH,BILASPUR,2021-02-23,33,887,11,931,
CHHATTISGARH,BILASPUR,2021-02-24,18,1013,7,1038,
CHHATTISGARH,BILASPUR,2021-02-25,24,828,7,859,
CHHATTISGARH,DANTEWADA,2021-02-23,1,232,0,233,
CHHATTISGARH,DANTEWADA,2021-02-24,0,328,0,328,
CHHATTISGARH,DANTEWADA,2021-02-25,3,351,0,354,
CHHATTISGARH,DHAMTARI,2021-02-23,5,1048,20,1073,
CHHATTISGARH,DHAMTARI,2021-02-24,2,583,39,624,
CHHATTISGARH,DHAMTARI,2021-02-25,6,603,60,669,
CHHATTISGARH,DURG,2021-02-23,47,1072,2,1121,
CHHATTISGARH,DURG,2021-02-24,43,1013,2,1058,
CHHATTISGARH,DURG,2021-02-25,85,1475,0,1560,
CHHATTISGARH,GARIYABAND,2021-02-23,6,273,4,283,
CHHATTISGARH,GARIYABAND,2021-02-24,8,220,10,238,
CHHATTISGARH,GARIYABAND,2021-02-25,6,193,3,202,
CHHATTISGARH,GAURELLA PENDRA MARWAHI,2021-02-23,0,188,0,188,
CHHATTISGARH,GAURELLA PENDRA MARWAHI,2021-02-24,2,303,0,305,
CHHATTISGARH,GAURELLA PENDRA MARWAHI,2021-02-25,2,163,0,165,
CHHATTISGARH,JANJGIR CHAMPA,2021-02-23,7,1781,1,1789,
CHHATTISGARH,JANJGIR CHAMPA,2021-02-24,3,1609,0,1612,
CHHATTISGARH,JANJGIR CHAMPA,2021-02-25,16,1337,1,1354,
CHHATTISGARH,JASHPUR,2021-02-23,13,194,0,207,
CHHATTISGARH,JASHPUR,2021-02-24,10,493,1,504,
CHHATTISGARH,JASHPUR,2021-02-25,9,380,0,389,
CHHATTISGARH,KABIRDHAM,2021-02-23,1,582,17,600,
CHHATTISGARH,KABIRDHAM,2021-02-24,4,464,2,470,
CHHATTISGARH,KABIRDHAM,2021-02-25,3,590,0,593,
CHHATTISGARH,KANKER,2021-02-23,5,602,1,608,
CHHATTISGARH,KANKER,2021-02-24,4,432,0,436,
CHHATTISGARH,KANKER,2021-02-25,1,663,0,664,
CHHATTISGARH,KONDAGAON,2021-02-23,1,517,0,518,
CHHATTISGARH,KONDAGAON,2021-02-24,1,482,0,483,
CHHATTISGARH,KONDAGAON,2021-02-25,0,630,0,630,
CHHATTISGARH,KORBA,2021-02-23,12,996,0,1008,
CHHATTISGARH,KORBA,2021-02-24,5,851,0,856,
CHHATTISGARH,KORBA,2021-02-25,7,936,0,943,
CHHATTISGARH,KOREA,2021-02-23,3,771,0,774,
CHHATTISGARH,KOREA,2021-02-24,22,830,3,855,
CHHATTISGARH,KOREA,2021-02-25,2,899,3,904,
CHHATTISGARH,MAHASAMUND,2021-02-23,4,1183,9,1196,
CHHATTISGARH,MAHASAMUND,2021-02-24,3,1423,3,1429,
CHHATTISGARH,MAHASAMUND,2021-02-25,4,1155,4,1163,
CHHATTISGARH,MUNGELI,2021-02-23,5,547,0,552,
CHHATTISGARH,MUNGELI,2021-02-24,0,434,1,435,
CHHATTISGARH,MUNGELI,2021-02-25,0,432,5,437,
CHHATTISGARH,NARAYANPUR,2021-02-23,1,251,0,252,
CHHATTISGARH,NARAYANPUR,2021-02-24,1,239,0,240,
CHHATTISGARH,NARAYANPUR,2021-02-25,0,226,0,226,
CHHATTISGARH,RAIGARH,2021-02-23,6,1039,0,1045,
CHHATTISGARH,RAIGARH,2021-02-24,13,1171,0,1184,
CHHATTISGARH,RAIGARH,2021-02-25,18,1180,0,1198,
CHHATTISGARH,RAIPUR,2021-02-23,100,2472,4,2576,
CHHATTISGARH,RAIPUR,2021-02-24,94,2515,37,2646,
CHHATTISGARH,RAIPUR,2021-02-25,79,2205,16,2300,
CHHATTISGARH,RAJNANDGAON,2021-02-23,10,1002,13,1025,
CHHATTISGARH,RAJNANDGAON,2021-02-24,10,1051,1,1062,
CHHATTISGARH,RAJNANDGAON,2021-02-25,11,1462,40,1513,
CHHATTISGARH,SUKMA,2021-02-23,0,73,0,73,
CHHATTISGARH,SUKMA,2021-02-24,0,28,0,28,
CHHATTISGARH,SUKMA,2021-02-25,0,461,0,461,
CHHATTISGARH,SURAJPUR,2021-02-23,4,1135,3,1142,
CHHATTISGARH,SURAJPUR,2021-02-24,4,877,0,881,
CHHATTISGARH,SURAJPUR,2021-02-25,2,576,0,578,
CHHATTISGARH,SURGUJA,2021-02-23,13,709,1,723,
CHHATTISGARH,SURGUJA,2021-02-24,7,643,0,650,
CHHATTISGARH,SURGUJA,2021-02-25,13,719,0,732,
DADRA AND NAGAR HAVELI,DADRA AND NAGAR HAVELI,2021-02-23,2,235,0,237,
DADRA AND NAGAR HAVELI,DADRA AND NAGAR HAVELI,2021-02-24,0,191,0,191,
DADRA AND NAGAR HAVELI,DADRA AND NAGAR HAVELI,2021-02-25,0,304,0,304,
DAMAN AND DIU,DAMAN,2021-02-23,0,91,0,91,
DAMAN AND DIU,DAMAN,2021-02-24,0,89,0,89,
DAMAN AND DIU,DAMAN,2021-02-25,0,89,0,89,
DAMAN AND DIU,DIU,2021-02-23,0,20,1,21,
DAMAN AND DIU,DIU,2021-02-24,0,30,1,31,
DAMAN AND DIU,DIU,2021-02-25,0,52,0,52,
DELHI,CENTRAL,2021-02-23,14,3914,25,3953,
DELHI,CENTRAL,2021-02-24,10,2974,7,2991,
DELHI,CENTRAL,2021-02-25,19,4254,3,4276,
DELHI,EAST,2021-02-23,6,3612,3,3621,
DELHI,EAST,2021-02-24,10,3434,2,3446,
DELHI,EAST,2021-02-25,46,3552,21,3619,
DELHI,NEW DELHI,2021-02-23,36,4874,9,4919,
DELHI,NEW DELHI,2021-02-24,49,6815,7,6871,
DELHI,NEW DELHI,2021-02-25,41,5199,16,5256,
DELHI,NORTH,2021-02-23,11,7239,28,7278,
DELHI,NORTH,2021-02-24,10,7242,55,7307,
DELHI,NORTH,2021-02-25,12,8594,17,8623,
DELHI,NORTH EAST,2021-02-23,3,3126,5,3134,
DELHI,NORTH EAST,2021-02-24,2,4820,11,4833,
DELHI,NORTH EAST,2021-02-25,2,4975,0,4977,
DELHI,NORTH WEST,2021-02-23,31,5336,1,5368,
DELHI,NORTH WEST,2021-02-24,28,5908,20,5956,
DELHI,NORTH WEST,2021-02-25,33,6840,10,6883,
DELHI,SHAHDARA,2021-02-23,6,6201,1,6208,
DELHI,SHAHDARA,2021-02-24,5,6911,1,6917,
DELHI,SHAHDARA,2021-02-25,4,6386,1,6391,
DELHI,SOUTH,2021-02-23,56,4180,5,4241,
DELHI,SOUTH,2021-02-24,56,7652,14,7722,
DELHI,SOUTH,2021-02-25,63,4817,16,4896,
DELHI,SOUTH EAST,2021-02-23,8,4308,5,4321,
DELHI,SOUTH EAST,2021-02-24,9,4267,5,4281,
DELHI,SOUTH EAST,2021-02-25,8,4064,56,4128,
DELHI,SOUTH WEST,2021-02-23,18,3959,8,3985,
DELHI,SOUTH WEST,2021-02-24,25,4315,0,4340,
DELHI,SOUTH WEST,2021-02-25,23,4217,4,4244,
DELHI,WEST,2021-02-23,30,9078,4,9112,
DELHI,WEST,2021-02-24,30,9275,4,9309,
DELHI,WEST,2021-02-25,38,9416,2,9456,
GOA,NORTH GOA,2021-02-23,33,854,1,888,
GOA,NORTH GOA,2021-02-24,35,737,3,775,
GOA,NORTH GOA,2021-02-25,40,666,2,708,
GOA,SOUTH GOA,2021-02-23,35,998,0,1033,
GOA,SOUTH GOA,2021-02-24,34,718,1,753,
GOA,SOUTH GOA,2021-02-25,37,884,0,921,
GUJARAT,AHMADABAD,2021-02-23,190,4353,70,4613,
GUJARAT,AHMADABAD,2021-02-24,145,3496,37,3678,
GUJARAT,AHMADABAD,2021-02-25,90,3964,54,4108,
GUJARAT,AMRELI,2021-02-23,1,380,0,381,
GUJARAT,AMRELI,2021-02-24,4,645,37,686,
GUJARAT,AMRELI,2021-02-25,13,483,0,496,
GUJARAT,ANAND,2021-02-23,18,349,11,378,
GUJARAT,ANAND,2021-02-24,14,326,9,349,
GUJARAT,ANAND,2021-02-25,7,410,0,417,
GUJARAT,ARVALLI,2021-02-23,0,190,0,190,
GUJARAT,ARVALLI,2021-02-24,1,218,0,219,
GUJARAT,ARVALLI,2021-02-25,3,200,0,203,
GUJARAT,BANAS KANTHA,2021-02-23,2,245,0,247,
GUJARAT,BANAS KANTHA,2021-02-24,1,419,0,420,
GUJARAT,BANAS KANTHA,2021-02-25,2,292,0,294,
GUJARAT,BHARUCH,2021-02-23,8,584,22,614,
GUJARAT,BHARUCH,2021-02-24,9,447,5,461,
GUJARAT,BHARUCH,2021-02-25,9,417,0,426,
GUJARAT,BHAVNAGAR,2021-02-23,8,352,1,361,
GUJARAT,BHAVNAGAR,2021-02-24,9,392,1,402,
GUJARAT,BHAVNAGAR,2021-02-25,5,525,0,530,
GUJARAT,BOTAD,2021-02-23,0,334,2,336,
GUJARAT,BOTAD,2021-02-24,2,245,0,247,
GUJARAT,BOTAD,2021-02-25,1,197,0,198,
GUJARAT,CHHOTAUDEPUR,2021-02-23,4,235,0,239,
GUJARAT,CHHOTAUDEPUR,2021-02-24,1,66,0,67,
GUJARAT,CHHOTAUDEPUR,2021-02-25,9,373,0,382,
GUJARAT,DANG,2021-02-23,0,127,0,127,
GUJARAT,DANG,2021-02-24,0,83,0,83,
GUJARAT,DANG,2021-02-25,0,80,0,80,
GUJARAT,DEVBHUMI DWARKA,2021-02-23,4,128,2,134,
GUJARAT,DEVBHUMI DWARKA,2021-02-24,0,172,1,173,
GUJARAT,DEVBHUMI DWARKA,2021-02-25,2,195,3,200,
GUJARAT,DOHAD,2021-02-23,1,207,0,208,
GUJARAT,DOHAD,2021-02-24,7,195,3,205,
GUJARAT,DOHAD,2021-02-25,5,336,0,341,
GUJARAT,GANDHINAGAR,2021-02-23,17,624,6,647,
GUJARAT,GANDHINAGAR,2021-02-24,13,646,5,664,
GUJARAT,GANDHINAGAR,2021-02-25,7,635,1,643,
GUJARAT,GIR SOMNATH,2021-02-23,5,157,0,162,
GUJARAT,GIR SOMNATH,2021-02-24,3,197,0,200,
GUJARAT,GIR SOMNATH,2021-02-25,7,207,0,214,
GUJARAT,JAMNAGAR,2021-02-23,18,865,3,886,
GUJARAT,JAMNAGAR,2021-02-24,21,790,1,812,
GUJARAT,JAMNAGAR,2021-02-25,8,810,9,827,
GUJARAT,JUNAGADH,2021-02-23,11,291,0,302,
GUJARAT,JUNAGADH,2021-02-24,12,336,0,348,
GUJARAT,JUNAGADH,2021-02-25,16,509,0,525,
GUJARAT,KACHCHH,2021-02-23,18,398,29,445,
GUJARAT,KACHCHH,2021-02-24,18,468,33,519,
GUJARAT,KACHCHH,2021-02-25,20,593,11,624,
GUJARAT,KHEDA,2021-02-23,11,436,13,460,
GUJARAT,KHEDA,2021-02-24,18,640,6,664,
GUJARAT,KHEDA,2021-02-25,16,421,3,440,
GUJARAT,MAHESANA,2021-02-23,7,165,5,177,
GUJARAT,MAHESANA,2021-02-24,8,367,0,375,
GUJARAT,MAHESANA,2021-02-25,6,214,10,230,
GUJARAT,MAHISAGAR,2021-02-23,11,318,0,329,
GUJARAT,MAHISAGAR,2021-02-24,3,363,4,370,
GUJARAT,MAHISAGAR,2021-02-25,4,295,0,299,
GUJARAT,MORBI,2021-02-23,2,243,0,245,
GUJARAT,MORBI,2021-02-24,3,229,0,232,
GUJARAT,MORBI,2021-02-25,3,310,11,324,
GUJARAT,NARMADA,2021-02-23,2,25,2,29,
GUJARAT,NARMADA,2021-02-24,1,21,0,22,
GUJARAT,NARMADA,2021-02-25,4,74,0,78,
GUJARAT,NAVSARI,2021-02-23,0,360,1,361,
GUJARAT,NAVSARI,2021-02-24,4,429,1,434,
GUJARAT,NAVSARI,2021-02-25,3,281,0,284,
GUJARAT,PANCH MAHALS,2021-02-23,2,275,0,277,
GUJARAT,PANCH MAHALS,2021-02-24,9,216,3,228,
GUJARAT,PANCH MAHALS,2021-02-25,22,275,0,297,
GUJARAT,PATAN,2021-02-23,3,536,1,540,
GUJARAT,PATAN,2021-02-24,1,659,2,662,
GUJARAT,PATAN,2021-02-25,1,399,3,403,
GUJARAT,PORBANDAR,2021-02-23,0,401,0,401,
GUJARAT,PORBANDAR,2021-02-24,0,401,0,401,
GUJARAT,PORBANDAR,2021-02-25,0,249,0,249,
GUJARAT,RAJKOT,2021-02-23,56,1757,7,1820,
GUJARAT,RAJKOT,2021-02-24,50,1717,39,1806,
GUJARAT,RAJKOT,2021-02-25,95,1405,19,1519,
GUJARAT,SABAR KANTHA,2021-02-23,3,168,0,171,
GUJARAT,SABAR KANTHA,2021-02-24,7,170,0,177,
GUJARAT,SABAR KANTHA,2021-02-25,8,216,5,229,
GUJARAT,SURAT,2021-02-23,58,1926,3,1987,
GUJARAT,SURAT,2021-02-24,51,1857,4,1912,
GUJARAT,SURAT,2021-02-25,60,1905,1,1966,
GUJARAT,SURENDRANAGAR,2021-02-23,0,377,0,377,
GUJARAT,SURENDRANAGAR,2021-02-24,1,524,0,525,
GUJARAT,SURENDRANAGAR,2021-02-25,1,775,1,777,
GUJARAT,TAPI,2021-02-23,5,408,0,413,
GUJARAT,TAPI,2021-02-24,8,387,0,395,
GUJARAT,TAPI,2021-02-25,0,422,2,424,
GUJARAT,VADODARA,2021-02-23,67,1580,64,1711,
GUJARAT,VADODARA,2021-02-24,69,1683,116,1868,
GUJARAT,VADODARA,2021-02-25,75,1709,69,1853,
GUJARAT,VALSAD,2021-02-23,6,458,8,472,
GUJARAT,VALSAD,2021-02-24,4,455,1,460,
GUJARAT,VALSAD,2021-02-25,11,518,0,529,
HARYANA,AMBALA,2021-02-23,25,791,16,832,
HARYANA,AMBALA,2021-02-24,26,845,17,888,
HARYANA,AMBALA,2021-02-25,37,902,8,947,
HARYANA,BHIWANI,2021-02-23,4,920,0,924,
HARYANA,BHIWANI,2021-02-24,1,942,0,943,
HARYANA,BHIWANI,2021-02-25,5,891,0,896,
HARYANA,CHARKI DADRI,2021-02-23,0,354,0,354,
HARYANA,CHARKI DADRI,2021-02-24,1,131,0,132,
HARYANA,CHARKI DADRI,2021-02-25,0,511,0,511,
HARYANA,FARIDABAD,2021-02-23,12,1134,6,1152,
HARYANA,FARIDABAD,2021-02-24,7,1102,4,1113,
HARYANA,FARIDABAD,2021-02-25,9,991,15,1015,
HARYANA,FATEHABAD,2021-02-23,1,533,0,534,
HARYANA,FATEHABAD,2021-02-24,2,573,1,576,
HARYANA,FATEHABAD,2021-02-25,0,757,1,758,
HARYANA,GURUGRAM,2021-02-23,56,3141,7,3204,
HARYANA,GURUGRAM,2021-02-24,44,3292,7,3343,
HARYANA,GURUGRAM,2021-02-25,47,3165,13,3225,
HARYANA,HISAR,2021-02-23,1,1372,4,1377,
HARYANA,HISAR,2021-02-24,3,1357,0,1360,
HARYANA,HISAR,2021-02-25,1,1163,1,1165,
HARYANA,JHAJJAR,2021-02-23,3,1828,0,1831,
HARYANA,JHAJJAR,2021-02-24,3,797,0,800,
HARYANA,JHAJJAR,2021-02-25,1,1362,0,1363,
HARYANA,JIND,2021-02-23,1,308,4,313,
HARYANA,JIND,2021-02-24,5,382,4,391,
HARYANA,JIND,2021-02-25,2,713,9,724,
HARYANA,KAITHAL,2021-02-23,7,633,3,643,
HARYANA,KAITHAL,2021-02-24,5,581,29,615,
HARYANA,KAITHAL,2021-02-25,8,527,63,598,
HARYANA,KARNAL,2021-02-23,7,700,1,708,
HARYANA,KARNAL,2021-02-24,41,643,0,684,
HARYANA,KARNAL,2021-02-25,20,649,0,669,
HARYANA,KURUKSHETRA,2021-02-23,12,1403,7,1422,
HARYANA,KURUKSHETRA,2021-02-24,24,1214,2,1240,
HARYANA,KURUKSHETRA,2021-02-25,15,764,2,781,
HARYANA,MAHENDRAGARH,2021-02-23,0,277,2,279,
HARYANA,MAHENDRAGARH,2021-02-24,0,135,0,135,
HARYANA,MAHENDRAGARH,2021-02-25,0,347,2,349,
HARYANA,NUH,2021-02-23,0,129,1,130,
HARYANA,NUH,2021-02-24,1,244,0,245,
HARYANA,NUH,2021-02-25,0,207,0,207,
HARYANA,PALWAL,2021-02-23,1,248,2,251,
HARYANA,PALWAL,2021-02-24,0,284,1,285,
HARYANA,PALWAL,2021-02-25,0,160,2,162,
HARYANA,PANCHKULA,2021-02-23,19,605,8,632,
HARYANA,PANCHKULA,2021-02-24,19,354,6,379,
HARYANA,PANCHKULA,2021-02-25,31,453,7,491,
HARYANA,PANIPAT,2021-02-23,12,460,1,473,
HARYANA,PANIPAT,2021-02-24,7,350,0,357,
HARYANA,PANIPAT,2021-02-25,6,538,1,545,
HARYANA,REWARI,2021-02-23,1,373,0,374,
HARYANA,REWARI,2021-02-24,1,640,5,646,
HARYANA,REWARI,2021-02-25,0,501,1,502,
HARYANA,ROHTAK,2021-02-23,3,769,0,772,
HARYANA,ROHTAK,2021-02-24,6,1135,0,1141,
HARYANA,ROHTAK,2021-02-25,4,728,1,733,
HARYANA,SIRSA,2021-02-23,1,1113,25,1139,
HARYANA,SIRSA,2021-02-24,0,1222,6,1228,
HARYANA,SIRSA,2021-02-25,1,969,14,984,
HARYANA,SONIPAT,2021-02-23,2,1018,14,1034,
HARYANA,SONIPAT,2021-02-24,3,1514,3,1520,
HARYANA,SONIPAT,2021-02-25,2,1515,1,1518,
HARYANA,YAMUNANAGAR,2021-02-23,9,1178,4,1191,
HARYANA,YAMUNANAGAR,2021-02-24,5,1320,0,1325,
HARYANA,YAMUNANAGAR,2021-02-25,2,925,2,929,
HIMACHAL PRADESH,BILASPUR,2021-02-23,2,650,0,652,
HIMACHAL PRADESH,BILASPUR,2021-02-24,2,606,0,608,
HIMACHAL PRADESH,BILASPUR,2021-02-25,1,396,0,397,
HIMACHAL PRADESH,CHAMBA,2021-02-23,0,505,7,512,
HIMACHAL PRADESH,CHAMBA,2021-02-24,0,574,3,577,
HIMACHAL PRADESH,CHAMBA,2021-02-25,1,759,4,764,
HIMACHAL PRADESH,HAMIRPUR,2021-02-23,1,597,1,599,
HIMACHAL PRADESH,HAMIRPUR,2021-02-24,1,726,0,727,
HIMACHAL PRADESH,HAMIRPUR,2021-02-25,7,405,0,412,
HIMACHAL PRADESH,KANGRA,2021-02-23,4,931,1,936,
HIMACHAL PRADESH,KANGRA,2021-02-24,7,782,1,790,
HIMACHAL PRADESH,KANGRA,2021-02-25,0,605,1,606,
HIMACHAL PRADESH,KINNAUR,2021-02-23,0,146,0,146,
HIMACHAL PRADESH,KINNAUR,2021-02-24,4,20,0,24,
HIMACHAL PRADESH,KINNAUR,2021-02-25,1,21,0,22,
HIMACHAL PRADESH,KULLU,2021-02-23,1,287,2,290,
HIMACHAL PRADESH,KULLU,2021-02-24,0,130,1,131,
HIMACHAL PRADESH,KULLU,2021-02-25,1,56,0,57,
HIMACHAL PRADESH,LAHUL AND SPITI,2021-02-23,0,5,0,5,
HIMACHAL PRADESH,LAHUL AND SPITI,2021-02-24,0,1,0,1,
HIMACHAL PRADESH,MANDI,2021-02-23,0,325,2,327,
HIMACHAL PRADESH,MANDI,2021-02-24,1,286,12,299,
HIMACHAL PRADESH,MANDI,2021-02-25,1,265,10,276,
HIMACHAL PRADESH,SHIMLA,2021-02-23,1,877,0,878,
HIMACHAL PRADESH,SHIMLA,2021-02-24,6,702,2,710,
HIMACHAL PRADESH,SHIMLA,2021-02-25,5,1072,14,1091,
HIMACHAL PRADESH,SIRMAUR,2021-02-23,7,506,0,513,
HIMACHAL PRADESH,SIRMAUR,2021-02-24,2,314,1,317,
HIMACHAL PRADESH,SIRMAUR,2021-02-25,2,453,4,459,
HIMACHAL PRADESH,SOLAN,2021-02-23,3,538,0,541,
HIMACHAL PRADESH,SOLAN,2021-02-24,7,654,0,661,
HIMACHAL PRADESH,SOLAN,2021-02-25,7,582,2,591,
HIMACHAL PRADESH,UNA,2021-02-23,1,295,0,296,
HIMACHAL PRADESH,UNA,2021-02-24,6,441,0,447,
HIMACHAL PRADESH,UNA,2021-02-25,5,635,2,642,
INDIA,INDIA,2021-02-23,1,4,0,5,
INDIA,INDIA,2021-02-24,3,5,0,8,
INDIA,INDIA,2021-02-25,3,4,0,7,
JAMMU AND KASHMIR,ANANTNAG,2021-02-23,10,180,0,190,
JAMMU AND KASHMIR,ANANTNAG,2021-02-24,11,223,0,234,
JAMMU AND KASHMIR,ANANTNAG,2021-02-25,4,258,0,262,
JAMMU AND KASHMIR,BANDIPORA,2021-02-23,1,130,0,131,
JAMMU AND KASHMIR,BANDIPORA,2021-02-24,3,128,5,136,
JAMMU AND KASHMIR,BANDIPORA,2021-02-25,1,119,5,125,
JAMMU AND KASHMIR,BARAMULLA,2021-02-23,0,103,0,103,
JAMMU AND KASHMIR,BARAMULLA,2021-02-24,1,163,0,164,
JAMMU AND KASHMIR,BARAMULLA,2021-02-25,1,149,0,150,
JAMMU AND KASHMIR,BUDGAM,2021-02-23,7,688,0,695,
JAMMU AND KASHMIR,BUDGAM,2021-02-24,8,700,1,709,
JAMMU AND KASHMIR,BUDGAM,2021-02-25,1,608,0,609,
JAMMU AND KASHMIR,DODA,2021-02-23,4,49,0,53,
JAMMU AND KASHMIR,DODA,2021-02-24,0,23,0,23,
JAMMU AND KASHMIR,DODA,2021-02-25,0,30,0,30,
JAMMU AND KASHMIR,GANDERBAL,2021-02-23,2,119,0,121,
JAMMU AND KASHMIR,GANDERBAL,2021-02-24,4,89,0,93,
JAMMU AND KASHMIR,GANDERBAL,2021-02-25,1,49,0,50,
JAMMU AND KASHMIR,JAMMU,2021-02-23,10,777,0,787,
JAMMU AND KASHMIR,JAMMU,2021-02-24,5,584,0,589,
JAMMU AND KASHMIR,JAMMU,2021-02-25,21,944,2,967,
JAMMU AND KASHMIR,KATHUA,2021-02-23,1,352,1,354,
JAMMU AND KASHMIR,KATHUA,2021-02-24,0,212,0,212,
JAMMU AND KASHMIR,KATHUA,2021-02-25,0,135,0,135,
JAMMU AND KASHMIR,KISHTWAR,2021-02-23,0,75,0,75,
JAMMU AND KASHMIR,KISHTWAR,2021-02-24,1,113,0,114,
JAMMU AND KASHMIR,KISHTWAR,2021-02-25,0,107,0,107,
JAMMU AND KASHMIR,KULGAM,2021-02-23,1,180,0,181,
JAMMU AND KASHMIR,KULGAM,2021-02-24,3,119,0,122,
JAMMU AND KASHMIR,KULGAM,2021-02-25,1,163,0,164,
JAMMU AND KASHMIR,KUPWARA,2021-02-23,0,158,0,158,
JAMMU AND KASHMIR,KUPWARA,2021-02-24,1,368,0,369,
JAMMU AND KASHMIR,KUPWARA,2021-02-25,1,192,0,193,
JAMMU AND KASHMIR,POONCH,2021-02-23,0,278,0,278,
JAMMU AND KASHMIR,POONCH,2021-02-24,0,278,0,278,
JAMMU AND KASHMIR,POONCH,2021-02-25,0,306,0,306,
JAMMU AND KASHMIR,PULWAMA,2021-02-23,6,384,0,390,
JAMMU AND KASHMIR,PULWAMA,2021-02-24,2,419,0,421,
JAMMU AND KASHMIR,PULWAMA,2021-02-25,5,295,0,300,
JAMMU AND KASHMIR,RAJOURI,2021-02-23,0,247,1,248,
JAMMU AND KASHMIR,RAJOURI,2021-02-24,0,173,0,173,
JAMMU AND KASHMIR,RAJOURI,2021-02-25,0,162,2,164,
JAMMU AND KASHMIR,RAMBAN,2021-02-23,3,298,0,301,
JAMMU AND KASHMIR,RAMBAN,2021-02-24,1,287,0,288,
JAMMU AND KASHMIR,RAMBAN,2021-02-25,5,250,0,255,
JAMMU AND KASHMIR,REASI,2021-02-23,1,85,0,86,
JAMMU AND KASHMIR,REASI,2021-02-24,0,92,0,92,
JAMMU AND KASHMIR,REASI,2021-02-25,0,76,0,76,
JAMMU AND KASHMIR,SAMBA,2021-02-23,2,39,0,41,
JAMMU AND KASHMIR,SAMBA,2021-02-24,0,94,0,94,
JAMMU AND KASHMIR,SAMBA,2021-02-25,0,122,1,123,
JAMMU AND KASHMIR,SHOPIAN,2021-02-23,2,267,0,269,
JAMMU AND KASHMIR,SHOPIAN,2021-02-24,3,195,0,198,
JAMMU AND KASHMIR,SHOPIAN,2021-02-25,1,113,0,114,
JAMMU AND KASHMIR,SRINAGAR,2021-02-23,25,3727,1,3753,
JAMMU AND KASHMIR,SRINAGAR,2021-02-24,48,3316,10,3374,
JAMMU AND KASHMIR,SRINAGAR,2021-02-25,73,3601,3,3677,
JAMMU AND KASHMIR,UDHAMPUR,2021-02-23,23,865,0,888,
JAMMU AND KASHMIR,UDHAMPUR,2021-02-24,5,829,0,834,
JAMMU AND KASHMIR,UDHAMPUR,2021-02-25,18,595,0,613,
JHARKHAND,BOKARO,2021-02-23,4,910,0,914,
JHARKHAND,BOKARO,2021-02-24,2,920,9,931,
JHARKHAND,BOKARO,2021-02-25,4,1179,1,1184,
JHARKHAND,CHATRA,2021-02-23,1,340,0,341,
JHARKHAND,CHATRA,2021-02-24,0,185,0,185,
JHARKHAND,CHATRA,2021-02-25,1,389,1,391,
JHARKHAND,DEOGHAR,2021-02-23,0,570,13,583,
JHARKHAND,DEOGHAR,2021-02-24,2,821,1,824,
JHARKHAND,DEOGHAR,2021-02-25,5,1027,8,1040,
JHARKHAND,DHANBAD,2021-02-23,0,268,0,268,
JHARKHAND,DHANBAD,2021-02-24,6,390,0,396,
JHARKHAND,DHANBAD,2021-02-25,0,226,0,226,
JHARKHAND,DUMKA,2021-02-23,3,280,6,289,
JHARKHAND,DUMKA,2021-02-24,2,318,10,330,
JHARKHAND,DUMKA,2021-02-25,0,199,13,212,
JHARKHAND,EAST SINGHBUM,2021-02-23,13,2359,3,2375,
JHARKHAND,EAST SINGHBUM,2021-02-24,19,2550,2,2571,
JHARKHAND,EAST SINGHBUM,2021-02-25,11,1626,1,1638,
JHARKHAND,GARHWA,2021-02-23,0,218,1,219,
JHARKHAND,GARHWA,2021-02-24,0,879,0,879,
JHARKHAND,GARHWA,2021-02-25,0,1943,1,1944,
JHARKHAND,GIRIDIH,2021-02-23,2,2095,0,2097,
JHARKHAND,GIRIDIH,2021-02-24,1,1108,0,1109,
JHARKHAND,GIRIDIH,2021-02-25,1,1469,0,1470,
JHARKHAND,GODDA,2021-02-23,0,625,0,625,
JHARKHAND,GODDA,2021-02-24,1,402,0,403,
JHARKHAND,GODDA,2021-02-25,0,901,1,902,
JHARKHAND,GUMLA,2021-02-23,1,1176,2,1179,
JHARKHAND,GUMLA,2021-02-24,3,1985,0,1988,
JHARKHAND,GUMLA,2021-02-25,1,1795,0,1796,
JHARKHAND,HAZARIBAGH,2021-02-23,0,245,0,245,
JHARKHAND,HAZARIBAGH,2021-02-24,0,440,1,441,
JHARKHAND,HAZARIBAGH,2021-02-25,0,288,0,288,
JHARKHAND,JAMTARA,2021-02-23,0,646,14,660,
JHARKHAND,JAMTARA,2021-02-24,0,632,0,632,
JHARKHAND,JAMTARA,2021-02-25,0,936,0,936,
JHARKHAND,KHUNTI,2021-02-23,0,307,2,309,
JHARKHAND,KHUNTI,2021-02-24,1,354,4,359,
JHARKHAND,KHUNTI,2021-02-25,0,198,5,203,
JHARKHAND,KODERMA,2021-02-23,0,186,0,186,
JHARKHAND,KODERMA,2021-02-24,0,549,0,549,
JHARKHAND,KODERMA,2021-02-25,0,1254,3,1257,
JHARKHAND,LATEHAR,2021-02-23,0,731,4,735,
JHARKHAND,LATEHAR,2021-02-24,0,926,0,926,
JHARKHAND,LATEHAR,2021-02-25,0,826,2,828,
JHARKHAND,LOHARDAGA,2021-02-23,2,120,0,122,
JHARKHAND,LOHARDAGA,2021-02-24,1,158,0,159,
JHARKHAND,LOHARDAGA,2021-02-25,0,232,0,232,
JHARKHAND,PAKUR,2021-02-23,0,772,0,772,
JHARKHAND,PAKUR,2021-02-24,0,909,3,912,
JHARKHAND,PAKUR,2021-02-25,0,695,1,696,
JHARKHAND,PALAMU,2021-02-23,1,2415,4,2420,
JHARKHAND,PALAMU,2021-02-24,0,1731,0,1731,
JHARKHAND,PALAMU,2021-02-25,0,809,0,809,
JHARKHAND,RAMGARH,2021-02-23,19,223,0,242,
JHARKHAND,RAMGARH,2021-02-24,31,199,0,230,
JHARKHAND,RAMGARH,2021-02-25,25,353,0,378,
JHARKHAND,RANCHI,2021-02-23,31,712,1,744,
JHARKHAND,RANCHI,2021-02-24,84,659,0,743,
JHARKHAND,RANCHI,2021-02-25,50,710,1,761,
JHARKHAND,SAHEBGANJ,2021-02-23,0,54,0,54,
JHARKHAND,SAHEBGANJ,2021-02-24,1,226,0,227,
JHARKHAND,SAHEBGANJ,2021-02-25,0,368,0,368,
JHARKHAND,SARAIKELA KHARSAWAN,2021-02-23,0,200,0,200,
JHARKHAND,SARAIKELA KHARSAWAN,2021-02-24,1,223,0,224,
JHARKHAND,SARAIKELA KHARSAWAN,2021-02-25,7,372,0,379,
JHARKHAND,SIMDEGA,2021-02-23,0,755,0,755,
JHARKHAND,SIMDEGA,2021-02-24,1,866,0,867,
JHARKHAND,SIMDEGA,2021-02-25,0,1356,0,1356,
JHARKHAND,WEST SINGHBHUM,2021-02-23,0,1671,0,1671,
JHARKHAND,WEST SINGHBHUM,2021-02-24,1,1886,0,1887,
JHARKHAND,WEST SINGHBHUM,2021-02-25,0,2262,0,2262,
KARNATAKA,BAGALKOTE,2021-02-23,3,1066,0,1069,
KARNATAKA,BAGALKOTE,2021-02-24,1,918,0,919,
KARNATAKA,BAGALKOTE,2021-02-25,0,1382,6,1388,
KARNATAKA,BALLARI,2021-02-23,8,1894,44,1946,
KARNATAKA,BALLARI,2021-02-24,10,2184,37,2231,
KARNATAKA,BALLARI,2021-02-25,10,2325,33,2368,
KARNATAKA,BELAGAVI,2021-02-23,8,1672,4,1684,
KARNATAKA,BELAGAVI,2021-02-24,6,1776,6,1788,
KARNATAKA,BELAGAVI,2021-02-25,13,2144,0,2157,
KARNATAKA,BENGALURU RURAL,2021-02-23,9,1763,3,1775,
KARNATAKA,BENGALURU RURAL,2021-02-24,6,887,0,893,
KARNATAKA,BENGALURU RURAL,2021-02-25,12,1373,0,1385,
KARNATAKA,BENGALURU URBAN,2021-02-23,374,22561,395,23330,
KARNATAKA,BENGALURU URBAN,2021-02-24,291,26096,289,26676,
KARNATAKA,BENGALURU URBAN,2021-02-25,391,30364,313,31068,
KARNATAKA,BIDAR,2021-02-23,5,861,1,867,
KARNATAKA,BIDAR,2021-02-24,12,1163,0,1175,
KARNATAKA,BIDAR,2021-02-25,8,1009,1,1018,
KARNATAKA,CHAMARAJANAGARA,2021-02-23,1,990,0,991,
KARNATAKA,CHAMARAJANAGARA,2021-02-24,2,934,1,937,
KARNATAKA,CHAMARAJANAGARA,2021-02-25,5,794,0,799,
KARNATAKA,CHIKKABALLAPURA,2021-02-23,1,1392,2,1395,
KARNATAKA,CHIKKABALLAPURA,2021-02-24,6,1755,1,1762,
KARNATAKA,CHIKKABALLAPURA,2021-02-25,3,1728,4,1735,
KARNATAKA,CHIKKAMAGALURU,2021-02-23,3,1287,5,1295,
KARNATAKA,CHIKKAMAGALURU,2021-02-24,4,1617,7,1628,
KARNATAKA,CHIKKAMAGALURU,2021-02-25,1,1260,6,1267,
KARNATAKA,CHITRADURGA,2021-02-23,5,1135,17,1157,
KARNATAKA,CHITRADURGA,2021-02-24,4,1143,1,1148,
KARNATAKA,CHITRADURGA,2021-02-25,6,1552,13,1571,
KARNATAKA,DAKSHINA KANNADA,2021-02-23,12,1914,1,1927,
KARNATAKA,DAKSHINA KANNADA,2021-02-24,28,1785,0,1813,
KARNATAKA,DAKSHINA KANNADA,2021-02-25,28,1393,1,1422,
KARNATAKA,DAVANGERE,2021-02-23,4,1174,30,1208,
KARNATAKA,DAVANGERE,2021-02-24,1,1221,41,1263,
KARNATAKA,DAVANGERE,2021-02-25,3,1050,86,1139,
KARNATAKA,DHARWAD,2021-02-23,7,1804,17,1828,
KARNATAKA,DHARWAD,2021-02-24,7,2360,36,2403,
KARNATAKA,DHARWAD,2021-02-25,5,1890,3,1898,
KARNATAKA,GADAG,2021-02-23,0,904,45,949,
KARNATAKA,GADAG,2021-02-24,1,455,12,468,
KARNATAKA,GADAG,2021-02-25,2,1103,95,1200,
KARNATAKA,HASSAN,2021-02-23,9,1216,4,1229,
KARNATAKA,HASSAN,2021-02-24,8,1819,16,1843,
KARNATAKA,HASSAN,2021-02-25,12,2058,33,2103,
KARNATAKA,HAVERI,2021-02-23,0,892,0,892,
KARNATAKA,HAVERI,2021-02-24,2,758,0,760,
KARNATAKA,HAVERI,2021-02-25,1,895,0,896,
KARNATAKA,KALABURAGI,2021-02-23,15,1520,8,1543,
KARNATAKA,KALABURAGI,2021-02-24,17,1857,1,1875,
KARNATAKA,KALABURAGI,2021-02-25,27,2323,3,2353,
KARNATAKA,KODAGU,2021-02-23,1,720,8,729,
KARNATAKA,KODAGU,2021-02-24,8,680,12,700,
KARNATAKA,KODAGU,2021-02-25,3,829,13,845,
KARNATAKA,KOLAR,2021-02-23,5,2015,4,2024,
KARNATAKA,KOLAR,2021-02-24,2,2079,5,2086,
KARNATAKA,KOLAR,2021-02-25,5,1883,5,1893,
KARNATAKA,KOPPAL,2021-02-23,0,1221,7,1228,
KARNATAKA,KOPPAL,2021-02-24,1,1138,28,1167,
KARNATAKA,KOPPAL,2021-02-25,3,894,4,901,
KARNATAKA,MANDYA,2021-02-23,7,1908,7,1922,
KARNATAKA,MANDYA,2021-02-24,4,1875,1,1880,
KARNATAKA,MANDYA,2021-02-25,0,1744,2,1746,
KARNATAKA,MYSURU,2021-02-23,27,2896,1,2924,
KARNATAKA,MYSURU,2021-02-24,45,3192,5,3242,
KARNATAKA,MYSURU,2021-02-25,23,2921,11,2955,
KARNATAKA,RAICHUR,2021-02-23,4,537,3,544,
KARNATAKA,RAICHUR,2021-02-24,1,890,0,891,
KARNATAKA,RAICHUR,2021-02-25,0,1043,15,1058,
KARNATAKA,RAMANAGARA,2021-02-23,0,846,1,847,
KARNATAKA,RAMANAGARA,2021-02-24,0,681,0,681,
KARNATAKA,RAMANAGARA,2021-02-25,1,1126,3,1130,
KARNATAKA,SHIVAMOGGA,2021-02-23,8,1110,1,1119,
KARNATAKA,SHIVAMOGGA,2021-02-24,4,1721,23,1748,
KARNATAKA,SHIVAMOGGA,2021-02-25,2,1771,7,1780,
KARNATAKA,TUMAKURU,2021-02-23,19,2040,3,2062,
KARNATAKA,TUMAKURU,2021-02-24,25,1547,0,1572,
KARNATAKA,TUMAKURU,2021-02-25,19,3245,1,3265,
KARNATAKA,UDUPI,2021-02-23,7,1328,1,1336,
KARNATAKA,UDUPI,2021-02-24,12,1038,0,1050,
KARNATAKA,UDUPI,2021-02-25,7,1113,0,1120,
KARNATAKA,UTTARA KANNADA,2021-02-23,2,1429,117,1548,
KARNATAKA,UTTARA KANNADA,2021-02-24,4,1386,98,1488,
KARNATAKA,UTTARA KANNADA,2021-02-25,3,1476,105,1584,
KARNATAKA,VIJAYAPURA,2021-02-23,9,830,1,840,
KARNATAKA,VIJAYAPURA,2021-02-24,4,1304,0,1308,
KARNATAKA,VIJAYAPURA,2021-02-25,11,1474,0,1485,
KARNATAKA,YADGIR,2021-02-23,1,895,0,896,
KARNATAKA,YADGIR,2021-02-24,1,875,0,876,
KARNATAKA,YADGIR,2021-02-25,1,1354,0,1355,
KERALA,ALAPPUZHA,2021-02-23,301,3972,30,4303,
KERALA,ALAPPUZHA,2021-02-24,335,4513,9,4857,
KERALA,ALAPPUZHA,2021-02-25,432,6292,18,6742,
KERALA,ERNAKULAM,2021-02-23,591,7381,40,8012,
KERALA,ERNAKULAM,2021-02-24,573,7859,46,8478,
KERALA,ERNAKULAM,2021-02-25,414,6496,40,6950,
KERALA,IDUKKI,2021-02-23,95,2004,5,2104,
KERALA,IDUKKI,2021-02-24,147,1871,4,2022,
KERALA,IDUKKI,2021-02-25,87,1693,1,1781,
KERALA,KANNUR,2021-02-23,229,3394,5,3628,
KERALA,KANNUR,2021-02-24,289,3794,8,4091,
KERALA,KANNUR,2021-02-25,305,3095,9,3409,
KERALA,KASARAGOD,2021-02-23,194,2397,3,2594,
KERALA,KASARAGOD,2021-02-24,141,2397,6,2544,
KERALA,KASARAGOD,2021-02-25,155,2105,6,2266,
KERALA,KOLLAM,2021-02-23,467,5698,13,6178,
KERALA,KOLLAM,2021-02-24,507,5934,12,6453,
KERALA,KOLLAM,2021-02-25,395,5001,19,5415,
KERALA,KOTTAYAM,2021-02-23,415,5419,31,5865,
KERALA,KOTTAYAM,2021-02-24,410,4762,45,5217,
KERALA,KOTTAYAM,2021-02-25,379,3564,47,3990,
KERALA,KOZHIKODE,2021-02-23,521,5415,30,5966,
KERALA,KOZHIKODE,2021-02-24,632,6805,52,7489,
KERALA,KOZHIKODE,2021-02-25,535,5614,72,6221,
KERALA,MALAPPURAM,2021-02-23,314,3834,3,4151,
KERALA,MALAPPURAM,2021-02-24,304,4445,1,4750,
KERALA,MALAPPURAM,2021-02-25,263,4202,12,4477,
KERALA,PALAKKAD,2021-02-23,146,2815,0,2961,
KERALA,PALAKKAD,2021-02-24,169,2912,3,3084,
KERALA,PALAKKAD,2021-02-25,160,3044,2,3206,
KERALA,PATHANAMTHITTA,2021-02-23,536,3018,2,3556,
KERALA,PATHANAMTHITTA,2021-02-24,428,3143,3,3574,
KERALA,PATHANAMTHITTA,2021-02-25,319,3245,4,3568,
KERALA,THIRUVANANTHAPURAM,2021-02-23,365,5280,14,5659,
KERALA,THIRUVANANTHAPURAM,2021-02-24,363,5328,22,5713,
KERALA,THIRUVANANTHAPURAM,2021-02-25,388,5098,16,5502,
KERALA,THRISSUR,2021-02-23,478,5326,0,5804,
KERALA,THRISSUR,2021-02-24,299,4653,3,4955,
KERALA,THRISSUR,2021-02-25,399,4797,1,5197,
KERALA,WAYANAD,2021-02-23,129,1441,8,1578,
KERALA,WAYANAD,2021-02-24,177,1656,15,1848,
KERALA,WAYANAD,2021-02-25,125,1170,3,1298,
LADAKH,KARGIL,2021-02-23,0,82,0,82,
LADAKH,KARGIL,2021-02-24,1,54,0,55,
LADAKH,KARGIL,2021-02-25,0,79,0,79,
LADAKH,LEH LADAKH,2021-02-23,10,359,0,369,
LADAKH,LEH LADAKH,2021-02-24,2,215,0,217,
LADAKH,LEH LADAKH,2021-02-25,1,208,0,209,
LAKSHADWEEP,LAKSHADWEEP DISTRICT,2021-02-23,0,437,0,437,
LAKSHADWEEP,LAKSHADWEEP DISTRICT,2021-02-24,0,290,0,290,
LAKSHADWEEP,LAKSHADWEEP DISTRICT,2021-02-25,8,121,0,129,
MADHYA PRADESH,AGAR MALWA,2021-02-23,1,154,0,155,
MADHYA PRADESH,AGAR MALWA,2021-02-24,3,174,0,177,
MADHYA PRADESH,AGAR MALWA,2021-02-25,0,192,0,192,
MADHYA PRADESH,ALIRAJPUR,2021-02-23,0,41,0,41,
MADHYA PRADESH,ALIRAJPUR,2021-02-24,0,80,0,80,
MADHYA PRADESH,ALIRAJPUR,2021-02-25,1,72,0,73,
MADHYA PRADESH,ANUPPUR,2021-02-23,2,63,0,65,
MADHYA PRADESH,ANUPPUR,2021-02-24,3,74,0,77,
MADHYA PRADESH,ANUPPUR,2021-02-25,3,98,5,106,
MADHYA PRADESH,ASHOKNAGAR,2021-02-23,0,73,0,73,
MADHYA PRADESH,ASHOKNAGAR,2021-02-24,0,112,0,112,
MADHYA PRADESH,ASHOKNAGAR,2021-02-25,3,149,1,153,
MADHYA PRADESH,BALAGHAT,2021-02-23,4,360,1,365,
MADHYA PRADESH,BALAGHAT,2021-02-24,6,527,0,533,
MADHYA PRADESH,BALAGHAT,2021-02-25,8,499,0,507,
MADHYA PRADESH,BARWANI,2021-02-23,6,194,0,200,
MADHYA PRADESH,BARWANI,2021-02-24,1,97,0,98,
MADHYA PRADESH,BARWANI,2021-02-25,5,170,0,175,
MADHYA PRADESH,BETUL,2021-02-23,14,282,0,296,
MADHYA PRADESH,BETUL,2021-02-24,10,268,0,278,
MADHYA PRADESH,BETUL,2021-02-25,11,300,0,311,
MADHYA PRADESH,BHIND,2021-02-23,0,275,1,276,
MADHYA PRADESH,BHIND,2021-02-24,0,137,0,137,
MADHYA PRADESH,BHIND,2021-02-25,1,218,0,219,
MADHYA PRADESH,BHOPAL,2021-02-23,93,1233,2,1328,
MADHYA PRADESH,BHOPAL,2021-02-24,105,1471,7,1583,
MADHYA PRADESH,BHOPAL,2021-02-25,77,1537,4,1618,
MADHYA PRADESH,BURHANPUR,2021-02-23,8,44,0,52,
MADHYA PRADESH,BURHANPUR,2021-02-24,13,138,2,153,
MADHYA PRADESH,BURHANPUR,2021-02-25,5,274,0,279,
MADHYA PRADESH,CHHATARPUR,2021-02-23,1,185,0,186,
MADHYA PRADESH,CHHATARPUR,2021-02-24,1,106,0,107,
MADHYA PRADESH,CHHATARPUR,2021-02-25,1,244,0,245,
MADHYA PRADESH,CHHINDWARA,2021-02-23,20,482,2,504,
MADHYA PRADESH,CHHINDWARA,2021-02-24,18,392,1,411,
MADHYA PRADESH,CHHINDWARA,2021-02-25,25,449,38,512,
MADHYA PRADESH,DAMOH,2021-02-23,1,138,0,139,
MADHYA PRADESH,DAMOH,2021-02-24,3,146,0,149,
MADHYA PRADESH,DAMOH,2021-02-25,5,211,0,216,
MADHYA PRADESH,DATIA,2021-02-23,0,175,0,175,
MADHYA PRADESH,DATIA,2021-02-24,1,219,5,225,
MADHYA PRADESH,DATIA,2021-02-25,1,252,16,269,
MADHYA PRADESH,DEWAS,2021-02-23,3,81,0,84,
MADHYA PRADESH,DEWAS,2021-02-24,9,368,0,377,
MADHYA PRADESH,DEWAS,2021-02-25,12,394,0,406,
MADHYA PRADESH,DHAR,2021-02-23,3,365,0,368,
MADHYA PRADESH,DHAR,2021-02-24,5,117,0,122,
MADHYA PRADESH,DHAR,2021-02-25,3,135,0,138,
MADHYA PRADESH,DINDORI,2021-02-23,1,356,0,357,
MADHYA PRADESH,DINDORI,2021-02-24,0,599,0,599,
MADHYA PRADESH,DINDORI,2021-02-25,0,422,0,422,
MADHYA PRADESH,EAST NIMAR,2021-02-23,5,272,3,280,
MADHYA PRADESH,EAST NIMAR,2021-02-24,5,184,0,189,
MADHYA PRADESH,EAST NIMAR,2021-02-25,6,226,2,234,
MADHYA PRADESH,GUNA,2021-02-23,1,146,0,147,
MADHYA PRADESH,GUNA,2021-02-24,3,213,0,216,
MADHYA PRADESH,GUNA,2021-02-25,0,156,0,156,
MADHYA PRADESH,GWALIOR,2021-02-23,3,634,0,637,
MADHYA PRADESH,GWALIOR,2021-02-24,4,709,0,713,
MADHYA PRADESH,GWALIOR,2021-02-25,19,737,2,758,
MADHYA PRADESH,HARDA,2021-02-23,1,198,0,199,
MADHYA PRADESH,HARDA,2021-02-24,0,237,0,237,
MADHYA PRADESH,HARDA,2021-02-25,2,272,0,274,
MADHYA PRADESH,HOSHANGABAD,2021-02-23,1,218,0,219,
MADHYA PRADESH,HOSHANGABAD,2021-02-24,1,236,0,237,
MADHYA PRADESH,HOSHANGABAD,2021-02-25,3,291,0,294,
MADHYA PRADESH,INDORE,2021-02-23,133,1036,0,1169,
MADHYA PRADESH,INDORE,2021-02-24,172,1106,0,1278,
MADHYA PRADESH,INDORE,2021-02-25,185,1171,0,1356,
MADHYA PRADESH,JABALPUR,2021-02-23,20,786,0,806,
MADHYA PRADESH,JABALPUR,2021-02-24,13,328,0,341,
MADHYA PRADESH,JABALPUR,2021-02-25,15,507,2,524,
MADHYA PRADESH,JHABUA,2021-02-23,5,182,0,187,
MADHYA PRADESH,JHABUA,2021-02-24,5,80,0,85,
MADHYA PRADESH,JHABUA,2021-02-25,8,217,0,225,
MADHYA PRADESH,KATNI,2021-02-23,0,308,0,308,
MADHYA PRADESH,KATNI,2021-02-24,0,436,6,442,
MADHYA PRADESH,KATNI,2021-02-25,2,302,1,305,
MADHYA PRADESH,KHARGONE,2021-02-23,2,411,0,413,
MADHYA PRADESH,KHARGONE,2021-02-24,7,265,0,272,
MADHYA PRADESH,KHARGONE,2021-02-25,6,344,0,350,
MADHYA PRADESH,MANDLA,2021-02-23,1,542,0,543,
MADHYA PRADESH,MANDLA,2021-02-24,0,309,1,310,
MADHYA PRADESH,MANDLA,2021-02-25,8,143,0,151,
MADHYA PRADESH,MANDSAUR,2021-02-23,5,131,0,136,
MADHYA PRADESH,MANDSAUR,2021-02-24,7,91,1,99,
MADHYA PRADESH,MANDSAUR,2021-02-25,16,94,3,113,
MADHYA PRADESH,MORENA,2021-02-23,2,306,0,308,
MADHYA PRADESH,MORENA,2021-02-24,1,166,0,167,
MADHYA PRADESH,MORENA,2021-02-25,1,420,0,421,
MADHYA PRADESH,NARSINGHPUR,2021-02-23,2,398,1,401,
MADHYA PRADESH,NARSINGHPUR,2021-02-24,0,408,1,409,
MADHYA PRADESH,NARSINGHPUR,2021-02-25,0,391,0,391,
MADHYA PRADESH,NEEMUCH,2021-02-23,2,168,2,172,
MADHYA PRADESH,NEEMUCH,2021-02-24,0,102,0,102,
MADHYA PRADESH,NEEMUCH,2021-02-25,5,164,1,170,
MADHYA PRADESH,NIWARI,2021-02-23,0,7,0,7,
MADHYA PRADESH,NIWARI,2021-02-24,0,62,0,62,
MADHYA PRADESH,NIWARI,2021-02-25,0,22,0,22,
MADHYA PRADESH,PANNA,2021-02-23,2,217,1,220,
MADHYA PRADESH,PANNA,2021-02-24,1,84,0,85,
MADHYA PRADESH,PANNA,2021-02-25,5,73,0,78,
MADHYA PRADESH,RAISEN,2021-02-23,2,129,0,131,
MADHYA PRADESH,RAISEN,2021-02-24,0,152,0,152,
MADHYA PRADESH,RAISEN,2021-02-25,0,174,0,174,
MADHYA PRADESH,RAJGARH,2021-02-23,7,126,0,133,
MADHYA PRADESH,RAJGARH,2021-02-24,7,163,0,170,
MADHYA PRADESH,RAJGARH,2021-02-25,7,164,0,171,
MADHYA PRADESH,RATLAM,2021-02-23,3,143,4,150,
MADHYA PRADESH,RATLAM,2021-02-24,7,190,4,201,
MADHYA PRADESH,RATLAM,2021-02-25,7,195,10,212,
MADHYA PRADESH,REWA,2021-02-23,9,562,1,572,
MADHYA PRADESH,REWA,2021-02-24,12,459,3,474,
MADHYA PRADESH,REWA,2021-02-25,9,770,1,780,
MADHYA PRADESH,SAGAR,2021-02-23,7,675,0,682,
MADHYA PRADESH,SAGAR,2021-02-24,9,615,0,624,
MADHYA PRADESH,SAGAR,2021-02-25,10,648,1,659,
MADHYA PRADESH,SATNA,2021-02-23,11,292,0,303,
MADHYA PRADESH,SATNA,2021-02-24,6,448,1,455,
MADHYA PRADESH,SATNA,2021-02-25,0,172,1,173,
MADHYA PRADESH,SEHORE,2021-02-23,0,187,0,187,
MADHYA PRADESH,SEHORE,2021-02-24,1,330,0,331,
MADHYA PRADESH,SEHORE,2021-02-25,1,272,0,273,
MADHYA PRADESH,SEONI,2021-02-23,5,279,1,285,
MADHYA PRADESH,SEONI,2021-02-24,4,339,4,347,
MADHYA PRADESH,SEONI,2021-02-25,4,249,0,253,
MADHYA PRADESH,SHAHDOL,2021-02-23,1,12,0,13,
MADHYA PRADESH,SHAHDOL,2021-02-24,0,20,1,21,
MADHYA PRADESH,SHAHDOL,2021-02-25,0,64,1,65,
MADHYA PRADESH,SHAJAPUR,2021-02-23,3,181,0,184,
MADHYA PRADESH,SHAJAPUR,2021-02-24,5,162,0,167,
MADHYA PRADESH,SHAJAPUR,2021-02-25,1,192,0,193,
MADHYA PRADESH,SHEOPUR,2021-02-23,3,163,0,166,
MADHYA PRADESH,SHEOPUR,2021-02-24,2,223,0,225,
MADHYA PRADESH,SHEOPUR,2021-02-25,2,71,0,73,
MADHYA PRADESH,SHIVPURI,2021-02-23,0,180,11,191,
MADHYA PRADESH,SHIVPURI,2021-02-24,0,125,0,125,
MADHYA PRADESH,SHIVPURI,2021-02-25,1,203,13,217,
MADHYA PRADESH,SIDHI,2021-02-23,7,53,0,60,
MADHYA PRADESH,SIDHI,2021-02-24,5,247,0,252,
MADHYA PRADESH,SIDHI,2021-02-25,7,121,0,128,
MADHYA PRADESH,SINGRAULI,2021-02-23,8,131,0,139,
MADHYA PRADESH,SINGRAULI,2021-02-24,0,29,0,29,
MADHYA PRADESH,SINGRAULI,2021-02-25,7,119,0,126,
MADHYA PRADESH,TIKAMGARH,2021-02-23,0,164,0,164,
MADHYA PRADESH,TIKAMGARH,2021-02-24,0,180,0,180,
MADHYA PRADESH,TIKAMGARH,2021-02-25,0,174,0,174,
MADHYA PRADESH,UJJAIN,2021-02-23,14,92,0,106,
MADHYA PRADESH,UJJAIN,2021-02-24,9,71,1,81,
MADHYA PRADESH,UJJAIN,2021-02-25,4,242,0,246,
MADHYA PRADESH,UMARIA,2021-02-23,1,49,8,58,
MADHYA PRADESH,UMARIA,2021-02-24,0,167,22,189,
MADHYA PRADESH,UMARIA,2021-02-25,0,148,49,197,
MADHYA PRADESH,VIDISHA,2021-02-23,1,98,0,99,
MADHYA PRADESH,VIDISHA,2021-02-24,0,94,0,94,
MADHYA PRADESH,VIDISHA,2021-02-25,1,159,0,160,
MAHARASHTRA,AHMEDNAGAR,2021-02-23,337,2236,9,2582,
MAHARASHTRA,AHMEDNAGAR,2021-02-24,261,1339,6,1606,
MAHARASHTRA,AHMEDNAGAR,2021-02-25,183,723,4,910,
MAHARASHTRA,AKOLA,2021-02-23,204,258,0,462,
MAHARASHTRA,AKOLA,2021-02-24,276,787,4,1067,
MAHARASHTRA,AKOLA,2021-02-25,316,1060,7,1383,
MAHARASHTRA,AMRAVATI,2021-02-23,802,1248,5,2055,
MAHARASHTRA,AMRAVATI,2021-02-24,780,1330,5,2115,
MAHARASHTRA,AMRAVATI,2021-02-25,945,1258,3,2206,
MAHARASHTRA,AURANGABAD,2021-02-23,238,1209,0,1447,
MAHARASHTRA,AURANGABAD,2021-02-24,357,1018,2,1377,
MAHARASHTRA,AURANGABAD,2021-02-25,217,1464,1,1682,
MAHARASHTRA,BEED,2021-02-23,51,604,0,655,
MAHARASHTRA,BEED,2021-02-24,55,783,0,838,
MAHARASHTRA,BEED,2021-02-25,58,815,0,873,
MAHARASHTRA,BHANDARA,2021-02-23,15,722,0,737,
MAHARASHTRA,BHANDARA,2021-02-24,20,679,0,699,
MAHARASHTRA,BHANDARA,2021-02-25,43,900,1,944,
MAHARASHTRA,BULDHANA,2021-02-23,170,490,30,690,
MAHARASHTRA,BULDHANA,2021-02-24,138,453,0,591,
MAHARASHTRA,BULDHANA,2021-02-25,140,572,7,719,
MAHARASHTRA,CHANDRAPUR,2021-02-23,37,690,3,730,
MAHARASHTRA,CHANDRAPUR,2021-02-24,71,792,0,863,
MAHARASHTRA,CHANDRAPUR,2021-02-25,51,1078,1,1130,
MAHARASHTRA,DHULE,2021-02-23,76,272,0,348,
MAHARASHTRA,DHULE,2021-02-24,68,344,1,413,
MAHARASHTRA,DHULE,2021-02-25,61,280,0,341,
MAHARASHTRA,GADCHIROLI,2021-02-23,11,683,3,697,
MAHARASHTRA,GADCHIROLI,2021-02-24,7,595,1,603,
MAHARASHTRA,GADCHIROLI,2021-02-25,22,791,1,814,
MAHARASHTRA,GONDIA,2021-02-23,11,287,0,298,
MAHARASHTRA,GONDIA,2021-02-24,24,271,0,295,
MAHARASHTRA,GONDIA,2021-02-25,11,403,0,414,
MAHARASHTRA,HINGOLI,2021-02-23,39,236,0,275,
MAHARASHTRA,HINGOLI,2021-02-24,10,217,0,227,
MAHARASHTRA,HINGOLI,2021-02-25,57,259,0,316,
MAHARASHTRA,JALGAON,2021-02-23,289,1518,11,1818,
MAHARASHTRA,JALGAON,2021-02-24,401,2259,5,2665,
MAHARASHTRA,JALGAON,2021-02-25,494,1908,3,2405,
MAHARASHTRA,JALNA,2021-02-23,72,825,0,897,
MAHARASHTRA,JALNA,2021-02-24,53,541,0,594,
MAHARASHTRA,JALNA,2021-02-25,40,772,0,812,
MAHARASHTRA,KOLHAPUR,2021-02-23,75,3381,21,3477,
MAHARASHTRA,KOLHAPUR,2021-02-24,31,1408,6,1445,
MAHARASHTRA,KOLHAPUR,2021-02-25,37,1257,8,1302,
MAHARASHTRA,LATUR,2021-02-23,121,1318,5,1444,
MAHARASHTRA,LATUR,2021-02-24,89,1428,0,1517,
MAHARASHTRA,LATUR,2021-02-25,86,1491,2,1579,
MAHARASHTRA,MUMBAI,2021-02-23,985,14556,37,15578,
MAHARASHTRA,MUMBAI,2021-02-24,1020,17672,57,18749,
MAHARASHTRA,MUMBAI,2021-02-25,873,16933,73,17879,
MAHARASHTRA,MUMBAI SUBURBAN,2021-02-23,322,3344,0,3666,
MAHARASHTRA,MUMBAI SUBURBAN,2021-02-24,316,3484,7,3807,
MAHARASHTRA,MUMBAI SUBURBAN,2021-02-25,303,3768,4,4075,
MAHARASHTRA,NAGPUR,2021-02-23,1054,5382,21,6457,
MAHARASHTRA,NAGPUR,2021-02-24,1213,5488,29,6730,
MAHARASHTRA,NAGPUR,2021-02-25,1417,5954,24,7395,
MAHARASHTRA,NANDED,2021-02-23,123,1314,15,1452,
MAHARASHTRA,NANDED,2021-02-24,68,1520,3,1591,
MAHARASHTRA,NANDED,2021-02-25,90,1203,3,1296,
MAHARASHTRA,NANDURBAR,2021-02-23,16,166,0,182,
MAHARASHTRA,NANDURBAR,2021-02-24,17,302,0,319,
MAHARASHTRA,NANDURBAR,2021-02-25,30,209,2,241,
MAHARASHTRA,NASHIK,2021-02-23,424,2190,1,2615,
MAHARASHTRA,NASHIK,2021-02-24,773,2310,87,3170,
MAHARASHTRA,NASHIK,2021-02-25,375,1682,45,2102,
MAHARASHTRA,OSMANABAD,2021-02-23,17,443,0,460,
MAHARASHTRA,OSMANABAD,2021-02-24,30,365,0,395,
MAHARASHTRA,OSMANABAD,2021-02-25,26,370,3,399,
MAHARASHTRA,PALGHAR,2021-02-23,88,819,2,909,
MAHARASHTRA,PALGHAR,2021-02-24,52,1115,0,1167,
MAHARASHTRA,PALGHAR,2021-02-25,59,1110,6,1175,
MAHARASHTRA,PARBHANI,2021-02-23,123,846,14,983,
MAHARASHTRA,PARBHANI,2021-02-24,46,704,3,753,
MAHARASHTRA,PARBHANI,2021-02-25,38,848,2,888,
MAHARASHTRA,PUNE,2021-02-23,1631,7807,217,9655,
MAHARASHTRA,PUNE,2021-02-24,1592,7900,189,9681,
MAHARASHTRA,PUNE,2021-02-25,1618,8284,115,10017,
MAHARASHTRA,RAIGAD,2021-02-23,123,1031,3,1157,
MAHARASHTRA,RAIGAD,2021-02-24,101,1309,6,1416,
MAHARASHTRA,RAIGAD,2021-02-25,136,1554,11,1701,
MAHARASHTRA,RATNAGIRI,2021-02-23,10,487,0,497,
MAHARASHTRA,RATNAGIRI,2021-02-24,10,180,0,190,
MAHARASHTRA,RATNAGIRI,2021-02-25,6,105,1,112,
MAHARASHTRA,SANGLI,2021-02-23,31,1639,1,1671,
MAHARASHTRA,SANGLI,2021-02-24,23,1793,0,1816,
MAHARASHTRA,SANGLI,2021-02-25,21,1247,0,1268,
MAHARASHTRA,SATARA,2021-02-23,205,1000,4,1209,
MAHARASHTRA,SATARA,2021-02-24,111,1022,4,1137,
MAHARASHTRA,SATARA,2021-02-25,139,1562,11,1712,
MAHARASHTRA,SINDHUDURG,2021-02-23,6,240,1,247,
MAHARASHTRA,SINDHUDURG,2021-02-24,11,279,0,290,
MAHARASHTRA,SINDHUDURG,2021-02-25,1,352,0,353,
MAHARASHTRA,SOLAPUR,2021-02-23,150,1983,17,2150,
MAHARASHTRA,SOLAPUR,2021-02-24,99,1650,1,1750,
MAHARASHTRA,SOLAPUR,2021-02-25,139,1792,5,1936,
MAHARASHTRA,THANE,2021-02-23,745,7715,42,8502,
MAHARASHTRA,THANE,2021-02-24,855,8929,56,9840,
MAHARASHTRA,THANE,2021-02-25,789,9520,39,10348,
MAHARASHTRA,WARDHA,2021-02-23,239,844,13,1096,
MAHARASHTRA,WARDHA,2021-02-24,178,1052,2,1232,
MAHARASHTRA,WARDHA,2021-02-25,214,788,6,1008,
MAHARASHTRA,WASHIM,2021-02-23,318,837,3,1158,
MAHARASHTRA,WASHIM,2021-02-24,229,879,6,1114,
MAHARASHTRA,WASHIM,2021-02-25,153,1097,3,1253,
MAHARASHTRA,YAVATMAL,2021-02-23,183,504,3,690,
MAHARASHTRA,YAVATMAL,2021-02-24,163,715,1,879,
MAHARASHTRA,YAVATMAL,2021-02-25,113,741,1,855,
MANIPUR,BISHNUPUR,2021-02-23,0,147,0,147,
MANIPUR,BISHNUPUR,2021-02-24,1,66,0,67,
MANIPUR,BISHNUPUR,2021-02-25,1,54,0,55,
MANIPUR,CHANDEL,2021-02-23,0,10,0,10,
MANIPUR,CHANDEL,2021-02-24,0,24,0,24,
MANIPUR,CHANDEL,2021-02-25,0,11,0,11,
MANIPUR,CHURACHANDPUR,2021-02-23,0,90,0,90,
MANIPUR,CHURACHANDPUR,2021-02-24,0,132,0,132,
MANIPUR,CHURACHANDPUR,2021-02-25,0,91,0,91,
MANIPUR,IMPHAL EAST,2021-02-23,0,157,0,157,
MANIPUR,IMPHAL EAST,2021-02-24,1,144,0,145,
MANIPUR,IMPHAL EAST,2021-02-25,0,140,0,140,
MANIPUR,IMPHAL WEST,2021-02-23,3,621,0,624,
MANIPUR,IMPHAL WEST,2021-02-24,4,636,0,640,
MANIPUR,IMPHAL WEST,2021-02-25,6,545,0,551,
MANIPUR,JIRIBAM,2021-02-23,0,3,0,3,
MANIPUR,KAKCHING,2021-02-23,0,29,0,29,
MANIPUR,KAKCHING,2021-02-24,0,52,0,52,
MANIPUR,KAKCHING,2021-02-25,0,33,0,33,
MANIPUR,KAMJONG,2021-02-23,0,6,0,6,
MANIPUR,KAMJONG,2021-02-24,0,5,0,5,
MANIPUR,KAMJONG,2021-02-25,0,92,0,92,
MANIPUR,KANGPOKPI,2021-02-23,0,24,0,24,
MANIPUR,KANGPOKPI,2021-02-24,0,19,0,19,
MANIPUR,KANGPOKPI,2021-02-25,0,22,0,22,
MANIPUR,NONEY,2021-02-23,0,5,0,5,
MANIPUR,NONEY,2021-02-24,0,4,0,4,
MANIPUR,NONEY,2021-02-25,0,3,0,3,
MANIPUR,SENAPATI,2021-02-23,0,22,0,22,
MANIPUR,SENAPATI,2021-02-24,0,33,0,33,
MANIPUR,SENAPATI,2021-02-25,0,27,0,27,
MANIPUR,TAMENGLONG,2021-02-23,0,195,0,195,
MANIPUR,TAMENGLONG,2021-02-24,0,73,0,73,
MANIPUR,TAMENGLONG,2021-02-25,0,73,0,73,
MANIPUR,TENGNOUPAL,2021-02-23,0,10,0,10,
MANIPUR,TENGNOUPAL,2021-02-24,0,1,0,1,
MANIPUR,TENGNOUPAL,2021-02-25,0,4,0,4,
MANIPUR,THOUBAL,2021-02-23,0,152,0,152,
MANIPUR,THOUBAL,2021-02-24,1,97,0,98,
MANIPUR,THOUBAL,2021-02-25,7,107,0,114,
MANIPUR,UKHRUL,2021-02-23,0,130,0,130,
MANIPUR,UKHRUL,2021-02-24,0,85,0,85,
MANIPUR,UKHRUL,2021-02-25,1,74,0,75,
MEGHALAYA,EAST GARO HILLS,2021-02-23,0,32,0,32,
MEGHALAYA,EAST GARO HILLS,2021-02-24,0,14,0,14,
MEGHALAYA,EAST GARO HILLS,2021-02-25,0,28,0,28,
MEGHALAYA,EAST JAINTIA HILLS,2021-02-23,2,36,0,38,
MEGHALAYA,EAST JAINTIA HILLS,2021-02-24,0,24,0,24,
MEGHALAYA,EAST JAINTIA HILLS,2021-02-25,1,118,0,119,
MEGHALAYA,EAST KHASI HILLS,2021-02-23,1,858,0,859,
MEGHALAYA,EAST KHASI HILLS,2021-02-24,1,798,0,799,
MEGHALAYA,EAST KHASI HILLS,2021-02-25,2,984,0,986,
MEGHALAYA,NORTH GARO HILLS,2021-02-23,0,4,0,4,
MEGHALAYA,NORTH GARO HILLS,2021-02-25,0,11,0,11,
MEGHALAYA,RI BHOI,2021-02-23,0,185,0,185,
MEGHALAYA,RI BHOI,2021-02-24,1,77,0,78,
MEGHALAYA,RI BHOI,2021-02-25,0,105,0,105,
MEGHALAYA,SOUTH GARO HILLS,2021-02-23,0,11,0,11,
MEGHALAYA,SOUTH GARO HILLS,2021-02-24,0,2,0,2,
MEGHALAYA,SOUTH GARO HILLS,2021-02-25,0,3,0,3,
MEGHALAYA,SOUTH WEST GARO HILLS,2021-02-23,0,6,0,6,
MEGHALAYA,SOUTH WEST GARO HILLS,2021-02-24,0,25,0,25,
MEGHALAYA,SOUTH WEST GARO HILLS,2021-02-25,0,24,0,24,
MEGHALAYA,SOUTH WEST KHASI HILLS,2021-02-23,0,9,0,9,
MEGHALAYA,SOUTH WEST KHASI HILLS,2021-02-24,0,18,0,18,
MEGHALAYA,SOUTH WEST KHASI HILLS,2021-02-25,0,8,0,8,
MEGHALAYA,WEST GARO HILLS,2021-02-23,0,43,0,43,
MEGHALAYA,WEST GARO HILLS,2021-02-24,1,81,0,82,
MEGHALAYA,WEST GARO HILLS,2021-02-25,0,58,0,58,
MEGHALAYA,WEST JAINTIA HILLS,2021-02-23,0,74,0,74,
MEGHALAYA,WEST JAINTIA HILLS,2021-02-24,0,73,0,73,
MEGHALAYA,WEST JAINTIA HILLS,2021-02-25,0,74,0,74,
MEGHALAYA,WEST KHASI HILLS,2021-02-23,0,85,0,85,
MEGHALAYA,WEST KHASI HILLS,2021-02-24,0,55,0,55,
MEGHALAYA,WEST KHASI HILLS,2021-02-25,0,137,0,137,
MIZORAM,AIZAWL,2021-02-23,2,352,1,355,
MIZORAM,AIZAWL,2021-02-24,0,383,0,383,
MIZORAM,AIZAWL,2021-02-25,4,582,0,586,
MIZORAM,CHAMPHAI,2021-02-23,0,33,0,33,
MIZORAM,CHAMPHAI,2021-02-24,0,49,0,49,
MIZORAM,CHAMPHAI,2021-02-25,1,66,1,68,
MIZORAM,HNAHTHIAL,2021-02-23,0,4,0,4,
MIZORAM,HNAHTHIAL,2021-02-24,0,20,0,20,
MIZORAM,HNAHTHIAL,2021-02-25,0,15,0,15,
MIZORAM,KHAWZAWL,2021-02-23,0,1,0,1,
MIZORAM,KHAWZAWL,2021-02-24,0,6,0,6,
MIZORAM,KOLASIB,2021-02-23,0,194,0,194,
MIZORAM,KOLASIB,2021-02-24,0,163,0,163,
MIZORAM,KOLASIB,2021-02-25,0,76,0,76,
MIZORAM,LAWNGTLAI,2021-02-23,0,27,0,27,
MIZORAM,LAWNGTLAI,2021-02-24,0,11,0,11,
MIZORAM,LAWNGTLAI,2021-02-25,0,32,0,32,
MIZORAM,LUNGLEI,2021-02-23,1,48,0,49,
MIZORAM,LUNGLEI,2021-02-24,0,53,0,53,
MIZORAM,LUNGLEI,2021-02-25,0,49,0,49,
MIZORAM,MAMIT,2021-02-23,0,64,0,64,
MIZORAM,MAMIT,2021-02-24,0,63,0,63,
MIZORAM,MAMIT,2021-02-25,0,16,0,16,
MIZORAM,SAIHA,2021-02-23,0,10,0,10,
MIZORAM,SAIHA,2021-02-24,0,10,0,10,
MIZORAM,SAIHA,2021-02-25,0,5,0,5,
MIZORAM,SAITUAL,2021-02-23,0,14,0,14,
MIZORAM,SAITUAL,2021-02-24,0,93,0,93,
MIZORAM,SAITUAL,2021-02-25,1,66,0,67,
MIZORAM,SERCHHIP,2021-02-23,0,16,0,16,
MIZORAM,SERCHHIP,2021-02-24,0,6,0,6,
MIZORAM,SERCHHIP,2021-02-25,0,4,0,4,
NAGALAND,DIMAPUR,2021-02-23,6,142,0,148,
NAGALAND,DIMAPUR,2021-02-24,8,88,0,96,
NAGALAND,DIMAPUR,2021-02-25,15,68,0,83,
NAGALAND,KIPHIRE,2021-02-23,0,1,0,1,
NAGALAND,KIPHIRE,2021-02-24,0,4,0,4,
NAGALAND,KOHIMA,2021-02-23,23,84,0,107,
NAGALAND,KOHIMA,2021-02-24,0,76,0,76,
NAGALAND,KOHIMA,2021-02-25,15,114,0,129,
NAGALAND,LONGLENG,2021-02-24,0,1,0,1,
NAGALAND,MOKOKCHUNG,2021-02-23,0,9,0,9,
NAGALAND,MOKOKCHUNG,2021-02-24,0,14,0,14,
NAGALAND,MOKOKCHUNG,2021-02-25,0,9,0,9,
NAGALAND,MON,2021-02-23,1,7,0,8,
NAGALAND,MON,2021-02-24,0,4,0,4,
NAGALAND,MON,2021-02-25,0,1,0,1,
NAGALAND,PEREN,2021-02-23,0,2,0,2,
NAGALAND,PEREN,2021-02-24,0,4,0,4,
NAGALAND,PEREN,2021-02-25,0,1,0,1,
NAGALAND,PHEK,2021-02-23,0,4,0,4,
NAGALAND,PHEK,2021-02-25,0,1,0,1,
NAGALAND,WOKHA,2021-02-25,0,2,0,2,
NAGALAND,ZUNHEBOTO,2021-02-24,0,2,0,2,
NAGALAND,ZUNHEBOTO,2021-02-25,0,1,0,1,
ODISHA,ANUGUL,2021-02-23,4,435,0,439,
ODISHA,ANUGUL,2021-02-24,6,502,0,508,
ODISHA,ANUGUL,2021-02-25,2,521,0,523,
ODISHA,BALANGIR,2021-02-23,3,1153,1,1157,
ODISHA,BALANGIR,2021-02-24,1,955,8,964,
ODISHA,BALANGIR,2021-02-25,4,989,1,994,
ODISHA,BALESHWAR,2021-02-23,30,2954,2,2986,
ODISHA,BALESHWAR,2021-02-24,19,2644,9,2672,
ODISHA,BALESHWAR,2021-02-25,19,2372,1,2392,
ODISHA,BARGARH,2021-02-23,1,336,0,337,
ODISHA,BARGARH,2021-02-24,0,453,0,453,
ODISHA,BARGARH,2021-02-25,2,419,0,421,
ODISHA,BHADRAK,2021-02-23,0,810,2,812,
ODISHA,BHADRAK,2021-02-24,0,625,4,629,
ODISHA,BHADRAK,2021-02-25,3,602,7,612,
ODISHA,BOUDH,2021-02-23,0,412,0,412,
ODISHA,BOUDH,2021-02-24,1,390,0,391,
ODISHA,BOUDH,2021-02-25,0,310,0,310,
ODISHA,CUTTACK,2021-02-23,3,1632,0,1635,
ODISHA,CUTTACK,2021-02-24,4,1473,0,1477,
ODISHA,CUTTACK,2021-02-25,6,1683,0,1689,
ODISHA,DEOGARH,2021-02-23,2,77,0,79,
ODISHA,DEOGARH,2021-02-24,1,129,0,130,
ODISHA,DEOGARH,2021-02-25,0,191,0,191,
ODISHA,DHENKANAL,2021-02-23,0,647,0,647,
ODISHA,DHENKANAL,2021-02-24,0,699,0,699,
ODISHA,DHENKANAL,2021-02-25,0,1197,0,1197,
ODISHA,GAJAPATI,2021-02-23,0,200,0,200,
ODISHA,GAJAPATI,2021-02-24,1,307,3,311,
ODISHA,GAJAPATI,2021-02-25,2,190,0,192,
ODISHA,GANJAM,2021-02-23,0,1077,28,1105,
ODISHA,GANJAM,2021-02-24,1,1074,1,1076,
ODISHA,GANJAM,2021-02-25,3,1167,18,1188,
ODISHA,JAGATSINGHAPUR,2021-02-23,0,717,1,718,
ODISHA,JAGATSINGHAPUR,2021-02-24,0,686,0,686,
ODISHA,JAGATSINGHAPUR,2021-02-25,0,700,0,700,
ODISHA,JAJAPUR,2021-02-23,8,612,0,620,
ODISHA,JAJAPUR,2021-02-24,2,581,0,583,
ODISHA,JAJAPUR,2021-02-25,6,483,0,489,
ODISHA,JHARSUGUDA,2021-02-23,1,289,1,291,
ODISHA,JHARSUGUDA,2021-02-24,5,330,1,336,
ODISHA,JHARSUGUDA,2021-02-25,3,375,4,382,
ODISHA,KALAHANDI,2021-02-23,0,286,0,286,
ODISHA,KALAHANDI,2021-02-24,0,363,0,363,
ODISHA,KALAHANDI,2021-02-25,0,377,0,377,
ODISHA,KANDHAMAL,2021-02-23,0,603,0,603,
ODISHA,KANDHAMAL,2021-02-24,3,679,0,682,
ODISHA,KANDHAMAL,2021-02-25,0,754,0,754,
ODISHA,KENDRAPARA,2021-02-23,1,1261,0,1262,
ODISHA,KENDRAPARA,2021-02-24,1,1410,0,1411,
ODISHA,KENDRAPARA,2021-02-25,0,1119,0,1119,
ODISHA,KENDUJHAR,2021-02-23,1,637,0,638,
ODISHA,KENDUJHAR,2021-02-24,0,755,0,755,
ODISHA,KENDUJHAR,2021-02-25,0,725,0,725,
ODISHA,KHORDHA,2021-02-23,11,2126,2,2139,
ODISHA,KHORDHA,2021-02-24,13,2024,8,2045,
ODISHA,KHORDHA,2021-02-25,8,2295,3,2306,
ODISHA,KORAPUT,2021-02-23,0,1092,0,1092,
ODISHA,KORAPUT,2021-02-24,0,1271,0,1271,
ODISHA,KORAPUT,2021-02-25,1,1357,0,1358,
ODISHA,MALKANGIRI,2021-02-23,1,479,0,480,
ODISHA,MALKANGIRI,2021-02-24,0,377,0,377,
ODISHA,MALKANGIRI,2021-02-25,0,494,0,494,
ODISHA,MAYURBHANJ,2021-02-23,3,1510,0,1513,
ODISHA,MAYURBHANJ,2021-02-24,4,1744,0,1748,
ODISHA,MAYURBHANJ,2021-02-25,7,1571,0,1578,
ODISHA,NABARANGPUR,2021-02-23,0,786,0,786,
ODISHA,NABARANGPUR,2021-02-24,1,910,0,911,
ODISHA,NABARANGPUR,2021-02-25,5,671,0,676,
ODISHA,NAYAGARH,2021-02-23,0,726,1,727,
ODISHA,NAYAGARH,2021-02-24,0,607,1,608,
ODISHA,NAYAGARH,2021-02-25,1,636,0,637,
ODISHA,NUAPADA,2021-02-23,0,150,0,150,
ODISHA,NUAPADA,2021-02-24,2,119,0,121,
ODISHA,NUAPADA,2021-02-25,1,154,1,156,
ODISHA,PURI,2021-02-23,5,911,1,917,
ODISHA,PURI,2021-02-24,1,854,0,855,
ODISHA,PURI,2021-02-25,5,906,2,913,
ODISHA,RAYAGADA,2021-02-23,1,792,0,793,
ODISHA,RAYAGADA,2021-02-24,0,663,0,663,
ODISHA,RAYAGADA,2021-02-25,0,849,0,849,
ODISHA,SAMBALPUR,2021-02-23,41,394,1,436,
ODISHA,SAMBALPUR,2021-02-24,28,409,0,437,
ODISHA,SAMBALPUR,2021-02-25,38,453,0,491,
ODISHA,SONEPUR,2021-02-23,1,534,0,535,
ODISHA,SONEPUR,2021-02-24,0,330,0,330,
ODISHA,SONEPUR,2021-02-25,0,535,0,535,
ODISHA,SUNDARGARH,2021-02-23,10,605,0,615,
ODISHA,SUNDARGARH,2021-02-24,5,570,0,575,
ODISHA,SUNDARGARH,2021-02-25,4,506,0,510,
PUDUCHERRY,KARAIKAL,2021-02-23,4,235,0,239,
PUDUCHERRY,KARAIKAL,2021-02-24,3,287,0,290,
PUDUCHERRY,KARAIKAL,2021-02-25,6,234,0,240,
PUDUCHERRY,MAHE,2021-02-23,4,182,0,186,
PUDUCHERRY,MAHE,2021-02-24,7,247,0,254,
PUDUCHERRY,MAHE,2021-02-25,3,167,0,170,
PUDUCHERRY,PONDICHERRY,2021-02-23,20,606,1,627,
PUDUCHERRY,PONDICHERRY,2021-02-24,15,691,5,711,
PUDUCHERRY,PONDICHERRY,2021-02-25,9,263,4,276,
PUDUCHERRY,YANAM,2021-02-23,0,86,0,86,
PUDUCHERRY,YANAM,2021-02-24,0,225,0,225,
PUDUCHERRY,YANAM,2021-02-25,4,146,0,150,
PUNJAB,AMRITSAR,2021-02-23,64,1299,9,1372,
PUNJAB,AMRITSAR,2021-02-24,100,1069,12,1181,
PUNJAB,AMRITSAR,2021-02-25,45,1557,3,1605,
PUNJAB,BARNALA,2021-02-23,1,197,5,203,
PUNJAB,BARNALA,2021-02-24,1,136,0,137,
PUNJAB,BARNALA,2021-02-25,1,171,10,182,
PUNJAB,BATHINDA,2021-02-23,8,715,36,759,
PUNJAB,BATHINDA,2021-02-24,18,879,3,900,
PUNJAB,BATHINDA,2021-02-25,26,854,4,884,
PUNJAB,FARIDKOT,2021-02-23,13,248,1,262,
PUNJAB,FARIDKOT,2021-02-24,5,256,1,262,
PUNJAB,FARIDKOT,2021-02-25,11,385,4,400,
PUNJAB,FATEHGARH SAHIB,2021-02-23,1,152,0,153,
PUNJAB,FATEHGARH SAHIB,2021-02-24,5,650,1,656,
PUNJAB,FATEHGARH SAHIB,2021-02-25,8,342,1,351,
PUNJAB,FAZILKA,2021-02-23,1,122,1,124,
PUNJAB,FAZILKA,2021-02-24,0,153,0,153,
PUNJAB,FAZILKA,2021-02-25,4,121,6,131,
PUNJAB,FIROZEPUR,2021-02-23,0,389,2,391,
PUNJAB,FIROZEPUR,2021-02-24,0,358,0,358,
PUNJAB,FIROZEPUR,2021-02-25,5,190,16,211,
PUNJAB,GURDASPUR,2021-02-23,8,543,1,552,
PUNJAB,GURDASPUR,2021-02-24,21,703,5,729,
PUNJAB,GURDASPUR,2021-02-25,23,1027,4,1054,
PUNJAB,HOSHIARPUR,2021-02-23,31,664,1,696,
PUNJAB,HOSHIARPUR,2021-02-24,70,1540,6,1616,
PUNJAB,HOSHIARPUR,2021-02-25,48,1523,5,1576,
PUNJAB,JALANDHAR,2021-02-23,66,2257,121,2444,
PUNJAB,JALANDHAR,2021-02-24,100,2566,59,2725,
PUNJAB,JALANDHAR,2021-02-25,89,3118,68,3275,
PUNJAB,KAPURTHALA,2021-02-23,15,519,2,536,
PUNJAB,KAPURTHALA,2021-02-24,90,499,0,589,
PUNJAB,KAPURTHALA,2021-02-25,14,667,13,694,
PUNJAB,LUDHIANA,2021-02-23,78,2119,16,2213,
PUNJAB,LUDHIANA,2021-02-24,71,2466,7,2544,
PUNJAB,LUDHIANA,2021-02-25,74,2285,12,2371,
PUNJAB,MANSA,2021-02-23,2,278,0,280,
PUNJAB,MANSA,2021-02-24,1,325,0,326,
PUNJAB,MANSA,2021-02-25,0,380,0,380,
PUNJAB,MOGA,2021-02-23,18,224,2,244,
PUNJAB,MOGA,2021-02-24,10,309,1,320,
PUNJAB,MOGA,2021-02-25,3,369,9,381,
PUNJAB,PATHANKOT,2021-02-23,1,420,0,421,
PUNJAB,PATHANKOT,2021-02-24,4,816,1,821,
PUNJAB,PATHANKOT,2021-02-25,4,304,0,308,
PUNJAB,PATIALA,2021-02-23,28,1432,2,1462,
PUNJAB,PATIALA,2021-02-24,76,1406,4,1486,
PUNJAB,PATIALA,2021-02-25,71,1434,0,1505,
PUNJAB,RUPNAGAR,2021-02-23,11,759,1,771,
PUNJAB,RUPNAGAR,2021-02-24,13,603,1,617,
PUNJAB,RUPNAGAR,2021-02-25,8,1043,5,1056,
PUNJAB,S.A.S NAGAR,2021-02-23,36,893,3,932,
PUNJAB,S.A.S NAGAR,2021-02-24,64,1248,2,1314,
PUNJAB,S.A.S NAGAR,2021-02-25,61,1428,0,1489,
PUNJAB,SANGRUR,2021-02-23,9,966,0,975,
PUNJAB,SANGRUR,2021-02-24,13,1106,1,1120,
PUNJAB,SANGRUR,2021-02-25,3,1367,0,1370,
PUNJAB,SHAHID BHAGAT SINGH NAGAR,2021-02-23,107,785,1,893,
PUNJAB,SHAHID BHAGAT SINGH NAGAR,2021-02-24,77,908,1,986,
PUNJAB,SHAHID BHAGAT SINGH NAGAR,2021-02-25,122,1064,1,1187,
PUNJAB,SRI MUKTSAR SAHIB,2021-02-23,3,410,2,415,
PUNJAB,SRI MUKTSAR SAHIB,2021-02-24,4,405,1,410,
PUNJAB,SRI MUKTSAR SAHIB,2021-02-25,2,402,15,419,
PUNJAB,TARN TARAN,2021-02-23,10,565,0,575,
PUNJAB,TARN TARAN,2021-02-24,11,167,0,178,
PUNJAB,TARN TARAN,2021-02-25,1,440,0,441,
RAJASTHAN,AJMER,2021-02-23,1,148,763,912,
RAJASTHAN,AJMER,2021-02-24,2,95,692,789,
RAJASTHAN,AJMER,2021-02-25,6,100,546,652,
RAJASTHAN,ALWAR,2021-02-23,0,2970,78,3048,
RAJASTHAN,ALWAR,2021-02-24,4,3329,65,3398,
RAJASTHAN,ALWAR,2021-02-25,2,3549,80,3631,
RAJASTHAN,BANSWARA,2021-02-23,8,40,0,48,
RAJASTHAN,BANSWARA,2021-02-24,1,59,20,80,
RAJASTHAN,BANSWARA,2021-02-25,1,36,0,37,
RAJASTHAN,BARAN,2021-02-23,1,191,1,193,
RAJASTHAN,BARAN,2021-02-24,0,204,1,205,
RAJASTHAN,BARAN,2021-02-25,0,18,0,18,
RAJASTHAN,BARMER,2021-02-23,0,184,0,184,
RAJASTHAN,BARMER,2021-02-24,0,329,3,332,
RAJASTHAN,BARMER,2021-02-25,0,443,0,443,
RAJASTHAN,BHARATPUR,2021-02-23,3,651,8,662,
RAJASTHAN,BHARATPUR,2021-02-24,11,569,1,581,
RAJASTHAN,BHARATPUR,2021-02-25,1,167,4,172,
RAJASTHAN,BHILWARA,2021-02-23,9,372,3,384,
RAJASTHAN,BHILWARA,2021-02-24,7,398,1,406,
RAJASTHAN,BHILWARA,2021-02-25,2,528,3,533,
RAJASTHAN,BIKANER,2021-02-23,0,2086,0,2086,
RAJASTHAN,BIKANER,2021-02-24,1,1983,7,1991,
RAJASTHAN,BIKANER,2021-02-25,12,1612,1,1625,
RAJASTHAN,BUNDI,2021-02-23,0,62,2,64,
RAJASTHAN,BUNDI,2021-02-24,0,235,0,235,
RAJASTHAN,BUNDI,2021-02-25,1,215,0,216,
RAJASTHAN,CHITTORGARH,2021-02-23,12,821,1,834,
RAJASTHAN,CHITTORGARH,2021-02-24,4,495,8,507,
RAJASTHAN,CHITTORGARH,2021-02-25,6,919,2,927,
RAJASTHAN,CHURU,2021-02-23,0,445,1,446,
RAJASTHAN,CHURU,2021-02-24,0,417,4,421,
RAJASTHAN,CHURU,2021-02-25,2,333,1,336,
RAJASTHAN,DAUSA,2021-02-23,0,316,10,326,
RAJASTHAN,DAUSA,2021-02-24,0,299,18,317,
RAJASTHAN,DAUSA,2021-02-25,0,308,7,315,
RAJASTHAN,DHOLPUR,2021-02-23,4,375,3,382,
RAJASTHAN,DHOLPUR,2021-02-24,3,233,0,236,
RAJASTHAN,DHOLPUR,2021-02-25,0,17,0,17,
RAJASTHAN,DUNGARPUR,2021-02-23,2,276,0,278,
RAJASTHAN,DUNGARPUR,2021-02-24,3,289,18,310,
RAJASTHAN,DUNGARPUR,2021-02-25,2,288,0,290,
RAJASTHAN,GANGANAGAR,2021-02-23,221,286,39,546,
RAJASTHAN,GANGANAGAR,2021-02-24,200,373,32,605,
RAJASTHAN,GANGANAGAR,2021-02-25,223,275,53,551,
RAJASTHAN,HANUMANGARH,2021-02-23,0,483,0,483,
RAJASTHAN,HANUMANGARH,2021-02-24,2,675,1,678,
RAJASTHAN,HANUMANGARH,2021-02-25,1,713,0,714,
RAJASTHAN,JAIPUR,2021-02-23,55,2447,309,2811,
RAJASTHAN,JAIPUR,2021-02-24,38,1793,269,2100,
RAJASTHAN,JAIPUR,2021-02-25,93,2782,380,3255,
RAJASTHAN,JAISALMER,2021-02-23,0,48,0,48,
RAJASTHAN,JAISALMER,2021-02-24,0,136,0,136,
RAJASTHAN,JAISALMER,2021-02-25,0,83,1,84,
RAJASTHAN,JALORE,2021-02-23,0,711,2,713,
RAJASTHAN,JALORE,2021-02-24,0,783,4,787,
RAJASTHAN,JALORE,2021-02-25,0,731,0,731,
RAJASTHAN,JHALAWAR,2021-02-23,2,159,1,162,
RAJASTHAN,JHALAWAR,2021-02-24,3,299,0,302,
RAJASTHAN,JHALAWAR,2021-02-25,1,220,1,222,
RAJASTHAN,JHUNJHUNU,2021-02-23,0,82,1,83,
RAJASTHAN,JHUNJHUNU,2021-02-24,1,75,4,80,
RAJASTHAN,JHUNJHUNU,2021-02-25,0,91,4,95,
RAJASTHAN,JODHPUR,2021-02-23,22,974,2,998,
RAJASTHAN,JODHPUR,2021-02-24,7,661,4,672,
RAJASTHAN,JODHPUR,2021-02-25,5,509,2,516,
RAJASTHAN,KARAULI,2021-02-23,0,98,2,100,
RAJASTHAN,KARAULI,2021-02-24,12,573,10,595,
RAJASTHAN,KARAULI,2021-02-25,13,356,11,380,
RAJASTHAN,KOTA,2021-02-23,13,1042,2,1057,
RAJASTHAN,KOTA,2021-02-24,5,1096,2,1103,
RAJASTHAN,KOTA,2021-02-25,16,980,3,999,
RAJASTHAN,NAGAUR,2021-02-23,0,447,632,1079,
RAJASTHAN,NAGAUR,2021-02-24,0,241,633,874,
RAJASTHAN,NAGAUR,2021-02-25,0,202,215,417,
RAJASTHAN,PALI,2021-02-23,0,21,5,26,
RAJASTHAN,PALI,2021-02-24,0,16,10,26,
RAJASTHAN,PALI,2021-02-25,0,20,10,30,
RAJASTHAN,PRATAPGARH,2021-02-23,0,3,0,3,
RAJASTHAN,PRATAPGARH,2021-02-24,2,7,1,10,
RAJASTHAN,PRATAPGARH,2021-02-25,0,7,0,7,
RAJASTHAN,RAJSAMAND,2021-02-23,6,387,3,396,
RAJASTHAN,RAJSAMAND,2021-02-24,6,204,8,218,
RAJASTHAN,RAJSAMAND,2021-02-25,6,330,0,336,
RAJASTHAN,SAWAI MADHOPUR,2021-02-23,2,409,8,419,
RAJASTHAN,SAWAI MADHOPUR,2021-02-24,3,157,4,164,
RAJASTHAN,SAWAI MADHOPUR,2021-02-25,2,214,6,222,
RAJASTHAN,SIKAR,2021-02-23,2,352,7,361,
RAJASTHAN,SIKAR,2021-02-24,0,267,13,280,
RAJASTHAN,SIKAR,2021-02-25,0,443,8,451,
RAJASTHAN,SIROHI,2021-02-23,0,351,1,352,
RAJASTHAN,SIROHI,2021-02-24,2,345,1,348,
RAJASTHAN,SIROHI,2021-02-25,2,361,0,363,
RAJASTHAN,TONK,2021-02-23,3,476,10,489,
RAJASTHAN,TONK,2021-02-24,0,358,2,360,
RAJASTHAN,TONK,2021-02-25,0,112,7,119,
RAJASTHAN,UDAIPUR,2021-02-23,39,787,0,826,
RAJASTHAN,UDAIPUR,2021-02-24,43,637,20,700,
RAJASTHAN,UDAIPUR,2021-02-25,52,961,1,1014,
SIKKIM,EAST DISTRICT,2021-02-23,0,147,0,147,
SIKKIM,EAST DISTRICT,2021-02-24,1,133,0,134,
SIKKIM,EAST DISTRICT,2021-02-25,3,166,0,169,
SIKKIM,NORTH DISTRICT,2021-02-23,0,1,0,1,
SIKKIM,NORTH DISTRICT,2021-02-24,0,3,0,3,
SIKKIM,NORTH DISTRICT,2021-02-25,0,2,0,2,
SIKKIM,SOUTH DISTRICT,2021-02-23,0,5,0,5,
SIKKIM,SOUTH DISTRICT,2021-02-24,0,25,0,25,
SIKKIM,SOUTH DISTRICT,2021-02-25,0,6,0,6,
SIKKIM,WEST DISTRICT,2021-02-23,0,4,0,4,
SIKKIM,WEST DISTRICT,2021-02-24,0,1,0,1,
SIKKIM,WEST DISTRICT,2021-02-25,0,1,0,1,
TAMIL NADU,ARIYALUR,2021-02-23,0,741,0,741,
TAMIL NADU,ARIYALUR,2021-02-24,2,753,0,755,
TAMIL NADU,ARIYALUR,2021-02-25,0,312,0,312,
TAMIL NADU,CHENGALPATTU,2021-02-23,23,1773,0,1796,
TAMIL NADU,CHENGALPATTU,2021-02-24,26,2359,0,2385,
TAMIL NADU,CHENGALPATTU,2021-02-25,77,3015,0,3092,
TAMIL NADU,CHENNAI,2021-02-23,169,10100,11,10280,
TAMIL NADU,CHENNAI,2021-02-24,177,11053,22,11252,
TAMIL NADU,CHENNAI,2021-02-25,241,10853,10,11104,
TAMIL NADU,COIMBATORE,2021-02-23,63,1494,0,1557,
TAMIL NADU,COIMBATORE,2021-02-24,45,2643,1,2689,
TAMIL NADU,COIMBATORE,2021-02-25,47,2357,1,2405,
TAMIL NADU,CUDDALORE,2021-02-23,11,1200,2,1213,
TAMIL NADU,CUDDALORE,2021-02-24,11,1357,0,1368,
TAMIL NADU,CUDDALORE,2021-02-25,2,1267,0,1269,
TAMIL NADU,DHARMAPURI,2021-02-23,0,639,0,639,
TAMIL NADU,DHARMAPURI,2021-02-24,1,625,0,626,
TAMIL NADU,DHARMAPURI,2021-02-25,1,438,0,439,
TAMIL NADU,DINDIGUL,2021-02-23,17,175,0,192,
TAMIL NADU,DINDIGUL,2021-02-24,12,178,1,191,
TAMIL NADU,DINDIGUL,2021-02-25,12,279,0,291,
TAMIL NADU,ERODE,2021-02-23,8,1303,0,1311,
TAMIL NADU,ERODE,2021-02-24,15,1038,0,1053,
TAMIL NADU,ERODE,2021-02-25,11,1244,0,1255,
TAMIL NADU,KALLAKURICHI,2021-02-23,1,285,0,286,
TAMIL NADU,KALLAKURICHI,2021-02-24,0,337,0,337,
TAMIL NADU,KALLAKURICHI,2021-02-25,0,302,0,302,
TAMIL NADU,KANCHIPURAM,2021-02-23,17,1017,0,1034,
TAMIL NADU,KANCHIPURAM,2021-02-24,13,1178,0,1191,
TAMIL NADU,KANCHIPURAM,2021-02-25,9,1943,0,1952,
TAMIL NADU,KANNIYAKUMARI,2021-02-23,4,1426,5,1435,
TAMIL NADU,KANNIYAKUMARI,2021-02-24,8,1966,6,1980,
TAMIL NADU,KANNIYAKUMARI,2021-02-25,3,2047,19,2069,
TAMIL NADU,KARUR,2021-02-23,3,956,0,959,
TAMIL NADU,KARUR,2021-02-24,4,903,0,907,
TAMIL NADU,KARUR,2021-02-25,3,947,1,951,
TAMIL NADU,KRISHNAGIRI,2021-02-23,5,556,1,562,
TAMIL NADU,KRISHNAGIRI,2021-02-24,5,922,1,928,
TAMIL NADU,KRISHNAGIRI,2021-02-25,10,567,1,578,
TAMIL NADU,MADURAI,2021-02-23,9,2102,0,2111,
TAMIL NADU,MADURAI,2021-02-24,12,1636,0,1648,
TAMIL NADU,MADURAI,2021-02-25,6,2720,0,2726,
TAMIL NADU,NAGAPATTINAM,2021-02-23,5,487,0,492,
TAMIL NADU,NAGAPATTINAM,2021-02-24,5,466,0,471,
TAMIL NADU,NAGAPATTINAM,2021-02-25,6,477,0,483,
TAMIL NADU,NAMAKKAL,2021-02-23,5,549,0,554,
TAMIL NADU,NAMAKKAL,2021-02-24,10,974,1,985,
TAMIL NADU,NAMAKKAL,2021-02-25,3,789,2,794,
TAMIL NADU,PERAMBALUR,2021-02-23,0,201,0,201,
TAMIL NADU,PERAMBALUR,2021-02-24,1,286,0,287,
TAMIL NADU,PERAMBALUR,2021-02-25,0,222,0,222,
TAMIL NADU,PUDUKKOTTAI,2021-02-23,7,520,0,527,
TAMIL NADU,PUDUKKOTTAI,2021-02-24,1,545,0,546,
TAMIL NADU,PUDUKKOTTAI,2021-02-25,3,572,0,575,
TAMIL NADU,RAMANATHAPURAM,2021-02-23,3,913,0,916,
TAMIL NADU,RAMANATHAPURAM,2021-02-24,0,736,0,736,
TAMIL NADU,RAMANATHAPURAM,2021-02-25,2,752,0,754,
TAMIL NADU,RANIPET,2021-02-23,2,563,0,565,
TAMIL NADU,RANIPET,2021-02-24,2,329,0,331,
TAMIL NADU,RANIPET,2021-02-25,2,372,0,374,
TAMIL NADU,SALEM,2021-02-23,8,221,0,229,
TAMIL NADU,SALEM,2021-02-24,7,250,1,258,
TAMIL NADU,SALEM,2021-02-25,8,198,7,213,
TAMIL NADU,SIVAGANGA,2021-02-23,4,592,0,596,
TAMIL NADU,SIVAGANGA,2021-02-24,6,648,0,654,
TAMIL NADU,SIVAGANGA,2021-02-25,4,559,0,563,
TAMIL NADU,TENKASI,2021-02-23,12,521,10,543,
TAMIL NADU,TENKASI,2021-02-24,12,416,3,431,
TAMIL NADU,TENKASI,2021-02-25,9,437,3,449,
TAMIL NADU,THANJAVUR,2021-02-23,19,864,3,886,
TAMIL NADU,THANJAVUR,2021-02-24,17,494,1,512,
TAMIL NADU,THANJAVUR,2021-02-25,27,747,0,774,
TAMIL NADU,THE NILGIRIS,2021-02-23,6,1001,0,1007,
TAMIL NADU,THE NILGIRIS,2021-02-24,4,675,2,681,
TAMIL NADU,THE NILGIRIS,2021-02-25,7,510,2,519,
TAMIL NADU,THENI,2021-02-23,2,282,0,284,
TAMIL NADU,THENI,2021-02-24,1,437,0,438,
TAMIL NADU,THENI,2021-02-25,1,504,0,505,
TAMIL NADU,THIRUVALLUR,2021-02-23,50,1748,5,1803,
TAMIL NADU,THIRUVALLUR,2021-02-24,34,1367,1,1402,
TAMIL NADU,THIRUVALLUR,2021-02-25,48,1778,4,1830,
TAMIL NADU,THIRUVARUR,2021-02-23,1,733,0,734,
TAMIL NADU,THIRUVARUR,2021-02-24,5,811,0,816,
TAMIL NADU,THIRUVARUR,2021-02-25,4,412,0,416,
TAMIL NADU,TIRUCHIRAPPALLI,2021-02-23,9,1422,1,1432,
TAMIL NADU,TIRUCHIRAPPALLI,2021-02-24,8,1476,2,1486,
TAMIL NADU,TIRUCHIRAPPALLI,2021-02-25,16,1601,3,1620,
TAMIL NADU,TIRUNELVELI,2021-02-23,6,1012,0,1018,
TAMIL NADU,TIRUNELVELI,2021-02-24,15,1167,0,1182,
TAMIL NADU,TIRUNELVELI,2021-02-25,3,770,35,808,
TAMIL NADU,TIRUPATHUR,2021-02-23,2,1902,1,1905,
TAMIL NADU,TIRUPATHUR,2021-02-24,1,2165,3,2169,
TAMIL NADU,TIRUPATHUR,2021-02-25,1,2397,2,2400,
TAMIL NADU,TIRUPPUR,2021-02-23,25,1631,1,1657,
TAMIL NADU,TIRUPPUR,2021-02-24,18,1754,2,1774,
TAMIL NADU,TIRUPPUR,2021-02-25,16,1474,1,1491,
TAMIL NADU,TIRUVANNAMALAI,2021-02-23,4,832,0,836,
TAMIL NADU,TIRUVANNAMALAI,2021-02-24,1,977,0,978,
TAMIL NADU,TIRUVANNAMALAI,2021-02-25,4,875,0,879,
TAMIL NADU,TUTICORIN,2021-02-23,6,885,5,896,
TAMIL NADU,TUTICORIN,2021-02-24,0,829,1,830,
TAMIL NADU,TUTICORIN,2021-02-25,4,860,15,879,
TAMIL NADU,VELLORE,2021-02-23,12,1477,0,1489,
TAMIL NADU,VELLORE,2021-02-24,7,1195,0,1202,
TAMIL NADU,VELLORE,2021-02-25,7,1371,0,1378,
TAMIL NADU,VILLUPURAM,2021-02-23,1,483,0,484,
TAMIL NADU,VILLUPURAM,2021-02-24,1,918,0,919,
TAMIL NADU,VILLUPURAM,2021-02-25,4,876,0,880,
TAMIL NADU,VIRUDHUNAGAR,2021-02-23,0,1197,3,1200,
TAMIL NADU,VIRUDHUNAGAR,2021-02-24,5,1310,7,1322,
TAMIL NADU,VIRUDHUNAGAR,2021-02-25,6,212,3,221,
TELANGANA,ADILABAD,2021-02-23,1,532,0,533,
TELANGANA,ADILABAD,2021-02-24,0,420,0,420,
TELANGANA,ADILABAD,2021-02-25,1,510,0,511,
TELANGANA,BHADRADRI KOTHAGUDEM,2021-02-23,1,531,0,532,
TELANGANA,BHADRADRI KOTHAGUDEM,2021-02-24,0,364,0,364,
TELANGANA,BHADRADRI KOTHAGUDEM,2021-02-25,0,337,0,337,
TELANGANA,HYDERABAD,2021-02-23,25,7984,6,8015,
TELANGANA,HYDERABAD,2021-02-24,34,7357,2,7393,
TELANGANA,HYDERABAD,2021-02-25,35,7873,10,7918,
TELANGANA,JAGITIAL,2021-02-23,0,871,0,871,
TELANGANA,JAGITIAL,2021-02-24,0,816,0,816,
TELANGANA,JAGITIAL,2021-02-25,0,938,0,938,
TELANGANA,JANGOAN,2021-02-23,0,654,0,654,
TELANGANA,JANGOAN,2021-02-24,0,632,0,632,
TELANGANA,JANGOAN,2021-02-25,0,693,0,693,
TELANGANA,JAYASHANKAR BHUPALAPALLY,2021-02-23,0,318,0,318,
TELANGANA,JAYASHANKAR BHUPALAPALLY,2021-02-24,0,426,0,426,
TELANGANA,JAYASHANKAR BHUPALAPALLY,2021-02-25,0,294,0,294,
TELANGANA,JOGULAMBA GADWAL,2021-02-23,0,321,0,321,
TELANGANA,JOGULAMBA GADWAL,2021-02-24,0,378,0,378,
TELANGANA,JOGULAMBA GADWAL,2021-02-25,0,379,0,379,
TELANGANA,KAMAREDDY,2021-02-23,0,418,0,418,
TELANGANA,KAMAREDDY,2021-02-24,0,647,0,647,
TELANGANA,KAMAREDDY,2021-02-25,0,678,0,678,
TELANGANA,KARIMNAGAR,2021-02-23,1,1371,0,1372,
TELANGANA,KARIMNAGAR,2021-02-24,0,1575,0,1575,
TELANGANA,KARIMNAGAR,2021-02-25,0,1575,0,1575,
TELANGANA,KHAMMAM,2021-02-23,9,794,0,803,
TELANGANA,KHAMMAM,2021-02-24,1,683,0,684,
TELANGANA,KHAMMAM,2021-02-25,0,839,0,839,
TELANGANA,KUMURAM BHEEM ASIFABAD,2021-02-23,0,341,0,341,
TELANGANA,KUMURAM BHEEM ASIFABAD,2021-02-24,0,263,0,263,
TELANGANA,KUMURAM BHEEM ASIFABAD,2021-02-25,0,321,0,321,
TELANGANA,MAHABUBABAD,2021-02-23,0,444,0,444,
TELANGANA,MAHABUBABAD,2021-02-24,0,447,0,447,
TELANGANA,MAHABUBABAD,2021-02-25,0,436,0,436,
TELANGANA,MAHABUBNAGAR,2021-02-23,0,638,0,638,
TELANGANA,MAHABUBNAGAR,2021-02-24,0,712,0,712,
TELANGANA,MAHABUBNAGAR,2021-02-25,0,891,0,891,
TELANGANA,MANCHERIAL,2021-02-23,1,1149,0,1150,
TELANGANA,MANCHERIAL,2021-02-24,0,1208,0,1208,
TELANGANA,MANCHERIAL,2021-02-25,2,1199,0,1201,
TELANGANA,MEDAK,2021-02-23,0,371,0,371,
TELANGANA,MEDAK,2021-02-24,1,744,0,745,
TELANGANA,MEDAK,2021-02-25,0,548,2,550,
TELANGANA,MEDCHAL MALKAJGIRI,2021-02-23,3,1852,0,1855,
TELANGANA,MEDCHAL MALKAJGIRI,2021-02-24,0,2072,0,2072,
TELANGANA,MEDCHAL MALKAJGIRI,2021-02-25,0,2003,0,2003,
TELANGANA,MULUGU,2021-02-23,0,193,0,193,
TELANGANA,MULUGU,2021-02-24,0,215,0,215,
TELANGANA,MULUGU,2021-02-25,0,412,0,412,
TELANGANA,NAGARKURNOOL,2021-02-23,0,1087,0,1087,
TELANGANA,NAGARKURNOOL,2021-02-24,0,1323,0,1323,
TELANGANA,NAGARKURNOOL,2021-02-25,0,1504,0,1504,
TELANGANA,NALGONDA,2021-02-23,0,1011,0,1011,
TELANGANA,NALGONDA,2021-02-24,0,1269,0,1269,
TELANGANA,NALGONDA,2021-02-25,0,1331,0,1331,
TELANGANA,NARAYANPET,2021-02-23,0,177,0,177,
TELANGANA,NARAYANPET,2021-02-24,0,226,0,226,
TELANGANA,NARAYANPET,2021-02-25,0,208,0,208,
TELANGANA,NIRMAL,2021-02-23,0,1882,0,1882,
TELANGANA,NIRMAL,2021-02-24,0,1848,0,1848,
TELANGANA,NIRMAL,2021-02-25,0,937,0,937,
TELANGANA,NIZAMABAD,2021-02-23,0,539,0,539,
TELANGANA,NIZAMABAD,2021-02-24,0,669,0,669,
TELANGANA,NIZAMABAD,2021-02-25,0,797,0,797,
TELANGANA,PEDDAPALLI,2021-02-23,0,1088,0,1088,
TELANGANA,PEDDAPALLI,2021-02-24,0,1116,0,1116,
TELANGANA,PEDDAPALLI,2021-02-25,0,1131,0,1131,
TELANGANA,RAJANNA SIRCILLA,2021-02-23,0,209,0,209,
TELANGANA,RAJANNA SIRCILLA,2021-02-24,0,335,0,335,
TELANGANA,RAJANNA SIRCILLA,2021-02-25,0,282,0,282,
TELANGANA,RANGA REDDY,2021-02-23,2,2746,0,2748,
TELANGANA,RANGA REDDY,2021-02-24,5,2565,1,2571,
TELANGANA,RANGA REDDY,2021-02-25,6,2948,7,2961,
TELANGANA,SANGAREDDY,2021-02-23,3,761,0,764,
TELANGANA,SANGAREDDY,2021-02-24,0,604,0,604,
TELANGANA,SANGAREDDY,2021-02-25,0,614,1,615,
TELANGANA,SIDDIPET,2021-02-23,0,1244,0,1244,
TELANGANA,SIDDIPET,2021-02-24,0,1621,0,1621,
TELANGANA,SIDDIPET,2021-02-25,0,1648,0,1648,
TELANGANA,SURYAPET,2021-02-23,0,694,0,694,
TELANGANA,SURYAPET,2021-02-24,0,906,0,906,
TELANGANA,SURYAPET,2021-02-25,0,989,0,989,
TELANGANA,VIKARABAD,2021-02-23,0,475,1,476,
TELANGANA,VIKARABAD,2021-02-24,0,619,0,619,
TELANGANA,VIKARABAD,2021-02-25,1,612,0,613,
TELANGANA,WANAPARTHY,2021-02-23,0,175,0,175,
TELANGANA,WANAPARTHY,2021-02-24,0,274,0,274,
TELANGANA,WANAPARTHY,2021-02-25,0,346,0,346,
TELANGANA,WARANGAL RURAL,2021-02-23,0,332,0,332,
TELANGANA,WARANGAL RURAL,2021-02-24,4,331,0,335,
TELANGANA,WARANGAL RURAL,2021-02-25,0,296,0,296,
TELANGANA,WARANGAL URBAN,2021-02-23,0,1507,0,1507,
TELANGANA,WARANGAL URBAN,2021-02-24,0,2012,0,2012,
TELANGANA,WARANGAL URBAN,2021-02-25,2,2250,0,2252,
TELANGANA,YADADRI BHUVANAGIRI,2021-02-23,0,248,0,248,
TELANGANA,YADADRI BHUVANAGIRI,2021-02-24,0,437,0,437,
TELANGANA,YADADRI BHUVANAGIRI,2021-02-25,0,388,0,388,
TRIPURA,DHALAI,2021-02-23,0,8,0,8,
TRIPURA,DHALAI,2021-02-24,0,5,0,5,
TRIPURA,DHALAI,2021-02-25,0,28,0,28,
TRIPURA,GOMATI,2021-02-23,0,37,0,37,
TRIPURA,GOMATI,2021-02-24,0,50,0,50,
TRIPURA,GOMATI,2021-02-25,1,46,0,47,
TRIPURA,KHOWAI,2021-02-23,0,8,0,8,
TRIPURA,KHOWAI,2021-02-24,0,39,0,39,
TRIPURA,KHOWAI,2021-02-25,0,12,0,12,
TRIPURA,NORTH TRIPURA,2021-02-23,0,95,0,95,
TRIPURA,NORTH TRIPURA,2021-02-24,0,64,0,64,
TRIPURA,NORTH TRIPURA,2021-02-25,0,80,0,80,
TRIPURA,SEPAHIJALA,2021-02-23,0,47,0,47,
TRIPURA,SEPAHIJALA,2021-02-24,0,29,0,29,
TRIPURA,SEPAHIJALA,2021-02-25,1,43,0,44,
TRIPURA,SOUTH TRIPURA,2021-02-23,0,51,0,51,
TRIPURA,SOUTH TRIPURA,2021-02-24,0,50,0,50,
TRIPURA,SOUTH TRIPURA,2021-02-25,1,92,0,93,
TRIPURA,UNAKOTI,2021-02-23,0,5,0,5,
TRIPURA,UNAKOTI,2021-02-24,0,6,0,6,
TRIPURA,UNAKOTI,2021-02-25,0,3,0,3,
TRIPURA,WEST TRIPURA,2021-02-23,2,246,0,248,
TRIPURA,WEST TRIPURA,2021-02-24,2,235,0,237,
TRIPURA,WEST TRIPURA,2021-02-25,5,200,0,205,
UTTAR PRADESH,AGRA,2021-02-23,4,2336,1,2341,
UTTAR PRADESH,AGRA,2021-02-24,1,1853,1,1855,
UTTAR PRADESH,AGRA,2021-02-25,4,4807,2,4813,
UTTAR PRADESH,ALIGARH,2021-02-23,1,3715,99,3815,
UTTAR PRADESH,ALIGARH,2021-02-24,2,3827,19,3848,
UTTAR PRADESH,ALIGARH,2021-02-25,0,1522,5,1527,
UTTAR PRADESH,AMBEDKAR NAGAR,2021-02-23,0,1094,19,1113,
UTTAR PRADESH,AMBEDKAR NAGAR,2021-02-24,0,1274,2,1276,
UTTAR PRADESH,AMBEDKAR NAGAR,2021-02-25,0,1149,11,1160,
UTTAR PRADESH,AMETHI,2021-02-23,0,1841,0,1841,
UTTAR PRADESH,AMETHI,2021-02-24,0,1230,0,1230,
UTTAR PRADESH,AMETHI,2021-02-25,0,945,3,948,
UTTAR PRADESH,AMROHA,2021-02-23,0,1142,0,1142,
UTTAR PRADESH,AMROHA,2021-02-24,0,902,0,902,
UTTAR PRADESH,AMROHA,2021-02-25,0,580,0,580,
UTTAR PRADESH,AURAIYA,2021-02-23,1,679,94,774,
UTTAR PRADESH,AURAIYA,2021-02-24,0,1137,80,1217,
UTTAR PRADESH,AURAIYA,2021-02-25,0,706,93,799,
UTTAR PRADESH,AYODHYA,2021-02-23,1,1450,1,1452,
UTTAR PRADESH,AYODHYA,2021-02-24,1,1147,0,1148,
UTTAR PRADESH,AYODHYA,2021-02-25,5,1168,0,1173,
UTTAR PRADESH,AZAMGARH,2021-02-23,2,863,17,882,
UTTAR PRADESH,AZAMGARH,2021-02-24,0,975,2,977,
UTTAR PRADESH,AZAMGARH,2021-02-25,0,744,3,747,
UTTAR PRADESH,BAGHPAT,2021-02-23,0,404,39,443,
UTTAR PRADESH,BAGHPAT,2021-02-24,0,2262,33,2295,
UTTAR PRADESH,BAGHPAT,2021-02-25,0,1439,39,1478,
UTTAR PRADESH,BAHRAICH,2021-02-23,0,1723,36,1759,
UTTAR PRADESH,BAHRAICH,2021-02-24,0,1793,57,1850,
UTTAR PRADESH,BAHRAICH,2021-02-25,1,1520,86,1607,
UTTAR PRADESH,BALLIA,2021-02-23,2,747,0,749,
UTTAR PRADESH,BALLIA,2021-02-24,3,1252,2,1257,
UTTAR PRADESH,BALLIA,2021-02-25,0,1876,0,1876,
UTTAR PRADESH,BALRAMPUR,2021-02-23,0,1154,0,1154,
UTTAR PRADESH,BALRAMPUR,2021-02-24,1,998,0,999,
UTTAR PRADESH,BALRAMPUR,2021-02-25,0,881,0,881,
UTTAR PRADESH,BANDA,2021-02-23,2,1942,26,1970,
UTTAR PRADESH,BANDA,2021-02-24,0,1687,2,1689,
UTTAR PRADESH,BANDA,2021-02-25,2,1926,143,2071,
UTTAR PRADESH,BARABANKI,2021-02-23,2,1683,131,1816,
UTTAR PRADESH,BARABANKI,2021-02-24,0,1645,3,1648,
UTTAR PRADESH,BARABANKI,2021-02-25,0,925,0,925,
UTTAR PRADESH,BAREILLY,2021-02-23,3,1481,0,1484,
UTTAR PRADESH,BAREILLY,2021-02-24,6,1776,0,1782,
UTTAR PRADESH,BAREILLY,2021-02-25,5,3633,36,3674,
UTTAR PRADESH,BASTI,2021-02-23,3,981,49,1033,
UTTAR PRADESH,BASTI,2021-02-24,0,1275,211,1486,
UTTAR PRADESH,BASTI,2021-02-25,0,436,1,437,
UTTAR PRADESH,BHADOHI,2021-02-23,0,1424,0,1424,
UTTAR PRADESH,BHADOHI,2021-02-24,0,1501,0,1501,
UTTAR PRADESH,BHADOHI,2021-02-25,3,1512,1,1516,
UTTAR PRADESH,BIJNOR,2021-02-23,1,1557,60,1618,
UTTAR PRADESH,BIJNOR,2021-02-24,1,1530,0,1531,
UTTAR PRADESH,BIJNOR,2021-02-25,1,1445,3,1449,
UTTAR PRADESH,BUDAUN,2021-02-23,0,1863,28,1891,
UTTAR PRADESH,BUDAUN,2021-02-24,1,745,7,753,
UTTAR PRADESH,BUDAUN,2021-02-25,0,2761,88,2849,
UTTAR PRADESH,BULANDSHAHR,2021-02-23,0,2164,1,2165,
UTTAR PRADESH,BULANDSHAHR,2021-02-24,1,2198,0,2199,
UTTAR PRADESH,BULANDSHAHR,2021-02-25,1,1940,4,1945,
UTTAR PRADESH,CHANDAULI,2021-02-23,0,884,6,890,
UTTAR PRADESH,CHANDAULI,2021-02-24,1,830,7,838,
UTTAR PRADESH,CHANDAULI,2021-02-25,0,1083,14,1097,
UTTAR PRADESH,CHITRAKOOT,2021-02-23,2,921,5,928,
UTTAR PRADESH,CHITRAKOOT,2021-02-24,0,2578,15,2593,
UTTAR PRADESH,CHITRAKOOT,2021-02-25,0,808,30,838,
UTTAR PRADESH,DEORIA,2021-02-23,0,304,4,308,
UTTAR PRADESH,DEORIA,2021-02-24,1,1197,43,1241,
UTTAR PRADESH,DEORIA,2021-02-25,0,1048,59,1107,
UTTAR PRADESH,ETAH,2021-02-23,0,1085,1,1086,
UTTAR PRADESH,ETAH,2021-02-24,0,1045,0,1045,
UTTAR PRADESH,ETAH,2021-02-25,0,696,9,705,
UTTAR PRADESH,ETAWAH,2021-02-23,0,1774,120,1894,
UTTAR PRADESH,ETAWAH,2021-02-24,1,678,98,777,
UTTAR PRADESH,ETAWAH,2021-02-25,0,1967,87,2054,
UTTAR PRADESH,FARRUKHABAD,2021-02-23,3,1410,57,1470,
UTTAR PRADESH,FARRUKHABAD,2021-02-24,0,1248,1,1249,
UTTAR PRADESH,FARRUKHABAD,2021-02-25,0,1226,12,1238,
UTTAR PRADESH,FATEHPUR,2021-02-23,0,793,0,793,
UTTAR PRADESH,FATEHPUR,2021-02-24,0,1040,133,1173,
UTTAR PRADESH,FATEHPUR,2021-02-25,0,798,129,927,
UTTAR PRADESH,FIROZABAD,2021-02-23,16,1418,4,1438,
UTTAR PRADESH,FIROZABAD,2021-02-24,12,3541,8,3561,
UTTAR PRADESH,FIROZABAD,2021-02-25,17,2614,0,2631,
UTTAR PRADESH,GAUTAM BUDDHA NAGAR,2021-02-23,24,2448,14,2486,
UTTAR PRADESH,GAUTAM BUDDHA NAGAR,2021-02-24,29,2659,6,2694,
UTTAR PRADESH,GAUTAM BUDDHA NAGAR,2021-02-25,19,3066,55,3140,
UTTAR PRADESH,GHAZIABAD,2021-02-23,20,3008,152,3180,
UTTAR PRADESH,GHAZIABAD,2021-02-24,13,3884,173,4070,
UTTAR PRADESH,GHAZIABAD,2021-02-25,18,3480,223,3721,
UTTAR PRADESH,GHAZIPUR,2021-02-23,0,534,285,819,
UTTAR PRADESH,GHAZIPUR,2021-02-24,1,1184,67,1252,
UTTAR PRADESH,GHAZIPUR,2021-02-25,1,919,20,940,
UTTAR PRADESH,GONDA,2021-02-23,0,1418,72,1490,
UTTAR PRADESH,GONDA,2021-02-24,0,1226,0,1226,
UTTAR PRADESH,GONDA,2021-02-25,1,1607,74,1682,
UTTAR PRADESH,GORAKHPUR,2021-02-23,0,2263,69,2332,
UTTAR PRADESH,GORAKHPUR,2021-02-24,5,2718,16,2739,
UTTAR PRADESH,GORAKHPUR,2021-02-25,2,2351,95,2448,
UTTAR PRADESH,HAMIRPUR,2021-02-23,0,934,27,961,
UTTAR PRADESH,HAMIRPUR,2021-02-24,0,1159,46,1205,
UTTAR PRADESH,HAMIRPUR,2021-02-25,0,973,5,978,
UTTAR PRADESH,HAPUR,2021-02-23,0,655,11,666,
UTTAR PRADESH,HAPUR,2021-02-24,0,1833,5,1838,
UTTAR PRADESH,HAPUR,2021-02-25,6,954,17,977,
UTTAR PRADESH,HARDOI,2021-02-23,1,1203,230,1434,
UTTAR PRADESH,HARDOI,2021-02-24,2,1491,12,1505,
UTTAR PRADESH,HARDOI,2021-02-25,0,1259,330,1589,
UTTAR PRADESH,HATHRAS,2021-02-23,0,1139,0,1139,
UTTAR PRADESH,HATHRAS,2021-02-24,0,1357,0,1357,
UTTAR PRADESH,HATHRAS,2021-02-25,1,1004,0,1005,
UTTAR PRADESH,JALAUN,2021-02-23,1,1274,2,1277,
UTTAR PRADESH,JALAUN,2021-02-24,0,1309,4,1313,
UTTAR PRADESH,JALAUN,2021-02-25,0,1059,8,1067,
UTTAR PRADESH,JAUNPUR,2021-02-23,1,1522,64,1587,
UTTAR PRADESH,JAUNPUR,2021-02-24,1,1173,0,1174,
UTTAR PRADESH,JAUNPUR,2021-02-25,0,1764,1,1765,
UTTAR PRADESH,JHANSI,2021-02-23,4,3197,0,3201,
UTTAR PRADESH,JHANSI,2021-02-24,1,2566,0,2567,
UTTAR PRADESH,JHANSI,2021-02-25,6,2039,1,2046,
UTTAR PRADESH,KANNAUJ,2021-02-23,0,1641,0,1641,
UTTAR PRADESH,KANNAUJ,2021-02-24,0,1784,1,1785,
UTTAR PRADESH,KANNAUJ,2021-02-25,0,1621,0,1621,
UTTAR PRADESH,KANPUR DEHAT,2021-02-23,3,1721,0,1724,
UTTAR PRADESH,KANPUR DEHAT,2021-02-24,0,858,0,858,
UTTAR PRADESH,KANPUR DEHAT,2021-02-25,0,1099,0,1099,
UTTAR PRADESH,KANPUR NAGAR,2021-02-23,13,2612,0,2625,
UTTAR PRADESH,KANPUR NAGAR,2021-02-24,7,2590,2,2599,
UTTAR PRADESH,KANPUR NAGAR,2021-02-25,6,2336,1,2343,
UTTAR PRADESH,KASGANJ,2021-02-23,0,643,2,645,
UTTAR PRADESH,KASGANJ,2021-02-24,0,1590,8,1598,
UTTAR PRADESH,KASGANJ,2021-02-25,1,505,30,536,
UTTAR PRADESH,KAUSHAMBI,2021-02-23,0,1269,0,1269,
UTTAR PRADESH,KAUSHAMBI,2021-02-24,0,1741,0,1741,
UTTAR PRADESH,KAUSHAMBI,2021-02-25,0,1005,0,1005,
UTTAR PRADESH,KHERI,2021-02-23,6,2227,1,2234,
UTTAR PRADESH,KHERI,2021-02-24,3,2375,134,2512,
UTTAR PRADESH,KHERI,2021-02-25,0,1840,0,1840,
UTTAR PRADESH,KUSHI NAGAR,2021-02-23,1,1260,16,1277,
UTTAR PRADESH,KUSHI NAGAR,2021-02-24,1,835,45,881,
UTTAR PRADESH,KUSHI NAGAR,2021-02-25,0,1465,29,1494,
UTTAR PRADESH,LALITPUR,2021-02-23,0,1553,1,1554,
UTTAR PRADESH,LALITPUR,2021-02-24,0,2345,0,2345,
UTTAR PRADESH,LALITPUR,2021-02-25,1,1667,11,1679,
UTTAR PRADESH,LUCKNOW,2021-02-23,30,7184,31,7245,
UTTAR PRADESH,LUCKNOW,2021-02-24,18,6542,169,6729,
UTTAR PRADESH,LUCKNOW,2021-02-25,14,7686,15,7715,
UTTAR PRADESH,MAHARAJGANJ,2021-02-23,0,645,29,674,
UTTAR PRADESH,MAHARAJGANJ,2021-02-24,0,786,79,865,
UTTAR PRADESH,MAHARAJGANJ,2021-02-25,1,772,69,842,
UTTAR PRADESH,MAHOBA,2021-02-23,1,672,10,683,
UTTAR PRADESH,MAHOBA,2021-02-24,0,549,2,551,
UTTAR PRADESH,MAHOBA,2021-02-25,2,545,20,567,
UTTAR PRADESH,MAINPURI,2021-02-23,1,1465,0,1466,
UTTAR PRADESH,MAINPURI,2021-02-24,0,1540,0,1540,
UTTAR PRADESH,MAINPURI,2021-02-25,0,1509,0,1509,
UTTAR PRADESH,MATHURA,2021-02-23,0,1953,4,1957,
UTTAR PRADESH,MATHURA,2021-02-24,0,2385,2,2387,
UTTAR PRADESH,MATHURA,2021-02-25,2,4430,115,4547,
UTTAR PRADESH,MAU,2021-02-23,1,889,1,891,
UTTAR PRADESH,MAU,2021-02-24,1,1231,0,1232,
UTTAR PRADESH,MAU,2021-02-25,0,966,0,966,
UTTAR PRADESH,MEERUT,2021-02-23,4,3953,8,3965,
UTTAR PRADESH,MEERUT,2021-02-24,5,4430,3,4438,
UTTAR PRADESH,MEERUT,2021-02-25,3,3811,4,3818,
UTTAR PRADESH,MIRZAPUR,2021-02-23,0,1521,0,1521,
UTTAR PRADESH,MIRZAPUR,2021-02-24,1,1592,0,1593,
UTTAR PRADESH,MIRZAPUR,2021-02-25,0,1481,0,1481,
UTTAR PRADESH,MORADABAD,2021-02-23,0,2220,1,2221,
UTTAR PRADESH,MORADABAD,2021-02-24,0,2216,0,2216,
UTTAR PRADESH,MORADABAD,2021-02-25,1,1948,1,1950,
UTTAR PRADESH,MUZAFFARNAGAR,2021-02-23,2,1416,0,1418,
UTTAR PRADESH,MUZAFFARNAGAR,2021-02-24,1,1206,2,1209,
UTTAR PRADESH,MUZAFFARNAGAR,2021-02-25,2,1269,3,1274,
UTTAR PRADESH,PILIBHIT,2021-02-23,0,1581,27,1608,
UTTAR PRADESH,PILIBHIT,2021-02-24,1,1531,0,1532,
UTTAR PRADESH,PILIBHIT,2021-02-25,2,1373,7,1382,
UTTAR PRADESH,PRATAPGARH,2021-02-23,1,1778,178,1957,
UTTAR PRADESH,PRATAPGARH,2021-02-24,2,1573,84,1659,
UTTAR PRADESH,PRATAPGARH,2021-02-25,0,1627,1,1628,
UTTAR PRADESH,PRAYAGRAJ,2021-02-23,28,2869,0,2897,
UTTAR PRADESH,PRAYAGRAJ,2021-02-24,28,5640,0,5668,
UTTAR PRADESH,PRAYAGRAJ,2021-02-25,8,2933,0,2941,
UTTAR PRADESH,RAE BARELI,2021-02-23,3,1686,3,1692,
UTTAR PRADESH,RAE BARELI,2021-02-24,1,1502,2,1505,
UTTAR PRADESH,RAE BARELI,2021-02-25,3,2041,14,2058,
UTTAR PRADESH,RAMPUR,2021-02-23,1,1463,0,1464,
UTTAR PRADESH,RAMPUR,2021-02-24,1,1333,22,1356,
UTTAR PRADESH,RAMPUR,2021-02-25,0,1332,5,1337,
UTTAR PRADESH,SAHARANPUR,2021-02-23,5,2503,2,2510,
UTTAR PRADESH,SAHARANPUR,2021-02-24,2,2747,20,2769,
UTTAR PRADESH,SAHARANPUR,2021-02-25,4,1076,35,1115,
UTTAR PRADESH,SAMBHAL,2021-02-23,1,1476,14,1491,
UTTAR PRADESH,SAMBHAL,2021-02-24,0,2114,70,2184,
UTTAR PRADESH,SAMBHAL,2021-02-25,2,751,0,753,
UTTAR PRADESH,SANT KABEER NAGAR,2021-02-23,0,1196,1,1197,
UTTAR PRADESH,SANT KABEER NAGAR,2021-02-24,0,1138,0,1138,
UTTAR PRADESH,SANT KABEER NAGAR,2021-02-25,4,1512,1,1517,
UTTAR PRADESH,SHAHJAHANPUR,2021-02-23,8,1087,4,1099,
UTTAR PRADESH,SHAHJAHANPUR,2021-02-24,1,669,99,769,
UTTAR PRADESH,SHAHJAHANPUR,2021-02-25,0,1628,57,1685,
UTTAR PRADESH,SHAMLI,2021-02-23,0,980,0,980,
UTTAR PRADESH,SHAMLI,2021-02-24,0,1918,0,1918,
UTTAR PRADESH,SHAMLI,2021-02-25,1,1023,0,1024,
UTTAR PRADESH,SHRAVASTI,2021-02-23,0,749,0,749,
UTTAR PRADESH,SHRAVASTI,2021-02-24,0,733,0,733,
UTTAR PRADESH,SHRAVASTI,2021-02-25,0,734,1,735,
UTTAR PRADESH,SIDDHARTH NAGAR,2021-02-23,0,565,0,565,
UTTAR PRADESH,SIDDHARTH NAGAR,2021-02-24,0,875,105,980,
UTTAR PRADESH,SIDDHARTH NAGAR,2021-02-25,0,848,96,944,
UTTAR PRADESH,SITAPUR,2021-02-23,3,1650,11,1664,
UTTAR PRADESH,SITAPUR,2021-02-24,0,1715,5,1720,
UTTAR PRADESH,SITAPUR,2021-02-25,1,1604,7,1612,
UTTAR PRADESH,SONBHADRA,2021-02-23,1,1091,22,1114,
UTTAR PRADESH,SONBHADRA,2021-02-24,1,1562,0,1563,
UTTAR PRADESH,SONBHADRA,2021-02-25,1,1397,1,1399,
UTTAR PRADESH,SULTANPUR,2021-02-23,1,3670,36,3707,
UTTAR PRADESH,SULTANPUR,2021-02-24,5,9897,35,9937,
UTTAR PRADESH,SULTANPUR,2021-02-25,1,3194,71,3266,
UTTAR PRADESH,UNNAO,2021-02-23,1,1773,55,1829,
UTTAR PRADESH,UNNAO,2021-02-24,0,1676,53,1729,
UTTAR PRADESH,UNNAO,2021-02-25,0,1766,21,1787,
UTTAR PRADESH,VARANASI,2021-02-23,4,2757,38,2799,
UTTAR PRADESH,VARANASI,2021-02-24,8,2903,4,2915,
UTTAR PRADESH,VARANASI,2021-02-25,5,2301,4,2310,
UTTARAKHAND,ALMORA,2021-02-23,0,128,0,128,
UTTARAKHAND,ALMORA,2021-02-24,1,122,0,123,
UTTARAKHAND,ALMORA,2021-02-25,0,158,0,158,
UTTARAKHAND,BAGESHWAR,2021-02-23,0,57,0,57,
UTTARAKHAND,BAGESHWAR,2021-02-24,0,713,6,719,
UTTARAKHAND,BAGESHWAR,2021-02-25,1,338,0,339,
UTTARAKHAND,CHAMOLI,2021-02-23,1,273,2,276,
UTTARAKHAND,CHAMOLI,2021-02-24,0,56,0,56,
UTTARAKHAND,CHAMOLI,2021-02-25,1,197,2,200,
UTTARAKHAND,CHAMPAWAT,2021-02-23,0,204,0,204,
UTTARAKHAND,CHAMPAWAT,2021-02-24,1,145,33,179,
UTTARAKHAND,CHAMPAWAT,2021-02-25,0,106,1,107,
UTTARAKHAND,DEHRADUN,2021-02-23,29,2085,4,2118,
UTTARAKHAND,DEHRADUN,2021-02-24,21,1741,4,1766,
UTTARAKHAND,DEHRADUN,2021-02-25,14,1773,2,1789,
UTTARAKHAND,HARIDWAR,2021-02-23,4,1943,4,1951,
UTTARAKHAND,HARIDWAR,2021-02-24,6,1530,326,1862,
UTTARAKHAND,HARIDWAR,2021-02-25,2,2228,51,2281,
UTTARAKHAND,NAINITAL,2021-02-23,6,855,0,861,
UTTARAKHAND,NAINITAL,2021-02-24,6,909,3,918,
UTTARAKHAND,NAINITAL,2021-02-25,1,637,0,638,
UTTARAKHAND,PAURI GARHWAL,2021-02-23,0,423,5,428,
UTTARAKHAND,PAURI GARHWAL,2021-02-24,4,319,1,324,
UTTARAKHAND,PAURI GARHWAL,2021-02-25,1,167,26,194,
UTTARAKHAND,PITHORAGARH,2021-02-23,0,270,0,270,
UTTARAKHAND,PITHORAGARH,2021-02-24,0,22,0,22,
UTTARAKHAND,PITHORAGARH,2021-02-25,1,33,0,34,
UTTARAKHAND,RUDRA PRAYAG,2021-02-23,0,128,0,128,
UTTARAKHAND,RUDRA PRAYAG,2021-02-24,0,44,0,44,
UTTARAKHAND,RUDRA PRAYAG,2021-02-25,0,174,2,176,
UTTARAKHAND,TEHRI GARHWAL,2021-02-23,0,180,0,180,
UTTARAKHAND,TEHRI GARHWAL,2021-02-24,0,230,2,232,
UTTARAKHAND,TEHRI GARHWAL,2021-02-25,0,102,0,102,
UTTARAKHAND,UDAM SINGH NAGAR,2021-02-23,9,990,62,1061,
UTTARAKHAND,UDAM SINGH NAGAR,2021-02-24,7,1185,122,1314,
UTTARAKHAND,UDAM SINGH NAGAR,2021-02-25,3,813,1,817,
UTTARAKHAND,UTTAR KASHI,2021-02-23,0,85,0,85,
UTTARAKHAND,UTTAR KASHI,2021-02-24,0,29,0,29,
UTTARAKHAND,UTTAR KASHI,2021-02-25,0,455,0,455,
WEST BENGAL,24 PARAGANAS NORTH,2021-02-23,43,3346,13,3402,
WEST BENGAL,24 PARAGANAS NORTH,2021-02-24,39,3487,17,3543,
WEST BENGAL,24 PARAGANAS NORTH,2021-02-25,62,3163,9,3234,
WEST BENGAL,24 PARAGANAS SOUTH,2021-02-23,17,2670,3,2690,
WEST BENGAL,24 PARAGANAS SOUTH,2021-02-24,9,2654,1,2664,
WEST BENGAL,24 PARAGANAS SOUTH,2021-02-25,12,2906,5,2923,
WEST BENGAL,ALIPURDUAR,2021-02-23,0,87,0,87,
WEST BENGAL,ALIPURDUAR,2021-02-24,0,134,1,135,
WEST BENGAL,ALIPURDUAR,2021-02-25,0,162,1,163,
WEST BENGAL,BANKURA,2021-02-23,5,992,1,998,
WEST BENGAL,BANKURA,2021-02-24,3,988,1,992,
WEST BENGAL,BANKURA,2021-02-25,22,657,0,679,
WEST BENGAL,BIRBHUM,2021-02-23,4,544,7,555,
WEST BENGAL,BIRBHUM,2021-02-24,1,525,4,530,
WEST BENGAL,BIRBHUM,2021-02-25,1,472,1,474,
WEST BENGAL,COOCHBEHAR,2021-02-23,0,745,0,745,
WEST BENGAL,COOCHBEHAR,2021-02-24,2,944,9,955,
WEST BENGAL,COOCHBEHAR,2021-02-25,1,1184,0,1185,
WEST BENGAL,DARJEELING,2021-02-23,3,326,0,329,
WEST BENGAL,DARJEELING,2021-02-24,2,376,6,384,
WEST BENGAL,DARJEELING,2021-02-25,5,151,0,156,
WEST BENGAL,DINAJPUR DAKSHIN,2021-02-23,1,575,7,583,
WEST BENGAL,DINAJPUR DAKSHIN,2021-02-24,0,608,0,608,
WEST BENGAL,DINAJPUR DAKSHIN,2021-02-25,0,641,10,651,
WEST BENGAL,DINAJPUR UTTAR,2021-02-23,2,186,0,188,
WEST BENGAL,DINAJPUR UTTAR,2021-02-24,3,220,0,223,
WEST BENGAL,DINAJPUR UTTAR,2021-02-25,2,131,0,133,
WEST BENGAL,HOOGHLY,2021-02-23,7,390,0,397,
WEST BENGAL,HOOGHLY,2021-02-24,2,413,10,425,
WEST BENGAL,HOOGHLY,2021-02-25,3,357,2,362,
WEST BENGAL,HOWRAH,2021-02-23,17,1021,56,1094,
WEST BENGAL,HOWRAH,2021-02-24,9,996,48,1053,
WEST BENGAL,HOWRAH,2021-02-25,14,858,60,932,
WEST BENGAL,JALPAIGURI,2021-02-23,4,334,1,339,
WEST BENGAL,JALPAIGURI,2021-02-24,4,341,0,345,
WEST BENGAL,JALPAIGURI,2021-02-25,3,301,0,304,
WEST BENGAL,JHARGRAM,2021-02-23,0,28,0,28,
WEST BENGAL,JHARGRAM,2021-02-24,0,23,0,23,
WEST BENGAL,JHARGRAM,2021-02-25,0,23,0,23,
WEST BENGAL,KALIMPONG,2021-02-23,3,41,0,44,
WEST BENGAL,KALIMPONG,2021-02-24,0,81,0,81,
WEST BENGAL,KALIMPONG,2021-02-25,0,100,0,100,
WEST BENGAL,KOLKATA,2021-02-23,116,3451,7,3574,
WEST BENGAL,KOLKATA,2021-02-24,111,3294,8,3413,
WEST BENGAL,KOLKATA,2021-02-25,79,2890,10,2979,
WEST BENGAL,MALDAH,2021-02-23,1,566,1,568,
WEST BENGAL,MALDAH,2021-02-24,0,463,0,463,
WEST BENGAL,MALDAH,2021-02-25,1,704,8,713,
WEST BENGAL,MEDINIPUR EAST,2021-02-23,2,393,0,395,
WEST BENGAL,MEDINIPUR EAST,2021-02-24,4,710,2,716,
WEST BENGAL,MEDINIPUR EAST,2021-02-25,0,585,2,587,
WEST BENGAL,MEDINIPUR WEST,2021-02-23,2,316,5,323,
WEST BENGAL,MEDINIPUR WEST,2021-02-24,4,401,2,407,
WEST BENGAL,MEDINIPUR WEST,2021-02-25,3,365,2,370,
WEST BENGAL,MURSHIDABAD,2021-02-23,1,1107,1,1109,
WEST BENGAL,MURSHIDABAD,2021-02-24,1,968,7,976,
WEST BENGAL,MURSHIDABAD,2021-02-25,0,1128,3,1131,
WEST BENGAL,NADIA,2021-02-23,5,518,12,535,
WEST BENGAL,NADIA,2021-02-24,3,593,8,604,
WEST BENGAL,NADIA,2021-02-25,1,543,7,551,
WEST BENGAL,PASCHIM BARDHAMAN,2021-02-23,5,606,4,615,
WEST BENGAL,PASCHIM BARDHAMAN,2021-02-24,10,860,0,870,
WEST BENGAL,PASCHIM BARDHAMAN,2021-02-25,11,874,0,885,
WEST BENGAL,PURBA BARDHAMAN,2021-02-23,0,705,1,706,
WEST BENGAL,PURBA BARDHAMAN,2021-02-24,4,592,0,596,
WEST BENGAL,PURBA BARDHAMAN,2021-02-25,0,542,0,542,
WEST BENGAL,PURULIA,2021-02-23,6,239,0,245,
WEST BENGAL,PURULIA,2021-02-24,1,388,0,389,
WEST BENGAL,PURULIA,2021-02-25,2,544,0,546,
