state_residence,district_residence,Date,new_case,negative_case,Failed_test,Total_test
ANDAMAN AND NICOBAR ISLANDS,NICOBARS,2021-01-11,0,14,0,14
ANDAMAN AND NICOBAR ISLANDS,NICOBARS,2021-01-12,0,15,0,15
ANDAMAN AND NICOBAR ISLANDS,NICOBARS,2021-01-13,0,13,0,13
ANDAMAN AND NICOBAR ISLANDS,NICOBARS,2021-01-14,1,3,0,4
ANDAMAN AND NICOBAR ISLANDS,NICOBARS,2021-01-15,0,20,0,20
ANDAMAN AND NICOBAR ISLANDS,NORTH AND MIDDLE ANDAMAN,2021-01-11,0,8,0,8
ANDAMAN AND NICOBAR ISLANDS,NORTH AND MIDDLE ANDAMAN,2021-01-12,0,39,0,39
ANDAMAN AND NICOBAR ISLANDS,NORTH AND MIDDLE ANDAMAN,2021-01-13,1,6,0,7
ANDAMAN AND NICOBAR ISLANDS,NORTH AND MIDDLE ANDAMAN,2021-01-14,1,8,0,9
ANDAMAN AND NICOBAR ISLANDS,NORTH AND MIDDLE ANDAMAN,2021-01-15,0,6,0,6
ANDAMAN AND NICOBAR ISLANDS,SOUTH ANDAMANS,2021-01-11,1,571,0,572
ANDAMAN AND NICOBAR ISLANDS,SOUTH ANDAMANS,2021-01-12,1,595,0,596
ANDAMAN AND NICOBAR ISLANDS,SOUTH ANDAMANS,2021-01-13,0,488,0,488
ANDAMAN AND NICOBAR ISLANDS,SOUTH ANDAMANS,2021-01-14,1,212,0,213
ANDAMAN AND NICOBAR ISLANDS,SOUTH ANDAMANS,2021-01-15,0,487,0,487
ANDHRA PRADESH,ANANTAPUR,2021-01-11,6,1860,0,1866
ANDHRA PRADESH,ANANTAPUR,2021-01-12,23,3232,0,3255
ANDHRA PRADESH,ANANTAPUR,2021-01-13,9,6287,0,6296
ANDHRA PRADESH,ANANTAPUR,2021-01-14,4,4295,0,4299
ANDHRA PRADESH,ANANTAPUR,2021-01-15,3,1987,1,1991
ANDHRA PRADESH,CHITTOOR,2021-01-11,35,3733,0,3768
ANDHRA PRADESH,CHITTOOR,2021-01-12,22,2918,0,2940
ANDHRA PRADESH,CHITTOOR,2021-01-13,47,3865,0,3912
ANDHRA PRADESH,CHITTOOR,2021-01-14,17,2774,0,2791
ANDHRA PRADESH,CHITTOOR,2021-01-15,18,2061,0,2079
ANDHRA PRADESH,EAST GODAVARI,2021-01-11,20,3146,0,3166
ANDHRA PRADESH,EAST GODAVARI,2021-01-12,32,2091,0,2123
ANDHRA PRADESH,EAST GODAVARI,2021-01-13,17,1398,1,1416
ANDHRA PRADESH,EAST GODAVARI,2021-01-14,16,964,0,980
ANDHRA PRADESH,EAST GODAVARI,2021-01-15,16,428,0,444
ANDHRA PRADESH,GUNTUR,2021-01-11,30,1664,0,1694
ANDHRA PRADESH,GUNTUR,2021-01-12,42,3189,0,3231
ANDHRA PRADESH,GUNTUR,2021-01-13,26,4182,0,4208
ANDHRA PRADESH,GUNTUR,2021-01-14,14,1381,0,1395
ANDHRA PRADESH,GUNTUR,2021-01-15,9,1513,0,1522
ANDHRA PRADESH,KRISHNA,2021-01-11,36,1491,0,1527
ANDHRA PRADESH,KRISHNA,2021-01-12,51,2603,0,2654
ANDHRA PRADESH,KRISHNA,2021-01-13,30,3203,0,3233
ANDHRA PRADESH,KRISHNA,2021-01-14,13,3547,0,3560
ANDHRA PRADESH,KRISHNA,2021-01-15,21,731,0,752
ANDHRA PRADESH,KURNOOL,2021-01-11,6,1955,0,1961
ANDHRA PRADESH,KURNOOL,2021-01-12,5,2381,0,2386
ANDHRA PRADESH,KURNOOL,2021-01-13,19,3824,0,3843
ANDHRA PRADESH,KURNOOL,2021-01-14,2,3484,0,3486
ANDHRA PRADESH,KURNOOL,2021-01-15,9,1137,0,1146
ANDHRA PRADESH,PRAKASAM,2021-01-11,13,2879,0,2892
ANDHRA PRADESH,PRAKASAM,2021-01-12,2,2320,0,2322
ANDHRA PRADESH,PRAKASAM,2021-01-13,4,2603,0,2607
ANDHRA PRADESH,PRAKASAM,2021-01-14,6,3889,0,3895
ANDHRA PRADESH,PRAKASAM,2021-01-15,4,1737,0,1741
ANDHRA PRADESH,SPSR NELLORE,2021-01-11,9,4364,1,4374
ANDHRA PRADESH,SPSR NELLORE,2021-01-12,8,2755,0,2763
ANDHRA PRADESH,SPSR NELLORE,2021-01-13,7,2599,0,2606
ANDHRA PRADESH,SPSR NELLORE,2021-01-14,6,494,0,500
ANDHRA PRADESH,SPSR NELLORE,2021-01-15,5,2142,0,2147
ANDHRA PRADESH,SRIKAKULAM,2021-01-11,3,1612,0,1615
ANDHRA PRADESH,SRIKAKULAM,2021-01-12,13,2663,0,2676
ANDHRA PRADESH,SRIKAKULAM,2021-01-13,4,1596,0,1600
ANDHRA PRADESH,SRIKAKULAM,2021-01-14,0,1554,0,1554
ANDHRA PRADESH,SRIKAKULAM,2021-01-15,7,1563,0,1570
ANDHRA PRADESH,VISAKHAPATANAM,2021-01-11,35,2283,0,2318
ANDHRA PRADESH,VISAKHAPATANAM,2021-01-12,33,3566,0,3599
ANDHRA PRADESH,VISAKHAPATANAM,2021-01-13,10,2864,0,2874
ANDHRA PRADESH,VISAKHAPATANAM,2021-01-14,26,2858,0,2884
ANDHRA PRADESH,VISAKHAPATANAM,2021-01-15,26,1358,0,1384
ANDHRA PRADESH,VIZIANAGARAM,2021-01-11,4,685,0,689
ANDHRA PRADESH,VIZIANAGARAM,2021-01-12,14,3228,0,3242
ANDHRA PRADESH,VIZIANAGARAM,2021-01-13,11,1935,0,1946
ANDHRA PRADESH,VIZIANAGARAM,2021-01-14,2,1552,0,1554
ANDHRA PRADESH,VIZIANAGARAM,2021-01-15,3,1508,0,1511
ANDHRA PRADESH,WEST GODAVARI,2021-01-11,9,2027,0,2036
ANDHRA PRADESH,WEST GODAVARI,2021-01-12,8,5398,0,5406
ANDHRA PRADESH,WEST GODAVARI,2021-01-13,10,1653,0,1663
ANDHRA PRADESH,WEST GODAVARI,2021-01-14,4,326,0,330
ANDHRA PRADESH,WEST GODAVARI,2021-01-15,6,3011,0,3017
ANDHRA PRADESH,Y.S.R.,2021-01-11,17,2349,1,2367
ANDHRA PRADESH,Y.S.R.,2021-01-12,8,2752,0,2760
ANDHRA PRADESH,Y.S.R.,2021-01-13,10,2169,0,2179
ANDHRA PRADESH,Y.S.R.,2021-01-14,14,2195,0,2209
ANDHRA PRADESH,Y.S.R.,2021-01-15,1,782,0,783
ARUNACHAL PRADESH,ANJAW,2021-01-13,0,6,0,6
ARUNACHAL PRADESH,ANJAW,2021-01-14,0,12,0,12
ARUNACHAL PRADESH,ANJAW,2021-01-15,0,1,0,1
ARUNACHAL PRADESH,CHANGLANG,2021-01-11,3,3,0,6
ARUNACHAL PRADESH,CHANGLANG,2021-01-12,1,0,0,1
ARUNACHAL PRADESH,CHANGLANG,2021-01-14,0,3,0,3
ARUNACHAL PRADESH,CHANGLANG,2021-01-15,1,2,0,3
ARUNACHAL PRADESH,EAST KAMENG,2021-01-11,0,1,0,1
ARUNACHAL PRADESH,EAST KAMENG,2021-01-12,0,2,0,2
ARUNACHAL PRADESH,EAST KAMENG,2021-01-13,0,1,0,1
ARUNACHAL PRADESH,EAST SIANG,2021-01-11,2,32,0,34
ARUNACHAL PRADESH,EAST SIANG,2021-01-12,0,30,0,30
ARUNACHAL PRADESH,EAST SIANG,2021-01-13,0,32,0,32
ARUNACHAL PRADESH,EAST SIANG,2021-01-14,0,4,0,4
ARUNACHAL PRADESH,EAST SIANG,2021-01-15,1,33,0,34
ARUNACHAL PRADESH,KRA  DAADI,2021-01-15,0,1,0,1
ARUNACHAL PRADESH,KURUNG KUMEY,2021-01-11,0,3,0,3
ARUNACHAL PRADESH,KURUNG KUMEY,2021-01-15,0,1,0,1
ARUNACHAL PRADESH,LEPARADA,2021-01-12,0,1,0,1
ARUNACHAL PRADESH,LEPARADA,2021-01-13,0,1,0,1
ARUNACHAL PRADESH,LOHIT,2021-01-12,1,1,0,2
ARUNACHAL PRADESH,LOHIT,2021-01-13,0,1,0,1
ARUNACHAL PRADESH,LOHIT,2021-01-15,0,1,0,1
ARUNACHAL PRADESH,LONGDING,2021-01-11,0,11,0,11
ARUNACHAL PRADESH,LONGDING,2021-01-13,0,1,0,1
ARUNACHAL PRADESH,LONGDING,2021-01-14,0,1,0,1
ARUNACHAL PRADESH,LOWER DIBANG VALLEY,2021-01-11,0,4,0,4
ARUNACHAL PRADESH,LOWER DIBANG VALLEY,2021-01-13,0,1,0,1
ARUNACHAL PRADESH,LOWER DIBANG VALLEY,2021-01-14,0,38,0,38
ARUNACHAL PRADESH,LOWER DIBANG VALLEY,2021-01-15,0,1,0,1
ARUNACHAL PRADESH,LOWER SIANG,2021-01-11,0,13,0,13
ARUNACHAL PRADESH,LOWER SIANG,2021-01-12,0,8,0,8
ARUNACHAL PRADESH,LOWER SIANG,2021-01-13,0,4,0,4
ARUNACHAL PRADESH,LOWER SIANG,2021-01-14,0,4,0,4
ARUNACHAL PRADESH,LOWER SIANG,2021-01-15,0,15,0,15
ARUNACHAL PRADESH,LOWER SUBANSIRI,2021-01-11,0,9,0,9
ARUNACHAL PRADESH,LOWER SUBANSIRI,2021-01-12,0,88,0,88
ARUNACHAL PRADESH,LOWER SUBANSIRI,2021-01-14,0,6,0,6
ARUNACHAL PRADESH,LOWER SUBANSIRI,2021-01-15,0,2,0,2
ARUNACHAL PRADESH,NAMSAI,2021-01-13,0,1,0,1
ARUNACHAL PRADESH,NAMSAI,2021-01-14,0,2,0,2
ARUNACHAL PRADESH,NAMSAI,2021-01-15,0,2,0,2
ARUNACHAL PRADESH,PAPUM PARE,2021-01-11,0,37,0,37
ARUNACHAL PRADESH,PAPUM PARE,2021-01-12,1,21,0,22
ARUNACHAL PRADESH,PAPUM PARE,2021-01-13,0,16,0,16
ARUNACHAL PRADESH,PAPUM PARE,2021-01-14,1,5,0,6
ARUNACHAL PRADESH,PAPUM PARE,2021-01-15,0,23,0,23
ARUNACHAL PRADESH,SIANG,2021-01-11,0,2,0,2
ARUNACHAL PRADESH,TAWANG,2021-01-11,0,61,0,61
ARUNACHAL PRADESH,TAWANG,2021-01-12,2,39,0,41
ARUNACHAL PRADESH,TAWANG,2021-01-13,0,38,0,38
ARUNACHAL PRADESH,TAWANG,2021-01-14,0,1,0,1
ARUNACHAL PRADESH,TAWANG,2021-01-15,1,33,0,34
ARUNACHAL PRADESH,UPPER SIANG,2021-01-13,0,1,0,1
ARUNACHAL PRADESH,UPPER SUBANSIRI,2021-01-14,0,1,0,1
ARUNACHAL PRADESH,UPPER SUBANSIRI,2021-01-15,0,1,0,1
ARUNACHAL PRADESH,WEST KAMENG,2021-01-11,1,258,0,259
ARUNACHAL PRADESH,WEST KAMENG,2021-01-12,0,243,0,243
ARUNACHAL PRADESH,WEST KAMENG,2021-01-13,13,107,0,120
ARUNACHAL PRADESH,WEST KAMENG,2021-01-14,10,96,0,106
ARUNACHAL PRADESH,WEST KAMENG,2021-01-15,0,71,0,71
ARUNACHAL PRADESH,WEST SIANG,2021-01-11,0,1,0,1
ARUNACHAL PRADESH,WEST SIANG,2021-01-12,0,5,0,5
ARUNACHAL PRADESH,WEST SIANG,2021-01-13,0,1,0,1
ARUNACHAL PRADESH,WEST SIANG,2021-01-15,0,2,0,2
ASSAM,BAKSA,2021-01-11,1,73,0,74
ASSAM,BAKSA,2021-01-12,0,125,0,125
ASSAM,BAKSA,2021-01-13,0,15,0,15
ASSAM,BAKSA,2021-01-14,0,8,0,8
ASSAM,BAKSA,2021-01-15,0,9,0,9
ASSAM,BARPETA,2021-01-11,0,203,0,203
ASSAM,BARPETA,2021-01-12,0,236,0,236
ASSAM,BARPETA,2021-01-13,2,184,0,186
ASSAM,BARPETA,2021-01-14,0,63,0,63
ASSAM,BARPETA,2021-01-15,0,63,0,63
ASSAM,BISWANATH,2021-01-11,0,76,0,76
ASSAM,BISWANATH,2021-01-12,0,67,0,67
ASSAM,BISWANATH,2021-01-13,1,18,0,19
ASSAM,BISWANATH,2021-01-14,1,17,0,18
ASSAM,BISWANATH,2021-01-15,0,19,0,19
ASSAM,BONGAIGAON,2021-01-11,0,401,0,401
ASSAM,BONGAIGAON,2021-01-12,1,302,0,303
ASSAM,BONGAIGAON,2021-01-13,0,157,0,157
ASSAM,BONGAIGAON,2021-01-14,0,80,0,80
ASSAM,BONGAIGAON,2021-01-15,0,82,0,82
ASSAM,CACHAR,2021-01-11,3,181,9,193
ASSAM,CACHAR,2021-01-12,6,239,7,252
ASSAM,CACHAR,2021-01-13,7,120,8,135
ASSAM,CACHAR,2021-01-14,9,1111,0,1120
ASSAM,CACHAR,2021-01-15,1,1945,0,1946
ASSAM,CHARAIDEO,2021-01-11,0,190,0,190
ASSAM,CHARAIDEO,2021-01-12,0,126,0,126
ASSAM,CHARAIDEO,2021-01-13,0,11,0,11
ASSAM,CHARAIDEO,2021-01-14,0,5,0,5
ASSAM,CHARAIDEO,2021-01-15,0,68,0,68
ASSAM,CHIRANG,2021-01-11,0,39,0,39
ASSAM,CHIRANG,2021-01-12,0,27,0,27
ASSAM,CHIRANG,2021-01-13,0,32,0,32
ASSAM,CHIRANG,2021-01-14,0,67,0,67
ASSAM,CHIRANG,2021-01-15,0,6,0,6
ASSAM,DARRANG,2021-01-11,1,499,0,500
ASSAM,DARRANG,2021-01-12,1,559,0,560
ASSAM,DARRANG,2021-01-13,0,194,0,194
ASSAM,DARRANG,2021-01-14,1,113,0,114
ASSAM,DARRANG,2021-01-15,0,225,0,225
ASSAM,DHEMAJI,2021-01-11,0,51,0,51
ASSAM,DHEMAJI,2021-01-12,3,108,0,111
ASSAM,DHEMAJI,2021-01-13,0,88,0,88
ASSAM,DHEMAJI,2021-01-14,0,14,0,14
ASSAM,DHEMAJI,2021-01-15,0,63,0,63
ASSAM,DHUBRI,2021-01-11,0,369,0,369
ASSAM,DHUBRI,2021-01-12,0,346,0,346
ASSAM,DHUBRI,2021-01-13,0,246,0,246
ASSAM,DHUBRI,2021-01-14,0,69,0,69
ASSAM,DHUBRI,2021-01-15,1,181,3,185
ASSAM,DIBRUGARH,2021-01-11,3,899,2,904
ASSAM,DIBRUGARH,2021-01-12,1,250,1,252
ASSAM,DIBRUGARH,2021-01-13,2,432,15,449
ASSAM,DIBRUGARH,2021-01-14,1,308,1,310
ASSAM,DIBRUGARH,2021-01-15,0,151,4,155
ASSAM,DIMA HASAO,2021-01-11,0,86,0,86
ASSAM,DIMA HASAO,2021-01-12,0,29,0,29
ASSAM,DIMA HASAO,2021-01-13,0,65,0,65
ASSAM,DIMA HASAO,2021-01-14,0,11,0,11
ASSAM,DIMA HASAO,2021-01-15,0,31,0,31
ASSAM,GOALPARA,2021-01-11,2,752,0,754
ASSAM,GOALPARA,2021-01-12,1,487,0,488
ASSAM,GOALPARA,2021-01-13,1,415,0,416
ASSAM,GOALPARA,2021-01-14,0,194,0,194
ASSAM,GOALPARA,2021-01-15,0,289,0,289
ASSAM,GOLAGHAT,2021-01-11,51,424,0,475
ASSAM,GOLAGHAT,2021-01-12,28,318,1,347
ASSAM,GOLAGHAT,2021-01-13,3,74,0,77
ASSAM,GOLAGHAT,2021-01-14,0,51,0,51
ASSAM,GOLAGHAT,2021-01-15,2,102,0,104
ASSAM,HAILAKANDI,2021-01-11,2,316,0,318
ASSAM,HAILAKANDI,2021-01-12,0,297,1,298
ASSAM,HAILAKANDI,2021-01-13,0,224,1,225
ASSAM,HAILAKANDI,2021-01-14,2,152,1,155
ASSAM,HAILAKANDI,2021-01-15,2,263,0,265
ASSAM,HOJAI,2021-01-11,0,142,0,142
ASSAM,HOJAI,2021-01-12,0,140,0,140
ASSAM,HOJAI,2021-01-13,2,118,0,120
ASSAM,HOJAI,2021-01-14,0,25,0,25
ASSAM,HOJAI,2021-01-15,0,55,0,55
ASSAM,JORHAT,2021-01-11,5,563,1,569
ASSAM,JORHAT,2021-01-12,2,455,0,457
ASSAM,JORHAT,2021-01-13,3,148,1,152
ASSAM,JORHAT,2021-01-14,0,96,0,96
ASSAM,JORHAT,2021-01-15,1,457,0,458
ASSAM,KAMRUP,2021-01-11,1,700,0,701
ASSAM,KAMRUP,2021-01-12,1,552,0,553
ASSAM,KAMRUP,2021-01-13,1,324,0,325
ASSAM,KAMRUP,2021-01-14,0,174,0,174
ASSAM,KAMRUP,2021-01-15,1,380,0,381
ASSAM,KAMRUP METRO,2021-01-11,20,3581,1,3602
ASSAM,KAMRUP METRO,2021-01-12,29,3588,1,3618
ASSAM,KAMRUP METRO,2021-01-13,28,2590,2,2620
ASSAM,KAMRUP METRO,2021-01-14,9,1961,1,1971
ASSAM,KAMRUP METRO,2021-01-15,15,1929,1,1945
ASSAM,KARBI ANGLONG,2021-01-11,0,99,0,99
ASSAM,KARBI ANGLONG,2021-01-12,0,85,0,85
ASSAM,KARBI ANGLONG,2021-01-13,1,42,0,43
ASSAM,KARBI ANGLONG,2021-01-14,2,31,0,33
ASSAM,KARBI ANGLONG,2021-01-15,0,39,0,39
ASSAM,KARIMGANJ,2021-01-11,4,304,0,308
ASSAM,KARIMGANJ,2021-01-12,1,153,1,155
ASSAM,KARIMGANJ,2021-01-13,2,171,0,173
ASSAM,KARIMGANJ,2021-01-14,1,100,0,101
ASSAM,KARIMGANJ,2021-01-15,1,130,0,131
ASSAM,KOKRAJHAR,2021-01-11,0,88,0,88
ASSAM,KOKRAJHAR,2021-01-12,0,84,0,84
ASSAM,KOKRAJHAR,2021-01-13,0,42,0,42
ASSAM,KOKRAJHAR,2021-01-14,0,18,0,18
ASSAM,KOKRAJHAR,2021-01-15,3,26,0,29
ASSAM,LAKHIMPUR,2021-01-11,0,263,0,263
ASSAM,LAKHIMPUR,2021-01-12,1,186,0,187
ASSAM,LAKHIMPUR,2021-01-13,0,173,0,173
ASSAM,LAKHIMPUR,2021-01-14,0,67,0,67
ASSAM,LAKHIMPUR,2021-01-15,0,193,0,193
ASSAM,MAJULI,2021-01-11,0,8,0,8
ASSAM,MAJULI,2021-01-12,0,6,0,6
ASSAM,MAJULI,2021-01-13,0,3,0,3
ASSAM,MAJULI,2021-01-14,0,1,0,1
ASSAM,MAJULI,2021-01-15,0,9,0,9
ASSAM,MARIGAON,2021-01-11,0,82,0,82
ASSAM,MARIGAON,2021-01-12,0,69,0,69
ASSAM,MARIGAON,2021-01-13,0,22,0,22
ASSAM,MARIGAON,2021-01-14,1,11,0,12
ASSAM,MARIGAON,2021-01-15,0,13,0,13
ASSAM,NAGAON,2021-01-11,0,795,0,795
ASSAM,NAGAON,2021-01-12,0,570,0,570
ASSAM,NAGAON,2021-01-13,0,292,0,292
ASSAM,NAGAON,2021-01-14,0,102,0,102
ASSAM,NAGAON,2021-01-15,1,187,0,188
ASSAM,NALBARI,2021-01-11,1,122,0,123
ASSAM,NALBARI,2021-01-12,1,65,0,66
ASSAM,NALBARI,2021-01-13,0,43,0,43
ASSAM,NALBARI,2021-01-14,0,12,0,12
ASSAM,NALBARI,2021-01-15,0,27,0,27
ASSAM,SIVASAGAR,2021-01-11,1,143,3,147
ASSAM,SIVASAGAR,2021-01-12,0,175,0,175
ASSAM,SIVASAGAR,2021-01-13,1,79,0,80
ASSAM,SIVASAGAR,2021-01-14,0,37,0,37
ASSAM,SIVASAGAR,2021-01-15,0,72,0,72
ASSAM,SONITPUR,2021-01-11,2,264,0,266
ASSAM,SONITPUR,2021-01-12,2,259,0,261
ASSAM,SONITPUR,2021-01-13,5,205,0,210
ASSAM,SONITPUR,2021-01-14,3,120,0,123
ASSAM,SONITPUR,2021-01-15,1,291,0,292
ASSAM,SOUTH SALMARA MANCACHAR,2021-01-11,1,149,0,150
ASSAM,SOUTH SALMARA MANCACHAR,2021-01-12,0,116,0,116
ASSAM,SOUTH SALMARA MANCACHAR,2021-01-13,0,87,0,87
ASSAM,SOUTH SALMARA MANCACHAR,2021-01-14,0,40,0,40
ASSAM,SOUTH SALMARA MANCACHAR,2021-01-15,0,62,0,62
ASSAM,TINSUKIA,2021-01-11,4,457,0,461
ASSAM,TINSUKIA,2021-01-12,1,200,0,201
ASSAM,TINSUKIA,2021-01-13,3,52,0,55
ASSAM,TINSUKIA,2021-01-14,1,276,0,277
ASSAM,TINSUKIA,2021-01-15,1,95,17,113
ASSAM,UDALGURI,2021-01-11,0,41,0,41
ASSAM,UDALGURI,2021-01-12,0,38,0,38
ASSAM,UDALGURI,2021-01-13,1,3,0,4
ASSAM,UDALGURI,2021-01-14,3,6,0,9
ASSAM,UDALGURI,2021-01-15,0,52,0,52
ASSAM,WEST KARBI ANGLONG,2021-01-11,3,7,0,10
ASSAM,WEST KARBI ANGLONG,2021-01-12,0,12,0,12
ASSAM,WEST KARBI ANGLONG,2021-01-13,0,3,0,3
ASSAM,WEST KARBI ANGLONG,2021-01-14,0,6,0,6
ASSAM,WEST KARBI ANGLONG,2021-01-15,0,5,0,5
BIHAR,ARARIA,2021-01-11,1,1073,0,1074
BIHAR,ARARIA,2021-01-12,2,292,0,294
BIHAR,ARARIA,2021-01-13,1,634,0,635
BIHAR,ARARIA,2021-01-14,6,924,0,930
BIHAR,ARARIA,2021-01-15,10,851,0,861
BIHAR,ARWAL,2021-01-11,3,1222,19,1244
BIHAR,ARWAL,2021-01-12,0,998,3,1001
BIHAR,ARWAL,2021-01-13,9,1242,0,1251
BIHAR,ARWAL,2021-01-14,9,1064,0,1073
BIHAR,ARWAL,2021-01-15,0,854,0,854
BIHAR,AURANGABAD,2021-01-11,11,1147,1,1159
BIHAR,AURANGABAD,2021-01-12,9,1001,0,1010
BIHAR,AURANGABAD,2021-01-13,3,1052,0,1055
BIHAR,AURANGABAD,2021-01-14,9,801,0,810
BIHAR,AURANGABAD,2021-01-15,2,1091,0,1093
BIHAR,BANKA,2021-01-11,10,2604,31,2645
BIHAR,BANKA,2021-01-12,1,2889,0,2890
BIHAR,BANKA,2021-01-13,12,1383,49,1444
BIHAR,BANKA,2021-01-14,6,1851,90,1947
BIHAR,BANKA,2021-01-15,6,1717,0,1723
BIHAR,BEGUSARAI,2021-01-11,24,3990,1,4015
BIHAR,BEGUSARAI,2021-01-12,22,5610,1,5633
BIHAR,BEGUSARAI,2021-01-13,15,5959,0,5974
BIHAR,BEGUSARAI,2021-01-14,8,3823,0,3831
BIHAR,BEGUSARAI,2021-01-15,17,4755,3,4775
BIHAR,BHAGALPUR,2021-01-11,9,2061,152,2222
BIHAR,BHAGALPUR,2021-01-12,13,4347,114,4474
BIHAR,BHAGALPUR,2021-01-13,3,2752,124,2879
BIHAR,BHAGALPUR,2021-01-14,6,2235,190,2431
BIHAR,BHAGALPUR,2021-01-15,8,3530,190,3728
BIHAR,BHOJPUR,2021-01-11,8,1717,19,1744
BIHAR,BHOJPUR,2021-01-12,2,1991,79,2072
BIHAR,BHOJPUR,2021-01-13,5,1373,32,1410
BIHAR,BHOJPUR,2021-01-14,3,1855,78,1936
BIHAR,BHOJPUR,2021-01-15,4,1345,90,1439
BIHAR,BUXAR,2021-01-11,0,1485,132,1617
BIHAR,BUXAR,2021-01-12,2,1178,41,1221
BIHAR,BUXAR,2021-01-13,6,1490,149,1645
BIHAR,BUXAR,2021-01-14,2,1663,85,1750
BIHAR,BUXAR,2021-01-15,1,1701,9,1711
BIHAR,DARBHANGA,2021-01-11,9,1735,8,1752
BIHAR,DARBHANGA,2021-01-12,4,2112,1,2117
BIHAR,DARBHANGA,2021-01-13,13,2013,10,2036
BIHAR,DARBHANGA,2021-01-14,11,2577,0,2588
BIHAR,DARBHANGA,2021-01-15,36,2168,0,2204
BIHAR,GAYA,2021-01-11,2,4196,0,4198
BIHAR,GAYA,2021-01-12,4,3926,13,3943
BIHAR,GAYA,2021-01-13,3,2309,82,2394
BIHAR,GAYA,2021-01-14,1,3149,49,3199
BIHAR,GAYA,2021-01-15,3,4174,30,4207
BIHAR,GOPALGANJ,2021-01-11,5,2206,25,2236
BIHAR,GOPALGANJ,2021-01-12,0,990,0,990
BIHAR,GOPALGANJ,2021-01-13,5,1734,21,1760
BIHAR,GOPALGANJ,2021-01-14,3,1302,4,1309
BIHAR,GOPALGANJ,2021-01-15,1,1248,0,1249
BIHAR,JAMUI,2021-01-11,0,1057,0,1057
BIHAR,JAMUI,2021-01-12,1,1354,1,1356
BIHAR,JAMUI,2021-01-13,1,1212,1,1214
BIHAR,JAMUI,2021-01-14,0,840,0,840
BIHAR,JAMUI,2021-01-15,0,881,0,881
BIHAR,JEHANABAD,2021-01-11,4,1519,5,1528
BIHAR,JEHANABAD,2021-01-12,17,1089,71,1177
BIHAR,JEHANABAD,2021-01-13,4,983,0,987
BIHAR,JEHANABAD,2021-01-14,3,804,56,863
BIHAR,JEHANABAD,2021-01-15,3,840,0,843
BIHAR,KAIMUR (BHABUA),2021-01-11,2,998,0,1000
BIHAR,KAIMUR (BHABUA),2021-01-12,12,2365,0,2377
BIHAR,KAIMUR (BHABUA),2021-01-13,11,1737,4,1752
BIHAR,KAIMUR (BHABUA),2021-01-14,9,2608,0,2617
BIHAR,KAIMUR (BHABUA),2021-01-15,6,1815,1,1822
BIHAR,KATIHAR,2021-01-11,1,1045,0,1046
BIHAR,KATIHAR,2021-01-12,4,1515,0,1519
BIHAR,KATIHAR,2021-01-13,2,1480,0,1482
BIHAR,KATIHAR,2021-01-14,3,1926,0,1929
BIHAR,KATIHAR,2021-01-15,0,1167,0,1167
BIHAR,KHAGARIA,2021-01-11,4,939,1,944
BIHAR,KHAGARIA,2021-01-12,0,156,0,156
BIHAR,KHAGARIA,2021-01-13,1,1121,0,1122
BIHAR,KHAGARIA,2021-01-14,1,2386,0,2387
BIHAR,KHAGARIA,2021-01-15,3,950,0,953
BIHAR,KISHANGANJ,2021-01-11,0,1006,9,1015
BIHAR,KISHANGANJ,2021-01-12,2,1403,1,1406
BIHAR,KISHANGANJ,2021-01-13,1,1171,1,1173
BIHAR,KISHANGANJ,2021-01-14,0,1013,2,1015
BIHAR,KISHANGANJ,2021-01-15,1,1082,1,1084
BIHAR,LAKHISARAI,2021-01-11,4,425,0,429
BIHAR,LAKHISARAI,2021-01-12,6,1363,0,1369
BIHAR,LAKHISARAI,2021-01-13,1,930,0,931
BIHAR,LAKHISARAI,2021-01-14,1,629,0,630
BIHAR,LAKHISARAI,2021-01-15,3,607,1,611
BIHAR,MADHEPURA,2021-01-11,2,1641,0,1643
BIHAR,MADHEPURA,2021-01-12,4,2087,0,2091
BIHAR,MADHEPURA,2021-01-13,1,1985,0,1986
BIHAR,MADHEPURA,2021-01-14,0,1772,0,1772
BIHAR,MADHEPURA,2021-01-15,2,1720,0,1722
BIHAR,MADHUBANI,2021-01-11,6,1806,31,1843
BIHAR,MADHUBANI,2021-01-12,2,2427,2,2431
BIHAR,MADHUBANI,2021-01-13,7,1680,5,1692
BIHAR,MADHUBANI,2021-01-14,2,1595,23,1620
BIHAR,MADHUBANI,2021-01-15,2,1404,56,1462
BIHAR,MUNGER,2021-01-11,0,1708,61,1769
BIHAR,MUNGER,2021-01-12,7,1676,4,1687
BIHAR,MUNGER,2021-01-13,2,1549,48,1599
BIHAR,MUNGER,2021-01-14,4,1014,10,1028
BIHAR,MUNGER,2021-01-15,3,1195,6,1204
BIHAR,MUZAFFARPUR,2021-01-11,15,2337,0,2352
BIHAR,MUZAFFARPUR,2021-01-12,13,1782,3,1798
BIHAR,MUZAFFARPUR,2021-01-13,8,1976,0,1984
BIHAR,MUZAFFARPUR,2021-01-14,7,1923,0,1930
BIHAR,MUZAFFARPUR,2021-01-15,4,2448,2,2454
BIHAR,NALANDA,2021-01-11,4,3569,0,3573
BIHAR,NALANDA,2021-01-12,11,3310,1,3322
BIHAR,NALANDA,2021-01-13,4,3141,0,3145
BIHAR,NALANDA,2021-01-14,2,3589,41,3632
BIHAR,NALANDA,2021-01-15,12,3474,3,3489
BIHAR,NAWADA,2021-01-11,0,717,0,717
BIHAR,NAWADA,2021-01-12,9,1748,0,1757
BIHAR,NAWADA,2021-01-13,9,1447,0,1456
BIHAR,NAWADA,2021-01-14,3,1131,0,1134
BIHAR,NAWADA,2021-01-15,0,1440,3,1443
BIHAR,PASHCHIM CHAMPARAN,2021-01-11,0,2263,72,2335
BIHAR,PASHCHIM CHAMPARAN,2021-01-12,3,2425,648,3076
BIHAR,PASHCHIM CHAMPARAN,2021-01-13,6,1743,126,1875
BIHAR,PASHCHIM CHAMPARAN,2021-01-14,3,2462,0,2465
BIHAR,PASHCHIM CHAMPARAN,2021-01-15,3,2297,45,2345
BIHAR,PATNA,2021-01-11,174,5692,16,5882
BIHAR,PATNA,2021-01-12,149,5173,4,5326
BIHAR,PATNA,2021-01-13,151,5608,8,5767
BIHAR,PATNA,2021-01-14,196,4802,49,5047
BIHAR,PATNA,2021-01-15,129,5048,9,5186
BIHAR,PURBI CHAMPARAN,2021-01-11,3,3806,25,3834
BIHAR,PURBI CHAMPARAN,2021-01-12,1,3983,5,3989
BIHAR,PURBI CHAMPARAN,2021-01-13,6,4093,0,4099
BIHAR,PURBI CHAMPARAN,2021-01-14,5,3589,9,3603
BIHAR,PURBI CHAMPARAN,2021-01-15,8,3874,1,3883
BIHAR,PURNIA,2021-01-11,2,1475,13,1490
BIHAR,PURNIA,2021-01-12,1,1450,0,1451
BIHAR,PURNIA,2021-01-13,7,1094,4,1105
BIHAR,PURNIA,2021-01-14,3,1157,0,1160
BIHAR,PURNIA,2021-01-15,6,970,0,976
BIHAR,ROHTAS,2021-01-11,12,1382,0,1394
BIHAR,ROHTAS,2021-01-12,12,1727,0,1739
BIHAR,ROHTAS,2021-01-13,7,1896,0,1903
BIHAR,ROHTAS,2021-01-14,3,3431,3,3437
BIHAR,ROHTAS,2021-01-15,7,2005,0,2012
BIHAR,SAHARSA,2021-01-11,1,339,0,340
BIHAR,SAHARSA,2021-01-12,3,1952,3,1958
BIHAR,SAHARSA,2021-01-13,6,720,0,726
BIHAR,SAHARSA,2021-01-14,5,689,1,695
BIHAR,SAHARSA,2021-01-15,0,684,0,684
BIHAR,SAMASTIPUR,2021-01-11,5,2883,64,2952
BIHAR,SAMASTIPUR,2021-01-12,11,3202,22,3235
BIHAR,SAMASTIPUR,2021-01-13,1,2920,82,3003
BIHAR,SAMASTIPUR,2021-01-14,3,3294,6,3303
BIHAR,SAMASTIPUR,2021-01-15,5,2909,34,2948
BIHAR,SARAN,2021-01-11,8,3451,1,3460
BIHAR,SARAN,2021-01-12,6,2868,0,2874
BIHAR,SARAN,2021-01-13,15,2517,3,2535
BIHAR,SARAN,2021-01-14,14,1968,4,1986
BIHAR,SARAN,2021-01-15,8,2941,1,2950
BIHAR,SHEIKHPURA,2021-01-11,0,224,2,226
BIHAR,SHEIKHPURA,2021-01-12,2,713,11,726
BIHAR,SHEIKHPURA,2021-01-13,1,1177,8,1186
BIHAR,SHEIKHPURA,2021-01-14,0,479,0,479
BIHAR,SHEIKHPURA,2021-01-15,1,512,4,517
BIHAR,SHEOHAR,2021-01-11,1,803,0,804
BIHAR,SHEOHAR,2021-01-12,1,809,0,810
BIHAR,SHEOHAR,2021-01-13,6,930,0,936
BIHAR,SHEOHAR,2021-01-14,0,397,0,397
BIHAR,SHEOHAR,2021-01-15,3,457,0,460
BIHAR,SITAMARHI,2021-01-11,1,1541,0,1542
BIHAR,SITAMARHI,2021-01-12,3,540,0,543
BIHAR,SITAMARHI,2021-01-13,1,608,1,610
BIHAR,SITAMARHI,2021-01-14,1,1675,0,1676
BIHAR,SITAMARHI,2021-01-15,0,1086,1,1087
BIHAR,SIWAN,2021-01-11,6,1964,1,1971
BIHAR,SIWAN,2021-01-12,13,2123,0,2136
BIHAR,SIWAN,2021-01-13,2,1963,1,1966
BIHAR,SIWAN,2021-01-14,6,1981,0,1987
BIHAR,SIWAN,2021-01-15,5,2283,0,2288
BIHAR,SUPAUL,2021-01-11,1,1503,0,1504
BIHAR,SUPAUL,2021-01-12,3,1001,3,1007
BIHAR,SUPAUL,2021-01-13,0,1917,11,1928
BIHAR,SUPAUL,2021-01-14,3,2013,116,2132
BIHAR,SUPAUL,2021-01-15,2,1514,70,1586
BIHAR,VAISHALI,2021-01-11,5,3770,0,3775
BIHAR,VAISHALI,2021-01-12,1,4815,0,4816
BIHAR,VAISHALI,2021-01-13,6,3035,47,3088
BIHAR,VAISHALI,2021-01-14,5,3650,0,3655
BIHAR,VAISHALI,2021-01-15,2,3473,1,3476
CHANDIGARH,CHANDIGARH,2021-01-11,46,1268,35,1349
CHANDIGARH,CHANDIGARH,2021-01-12,67,1395,87,1549
CHANDIGARH,CHANDIGARH,2021-01-13,70,1199,86,1355
CHANDIGARH,CHANDIGARH,2021-01-14,34,1049,12,1095
CHANDIGARH,CHANDIGARH,2021-01-15,53,1210,27,1290
CHHATTISGARH,BALOD,2021-01-11,31,1012,0,1043
CHHATTISGARH,BALOD,2021-01-12,34,1031,0,1065
CHHATTISGARH,BALOD,2021-01-13,23,937,0,960
CHHATTISGARH,BALOD,2021-01-14,23,878,0,901
CHHATTISGARH,BALOD,2021-01-15,29,1024,1,1054
CHHATTISGARH,BALODA BAZAR,2021-01-11,34,773,37,844
CHHATTISGARH,BALODA BAZAR,2021-01-12,30,799,3,832
CHHATTISGARH,BALODA BAZAR,2021-01-13,23,704,2,729
CHHATTISGARH,BALODA BAZAR,2021-01-14,13,547,29,589
CHHATTISGARH,BALODA BAZAR,2021-01-15,18,462,40,520
CHHATTISGARH,BALRAMPUR,2021-01-11,20,550,1,571
CHHATTISGARH,BALRAMPUR,2021-01-12,6,572,2,580
CHHATTISGARH,BALRAMPUR,2021-01-13,16,645,0,661
CHHATTISGARH,BALRAMPUR,2021-01-14,3,491,2,496
CHHATTISGARH,BALRAMPUR,2021-01-15,13,700,5,718
CHHATTISGARH,BASTAR,2021-01-11,4,1297,0,1301
CHHATTISGARH,BASTAR,2021-01-12,8,1291,0,1299
CHHATTISGARH,BASTAR,2021-01-13,8,1293,0,1301
CHHATTISGARH,BASTAR,2021-01-14,3,1244,0,1247
CHHATTISGARH,BASTAR,2021-01-15,18,1460,0,1478
CHHATTISGARH,BEMETARA,2021-01-11,9,282,0,291
CHHATTISGARH,BEMETARA,2021-01-12,13,787,0,800
CHHATTISGARH,BEMETARA,2021-01-13,22,504,2,528
CHHATTISGARH,BEMETARA,2021-01-14,22,532,0,554
CHHATTISGARH,BEMETARA,2021-01-15,21,617,1,639
CHHATTISGARH,BIJAPUR,2021-01-11,1,336,0,337
CHHATTISGARH,BIJAPUR,2021-01-12,0,206,0,206
CHHATTISGARH,BIJAPUR,2021-01-13,1,194,0,195
CHHATTISGARH,BIJAPUR,2021-01-14,3,487,1,491
CHHATTISGARH,BIJAPUR,2021-01-15,2,216,0,218
CHHATTISGARH,BILASPUR,2021-01-11,106,1331,20,1457
CHHATTISGARH,BILASPUR,2021-01-12,91,899,8,998
CHHATTISGARH,BILASPUR,2021-01-13,63,1107,7,1177
CHHATTISGARH,BILASPUR,2021-01-14,83,1189,8,1280
CHHATTISGARH,BILASPUR,2021-01-15,49,1333,9,1391
CHHATTISGARH,DANTEWADA,2021-01-11,4,481,0,485
CHHATTISGARH,DANTEWADA,2021-01-12,1,223,0,224
CHHATTISGARH,DANTEWADA,2021-01-13,3,297,0,300
CHHATTISGARH,DANTEWADA,2021-01-14,5,234,0,239
CHHATTISGARH,DANTEWADA,2021-01-15,4,326,0,330
CHHATTISGARH,DHAMTARI,2021-01-11,30,890,5,925
CHHATTISGARH,DHAMTARI,2021-01-12,31,927,11,969
CHHATTISGARH,DHAMTARI,2021-01-13,22,620,9,651
CHHATTISGARH,DHAMTARI,2021-01-14,24,639,10,673
CHHATTISGARH,DHAMTARI,2021-01-15,40,773,11,824
CHHATTISGARH,DURG,2021-01-11,112,1538,0,1650
CHHATTISGARH,DURG,2021-01-12,111,1146,2,1259
CHHATTISGARH,DURG,2021-01-13,101,1073,4,1178
CHHATTISGARH,DURG,2021-01-14,93,1330,2,1425
CHHATTISGARH,DURG,2021-01-15,54,952,1,1007
CHHATTISGARH,GARIYABAND,2021-01-11,10,446,4,460
CHHATTISGARH,GARIYABAND,2021-01-12,10,386,17,413
CHHATTISGARH,GARIYABAND,2021-01-13,9,459,10,478
CHHATTISGARH,GARIYABAND,2021-01-14,4,296,1,301
CHHATTISGARH,GARIYABAND,2021-01-15,8,318,8,334
CHHATTISGARH,GAURELLA PENDRA MARWAHI,2021-01-11,5,248,0,253
CHHATTISGARH,GAURELLA PENDRA MARWAHI,2021-01-12,12,247,0,259
CHHATTISGARH,GAURELLA PENDRA MARWAHI,2021-01-13,1,263,0,264
CHHATTISGARH,GAURELLA PENDRA MARWAHI,2021-01-14,5,365,1,371
CHHATTISGARH,GAURELLA PENDRA MARWAHI,2021-01-15,2,370,2,374
CHHATTISGARH,JANJGIR CHAMPA,2021-01-11,36,1865,5,1906
CHHATTISGARH,JANJGIR CHAMPA,2021-01-12,33,1835,2,1870
CHHATTISGARH,JANJGIR CHAMPA,2021-01-13,42,2045,6,2093
CHHATTISGARH,JANJGIR CHAMPA,2021-01-14,38,1520,0,1558
CHHATTISGARH,JANJGIR CHAMPA,2021-01-15,19,2117,5,2141
CHHATTISGARH,JASHPUR,2021-01-11,44,942,16,1002
CHHATTISGARH,JASHPUR,2021-01-12,23,535,1,559
CHHATTISGARH,JASHPUR,2021-01-13,38,457,1,496
CHHATTISGARH,JASHPUR,2021-01-14,16,299,0,315
CHHATTISGARH,JASHPUR,2021-01-15,13,534,0,547
CHHATTISGARH,KABIRDHAM,2021-01-11,11,374,0,385
CHHATTISGARH,KABIRDHAM,2021-01-12,4,710,1,715
CHHATTISGARH,KABIRDHAM,2021-01-13,9,794,1,804
CHHATTISGARH,KABIRDHAM,2021-01-14,2,362,2,366
CHHATTISGARH,KABIRDHAM,2021-01-15,9,872,0,881
CHHATTISGARH,KANKER,2021-01-11,16,893,0,909
CHHATTISGARH,KANKER,2021-01-12,5,275,0,280
CHHATTISGARH,KANKER,2021-01-13,12,918,0,930
CHHATTISGARH,KANKER,2021-01-14,7,350,0,357
CHHATTISGARH,KANKER,2021-01-15,5,512,0,517
CHHATTISGARH,KONDAGAON,2021-01-11,10,620,0,630
CHHATTISGARH,KONDAGAON,2021-01-12,8,705,10,723
CHHATTISGARH,KONDAGAON,2021-01-13,2,350,1,353
CHHATTISGARH,KONDAGAON,2021-01-14,10,489,2,501
CHHATTISGARH,KONDAGAON,2021-01-15,2,366,4,372
CHHATTISGARH,KORBA,2021-01-11,44,1500,1,1545
CHHATTISGARH,KORBA,2021-01-12,17,925,3,945
CHHATTISGARH,KORBA,2021-01-13,18,928,0,946
CHHATTISGARH,KORBA,2021-01-14,28,1429,0,1457
CHHATTISGARH,KORBA,2021-01-15,9,1039,1,1049
CHHATTISGARH,KOREA,2021-01-11,9,863,0,872
CHHATTISGARH,KOREA,2021-01-12,22,839,0,861
CHHATTISGARH,KOREA,2021-01-13,18,939,0,957
CHHATTISGARH,KOREA,2021-01-14,19,887,0,906
CHHATTISGARH,KOREA,2021-01-15,19,964,0,983
CHHATTISGARH,MAHASAMUND,2021-01-11,36,777,0,813
CHHATTISGARH,MAHASAMUND,2021-01-12,45,1033,0,1078
CHHATTISGARH,MAHASAMUND,2021-01-13,27,1014,1,1042
CHHATTISGARH,MAHASAMUND,2021-01-14,26,695,1,722
CHHATTISGARH,MAHASAMUND,2021-01-15,33,983,0,1016
CHHATTISGARH,MUNGELI,2021-01-11,13,536,1,550
CHHATTISGARH,MUNGELI,2021-01-12,2,502,0,504
CHHATTISGARH,MUNGELI,2021-01-13,8,465,2,475
CHHATTISGARH,MUNGELI,2021-01-14,4,506,1,511
CHHATTISGARH,MUNGELI,2021-01-15,5,364,0,369
CHHATTISGARH,NARAYANPUR,2021-01-11,1,166,1,168
CHHATTISGARH,NARAYANPUR,2021-01-12,4,234,0,238
CHHATTISGARH,NARAYANPUR,2021-01-13,0,249,0,249
CHHATTISGARH,NARAYANPUR,2021-01-14,0,233,0,233
CHHATTISGARH,NARAYANPUR,2021-01-15,0,158,0,158
CHHATTISGARH,RAIGARH,2021-01-11,63,2429,4,2496
CHHATTISGARH,RAIGARH,2021-01-12,52,1747,18,1817
CHHATTISGARH,RAIGARH,2021-01-13,35,2032,10,2077
CHHATTISGARH,RAIGARH,2021-01-14,58,1102,0,1160
CHHATTISGARH,RAIGARH,2021-01-15,43,1497,5,1545
CHHATTISGARH,RAIPUR,2021-01-11,159,2509,22,2690
CHHATTISGARH,RAIPUR,2021-01-12,163,2435,42,2640
CHHATTISGARH,RAIPUR,2021-01-13,213,2490,57,2760
CHHATTISGARH,RAIPUR,2021-01-14,167,2068,23,2258
CHHATTISGARH,RAIPUR,2021-01-15,131,2330,8,2469
CHHATTISGARH,RAJNANDGAON,2021-01-11,72,1508,0,1580
CHHATTISGARH,RAJNANDGAON,2021-01-12,52,1558,5,1615
CHHATTISGARH,RAJNANDGAON,2021-01-13,67,1720,0,1787
CHHATTISGARH,RAJNANDGAON,2021-01-14,45,1673,0,1718
CHHATTISGARH,RAJNANDGAON,2021-01-15,37,1623,13,1673
CHHATTISGARH,SUKMA,2021-01-11,1,270,0,271
CHHATTISGARH,SUKMA,2021-01-12,2,339,0,341
CHHATTISGARH,SUKMA,2021-01-13,3,248,0,251
CHHATTISGARH,SUKMA,2021-01-14,6,469,0,475
CHHATTISGARH,SUKMA,2021-01-15,6,461,0,467
CHHATTISGARH,SURAJPUR,2021-01-11,15,977,0,992
CHHATTISGARH,SURAJPUR,2021-01-12,31,907,1,939
CHHATTISGARH,SURAJPUR,2021-01-13,18,654,1,673
CHHATTISGARH,SURAJPUR,2021-01-14,16,1023,1,1040
CHHATTISGARH,SURAJPUR,2021-01-15,15,1283,2,1300
CHHATTISGARH,SURGUJA,2021-01-11,24,1133,1,1158
CHHATTISGARH,SURGUJA,2021-01-12,28,955,0,983
CHHATTISGARH,SURGUJA,2021-01-13,22,709,0,731
CHHATTISGARH,SURGUJA,2021-01-14,17,687,1,705
CHHATTISGARH,SURGUJA,2021-01-15,15,865,7,887
DADRA AND NAGAR HAVELI,DADRA AND NAGAR HAVELI,2021-01-11,0,212,1,213
DADRA AND NAGAR HAVELI,DADRA AND NAGAR HAVELI,2021-01-12,0,302,0,302
DADRA AND NAGAR HAVELI,DADRA AND NAGAR HAVELI,2021-01-13,1,425,1,427
DADRA AND NAGAR HAVELI,DADRA AND NAGAR HAVELI,2021-01-14,0,376,0,376
DADRA AND NAGAR HAVELI,DADRA AND NAGAR HAVELI,2021-01-15,0,394,0,394
DAMAN AND DIU,DAMAN,2021-01-11,0,24,1,25
DAMAN AND DIU,DAMAN,2021-01-12,0,119,0,119
DAMAN AND DIU,DAMAN,2021-01-13,1,118,0,119
DAMAN AND DIU,DAMAN,2021-01-14,1,282,0,283
DAMAN AND DIU,DAMAN,2021-01-15,2,247,0,249
DAMAN AND DIU,DIU,2021-01-11,1,13,0,14
DAMAN AND DIU,DIU,2021-01-12,1,91,0,92
DAMAN AND DIU,DIU,2021-01-13,0,40,0,40
DAMAN AND DIU,DIU,2021-01-14,0,1,0,1
DAMAN AND DIU,DIU,2021-01-15,0,183,0,183
DELHI,CENTRAL,2021-01-11,24,5977,199,6200
DELHI,CENTRAL,2021-01-12,17,6151,9,6177
DELHI,CENTRAL,2021-01-13,18,4566,306,4890
DELHI,CENTRAL,2021-01-14,24,6482,138,6644
DELHI,CENTRAL,2021-01-15,13,6999,111,7123
DELHI,EAST,2021-01-11,28,5819,1,5848
DELHI,EAST,2021-01-12,45,5115,1,5161
DELHI,EAST,2021-01-13,36,4372,3,4411
DELHI,EAST,2021-01-14,22,3937,4,3963
DELHI,EAST,2021-01-15,26,5883,10,5919
DELHI,NEW DELHI,2021-01-11,72,5794,35,5901
DELHI,NEW DELHI,2021-01-12,74,5501,17,5592
DELHI,NEW DELHI,2021-01-13,54,6093,26,6173
DELHI,NEW DELHI,2021-01-14,66,4861,15,4942
DELHI,NEW DELHI,2021-01-15,61,6045,6,6112
DELHI,NORTH,2021-01-11,14,7397,47,7458
DELHI,NORTH,2021-01-12,28,7552,5,7585
DELHI,NORTH,2021-01-13,26,7804,11,7841
DELHI,NORTH,2021-01-14,22,8354,66,8442
DELHI,NORTH,2021-01-15,17,7628,23,7668
DELHI,NORTH EAST,2021-01-11,15,4712,30,4757
DELHI,NORTH EAST,2021-01-12,12,3962,19,3993
DELHI,NORTH EAST,2021-01-13,15,4478,17,4510
DELHI,NORTH EAST,2021-01-14,8,4453,6,4467
DELHI,NORTH EAST,2021-01-15,11,3607,14,3632
DELHI,NORTH WEST,2021-01-11,75,7399,10,7484
DELHI,NORTH WEST,2021-01-12,61,7688,2,7751
DELHI,NORTH WEST,2021-01-13,50,8375,7,8432
DELHI,NORTH WEST,2021-01-14,44,6812,6,6862
DELHI,NORTH WEST,2021-01-15,33,7542,58,7633
DELHI,SHAHDARA,2021-01-11,22,7891,3,7916
DELHI,SHAHDARA,2021-01-12,8,7568,3,7579
DELHI,SHAHDARA,2021-01-13,21,5606,3,5630
DELHI,SHAHDARA,2021-01-14,12,6643,5,6660
DELHI,SHAHDARA,2021-01-15,22,7504,2,7528
DELHI,SOUTH,2021-01-11,51,6508,7,6566
DELHI,SOUTH,2021-01-12,61,5573,6,5640
DELHI,SOUTH,2021-01-13,60,6978,5,7043
DELHI,SOUTH,2021-01-14,38,4912,7,4957
DELHI,SOUTH,2021-01-15,42,5854,25,5921
DELHI,SOUTH EAST,2021-01-11,45,7381,3,7429
DELHI,SOUTH EAST,2021-01-12,35,6218,2,6255
DELHI,SOUTH EAST,2021-01-13,41,7667,3,7711
DELHI,SOUTH EAST,2021-01-14,40,5885,1,5926
DELHI,SOUTH EAST,2021-01-15,42,6087,4,6133
DELHI,SOUTH WEST,2021-01-11,56,8193,8,8257
DELHI,SOUTH WEST,2021-01-12,35,6535,13,6583
DELHI,SOUTH WEST,2021-01-13,38,6051,4,6093
DELHI,SOUTH WEST,2021-01-14,40,6302,15,6357
DELHI,SOUTH WEST,2021-01-15,44,6719,7,6770
DELHI,WEST,2021-01-11,61,8028,13,8102
DELHI,WEST,2021-01-12,53,8621,5,8679
DELHI,WEST,2021-01-13,27,8881,4,8912
DELHI,WEST,2021-01-14,40,7919,10,7969
DELHI,WEST,2021-01-15,30,7524,13,7567
GOA,NORTH GOA,2021-01-11,32,989,2,1023
GOA,NORTH GOA,2021-01-12,50,992,0,1042
GOA,NORTH GOA,2021-01-13,52,847,2,901
GOA,NORTH GOA,2021-01-14,56,856,5,917
GOA,NORTH GOA,2021-01-15,52,832,0,884
GOA,SOUTH GOA,2021-01-11,31,929,3,963
GOA,SOUTH GOA,2021-01-12,33,807,1,841
GOA,SOUTH GOA,2021-01-13,47,866,0,913
GOA,SOUTH GOA,2021-01-14,64,982,1,1047
GOA,SOUTH GOA,2021-01-15,44,785,0,829
GUJARAT,AHMADABAD,2021-01-11,99,4543,81,4723
GUJARAT,AHMADABAD,2021-01-12,125,3131,10,3266
GUJARAT,AHMADABAD,2021-01-13,138,3923,47,4108
GUJARAT,AHMADABAD,2021-01-14,49,1237,1,1287
GUJARAT,AHMADABAD,2021-01-15,50,1757,8,1815
GUJARAT,AMRELI,2021-01-11,48,941,6,995
GUJARAT,AMRELI,2021-01-12,4,928,5,937
GUJARAT,AMRELI,2021-01-13,5,647,0,652
GUJARAT,AMRELI,2021-01-14,1,182,0,183
GUJARAT,AMRELI,2021-01-15,3,730,23,756
GUJARAT,ANAND,2021-01-11,11,409,5,425
GUJARAT,ANAND,2021-01-12,20,397,0,417
GUJARAT,ANAND,2021-01-13,20,443,8,471
GUJARAT,ANAND,2021-01-14,3,49,1,53
GUJARAT,ANAND,2021-01-15,7,196,0,203
GUJARAT,ARVALLI,2021-01-11,3,416,0,419
GUJARAT,ARVALLI,2021-01-12,4,376,5,385
GUJARAT,ARVALLI,2021-01-13,18,370,0,388
GUJARAT,ARVALLI,2021-01-14,1,37,1,39
GUJARAT,ARVALLI,2021-01-15,2,168,4,174
GUJARAT,BANAS KANTHA,2021-01-11,4,401,1,406
GUJARAT,BANAS KANTHA,2021-01-12,4,421,0,425
GUJARAT,BANAS KANTHA,2021-01-13,7,383,1,391
GUJARAT,BANAS KANTHA,2021-01-14,1,55,0,56
GUJARAT,BANAS KANTHA,2021-01-15,2,335,1,338
GUJARAT,BHARUCH,2021-01-11,13,415,3,431
GUJARAT,BHARUCH,2021-01-12,13,315,1,329
GUJARAT,BHARUCH,2021-01-13,10,356,0,366
GUJARAT,BHARUCH,2021-01-14,10,42,0,52
GUJARAT,BHARUCH,2021-01-15,13,324,0,337
GUJARAT,BHAVNAGAR,2021-01-11,10,727,0,737
GUJARAT,BHAVNAGAR,2021-01-12,17,957,0,974
GUJARAT,BHAVNAGAR,2021-01-13,17,806,0,823
GUJARAT,BHAVNAGAR,2021-01-14,2,505,1,508
GUJARAT,BHAVNAGAR,2021-01-15,10,744,0,754
GUJARAT,BOTAD,2021-01-11,0,592,0,592
GUJARAT,BOTAD,2021-01-12,0,242,0,242
GUJARAT,BOTAD,2021-01-13,0,162,1,163
GUJARAT,BOTAD,2021-01-14,0,32,0,32
GUJARAT,BOTAD,2021-01-15,1,270,0,271
GUJARAT,CHHOTAUDEPUR,2021-01-11,1,436,0,437
GUJARAT,CHHOTAUDEPUR,2021-01-12,3,144,0,147
GUJARAT,CHHOTAUDEPUR,2021-01-13,0,183,0,183
GUJARAT,CHHOTAUDEPUR,2021-01-14,0,9,0,9
GUJARAT,CHHOTAUDEPUR,2021-01-15,0,62,0,62
GUJARAT,DANG,2021-01-11,3,309,0,312
GUJARAT,DANG,2021-01-12,16,109,0,125
GUJARAT,DANG,2021-01-13,0,79,0,79
GUJARAT,DANG,2021-01-14,1,15,0,16
GUJARAT,DANG,2021-01-15,5,53,0,58
GUJARAT,DEVBHUMI DWARKA,2021-01-11,1,181,0,182
GUJARAT,DEVBHUMI DWARKA,2021-01-12,4,149,0,153
GUJARAT,DEVBHUMI DWARKA,2021-01-13,2,140,1,143
GUJARAT,DEVBHUMI DWARKA,2021-01-14,0,24,1,25
GUJARAT,DEVBHUMI DWARKA,2021-01-15,6,55,1,62
GUJARAT,DOHAD,2021-01-11,22,838,0,860
GUJARAT,DOHAD,2021-01-12,26,668,0,694
GUJARAT,DOHAD,2021-01-13,30,636,0,666
GUJARAT,DOHAD,2021-01-14,1,198,0,199
GUJARAT,DOHAD,2021-01-15,20,476,0,496
GUJARAT,GANDHINAGAR,2021-01-11,16,1739,6,1761
GUJARAT,GANDHINAGAR,2021-01-12,14,1633,0,1647
GUJARAT,GANDHINAGAR,2021-01-13,14,803,2,819
GUJARAT,GANDHINAGAR,2021-01-14,7,264,1,272
GUJARAT,GANDHINAGAR,2021-01-15,12,675,6,693
GUJARAT,GIR SOMNATH,2021-01-11,5,349,0,354
GUJARAT,GIR SOMNATH,2021-01-12,2,236,0,238
GUJARAT,GIR SOMNATH,2021-01-13,6,355,0,361
GUJARAT,GIR SOMNATH,2021-01-14,11,177,0,188
GUJARAT,GIR SOMNATH,2021-01-15,5,209,0,214
GUJARAT,JAMNAGAR,2021-01-11,9,1373,12,1394
GUJARAT,JAMNAGAR,2021-01-12,11,1652,1,1664
GUJARAT,JAMNAGAR,2021-01-13,15,1865,2,1882
GUJARAT,JAMNAGAR,2021-01-14,12,849,2,863
GUJARAT,JAMNAGAR,2021-01-15,9,911,8,928
GUJARAT,JUNAGADH,2021-01-11,5,703,0,708
GUJARAT,JUNAGADH,2021-01-12,7,617,1,625
GUJARAT,JUNAGADH,2021-01-13,10,713,0,723
GUJARAT,JUNAGADH,2021-01-14,23,281,0,304
GUJARAT,JUNAGADH,2021-01-15,8,733,0,741
GUJARAT,KACHCHH,2021-01-11,17,823,19,859
GUJARAT,KACHCHH,2021-01-12,12,712,0,724
GUJARAT,KACHCHH,2021-01-13,37,467,18,522
GUJARAT,KACHCHH,2021-01-14,19,328,1,348
GUJARAT,KACHCHH,2021-01-15,15,544,9,568
GUJARAT,KHEDA,2021-01-11,7,1009,1,1017
GUJARAT,KHEDA,2021-01-12,20,1004,1,1025
GUJARAT,KHEDA,2021-01-13,7,765,2,774
GUJARAT,KHEDA,2021-01-14,4,134,1,139
GUJARAT,KHEDA,2021-01-15,2,262,0,264
GUJARAT,MAHESANA,2021-01-11,5,824,2,831
GUJARAT,MAHESANA,2021-01-12,4,603,1,608
GUJARAT,MAHESANA,2021-01-13,3,836,12,851
GUJARAT,MAHESANA,2021-01-14,10,7,0,17
GUJARAT,MAHESANA,2021-01-15,2,304,0,306
GUJARAT,MAHISAGAR,2021-01-11,3,344,0,347
GUJARAT,MAHISAGAR,2021-01-12,4,487,0,491
GUJARAT,MAHISAGAR,2021-01-13,3,476,1,480
GUJARAT,MAHISAGAR,2021-01-14,0,103,0,103
GUJARAT,MAHISAGAR,2021-01-15,0,285,0,285
GUJARAT,MORBI,2021-01-11,9,765,29,803
GUJARAT,MORBI,2021-01-12,10,626,67,703
GUJARAT,MORBI,2021-01-13,9,568,44,621
GUJARAT,MORBI,2021-01-14,7,214,21,242
GUJARAT,MORBI,2021-01-15,13,621,21,655
GUJARAT,NARMADA,2021-01-11,4,24,0,28
GUJARAT,NARMADA,2021-01-12,4,37,0,41
GUJARAT,NARMADA,2021-01-13,5,41,0,46
GUJARAT,NARMADA,2021-01-14,6,44,0,50
GUJARAT,NARMADA,2021-01-15,1,21,0,22
GUJARAT,NAVSARI,2021-01-11,5,486,0,491
GUJARAT,NAVSARI,2021-01-12,0,183,0,183
GUJARAT,NAVSARI,2021-01-13,5,222,0,227
GUJARAT,NAVSARI,2021-01-14,0,66,0,66
GUJARAT,NAVSARI,2021-01-15,1,309,0,310
GUJARAT,PANCH MAHALS,2021-01-11,10,453,0,463
GUJARAT,PANCH MAHALS,2021-01-12,13,615,0,628
GUJARAT,PANCH MAHALS,2021-01-13,10,556,0,566
GUJARAT,PANCH MAHALS,2021-01-14,2,187,0,189
GUJARAT,PANCH MAHALS,2021-01-15,9,297,0,306
GUJARAT,PATAN,2021-01-11,3,928,0,931
GUJARAT,PATAN,2021-01-12,1,802,7,810
GUJARAT,PATAN,2021-01-13,2,832,1,835
GUJARAT,PATAN,2021-01-14,0,45,0,45
GUJARAT,PATAN,2021-01-15,4,427,0,431
GUJARAT,PORBANDAR,2021-01-11,2,498,0,500
GUJARAT,PORBANDAR,2021-01-12,1,344,0,345
GUJARAT,PORBANDAR,2021-01-13,1,365,0,366
GUJARAT,PORBANDAR,2021-01-14,2,93,0,95
GUJARAT,PORBANDAR,2021-01-15,2,440,0,442
GUJARAT,RAJKOT,2021-01-11,41,1728,73,1842
GUJARAT,RAJKOT,2021-01-12,68,2113,47,2228
GUJARAT,RAJKOT,2021-01-13,70,1806,57,1933
GUJARAT,RAJKOT,2021-01-14,37,516,73,626
GUJARAT,RAJKOT,2021-01-15,61,1586,34,1681
GUJARAT,SABAR KANTHA,2021-01-11,7,290,6,303
GUJARAT,SABAR KANTHA,2021-01-12,9,244,18,271
GUJARAT,SABAR KANTHA,2021-01-13,8,340,7,355
GUJARAT,SABAR KANTHA,2021-01-14,2,54,1,57
GUJARAT,SABAR KANTHA,2021-01-15,5,118,4,127
GUJARAT,SURAT,2021-01-11,103,2141,6,2250
GUJARAT,SURAT,2021-01-12,70,1596,0,1666
GUJARAT,SURAT,2021-01-13,59,1506,43,1608
GUJARAT,SURAT,2021-01-14,12,710,2,724
GUJARAT,SURAT,2021-01-15,64,1690,0,1754
GUJARAT,SURENDRANAGAR,2021-01-11,0,902,0,902
GUJARAT,SURENDRANAGAR,2021-01-12,1,659,70,730
GUJARAT,SURENDRANAGAR,2021-01-13,4,221,48,273
GUJARAT,SURENDRANAGAR,2021-01-14,1,3,0,4
GUJARAT,SURENDRANAGAR,2021-01-15,1,411,3,415
GUJARAT,TAPI,2021-01-11,4,351,0,355
GUJARAT,TAPI,2021-01-12,5,199,0,204
GUJARAT,TAPI,2021-01-13,10,387,0,397
GUJARAT,TAPI,2021-01-14,2,107,0,109
GUJARAT,TAPI,2021-01-15,2,227,0,229
GUJARAT,VADODARA,2021-01-11,112,2231,20,2363
GUJARAT,VADODARA,2021-01-12,93,1842,23,1958
GUJARAT,VADODARA,2021-01-13,96,1952,55,2103
GUJARAT,VADODARA,2021-01-14,30,415,12,457
GUJARAT,VADODARA,2021-01-15,42,729,4,775
GUJARAT,VALSAD,2021-01-11,6,360,0,366
GUJARAT,VALSAD,2021-01-12,1,441,1,443
GUJARAT,VALSAD,2021-01-13,6,375,0,381
GUJARAT,VALSAD,2021-01-14,4,295,0,299
GUJARAT,VALSAD,2021-01-15,3,286,1,290
HARYANA,AMBALA,2021-01-11,34,790,26,850
HARYANA,AMBALA,2021-01-12,26,1096,24,1146
HARYANA,AMBALA,2021-01-13,27,517,65,609
HARYANA,AMBALA,2021-01-14,42,999,18,1059
HARYANA,AMBALA,2021-01-15,28,869,71,968
HARYANA,BHIWANI,2021-01-11,2,1095,0,1097
HARYANA,BHIWANI,2021-01-12,2,1418,2,1422
HARYANA,BHIWANI,2021-01-13,3,984,0,987
HARYANA,BHIWANI,2021-01-14,4,907,0,911
HARYANA,BHIWANI,2021-01-15,1,471,0,472
HARYANA,CHARKI DADRI,2021-01-11,3,1131,10,1144
HARYANA,CHARKI DADRI,2021-01-12,3,543,1,547
HARYANA,CHARKI DADRI,2021-01-13,3,646,0,649
HARYANA,CHARKI DADRI,2021-01-14,2,590,0,592
HARYANA,CHARKI DADRI,2021-01-15,0,441,0,441
HARYANA,FARIDABAD,2021-01-11,34,1712,3,1749
HARYANA,FARIDABAD,2021-01-12,32,1533,1,1566
HARYANA,FARIDABAD,2021-01-13,24,1946,18,1988
HARYANA,FARIDABAD,2021-01-14,22,1343,12,1377
HARYANA,FARIDABAD,2021-01-15,14,1269,4,1287
HARYANA,FATEHABAD,2021-01-11,3,408,0,411
HARYANA,FATEHABAD,2021-01-12,6,122,0,128
HARYANA,FATEHABAD,2021-01-13,5,411,0,416
HARYANA,FATEHABAD,2021-01-14,0,654,4,658
HARYANA,FATEHABAD,2021-01-15,4,734,0,738
HARYANA,GURUGRAM,2021-01-11,81,3433,8,3522
HARYANA,GURUGRAM,2021-01-12,54,3672,27,3753
HARYANA,GURUGRAM,2021-01-13,50,3447,25,3522
HARYANA,GURUGRAM,2021-01-14,51,3096,24,3171
HARYANA,GURUGRAM,2021-01-15,56,2796,26,2878
HARYANA,HISAR,2021-01-11,14,4248,2,4264
HARYANA,HISAR,2021-01-12,20,2083,8,2111
HARYANA,HISAR,2021-01-13,7,2023,9,2039
HARYANA,HISAR,2021-01-14,12,1995,3,2010
HARYANA,HISAR,2021-01-15,10,1822,1,1833
HARYANA,JHAJJAR,2021-01-11,5,2284,0,2289
HARYANA,JHAJJAR,2021-01-12,1,1569,3,1573
HARYANA,JHAJJAR,2021-01-13,7,1854,1,1862
HARYANA,JHAJJAR,2021-01-14,1,1563,0,1564
HARYANA,JHAJJAR,2021-01-15,1,1828,5,1834
HARYANA,JIND,2021-01-11,7,1370,4,1381
HARYANA,JIND,2021-01-12,6,622,3,631
HARYANA,JIND,2021-01-13,7,849,6,862
HARYANA,JIND,2021-01-14,10,1363,2,1375
HARYANA,JIND,2021-01-15,8,1135,12,1155
HARYANA,KAITHAL,2021-01-11,6,315,1,322
HARYANA,KAITHAL,2021-01-12,9,516,4,529
HARYANA,KAITHAL,2021-01-13,2,142,3,147
HARYANA,KAITHAL,2021-01-14,6,365,1,372
HARYANA,KAITHAL,2021-01-15,2,486,25,513
HARYANA,KARNAL,2021-01-11,36,1610,7,1653
HARYANA,KARNAL,2021-01-12,18,1490,5,1513
HARYANA,KARNAL,2021-01-13,27,2022,7,2056
HARYANA,KARNAL,2021-01-14,22,1626,5,1653
HARYANA,KARNAL,2021-01-15,14,1684,5,1703
HARYANA,KURUKSHETRA,2021-01-11,31,641,1,673
HARYANA,KURUKSHETRA,2021-01-12,13,618,3,634
HARYANA,KURUKSHETRA,2021-01-13,14,1043,5,1062
HARYANA,KURUKSHETRA,2021-01-14,16,470,2,488
HARYANA,KURUKSHETRA,2021-01-15,20,369,6,395
HARYANA,MAHENDRAGARH,2021-01-11,0,754,1,755
HARYANA,MAHENDRAGARH,2021-01-12,1,472,1,474
HARYANA,MAHENDRAGARH,2021-01-13,0,431,2,433
HARYANA,MAHENDRAGARH,2021-01-14,0,106,1,107
HARYANA,MAHENDRAGARH,2021-01-15,1,448,0,449
HARYANA,NUH,2021-01-11,1,464,0,465
HARYANA,NUH,2021-01-12,0,812,2,814
HARYANA,NUH,2021-01-13,0,640,2,642
HARYANA,NUH,2021-01-14,0,775,0,775
HARYANA,NUH,2021-01-15,0,297,0,297
HARYANA,PALWAL,2021-01-11,1,561,0,562
HARYANA,PALWAL,2021-01-12,2,184,1,187
HARYANA,PALWAL,2021-01-13,1,249,2,252
HARYANA,PALWAL,2021-01-14,5,162,0,167
HARYANA,PALWAL,2021-01-15,1,483,0,484
HARYANA,PANCHKULA,2021-01-11,31,522,3,556
HARYANA,PANCHKULA,2021-01-12,40,1176,12,1228
HARYANA,PANCHKULA,2021-01-13,25,384,7,416
HARYANA,PANCHKULA,2021-01-14,48,471,6,525
HARYANA,PANCHKULA,2021-01-15,23,788,2,813
HARYANA,PANIPAT,2021-01-11,7,544,0,551
HARYANA,PANIPAT,2021-01-12,4,744,3,751
HARYANA,PANIPAT,2021-01-13,4,615,2,621
HARYANA,PANIPAT,2021-01-14,7,855,0,862
HARYANA,PANIPAT,2021-01-15,10,895,1,906
HARYANA,REWARI,2021-01-11,3,815,2,820
HARYANA,REWARI,2021-01-12,1,589,2,592
HARYANA,REWARI,2021-01-13,3,665,4,672
HARYANA,REWARI,2021-01-14,2,464,2,468
HARYANA,REWARI,2021-01-15,5,309,0,314
HARYANA,ROHTAK,2021-01-11,66,640,1,707
HARYANA,ROHTAK,2021-01-12,35,1415,1,1451
HARYANA,ROHTAK,2021-01-13,60,968,2,1030
HARYANA,ROHTAK,2021-01-14,35,713,0,748
HARYANA,ROHTAK,2021-01-15,56,1084,3,1143
HARYANA,SIRSA,2021-01-11,1,342,11,354
HARYANA,SIRSA,2021-01-12,7,657,7,671
HARYANA,SIRSA,2021-01-13,12,297,2,311
HARYANA,SIRSA,2021-01-14,0,1135,11,1146
HARYANA,SIRSA,2021-01-15,7,1162,6,1175
HARYANA,SONIPAT,2021-01-11,5,1505,1,1511
HARYANA,SONIPAT,2021-01-12,11,1489,0,1500
HARYANA,SONIPAT,2021-01-13,15,1766,5,1786
HARYANA,SONIPAT,2021-01-14,12,2038,0,2050
HARYANA,SONIPAT,2021-01-15,7,2145,2,2154
HARYANA,YAMUNANAGAR,2021-01-11,4,684,4,692
HARYANA,YAMUNANAGAR,2021-01-12,36,1000,8,1044
HARYANA,YAMUNANAGAR,2021-01-13,9,778,16,803
HARYANA,YAMUNANAGAR,2021-01-14,9,1152,0,1161
HARYANA,YAMUNANAGAR,2021-01-15,9,1015,0,1024
HIMACHAL PRADESH,BILASPUR,2021-01-11,4,451,4,459
HIMACHAL PRADESH,BILASPUR,2021-01-12,2,432,4,438
HIMACHAL PRADESH,BILASPUR,2021-01-13,1,385,4,390
HIMACHAL PRADESH,BILASPUR,2021-01-14,5,284,1,290
HIMACHAL PRADESH,BILASPUR,2021-01-15,3,199,4,206
HIMACHAL PRADESH,CHAMBA,2021-01-11,7,583,19,609
HIMACHAL PRADESH,CHAMBA,2021-01-12,2,502,133,637
HIMACHAL PRADESH,CHAMBA,2021-01-13,1,361,7,369
HIMACHAL PRADESH,CHAMBA,2021-01-14,2,328,7,337
HIMACHAL PRADESH,CHAMBA,2021-01-15,2,369,4,375
HIMACHAL PRADESH,HAMIRPUR,2021-01-11,3,112,0,115
HIMACHAL PRADESH,HAMIRPUR,2021-01-12,2,452,2,456
HIMACHAL PRADESH,HAMIRPUR,2021-01-13,7,410,0,417
HIMACHAL PRADESH,HAMIRPUR,2021-01-14,7,342,0,349
HIMACHAL PRADESH,HAMIRPUR,2021-01-15,5,181,0,186
HIMACHAL PRADESH,KANGRA,2021-01-11,35,2218,0,2253
HIMACHAL PRADESH,KANGRA,2021-01-12,7,2502,5,2514
HIMACHAL PRADESH,KANGRA,2021-01-13,13,1866,1,1880
HIMACHAL PRADESH,KANGRA,2021-01-14,20,632,1,653
HIMACHAL PRADESH,KANGRA,2021-01-15,22,2242,2,2266
HIMACHAL PRADESH,KINNAUR,2021-01-11,1,64,0,65
HIMACHAL PRADESH,KINNAUR,2021-01-12,2,272,1,275
HIMACHAL PRADESH,KINNAUR,2021-01-13,0,78,0,78
HIMACHAL PRADESH,KINNAUR,2021-01-14,13,119,0,132
HIMACHAL PRADESH,KINNAUR,2021-01-15,0,24,0,24
HIMACHAL PRADESH,KULLU,2021-01-11,2,178,1,181
HIMACHAL PRADESH,KULLU,2021-01-12,1,213,3,217
HIMACHAL PRADESH,KULLU,2021-01-13,4,157,2,163
HIMACHAL PRADESH,KULLU,2021-01-14,2,158,3,163
HIMACHAL PRADESH,KULLU,2021-01-15,2,233,0,235
HIMACHAL PRADESH,LAHUL AND SPITI,2021-01-11,1,2,0,3
HIMACHAL PRADESH,LAHUL AND SPITI,2021-01-12,0,3,0,3
HIMACHAL PRADESH,LAHUL AND SPITI,2021-01-13,0,1,1,2
HIMACHAL PRADESH,LAHUL AND SPITI,2021-01-14,0,1,0,1
HIMACHAL PRADESH,LAHUL AND SPITI,2021-01-15,0,3,0,3
HIMACHAL PRADESH,MANDI,2021-01-11,6,324,3,333
HIMACHAL PRADESH,MANDI,2021-01-12,8,382,10,400
HIMACHAL PRADESH,MANDI,2021-01-13,12,474,6,492
HIMACHAL PRADESH,MANDI,2021-01-14,12,148,6,166
HIMACHAL PRADESH,MANDI,2021-01-15,4,356,5,365
HIMACHAL PRADESH,SHIMLA,2021-01-11,25,525,12,562
HIMACHAL PRADESH,SHIMLA,2021-01-12,19,591,1,611
HIMACHAL PRADESH,SHIMLA,2021-01-13,7,605,5,617
HIMACHAL PRADESH,SHIMLA,2021-01-14,5,467,5,477
HIMACHAL PRADESH,SHIMLA,2021-01-15,15,625,10,650
HIMACHAL PRADESH,SIRMAUR,2021-01-11,3,60,0,63
HIMACHAL PRADESH,SIRMAUR,2021-01-12,6,310,1,317
HIMACHAL PRADESH,SIRMAUR,2021-01-13,15,406,1,422
HIMACHAL PRADESH,SIRMAUR,2021-01-14,19,626,3,648
HIMACHAL PRADESH,SIRMAUR,2021-01-15,13,216,1,230
HIMACHAL PRADESH,SOLAN,2021-01-11,3,251,2,256
HIMACHAL PRADESH,SOLAN,2021-01-12,11,434,0,445
HIMACHAL PRADESH,SOLAN,2021-01-13,8,468,2,478
HIMACHAL PRADESH,SOLAN,2021-01-14,10,261,1,272
HIMACHAL PRADESH,SOLAN,2021-01-15,6,331,1,338
HIMACHAL PRADESH,UNA,2021-01-11,15,622,1,638
HIMACHAL PRADESH,UNA,2021-01-12,5,628,3,636
HIMACHAL PRADESH,UNA,2021-01-13,6,402,1,409
HIMACHAL PRADESH,UNA,2021-01-14,12,325,1,338
HIMACHAL PRADESH,UNA,2021-01-15,11,382,1,394
INDIA,INDIA,2021-01-11,11,2,0,13
INDIA,INDIA,2021-01-12,11,3,0,14
INDIA,INDIA,2021-01-13,12,2,0,14
INDIA,INDIA,2021-01-14,5,3,0,8
INDIA,INDIA,2021-01-15,8,3,0,11
JAMMU AND KASHMIR,ANANTNAG,2021-01-11,17,589,1,607
JAMMU AND KASHMIR,ANANTNAG,2021-01-12,24,595,2,621
JAMMU AND KASHMIR,ANANTNAG,2021-01-13,14,391,0,405
JAMMU AND KASHMIR,ANANTNAG,2021-01-14,13,249,0,262
JAMMU AND KASHMIR,ANANTNAG,2021-01-15,1,438,3,442
JAMMU AND KASHMIR,BANDIPORA,2021-01-11,3,308,0,311
JAMMU AND KASHMIR,BANDIPORA,2021-01-12,3,116,0,119
JAMMU AND KASHMIR,BANDIPORA,2021-01-13,4,157,0,161
JAMMU AND KASHMIR,BANDIPORA,2021-01-14,1,96,0,97
JAMMU AND KASHMIR,BANDIPORA,2021-01-15,1,123,0,124
JAMMU AND KASHMIR,BARAMULLA,2021-01-11,18,896,1,915
JAMMU AND KASHMIR,BARAMULLA,2021-01-12,12,701,0,713
JAMMU AND KASHMIR,BARAMULLA,2021-01-13,12,571,0,583
JAMMU AND KASHMIR,BARAMULLA,2021-01-14,12,760,0,772
JAMMU AND KASHMIR,BARAMULLA,2021-01-15,13,517,0,530
JAMMU AND KASHMIR,BUDGAM,2021-01-11,14,768,0,782
JAMMU AND KASHMIR,BUDGAM,2021-01-12,2,665,2,669
JAMMU AND KASHMIR,BUDGAM,2021-01-13,6,733,0,739
JAMMU AND KASHMIR,BUDGAM,2021-01-14,2,624,0,626
JAMMU AND KASHMIR,BUDGAM,2021-01-15,6,709,0,715
JAMMU AND KASHMIR,DODA,2021-01-11,1,86,0,87
JAMMU AND KASHMIR,DODA,2021-01-12,26,142,1,169
JAMMU AND KASHMIR,DODA,2021-01-13,1,37,0,38
JAMMU AND KASHMIR,DODA,2021-01-14,11,218,2,231
JAMMU AND KASHMIR,DODA,2021-01-15,20,140,0,160
JAMMU AND KASHMIR,GANDERBAL,2021-01-11,3,368,0,371
JAMMU AND KASHMIR,GANDERBAL,2021-01-12,2,342,1,345
JAMMU AND KASHMIR,GANDERBAL,2021-01-13,4,491,0,495
JAMMU AND KASHMIR,GANDERBAL,2021-01-14,10,371,0,381
JAMMU AND KASHMIR,GANDERBAL,2021-01-15,10,401,0,411
JAMMU AND KASHMIR,JAMMU,2021-01-11,125,1497,1,1623
JAMMU AND KASHMIR,JAMMU,2021-01-12,100,1550,8,1658
JAMMU AND KASHMIR,JAMMU,2021-01-13,72,963,5,1040
JAMMU AND KASHMIR,JAMMU,2021-01-14,67,1390,10,1467
JAMMU AND KASHMIR,JAMMU,2021-01-15,64,1407,1,1472
JAMMU AND KASHMIR,KATHUA,2021-01-11,2,199,0,201
JAMMU AND KASHMIR,KATHUA,2021-01-12,0,155,0,155
JAMMU AND KASHMIR,KATHUA,2021-01-13,1,49,0,50
JAMMU AND KASHMIR,KATHUA,2021-01-14,4,225,0,229
JAMMU AND KASHMIR,KATHUA,2021-01-15,2,289,0,291
JAMMU AND KASHMIR,KISHTWAR,2021-01-11,0,185,0,185
JAMMU AND KASHMIR,KISHTWAR,2021-01-12,2,139,0,141
JAMMU AND KASHMIR,KISHTWAR,2021-01-13,4,161,0,165
JAMMU AND KASHMIR,KISHTWAR,2021-01-14,6,182,0,188
JAMMU AND KASHMIR,KISHTWAR,2021-01-15,6,271,0,277
JAMMU AND KASHMIR,KULGAM,2021-01-11,1,669,0,670
JAMMU AND KASHMIR,KULGAM,2021-01-12,2,677,0,679
JAMMU AND KASHMIR,KULGAM,2021-01-13,1,721,1,723
JAMMU AND KASHMIR,KULGAM,2021-01-14,2,823,0,825
JAMMU AND KASHMIR,KULGAM,2021-01-15,1,582,0,583
JAMMU AND KASHMIR,KUPWARA,2021-01-11,2,430,0,432
JAMMU AND KASHMIR,KUPWARA,2021-01-12,2,44,0,46
JAMMU AND KASHMIR,KUPWARA,2021-01-13,4,283,0,287
JAMMU AND KASHMIR,KUPWARA,2021-01-14,3,42,0,45
JAMMU AND KASHMIR,KUPWARA,2021-01-15,0,532,1,533
JAMMU AND KASHMIR,POONCH,2021-01-11,1,700,1,702
JAMMU AND KASHMIR,POONCH,2021-01-12,2,537,0,539
JAMMU AND KASHMIR,POONCH,2021-01-13,0,249,2,251
JAMMU AND KASHMIR,POONCH,2021-01-14,1,475,0,476
JAMMU AND KASHMIR,POONCH,2021-01-15,2,304,0,306
JAMMU AND KASHMIR,PULWAMA,2021-01-11,8,535,7,550
JAMMU AND KASHMIR,PULWAMA,2021-01-12,3,444,0,447
JAMMU AND KASHMIR,PULWAMA,2021-01-13,3,403,0,406
JAMMU AND KASHMIR,PULWAMA,2021-01-14,7,474,1,482
JAMMU AND KASHMIR,PULWAMA,2021-01-15,10,473,4,487
JAMMU AND KASHMIR,RAJOURI,2021-01-11,2,171,0,173
JAMMU AND KASHMIR,RAJOURI,2021-01-12,0,294,0,294
JAMMU AND KASHMIR,RAJOURI,2021-01-13,1,145,0,146
JAMMU AND KASHMIR,RAJOURI,2021-01-14,1,207,0,208
JAMMU AND KASHMIR,RAJOURI,2021-01-15,1,263,0,264
JAMMU AND KASHMIR,RAMBAN,2021-01-11,1,260,0,261
JAMMU AND KASHMIR,RAMBAN,2021-01-12,1,238,0,239
JAMMU AND KASHMIR,RAMBAN,2021-01-13,1,156,0,157
JAMMU AND KASHMIR,RAMBAN,2021-01-14,2,450,0,452
JAMMU AND KASHMIR,RAMBAN,2021-01-15,3,237,0,240
JAMMU AND KASHMIR,REASI,2021-01-11,11,234,0,245
JAMMU AND KASHMIR,REASI,2021-01-12,12,197,1,210
JAMMU AND KASHMIR,REASI,2021-01-13,6,108,1,115
JAMMU AND KASHMIR,REASI,2021-01-14,1,168,1,170
JAMMU AND KASHMIR,REASI,2021-01-15,16,221,0,237
JAMMU AND KASHMIR,SAMBA,2021-01-11,1,162,0,163
JAMMU AND KASHMIR,SAMBA,2021-01-12,3,295,1,299
JAMMU AND KASHMIR,SAMBA,2021-01-13,2,154,0,156
JAMMU AND KASHMIR,SAMBA,2021-01-14,1,178,0,179
JAMMU AND KASHMIR,SAMBA,2021-01-15,10,168,0,178
JAMMU AND KASHMIR,SHOPIAN,2021-01-11,2,53,1,56
JAMMU AND KASHMIR,SHOPIAN,2021-01-12,1,65,0,66
JAMMU AND KASHMIR,SHOPIAN,2021-01-13,5,98,0,103
JAMMU AND KASHMIR,SHOPIAN,2021-01-14,3,101,0,104
JAMMU AND KASHMIR,SHOPIAN,2021-01-15,2,165,0,167
JAMMU AND KASHMIR,SRINAGAR,2021-01-11,61,2636,13,2710
JAMMU AND KASHMIR,SRINAGAR,2021-01-12,18,2353,0,2371
JAMMU AND KASHMIR,SRINAGAR,2021-01-13,71,1882,8,1961
JAMMU AND KASHMIR,SRINAGAR,2021-01-14,44,2660,4,2708
JAMMU AND KASHMIR,SRINAGAR,2021-01-15,35,2390,5,2430
JAMMU AND KASHMIR,UDHAMPUR,2021-01-11,5,533,0,538
JAMMU AND KASHMIR,UDHAMPUR,2021-01-12,5,472,0,477
JAMMU AND KASHMIR,UDHAMPUR,2021-01-13,1,345,0,346
JAMMU AND KASHMIR,UDHAMPUR,2021-01-14,1,536,0,537
JAMMU AND KASHMIR,UDHAMPUR,2021-01-15,8,443,0,451
JHARKHAND,BOKARO,2021-01-11,17,771,0,788
JHARKHAND,BOKARO,2021-01-12,6,451,5,462
JHARKHAND,BOKARO,2021-01-13,8,639,3,650
JHARKHAND,BOKARO,2021-01-14,7,796,1,804
JHARKHAND,BOKARO,2021-01-15,6,796,0,802
JHARKHAND,CHATRA,2021-01-11,0,569,0,569
JHARKHAND,CHATRA,2021-01-12,3,242,0,245
JHARKHAND,CHATRA,2021-01-13,0,198,0,198
JHARKHAND,CHATRA,2021-01-14,2,301,0,303
JHARKHAND,CHATRA,2021-01-15,0,322,0,322
JHARKHAND,DEOGHAR,2021-01-11,6,1211,2,1219
JHARKHAND,DEOGHAR,2021-01-12,3,1600,1,1604
JHARKHAND,DEOGHAR,2021-01-13,4,575,3,582
JHARKHAND,DEOGHAR,2021-01-14,2,1439,1,1442
JHARKHAND,DEOGHAR,2021-01-15,8,1156,3,1167
JHARKHAND,DHANBAD,2021-01-11,18,902,2,922
JHARKHAND,DHANBAD,2021-01-12,5,482,1,488
JHARKHAND,DHANBAD,2021-01-13,30,371,0,401
JHARKHAND,DHANBAD,2021-01-14,11,157,1,169
JHARKHAND,DHANBAD,2021-01-15,3,627,0,630
JHARKHAND,DUMKA,2021-01-11,1,1077,6,1084
JHARKHAND,DUMKA,2021-01-12,0,498,0,498
JHARKHAND,DUMKA,2021-01-13,2,760,0,762
JHARKHAND,DUMKA,2021-01-14,1,283,0,284
JHARKHAND,DUMKA,2021-01-15,1,719,0,720
JHARKHAND,EAST SINGHBUM,2021-01-11,19,2421,1,2441
JHARKHAND,EAST SINGHBUM,2021-01-12,26,1772,1,1799
JHARKHAND,EAST SINGHBUM,2021-01-13,23,888,0,911
JHARKHAND,EAST SINGHBUM,2021-01-14,13,792,0,805
JHARKHAND,EAST SINGHBUM,2021-01-15,13,846,1,860
JHARKHAND,GARHWA,2021-01-11,1,381,3,385
JHARKHAND,GARHWA,2021-01-12,3,1166,0,1169
JHARKHAND,GARHWA,2021-01-13,0,435,1,436
JHARKHAND,GARHWA,2021-01-14,2,685,0,687
JHARKHAND,GARHWA,2021-01-15,0,581,0,581
JHARKHAND,GIRIDIH,2021-01-11,1,982,0,983
JHARKHAND,GIRIDIH,2021-01-12,7,636,0,643
JHARKHAND,GIRIDIH,2021-01-13,2,70,0,72
JHARKHAND,GIRIDIH,2021-01-14,1,51,0,52
JHARKHAND,GIRIDIH,2021-01-15,0,889,1,890
JHARKHAND,GODDA,2021-01-11,2,464,0,466
JHARKHAND,GODDA,2021-01-12,2,498,0,500
JHARKHAND,GODDA,2021-01-13,0,457,1,458
JHARKHAND,GODDA,2021-01-14,2,768,0,770
JHARKHAND,GODDA,2021-01-15,0,471,0,471
JHARKHAND,GUMLA,2021-01-11,2,327,0,329
JHARKHAND,GUMLA,2021-01-12,2,54,0,56
JHARKHAND,GUMLA,2021-01-13,3,702,0,705
JHARKHAND,GUMLA,2021-01-14,3,131,0,134
JHARKHAND,GUMLA,2021-01-15,4,238,0,242
JHARKHAND,HAZARIBAGH,2021-01-11,1,603,0,604
JHARKHAND,HAZARIBAGH,2021-01-12,17,672,0,689
JHARKHAND,HAZARIBAGH,2021-01-13,6,494,0,500
JHARKHAND,HAZARIBAGH,2021-01-14,3,142,0,145
JHARKHAND,HAZARIBAGH,2021-01-15,6,373,1,380
JHARKHAND,JAMTARA,2021-01-11,1,488,17,506
JHARKHAND,JAMTARA,2021-01-12,0,267,6,273
JHARKHAND,JAMTARA,2021-01-13,0,311,25,336
JHARKHAND,JAMTARA,2021-01-14,2,332,6,340
JHARKHAND,JAMTARA,2021-01-15,1,207,15,223
JHARKHAND,KHUNTI,2021-01-11,3,512,0,515
JHARKHAND,KHUNTI,2021-01-12,0,275,2,277
JHARKHAND,KHUNTI,2021-01-13,1,196,0,197
JHARKHAND,KHUNTI,2021-01-14,1,15,0,16
JHARKHAND,KHUNTI,2021-01-15,6,443,0,449
JHARKHAND,KODERMA,2021-01-11,10,207,0,217
JHARKHAND,KODERMA,2021-01-12,2,301,0,303
JHARKHAND,KODERMA,2021-01-13,1,310,0,311
JHARKHAND,KODERMA,2021-01-14,2,232,0,234
JHARKHAND,KODERMA,2021-01-15,7,360,0,367
JHARKHAND,LATEHAR,2021-01-11,0,479,0,479
JHARKHAND,LATEHAR,2021-01-12,4,318,0,322
JHARKHAND,LATEHAR,2021-01-13,6,221,0,227
JHARKHAND,LATEHAR,2021-01-14,0,12,0,12
JHARKHAND,LATEHAR,2021-01-15,8,282,3,293
JHARKHAND,LOHARDAGA,2021-01-11,0,256,0,256
JHARKHAND,LOHARDAGA,2021-01-12,4,117,0,121
JHARKHAND,LOHARDAGA,2021-01-13,0,217,0,217
JHARKHAND,LOHARDAGA,2021-01-14,1,81,0,82
JHARKHAND,LOHARDAGA,2021-01-15,3,172,0,175
JHARKHAND,PAKUR,2021-01-11,0,938,1,939
JHARKHAND,PAKUR,2021-01-12,0,300,0,300
JHARKHAND,PAKUR,2021-01-13,0,454,0,454
JHARKHAND,PAKUR,2021-01-14,0,455,0,455
JHARKHAND,PAKUR,2021-01-15,0,950,0,950
JHARKHAND,PALAMU,2021-01-11,13,985,7,1005
JHARKHAND,PALAMU,2021-01-12,4,706,0,710
JHARKHAND,PALAMU,2021-01-13,2,1010,0,1012
JHARKHAND,PALAMU,2021-01-14,2,979,0,981
JHARKHAND,PALAMU,2021-01-15,8,1448,3,1459
JHARKHAND,RAMGARH,2021-01-11,4,476,2,482
JHARKHAND,RAMGARH,2021-01-12,4,477,0,481
JHARKHAND,RAMGARH,2021-01-13,4,372,0,376
JHARKHAND,RAMGARH,2021-01-14,1,202,0,203
JHARKHAND,RAMGARH,2021-01-15,3,257,0,260
JHARKHAND,RANCHI,2021-01-11,101,828,3,932
JHARKHAND,RANCHI,2021-01-12,93,952,3,1048
JHARKHAND,RANCHI,2021-01-13,91,721,0,812
JHARKHAND,RANCHI,2021-01-14,89,717,0,806
JHARKHAND,RANCHI,2021-01-15,62,710,2,774
JHARKHAND,SAHEBGANJ,2021-01-11,1,509,0,510
JHARKHAND,SAHEBGANJ,2021-01-12,0,600,0,600
JHARKHAND,SAHEBGANJ,2021-01-13,0,397,0,397
JHARKHAND,SAHEBGANJ,2021-01-14,0,873,0,873
JHARKHAND,SAHEBGANJ,2021-01-15,1,435,0,436
JHARKHAND,SARAIKELA KHARSAWAN,2021-01-11,3,583,5,591
JHARKHAND,SARAIKELA KHARSAWAN,2021-01-12,1,339,0,340
JHARKHAND,SARAIKELA KHARSAWAN,2021-01-13,1,333,0,334
JHARKHAND,SARAIKELA KHARSAWAN,2021-01-14,1,130,0,131
JHARKHAND,SARAIKELA KHARSAWAN,2021-01-15,2,50,0,52
JHARKHAND,SIMDEGA,2021-01-11,2,459,0,461
JHARKHAND,SIMDEGA,2021-01-12,0,336,0,336
JHARKHAND,SIMDEGA,2021-01-13,5,196,0,201
JHARKHAND,SIMDEGA,2021-01-14,1,119,0,120
JHARKHAND,SIMDEGA,2021-01-15,2,150,0,152
JHARKHAND,WEST SINGHBHUM,2021-01-11,3,262,0,265
JHARKHAND,WEST SINGHBHUM,2021-01-12,3,902,1,906
JHARKHAND,WEST SINGHBHUM,2021-01-13,1,762,0,763
JHARKHAND,WEST SINGHBHUM,2021-01-14,1,1058,0,1059
JHARKHAND,WEST SINGHBHUM,2021-01-15,2,1141,0,1143
KARNATAKA,BAGALKOTE,2021-01-11,5,3083,8,3096
KARNATAKA,BAGALKOTE,2021-01-12,8,3596,3,3607
KARNATAKA,BAGALKOTE,2021-01-13,3,3732,0,3735
KARNATAKA,BAGALKOTE,2021-01-14,1,1502,1,1504
KARNATAKA,BAGALKOTE,2021-01-15,4,1413,1,1418
KARNATAKA,BALLARI,2021-01-11,11,2836,5,2852
KARNATAKA,BALLARI,2021-01-12,20,2777,16,2813
KARNATAKA,BALLARI,2021-01-13,14,2786,4,2804
KARNATAKA,BALLARI,2021-01-14,13,2356,7,2376
KARNATAKA,BALLARI,2021-01-15,10,2758,6,2774
KARNATAKA,BELAGAVI,2021-01-11,14,2151,3,2168
KARNATAKA,BELAGAVI,2021-01-12,20,3002,2,3024
KARNATAKA,BELAGAVI,2021-01-13,10,3317,2,3329
KARNATAKA,BELAGAVI,2021-01-14,23,4377,8,4408
KARNATAKA,BELAGAVI,2021-01-15,42,3909,4,3955
KARNATAKA,BENGALURU RURAL,2021-01-11,21,1544,1,1566
KARNATAKA,BENGALURU RURAL,2021-01-12,24,1337,2,1363
KARNATAKA,BENGALURU RURAL,2021-01-13,28,2078,0,2106
KARNATAKA,BENGALURU RURAL,2021-01-14,7,855,3,865
KARNATAKA,BENGALURU RURAL,2021-01-15,10,2043,0,2053
KARNATAKA,BENGALURU URBAN,2021-01-11,426,42703,88,43217
KARNATAKA,BENGALURU URBAN,2021-01-12,460,40678,68,41206
KARNATAKA,BENGALURU URBAN,2021-01-13,335,35666,106,36107
KARNATAKA,BENGALURU URBAN,2021-01-14,340,31003,52,31395
KARNATAKA,BENGALURU URBAN,2021-01-15,376,30693,183,31252
KARNATAKA,BIDAR,2021-01-11,6,883,0,889
KARNATAKA,BIDAR,2021-01-12,1,49,0,50
KARNATAKA,BIDAR,2021-01-13,8,2352,0,2360
KARNATAKA,BIDAR,2021-01-14,13,953,0,966
KARNATAKA,BIDAR,2021-01-15,6,942,0,948
KARNATAKA,CHAMARAJANAGARA,2021-01-11,3,830,0,833
KARNATAKA,CHAMARAJANAGARA,2021-01-12,3,936,0,939
KARNATAKA,CHAMARAJANAGARA,2021-01-13,7,1673,0,1680
KARNATAKA,CHAMARAJANAGARA,2021-01-14,5,821,0,826
KARNATAKA,CHAMARAJANAGARA,2021-01-15,3,358,0,361
KARNATAKA,CHIKKABALLAPURA,2021-01-11,18,1882,3,1903
KARNATAKA,CHIKKABALLAPURA,2021-01-12,14,2245,4,2263
KARNATAKA,CHIKKABALLAPURA,2021-01-13,10,2522,2,2534
KARNATAKA,CHIKKABALLAPURA,2021-01-14,19,2876,7,2902
KARNATAKA,CHIKKABALLAPURA,2021-01-15,10,3843,10,3863
KARNATAKA,CHIKKAMAGALURU,2021-01-11,16,1379,7,1402
KARNATAKA,CHIKKAMAGALURU,2021-01-12,9,1630,4,1643
KARNATAKA,CHIKKAMAGALURU,2021-01-13,13,2127,9,2149
KARNATAKA,CHIKKAMAGALURU,2021-01-14,10,1541,8,1559
KARNATAKA,CHIKKAMAGALURU,2021-01-15,10,2083,2,2095
KARNATAKA,CHITRADURGA,2021-01-11,26,3539,3,3568
KARNATAKA,CHITRADURGA,2021-01-12,19,3410,5,3434
KARNATAKA,CHITRADURGA,2021-01-13,16,3166,1,3183
KARNATAKA,CHITRADURGA,2021-01-14,7,1702,1,1710
KARNATAKA,CHITRADURGA,2021-01-15,9,2572,13,2594
KARNATAKA,DAKSHINA KANNADA,2021-01-11,18,3251,4,3273
KARNATAKA,DAKSHINA KANNADA,2021-01-12,23,4806,18,4847
KARNATAKA,DAKSHINA KANNADA,2021-01-13,35,5171,16,5222
KARNATAKA,DAKSHINA KANNADA,2021-01-14,40,3746,9,3795
KARNATAKA,DAKSHINA KANNADA,2021-01-15,30,3705,9,3744
KARNATAKA,DAVANGERE,2021-01-11,18,2930,5,2953
KARNATAKA,DAVANGERE,2021-01-12,22,1319,54,1395
KARNATAKA,DAVANGERE,2021-01-13,12,3160,13,3185
KARNATAKA,DAVANGERE,2021-01-14,7,2005,3,2015
KARNATAKA,DAVANGERE,2021-01-15,7,2077,35,2119
KARNATAKA,DHARWAD,2021-01-11,14,2910,3,2927
KARNATAKA,DHARWAD,2021-01-12,9,3201,10,3220
KARNATAKA,DHARWAD,2021-01-13,27,3017,4,3048
KARNATAKA,DHARWAD,2021-01-14,7,1710,3,1720
KARNATAKA,DHARWAD,2021-01-15,5,3462,24,3491
KARNATAKA,GADAG,2021-01-11,0,1381,17,1398
KARNATAKA,GADAG,2021-01-12,3,3247,95,3345
KARNATAKA,GADAG,2021-01-13,3,2625,55,2683
KARNATAKA,GADAG,2021-01-14,0,1431,35,1466
KARNATAKA,GADAG,2021-01-15,4,3043,60,3107
KARNATAKA,HASSAN,2021-01-11,34,5523,8,5565
KARNATAKA,HASSAN,2021-01-12,21,5119,3,5143
KARNATAKA,HASSAN,2021-01-13,14,3604,13,3631
KARNATAKA,HASSAN,2021-01-14,5,3097,4,3106
KARNATAKA,HASSAN,2021-01-15,13,3428,12,3453
KARNATAKA,HAVERI,2021-01-11,3,2310,0,2313
KARNATAKA,HAVERI,2021-01-12,1,2489,0,2490
KARNATAKA,HAVERI,2021-01-13,1,2389,0,2390
KARNATAKA,HAVERI,2021-01-14,0,615,0,615
KARNATAKA,HAVERI,2021-01-15,2,1721,1,1724
KARNATAKA,KALABURAGI,2021-01-11,25,2587,10,2622
KARNATAKA,KALABURAGI,2021-01-12,28,3397,5,3430
KARNATAKA,KALABURAGI,2021-01-13,19,2105,10,2134
KARNATAKA,KALABURAGI,2021-01-14,21,2206,1,2228
KARNATAKA,KALABURAGI,2021-01-15,12,1511,32,1555
KARNATAKA,KODAGU,2021-01-11,6,491,10,507
KARNATAKA,KODAGU,2021-01-12,12,1171,27,1210
KARNATAKA,KODAGU,2021-01-13,21,936,8,965
KARNATAKA,KODAGU,2021-01-14,5,767,9,781
KARNATAKA,KODAGU,2021-01-15,3,685,5,693
KARNATAKA,KOLAR,2021-01-11,9,2243,0,2252
KARNATAKA,KOLAR,2021-01-12,7,3168,3,3178
KARNATAKA,KOLAR,2021-01-13,17,3079,1,3097
KARNATAKA,KOLAR,2021-01-14,7,2278,0,2285
KARNATAKA,KOLAR,2021-01-15,7,2911,0,2918
KARNATAKA,KOPPAL,2021-01-11,1,1480,6,1487
KARNATAKA,KOPPAL,2021-01-12,1,1806,6,1813
KARNATAKA,KOPPAL,2021-01-13,0,982,3,985
KARNATAKA,KOPPAL,2021-01-14,1,1873,3,1877
KARNATAKA,KOPPAL,2021-01-15,0,685,0,685
KARNATAKA,MANDYA,2021-01-11,12,2022,5,2039
KARNATAKA,MANDYA,2021-01-12,3,3014,6,3023
KARNATAKA,MANDYA,2021-01-13,10,3487,6,3503
KARNATAKA,MANDYA,2021-01-14,1,1403,0,1404
KARNATAKA,MANDYA,2021-01-15,12,1896,21,1929
KARNATAKA,MYSURU,2021-01-11,21,3375,7,3403
KARNATAKA,MYSURU,2021-01-12,41,7525,10,7576
KARNATAKA,MYSURU,2021-01-13,50,7235,9,7294
KARNATAKA,MYSURU,2021-01-14,21,4751,4,4776
KARNATAKA,MYSURU,2021-01-15,14,3365,2,3381
KARNATAKA,RAICHUR,2021-01-11,7,952,6,965
KARNATAKA,RAICHUR,2021-01-12,4,261,3,268
KARNATAKA,RAICHUR,2021-01-13,3,1291,13,1307
KARNATAKA,RAICHUR,2021-01-14,3,1632,7,1642
KARNATAKA,RAICHUR,2021-01-15,2,1914,9,1925
KARNATAKA,RAMANAGARA,2021-01-11,0,1144,4,1148
KARNATAKA,RAMANAGARA,2021-01-12,8,946,1,955
KARNATAKA,RAMANAGARA,2021-01-13,1,1047,2,1050
KARNATAKA,RAMANAGARA,2021-01-14,0,1129,1,1130
KARNATAKA,RAMANAGARA,2021-01-15,0,1298,0,1298
KARNATAKA,SHIVAMOGGA,2021-01-11,16,4757,3,4776
KARNATAKA,SHIVAMOGGA,2021-01-12,17,7693,7,7717
KARNATAKA,SHIVAMOGGA,2021-01-13,12,4278,3,4293
KARNATAKA,SHIVAMOGGA,2021-01-14,9,2563,2,2574
KARNATAKA,SHIVAMOGGA,2021-01-15,9,3292,73,3374
KARNATAKA,TUMAKURU,2021-01-11,18,6454,2,6474
KARNATAKA,TUMAKURU,2021-01-12,13,2962,1,2976
KARNATAKA,TUMAKURU,2021-01-13,15,3552,2,3569
KARNATAKA,TUMAKURU,2021-01-14,30,2366,1,2397
KARNATAKA,TUMAKURU,2021-01-15,37,4909,4,4950
KARNATAKA,UDUPI,2021-01-11,3,1666,0,1669
KARNATAKA,UDUPI,2021-01-12,5,1399,1,1405
KARNATAKA,UDUPI,2021-01-13,3,1368,0,1371
KARNATAKA,UDUPI,2021-01-14,10,1656,2,1668
KARNATAKA,UDUPI,2021-01-15,6,1128,2,1136
KARNATAKA,UTTARA KANNADA,2021-01-11,8,1881,22,1911
KARNATAKA,UTTARA KANNADA,2021-01-12,8,2241,26,2275
KARNATAKA,UTTARA KANNADA,2021-01-13,27,1832,72,1931
KARNATAKA,UTTARA KANNADA,2021-01-14,9,1422,3,1434
KARNATAKA,UTTARA KANNADA,2021-01-15,4,1779,105,1888
KARNATAKA,VIJAYAPURA,2021-01-11,6,2106,0,2112
KARNATAKA,VIJAYAPURA,2021-01-12,5,1308,0,1313
KARNATAKA,VIJAYAPURA,2021-01-13,9,2543,0,2552
KARNATAKA,VIJAYAPURA,2021-01-14,10,1538,0,1548
KARNATAKA,VIJAYAPURA,2021-01-15,12,1460,0,1472
KARNATAKA,YADGIR,2021-01-11,5,1032,0,1037
KARNATAKA,YADGIR,2021-01-12,1,1173,1,1175
KARNATAKA,YADGIR,2021-01-13,2,1118,0,1120
KARNATAKA,YADGIR,2021-01-14,0,944,0,944
KARNATAKA,YADGIR,2021-01-15,3,581,1,585
KERALA,ALAPPUZHA,2021-01-11,17,5440,0,5457
KERALA,ALAPPUZHA,2021-01-12,23,802,0,825
KERALA,ALAPPUZHA,2021-01-13,78,36,0,114
KERALA,ALAPPUZHA,2021-01-14,610,4237,2,4849
KERALA,ALAPPUZHA,2021-01-15,387,5340,5,5732
KERALA,ERNAKULAM,2021-01-11,21,13420,0,13441
KERALA,ERNAKULAM,2021-01-12,17,877,0,894
KERALA,ERNAKULAM,2021-01-13,228,56,0,284
KERALA,ERNAKULAM,2021-01-14,1339,7995,36,9370
KERALA,ERNAKULAM,2021-01-15,1168,9110,18,10296
KERALA,IDUKKI,2021-01-11,9,2379,0,2388
KERALA,IDUKKI,2021-01-12,4,204,0,208
KERALA,IDUKKI,2021-01-13,88,126,0,214
KERALA,IDUKKI,2021-01-14,494,2504,13,3011
KERALA,IDUKKI,2021-01-15,177,2910,8,3095
KERALA,KANNUR,2021-01-11,18,5779,1,5798
KERALA,KANNUR,2021-01-12,5,262,1,268
KERALA,KANNUR,2021-01-13,43,49,0,92
KERALA,KANNUR,2021-01-14,453,2937,2,3392
KERALA,KANNUR,2021-01-15,323,4646,1,4970
KERALA,KASARAGOD,2021-01-11,35,2355,2,2392
KERALA,KASARAGOD,2021-01-12,2,196,2,200
KERALA,KASARAGOD,2021-01-13,12,215,3,230
KERALA,KASARAGOD,2021-01-14,211,2327,13,2551
KERALA,KASARAGOD,2021-01-15,120,2579,2,2701
KERALA,KOLLAM,2021-01-11,7,7361,0,7368
KERALA,KOLLAM,2021-01-12,32,1164,0,1196
KERALA,KOLLAM,2021-01-13,145,83,0,228
KERALA,KOLLAM,2021-01-14,884,6237,1,7122
KERALA,KOLLAM,2021-01-15,487,7026,3,7516
KERALA,KOTTAYAM,2021-01-11,40,6472,0,6512
KERALA,KOTTAYAM,2021-01-12,2,254,0,256
KERALA,KOTTAYAM,2021-01-13,107,23,0,130
KERALA,KOTTAYAM,2021-01-14,970,5173,11,6154
KERALA,KOTTAYAM,2021-01-15,632,6211,3,6846
KERALA,KOZHIKODE,2021-01-11,42,10397,2,10441
KERALA,KOZHIKODE,2021-01-12,32,506,2,540
KERALA,KOZHIKODE,2021-01-13,137,120,0,257
KERALA,KOZHIKODE,2021-01-14,1205,4856,25,6086
KERALA,KOZHIKODE,2021-01-15,1011,8096,18,9125
KERALA,MALAPPURAM,2021-01-11,76,7951,0,8027
KERALA,MALAPPURAM,2021-01-12,7,414,0,421
KERALA,MALAPPURAM,2021-01-13,76,58,0,134
KERALA,MALAPPURAM,2021-01-14,1102,4232,0,5334
KERALA,MALAPPURAM,2021-01-15,530,6006,1,6537
KERALA,PALAKKAD,2021-01-11,21,5194,0,5215
KERALA,PALAKKAD,2021-01-12,2,387,0,389
KERALA,PALAKKAD,2021-01-13,53,42,0,95
KERALA,PALAKKAD,2021-01-14,407,3022,0,3429
KERALA,PALAKKAD,2021-01-15,248,5113,1,5362
KERALA,PATHANAMTHITTA,2021-01-11,31,5382,0,5413
KERALA,PATHANAMTHITTA,2021-01-12,11,306,0,317
KERALA,PATHANAMTHITTA,2021-01-13,69,13,0,82
KERALA,PATHANAMTHITTA,2021-01-14,959,4433,6,5398
KERALA,PATHANAMTHITTA,2021-01-15,568,5648,2,6218
KERALA,THIRUVANANTHAPURAM,2021-01-11,31,8657,0,8688
KERALA,THIRUVANANTHAPURAM,2021-01-12,8,1282,1,1291
KERALA,THIRUVANANTHAPURAM,2021-01-13,100,80,0,180
KERALA,THIRUVANANTHAPURAM,2021-01-14,643,4725,1,5369
KERALA,THIRUVANANTHAPURAM,2021-01-15,475,7043,1,7519
KERALA,THRISSUR,2021-01-11,5,11005,0,11010
KERALA,THRISSUR,2021-01-12,1,397,0,398
KERALA,THRISSUR,2021-01-13,98,29,1,128
KERALA,THRISSUR,2021-01-14,838,4832,0,5670
KERALA,THRISSUR,2021-01-15,668,7174,0,7842
KERALA,WAYANAD,2021-01-11,3,3101,0,3104
KERALA,WAYANAD,2021-01-12,3,438,0,441
KERALA,WAYANAD,2021-01-13,71,10,0,81
KERALA,WAYANAD,2021-01-14,460,1625,8,2093
KERALA,WAYANAD,2021-01-15,304,1896,6,2206
LADAKH,KARGIL,2021-01-11,0,86,0,86
LADAKH,KARGIL,2021-01-12,0,128,0,128
LADAKH,KARGIL,2021-01-13,1,132,0,133
LADAKH,KARGIL,2021-01-14,0,73,1,74
LADAKH,KARGIL,2021-01-15,0,99,0,99
LADAKH,LEH LADAKH,2021-01-11,12,397,0,409
LADAKH,LEH LADAKH,2021-01-12,7,177,1,185
LADAKH,LEH LADAKH,2021-01-13,5,193,1,199
LADAKH,LEH LADAKH,2021-01-14,6,192,0,198
LADAKH,LEH LADAKH,2021-01-15,1,148,1,150
LAKSHADWEEP,LAKSHADWEEP DISTRICT,2021-01-11,0,69,0,69
LAKSHADWEEP,LAKSHADWEEP DISTRICT,2021-01-12,0,53,0,53
LAKSHADWEEP,LAKSHADWEEP DISTRICT,2021-01-13,0,27,0,27
LAKSHADWEEP,LAKSHADWEEP DISTRICT,2021-01-14,0,1,0,1
LAKSHADWEEP,LAKSHADWEEP DISTRICT,2021-01-15,0,70,1,71
MADHYA PRADESH,AGAR MALWA,2021-01-11,1,185,0,186
MADHYA PRADESH,AGAR MALWA,2021-01-12,3,362,0,365
MADHYA PRADESH,AGAR MALWA,2021-01-13,0,224,0,224
MADHYA PRADESH,AGAR MALWA,2021-01-14,0,239,0,239
MADHYA PRADESH,AGAR MALWA,2021-01-15,1,213,0,214
MADHYA PRADESH,ALIRAJPUR,2021-01-11,2,225,0,227
MADHYA PRADESH,ALIRAJPUR,2021-01-12,1,162,0,163
MADHYA PRADESH,ALIRAJPUR,2021-01-13,3,99,0,102
MADHYA PRADESH,ALIRAJPUR,2021-01-14,0,37,0,37
MADHYA PRADESH,ALIRAJPUR,2021-01-15,0,101,0,101
MADHYA PRADESH,ANUPPUR,2021-01-11,7,83,0,90
MADHYA PRADESH,ANUPPUR,2021-01-12,0,78,0,78
MADHYA PRADESH,ANUPPUR,2021-01-13,1,54,0,55
MADHYA PRADESH,ANUPPUR,2021-01-14,3,52,0,55
MADHYA PRADESH,ANUPPUR,2021-01-15,4,43,0,47
MADHYA PRADESH,ASHOKNAGAR,2021-01-11,4,86,0,90
MADHYA PRADESH,ASHOKNAGAR,2021-01-12,1,245,0,246
MADHYA PRADESH,ASHOKNAGAR,2021-01-13,2,75,0,77
MADHYA PRADESH,ASHOKNAGAR,2021-01-14,4,115,0,119
MADHYA PRADESH,ASHOKNAGAR,2021-01-15,0,174,0,174
MADHYA PRADESH,BALAGHAT,2021-01-11,5,565,3,573
MADHYA PRADESH,BALAGHAT,2021-01-12,3,356,0,359
MADHYA PRADESH,BALAGHAT,2021-01-13,10,319,1,330
MADHYA PRADESH,BALAGHAT,2021-01-14,4,310,0,314
MADHYA PRADESH,BALAGHAT,2021-01-15,5,171,1,177
MADHYA PRADESH,BARWANI,2021-01-11,9,327,0,336
MADHYA PRADESH,BARWANI,2021-01-12,11,323,0,334
MADHYA PRADESH,BARWANI,2021-01-13,11,326,0,337
MADHYA PRADESH,BARWANI,2021-01-14,10,221,0,231
MADHYA PRADESH,BARWANI,2021-01-15,6,336,0,342
MADHYA PRADESH,BETUL,2021-01-11,23,533,10,566
MADHYA PRADESH,BETUL,2021-01-12,14,418,10,442
MADHYA PRADESH,BETUL,2021-01-13,15,239,11,265
MADHYA PRADESH,BETUL,2021-01-14,22,340,8,370
MADHYA PRADESH,BETUL,2021-01-15,49,222,3,274
MADHYA PRADESH,BHIND,2021-01-11,3,358,2,363
MADHYA PRADESH,BHIND,2021-01-12,1,261,1,263
MADHYA PRADESH,BHIND,2021-01-13,2,257,0,259
MADHYA PRADESH,BHIND,2021-01-14,1,273,2,276
MADHYA PRADESH,BHIND,2021-01-15,1,331,14,346
MADHYA PRADESH,BHOPAL,2021-01-11,111,2104,23,2238
MADHYA PRADESH,BHOPAL,2021-01-12,106,1462,10,1578
MADHYA PRADESH,BHOPAL,2021-01-13,91,1883,15,1989
MADHYA PRADESH,BHOPAL,2021-01-14,132,1629,10,1771
MADHYA PRADESH,BHOPAL,2021-01-15,114,2069,10,2193
MADHYA PRADESH,BURHANPUR,2021-01-11,2,237,0,239
MADHYA PRADESH,BURHANPUR,2021-01-12,3,221,2,226
MADHYA PRADESH,BURHANPUR,2021-01-13,1,310,0,311
MADHYA PRADESH,BURHANPUR,2021-01-14,3,186,0,189
MADHYA PRADESH,BURHANPUR,2021-01-15,0,114,0,114
MADHYA PRADESH,CHHATARPUR,2021-01-11,4,689,0,693
MADHYA PRADESH,CHHATARPUR,2021-01-12,4,84,0,88
MADHYA PRADESH,CHHATARPUR,2021-01-13,3,487,8,498
MADHYA PRADESH,CHHATARPUR,2021-01-14,1,243,0,244
MADHYA PRADESH,CHHATARPUR,2021-01-15,4,269,0,273
MADHYA PRADESH,CHHINDWARA,2021-01-11,15,263,10,288
MADHYA PRADESH,CHHINDWARA,2021-01-12,17,399,8,424
MADHYA PRADESH,CHHINDWARA,2021-01-13,16,384,3,403
MADHYA PRADESH,CHHINDWARA,2021-01-14,11,351,7,369
MADHYA PRADESH,CHHINDWARA,2021-01-15,7,383,2,392
MADHYA PRADESH,DAMOH,2021-01-11,6,141,10,157
MADHYA PRADESH,DAMOH,2021-01-12,7,202,12,221
MADHYA PRADESH,DAMOH,2021-01-13,6,218,1,225
MADHYA PRADESH,DAMOH,2021-01-14,5,311,0,316
MADHYA PRADESH,DAMOH,2021-01-15,10,246,0,256
MADHYA PRADESH,DATIA,2021-01-11,5,281,4,290
MADHYA PRADESH,DATIA,2021-01-12,1,285,4,290
MADHYA PRADESH,DATIA,2021-01-13,5,83,19,107
MADHYA PRADESH,DATIA,2021-01-14,6,257,3,266
MADHYA PRADESH,DATIA,2021-01-15,5,269,12,286
MADHYA PRADESH,DEWAS,2021-01-11,21,304,0,325
MADHYA PRADESH,DEWAS,2021-01-12,11,512,1,524
MADHYA PRADESH,DEWAS,2021-01-13,8,517,0,525
MADHYA PRADESH,DEWAS,2021-01-14,9,526,0,535
MADHYA PRADESH,DEWAS,2021-01-15,10,148,0,158
MADHYA PRADESH,DHAR,2021-01-11,14,574,5,593
MADHYA PRADESH,DHAR,2021-01-12,17,661,0,678
MADHYA PRADESH,DHAR,2021-01-13,8,575,6,589
MADHYA PRADESH,DHAR,2021-01-14,2,263,0,265
MADHYA PRADESH,DHAR,2021-01-15,5,598,11,614
MADHYA PRADESH,DINDORI,2021-01-11,1,184,0,185
MADHYA PRADESH,DINDORI,2021-01-12,2,98,0,100
MADHYA PRADESH,DINDORI,2021-01-13,5,259,0,264
MADHYA PRADESH,DINDORI,2021-01-14,2,63,0,65
MADHYA PRADESH,DINDORI,2021-01-15,3,363,0,366
MADHYA PRADESH,EAST NIMAR,2021-01-11,15,522,22,559
MADHYA PRADESH,EAST NIMAR,2021-01-12,5,465,14,484
MADHYA PRADESH,EAST NIMAR,2021-01-13,9,506,4,519
MADHYA PRADESH,EAST NIMAR,2021-01-14,10,388,3,401
MADHYA PRADESH,EAST NIMAR,2021-01-15,1,133,0,134
MADHYA PRADESH,GUNA,2021-01-11,5,211,0,216
MADHYA PRADESH,GUNA,2021-01-12,3,264,2,269
MADHYA PRADESH,GUNA,2021-01-13,7,403,0,410
MADHYA PRADESH,GUNA,2021-01-14,2,274,0,276
MADHYA PRADESH,GUNA,2021-01-15,8,130,0,138
MADHYA PRADESH,GWALIOR,2021-01-11,25,1411,2,1438
MADHYA PRADESH,GWALIOR,2021-01-12,26,778,3,807
MADHYA PRADESH,GWALIOR,2021-01-13,58,1551,3,1612
MADHYA PRADESH,GWALIOR,2021-01-14,12,1419,3,1434
MADHYA PRADESH,GWALIOR,2021-01-15,24,1550,1,1575
MADHYA PRADESH,HARDA,2021-01-11,7,302,2,311
MADHYA PRADESH,HARDA,2021-01-12,5,397,12,414
MADHYA PRADESH,HARDA,2021-01-13,5,223,7,235
MADHYA PRADESH,HARDA,2021-01-14,10,314,6,330
MADHYA PRADESH,HARDA,2021-01-15,1,276,0,277
MADHYA PRADESH,HOSHANGABAD,2021-01-11,9,401,0,410
MADHYA PRADESH,HOSHANGABAD,2021-01-12,11,351,3,365
MADHYA PRADESH,HOSHANGABAD,2021-01-13,12,337,0,349
MADHYA PRADESH,HOSHANGABAD,2021-01-14,10,342,4,356
MADHYA PRADESH,HOSHANGABAD,2021-01-15,11,363,5,379
MADHYA PRADESH,INDORE,2021-01-11,125,3904,0,4029
MADHYA PRADESH,INDORE,2021-01-12,144,2937,0,3081
MADHYA PRADESH,INDORE,2021-01-13,100,2833,1,2934
MADHYA PRADESH,INDORE,2021-01-14,96,2867,0,2963
MADHYA PRADESH,INDORE,2021-01-15,68,3158,0,3226
MADHYA PRADESH,JABALPUR,2021-01-11,22,1953,29,2004
MADHYA PRADESH,JABALPUR,2021-01-12,37,531,203,771
MADHYA PRADESH,JABALPUR,2021-01-13,18,316,0,334
MADHYA PRADESH,JABALPUR,2021-01-14,13,231,1,245
MADHYA PRADESH,JABALPUR,2021-01-15,53,264,23,340
MADHYA PRADESH,JHABUA,2021-01-11,9,527,0,536
MADHYA PRADESH,JHABUA,2021-01-12,6,660,1,667
MADHYA PRADESH,JHABUA,2021-01-13,11,534,3,548
MADHYA PRADESH,JHABUA,2021-01-14,1,257,0,258
MADHYA PRADESH,JHABUA,2021-01-15,3,232,1,236
MADHYA PRADESH,KATNI,2021-01-11,6,212,6,224
MADHYA PRADESH,KATNI,2021-01-12,2,369,4,375
MADHYA PRADESH,KATNI,2021-01-13,5,229,4,238
MADHYA PRADESH,KATNI,2021-01-14,0,161,1,162
MADHYA PRADESH,KATNI,2021-01-15,1,244,4,249
MADHYA PRADESH,KHARGONE,2021-01-11,15,401,1,417
MADHYA PRADESH,KHARGONE,2021-01-12,17,909,0,926
MADHYA PRADESH,KHARGONE,2021-01-13,13,403,0,416
MADHYA PRADESH,KHARGONE,2021-01-14,14,304,0,318
MADHYA PRADESH,KHARGONE,2021-01-15,6,204,5,215
MADHYA PRADESH,MANDLA,2021-01-11,1,84,0,85
MADHYA PRADESH,MANDLA,2021-01-12,1,253,0,254
MADHYA PRADESH,MANDLA,2021-01-13,1,225,0,226
MADHYA PRADESH,MANDLA,2021-01-14,1,29,0,30
MADHYA PRADESH,MANDLA,2021-01-15,1,339,0,340
MADHYA PRADESH,MANDSAUR,2021-01-11,5,193,1,199
MADHYA PRADESH,MANDSAUR,2021-01-12,12,220,36,268
MADHYA PRADESH,MANDSAUR,2021-01-13,12,604,66,682
MADHYA PRADESH,MANDSAUR,2021-01-14,4,218,4,226
MADHYA PRADESH,MANDSAUR,2021-01-15,7,218,4,229
MADHYA PRADESH,MORENA,2021-01-11,5,235,0,240
MADHYA PRADESH,MORENA,2021-01-12,1,312,0,313
MADHYA PRADESH,MORENA,2021-01-13,3,243,0,246
MADHYA PRADESH,MORENA,2021-01-14,0,145,0,145
MADHYA PRADESH,MORENA,2021-01-15,1,456,2,459
MADHYA PRADESH,NARSINGHPUR,2021-01-11,4,282,0,286
MADHYA PRADESH,NARSINGHPUR,2021-01-12,3,583,0,586
MADHYA PRADESH,NARSINGHPUR,2021-01-13,2,564,0,566
MADHYA PRADESH,NARSINGHPUR,2021-01-14,1,271,0,272
MADHYA PRADESH,NARSINGHPUR,2021-01-15,3,211,0,214
MADHYA PRADESH,NEEMUCH,2021-01-11,2,135,0,137
MADHYA PRADESH,NEEMUCH,2021-01-12,3,310,8,321
MADHYA PRADESH,NEEMUCH,2021-01-13,4,237,1,242
MADHYA PRADESH,NEEMUCH,2021-01-14,4,121,0,125
MADHYA PRADESH,NEEMUCH,2021-01-15,2,159,0,161
MADHYA PRADESH,NIWARI,2021-01-11,2,298,0,300
MADHYA PRADESH,NIWARI,2021-01-12,1,155,0,156
MADHYA PRADESH,NIWARI,2021-01-13,0,65,0,65
MADHYA PRADESH,NIWARI,2021-01-14,0,120,0,120
MADHYA PRADESH,NIWARI,2021-01-15,2,270,0,272
MADHYA PRADESH,PANNA,2021-01-11,2,93,0,95
MADHYA PRADESH,PANNA,2021-01-12,2,72,0,74
MADHYA PRADESH,PANNA,2021-01-13,6,234,1,241
MADHYA PRADESH,PANNA,2021-01-14,2,164,0,166
MADHYA PRADESH,PANNA,2021-01-15,2,174,0,176
MADHYA PRADESH,RAISEN,2021-01-11,3,201,0,204
MADHYA PRADESH,RAISEN,2021-01-12,7,192,1,200
MADHYA PRADESH,RAISEN,2021-01-13,6,184,0,190
MADHYA PRADESH,RAISEN,2021-01-14,2,98,0,100
MADHYA PRADESH,RAISEN,2021-01-15,1,167,0,168
MADHYA PRADESH,RAJGARH,2021-01-11,1,255,0,256
MADHYA PRADESH,RAJGARH,2021-01-12,3,351,0,354
MADHYA PRADESH,RAJGARH,2021-01-13,2,197,0,199
MADHYA PRADESH,RAJGARH,2021-01-14,5,220,0,225
MADHYA PRADESH,RAJGARH,2021-01-15,3,110,0,113
MADHYA PRADESH,RATLAM,2021-01-11,7,465,13,485
MADHYA PRADESH,RATLAM,2021-01-12,13,530,41,584
MADHYA PRADESH,RATLAM,2021-01-13,15,410,18,443
MADHYA PRADESH,RATLAM,2021-01-14,9,265,0,274
MADHYA PRADESH,RATLAM,2021-01-15,7,311,2,320
MADHYA PRADESH,REWA,2021-01-11,5,246,1,252
MADHYA PRADESH,REWA,2021-01-12,14,791,6,811
MADHYA PRADESH,REWA,2021-01-13,11,477,1,489
MADHYA PRADESH,REWA,2021-01-14,5,616,2,623
MADHYA PRADESH,REWA,2021-01-15,5,241,1,247
MADHYA PRADESH,SAGAR,2021-01-11,8,481,0,489
MADHYA PRADESH,SAGAR,2021-01-12,15,1192,4,1211
MADHYA PRADESH,SAGAR,2021-01-13,12,417,1,430
MADHYA PRADESH,SAGAR,2021-01-14,5,987,0,992
MADHYA PRADESH,SAGAR,2021-01-15,11,1092,4,1107
MADHYA PRADESH,SATNA,2021-01-11,16,526,1,543
MADHYA PRADESH,SATNA,2021-01-12,8,515,0,523
MADHYA PRADESH,SATNA,2021-01-13,10,509,2,521
MADHYA PRADESH,SATNA,2021-01-14,1,340,6,347
MADHYA PRADESH,SATNA,2021-01-15,10,513,2,525
MADHYA PRADESH,SEHORE,2021-01-11,11,439,4,454
MADHYA PRADESH,SEHORE,2021-01-12,5,400,0,405
MADHYA PRADESH,SEHORE,2021-01-13,2,352,0,354
MADHYA PRADESH,SEHORE,2021-01-14,4,385,0,389
MADHYA PRADESH,SEHORE,2021-01-15,4,468,3,475
MADHYA PRADESH,SEONI,2021-01-11,8,463,1,472
MADHYA PRADESH,SEONI,2021-01-12,2,288,10,300
MADHYA PRADESH,SEONI,2021-01-13,9,375,2,386
MADHYA PRADESH,SEONI,2021-01-14,0,267,7,274
MADHYA PRADESH,SEONI,2021-01-15,5,234,0,239
MADHYA PRADESH,SHAHDOL,2021-01-11,1,138,0,139
MADHYA PRADESH,SHAHDOL,2021-01-12,1,57,2,60
MADHYA PRADESH,SHAHDOL,2021-01-13,1,54,0,55
MADHYA PRADESH,SHAHDOL,2021-01-14,7,9,0,16
MADHYA PRADESH,SHAHDOL,2021-01-15,1,81,0,82
MADHYA PRADESH,SHAJAPUR,2021-01-11,3,322,0,325
MADHYA PRADESH,SHAJAPUR,2021-01-12,3,221,0,224
MADHYA PRADESH,SHAJAPUR,2021-01-13,2,305,0,307
MADHYA PRADESH,SHAJAPUR,2021-01-14,4,545,0,549
MADHYA PRADESH,SHAJAPUR,2021-01-15,7,513,1,521
MADHYA PRADESH,SHEOPUR,2021-01-11,2,75,0,77
MADHYA PRADESH,SHEOPUR,2021-01-12,3,162,0,165
MADHYA PRADESH,SHEOPUR,2021-01-13,2,25,2,29
MADHYA PRADESH,SHEOPUR,2021-01-14,2,46,0,48
MADHYA PRADESH,SHEOPUR,2021-01-15,2,78,0,80
MADHYA PRADESH,SHIVPURI,2021-01-11,16,250,0,266
MADHYA PRADESH,SHIVPURI,2021-01-12,4,279,2,285
MADHYA PRADESH,SHIVPURI,2021-01-13,3,254,0,257
MADHYA PRADESH,SHIVPURI,2021-01-14,0,200,0,200
MADHYA PRADESH,SHIVPURI,2021-01-15,6,188,1,195
MADHYA PRADESH,SIDHI,2021-01-11,2,466,6,474
MADHYA PRADESH,SIDHI,2021-01-12,7,252,1,260
MADHYA PRADESH,SIDHI,2021-01-13,3,281,1,285
MADHYA PRADESH,SIDHI,2021-01-14,0,275,0,275
MADHYA PRADESH,SIDHI,2021-01-15,4,403,0,407
MADHYA PRADESH,SINGRAULI,2021-01-11,2,242,1,245
MADHYA PRADESH,SINGRAULI,2021-01-12,2,245,0,247
MADHYA PRADESH,SINGRAULI,2021-01-13,2,238,3,243
MADHYA PRADESH,SINGRAULI,2021-01-14,5,228,1,234
MADHYA PRADESH,SINGRAULI,2021-01-15,8,308,1,317
MADHYA PRADESH,TIKAMGARH,2021-01-11,4,229,0,233
MADHYA PRADESH,TIKAMGARH,2021-01-12,1,167,1,169
MADHYA PRADESH,TIKAMGARH,2021-01-13,1,221,0,222
MADHYA PRADESH,TIKAMGARH,2021-01-14,2,198,0,200
MADHYA PRADESH,TIKAMGARH,2021-01-15,0,208,0,208
MADHYA PRADESH,UJJAIN,2021-01-11,12,582,0,594
MADHYA PRADESH,UJJAIN,2021-01-12,10,328,1,339
MADHYA PRADESH,UJJAIN,2021-01-13,29,441,0,470
MADHYA PRADESH,UJJAIN,2021-01-14,5,39,0,44
MADHYA PRADESH,UJJAIN,2021-01-15,25,612,5,642
MADHYA PRADESH,UMARIA,2021-01-11,9,25,0,34
MADHYA PRADESH,UMARIA,2021-01-12,1,138,6,145
MADHYA PRADESH,UMARIA,2021-01-13,2,53,0,55
MADHYA PRADESH,UMARIA,2021-01-14,2,150,0,152
MADHYA PRADESH,UMARIA,2021-01-15,11,175,0,186
MADHYA PRADESH,VIDISHA,2021-01-11,7,224,2,233
MADHYA PRADESH,VIDISHA,2021-01-12,7,209,1,217
MADHYA PRADESH,VIDISHA,2021-01-13,2,124,12,138
MADHYA PRADESH,VIDISHA,2021-01-14,3,119,0,122
MADHYA PRADESH,VIDISHA,2021-01-15,5,199,2,206
MAHARASHTRA,AHMEDNAGAR,2021-01-11,70,458,0,528
MAHARASHTRA,AHMEDNAGAR,2021-01-12,129,1079,8,1216
MAHARASHTRA,AHMEDNAGAR,2021-01-13,80,872,1,953
MAHARASHTRA,AHMEDNAGAR,2021-01-14,139,1238,3,1380
MAHARASHTRA,AHMEDNAGAR,2021-01-15,103,720,0,823
MAHARASHTRA,AKOLA,2021-01-11,13,141,1,155
MAHARASHTRA,AKOLA,2021-01-12,43,518,0,561
MAHARASHTRA,AKOLA,2021-01-13,49,386,2,437
MAHARASHTRA,AKOLA,2021-01-14,45,517,0,562
MAHARASHTRA,AKOLA,2021-01-15,54,603,0,657
MAHARASHTRA,AMRAVATI,2021-01-11,71,717,1,789
MAHARASHTRA,AMRAVATI,2021-01-12,86,677,0,763
MAHARASHTRA,AMRAVATI,2021-01-13,71,671,1,743
MAHARASHTRA,AMRAVATI,2021-01-14,91,674,0,765
MAHARASHTRA,AMRAVATI,2021-01-15,65,768,0,833
MAHARASHTRA,AURANGABAD,2021-01-11,23,713,0,736
MAHARASHTRA,AURANGABAD,2021-01-12,49,796,2,847
MAHARASHTRA,AURANGABAD,2021-01-13,40,733,2,775
MAHARASHTRA,AURANGABAD,2021-01-14,31,1008,1,1040
MAHARASHTRA,AURANGABAD,2021-01-15,102,544,0,646
MAHARASHTRA,BEED,2021-01-11,20,609,0,629
MAHARASHTRA,BEED,2021-01-12,56,642,1,699
MAHARASHTRA,BEED,2021-01-13,18,426,0,444
MAHARASHTRA,BEED,2021-01-14,38,375,0,413
MAHARASHTRA,BEED,2021-01-15,38,404,0,442
MAHARASHTRA,BHANDARA,2021-01-11,25,556,0,581
MAHARASHTRA,BHANDARA,2021-01-12,40,371,0,411
MAHARASHTRA,BHANDARA,2021-01-13,44,445,0,489
MAHARASHTRA,BHANDARA,2021-01-14,34,516,0,550
MAHARASHTRA,BHANDARA,2021-01-15,21,385,0,406
MAHARASHTRA,BULDHANA,2021-01-11,75,529,7,611
MAHARASHTRA,BULDHANA,2021-01-12,3,23,0,26
MAHARASHTRA,BULDHANA,2021-01-13,122,399,3,524
MAHARASHTRA,BULDHANA,2021-01-14,26,295,0,321
MAHARASHTRA,BULDHANA,2021-01-15,30,383,0,413
MAHARASHTRA,CHANDRAPUR,2021-01-11,30,583,0,613
MAHARASHTRA,CHANDRAPUR,2021-01-12,29,466,0,495
MAHARASHTRA,CHANDRAPUR,2021-01-13,26,568,2,596
MAHARASHTRA,CHANDRAPUR,2021-01-14,46,377,1,424
MAHARASHTRA,CHANDRAPUR,2021-01-15,14,373,1,388
MAHARASHTRA,DHULE,2021-01-11,27,484,4,515
MAHARASHTRA,DHULE,2021-01-12,26,690,22,738
MAHARASHTRA,DHULE,2021-01-13,23,557,4,584
MAHARASHTRA,DHULE,2021-01-14,20,519,0,539
MAHARASHTRA,DHULE,2021-01-15,26,459,5,490
MAHARASHTRA,GADCHIROLI,2021-01-11,13,569,2,584
MAHARASHTRA,GADCHIROLI,2021-01-12,11,681,1,693
MAHARASHTRA,GADCHIROLI,2021-01-13,27,868,6,901
MAHARASHTRA,GADCHIROLI,2021-01-14,8,400,1,409
MAHARASHTRA,GADCHIROLI,2021-01-15,12,381,1,394
MAHARASHTRA,GONDIA,2021-01-11,23,428,5,456
MAHARASHTRA,GONDIA,2021-01-12,11,445,1,457
MAHARASHTRA,GONDIA,2021-01-13,29,274,0,303
MAHARASHTRA,GONDIA,2021-01-14,15,266,0,281
MAHARASHTRA,GONDIA,2021-01-15,7,255,0,262
MAHARASHTRA,HINGOLI,2021-01-11,3,230,0,233
MAHARASHTRA,HINGOLI,2021-01-12,11,415,0,426
MAHARASHTRA,HINGOLI,2021-01-13,8,51,1,60
MAHARASHTRA,HINGOLI,2021-01-14,9,352,0,361
MAHARASHTRA,HINGOLI,2021-01-15,2,58,0,60
MAHARASHTRA,JALGAON,2021-01-11,50,820,0,870
MAHARASHTRA,JALGAON,2021-01-12,53,608,1,662
MAHARASHTRA,JALGAON,2021-01-13,58,1077,0,1135
MAHARASHTRA,JALGAON,2021-01-14,50,1003,0,1053
MAHARASHTRA,JALGAON,2021-01-15,41,719,0,760
MAHARASHTRA,JALNA,2021-01-11,10,76,0,86
MAHARASHTRA,JALNA,2021-01-12,23,263,0,286
MAHARASHTRA,JALNA,2021-01-13,14,248,0,262
MAHARASHTRA,JALNA,2021-01-14,31,322,0,353
MAHARASHTRA,JALNA,2021-01-15,7,181,0,188
MAHARASHTRA,KOLHAPUR,2021-01-11,14,600,9,623
MAHARASHTRA,KOLHAPUR,2021-01-12,16,1144,1,1161
MAHARASHTRA,KOLHAPUR,2021-01-13,19,947,4,970
MAHARASHTRA,KOLHAPUR,2021-01-14,23,891,2,916
MAHARASHTRA,KOLHAPUR,2021-01-15,17,919,2,938
MAHARASHTRA,LATUR,2021-01-11,30,1191,2,1223
MAHARASHTRA,LATUR,2021-01-12,52,754,4,810
MAHARASHTRA,LATUR,2021-01-13,45,1095,3,1143
MAHARASHTRA,LATUR,2021-01-14,52,1523,5,1580
MAHARASHTRA,LATUR,2021-01-15,40,950,3,993
MAHARASHTRA,MUMBAI,2021-01-11,471,11173,7,11651
MAHARASHTRA,MUMBAI,2021-01-12,590,12868,15,13473
MAHARASHTRA,MUMBAI,2021-01-13,584,12465,11,13060
MAHARASHTRA,MUMBAI,2021-01-14,532,13452,7,13991
MAHARASHTRA,MUMBAI,2021-01-15,547,13222,12,13781
MAHARASHTRA,MUMBAI SUBURBAN,2021-01-11,111,2145,5,2261
MAHARASHTRA,MUMBAI SUBURBAN,2021-01-12,150,2645,7,2802
MAHARASHTRA,MUMBAI SUBURBAN,2021-01-13,144,2690,2,2836
MAHARASHTRA,MUMBAI SUBURBAN,2021-01-14,127,2845,4,2976
MAHARASHTRA,MUMBAI SUBURBAN,2021-01-15,164,3070,12,3246
MAHARASHTRA,NAGPUR,2021-01-11,410,3001,24,3435
MAHARASHTRA,NAGPUR,2021-01-12,428,3324,27,3779
MAHARASHTRA,NAGPUR,2021-01-13,395,3421,36,3852
MAHARASHTRA,NAGPUR,2021-01-14,338,3013,19,3370
MAHARASHTRA,NAGPUR,2021-01-15,376,2912,23,3311
MAHARASHTRA,NANDED,2021-01-11,52,671,8,731
MAHARASHTRA,NANDED,2021-01-12,45,800,6,851
MAHARASHTRA,NANDED,2021-01-13,44,891,3,938
MAHARASHTRA,NANDED,2021-01-14,18,630,2,650
MAHARASHTRA,NANDED,2021-01-15,21,613,8,642
MAHARASHTRA,NANDURBAR,2021-01-11,67,297,1,365
MAHARASHTRA,NANDURBAR,2021-01-12,63,169,1,233
MAHARASHTRA,NANDURBAR,2021-01-13,42,175,2,219
MAHARASHTRA,NANDURBAR,2021-01-14,58,140,0,198
MAHARASHTRA,NANDURBAR,2021-01-15,46,93,0,139
MAHARASHTRA,NASHIK,2021-01-11,327,1418,1,1746
MAHARASHTRA,NASHIK,2021-01-12,199,1301,6,1506
MAHARASHTRA,NASHIK,2021-01-13,219,1120,2,1341
MAHARASHTRA,NASHIK,2021-01-14,237,1708,1,1946
MAHARASHTRA,NASHIK,2021-01-15,88,1122,2,1212
MAHARASHTRA,OSMANABAD,2021-01-11,18,371,5,394
MAHARASHTRA,OSMANABAD,2021-01-12,37,242,2,281
MAHARASHTRA,OSMANABAD,2021-01-13,32,386,4,422
MAHARASHTRA,OSMANABAD,2021-01-14,19,285,3,307
MAHARASHTRA,OSMANABAD,2021-01-15,32,316,5,353
MAHARASHTRA,PALGHAR,2021-01-11,33,826,5,864
MAHARASHTRA,PALGHAR,2021-01-12,64,1127,2,1193
MAHARASHTRA,PALGHAR,2021-01-13,50,1321,1,1372
MAHARASHTRA,PALGHAR,2021-01-14,52,886,1,939
MAHARASHTRA,PALGHAR,2021-01-15,44,1031,1,1076
MAHARASHTRA,PARBHANI,2021-01-11,7,616,0,623
MAHARASHTRA,PARBHANI,2021-01-12,17,1109,0,1126
MAHARASHTRA,PARBHANI,2021-01-13,22,1518,0,1540
MAHARASHTRA,PARBHANI,2021-01-14,12,1214,0,1226
MAHARASHTRA,PARBHANI,2021-01-15,15,517,0,532
MAHARASHTRA,PUNE,2021-01-11,541,5814,30,6385
MAHARASHTRA,PUNE,2021-01-12,732,6619,41,7392
MAHARASHTRA,PUNE,2021-01-13,592,6138,111,6841
MAHARASHTRA,PUNE,2021-01-14,632,5573,63,6268
MAHARASHTRA,PUNE,2021-01-15,514,5414,40,5968
MAHARASHTRA,RAIGAD,2021-01-11,59,716,1,776
MAHARASHTRA,RAIGAD,2021-01-12,98,1135,0,1233
MAHARASHTRA,RAIGAD,2021-01-13,97,1371,5,1473
MAHARASHTRA,RAIGAD,2021-01-14,91,1155,2,1248
MAHARASHTRA,RAIGAD,2021-01-15,88,1228,1,1317
MAHARASHTRA,RATNAGIRI,2021-01-11,10,188,1,199
MAHARASHTRA,RATNAGIRI,2021-01-12,18,189,0,207
MAHARASHTRA,RATNAGIRI,2021-01-13,24,250,0,274
MAHARASHTRA,RATNAGIRI,2021-01-14,40,265,0,305
MAHARASHTRA,RATNAGIRI,2021-01-15,5,161,0,166
MAHARASHTRA,SANGLI,2021-01-11,31,845,3,879
MAHARASHTRA,SANGLI,2021-01-12,23,724,2,749
MAHARASHTRA,SANGLI,2021-01-13,35,877,0,912
MAHARASHTRA,SANGLI,2021-01-14,23,573,2,598
MAHARASHTRA,SANGLI,2021-01-15,25,654,0,679
MAHARASHTRA,SATARA,2021-01-11,34,1418,10,1462
MAHARASHTRA,SATARA,2021-01-12,72,819,11,902
MAHARASHTRA,SATARA,2021-01-13,54,1127,2,1183
MAHARASHTRA,SATARA,2021-01-14,53,416,5,474
MAHARASHTRA,SATARA,2021-01-15,43,1314,19,1376
MAHARASHTRA,SINDHUDURG,2021-01-11,14,175,0,189
MAHARASHTRA,SINDHUDURG,2021-01-12,22,201,0,223
MAHARASHTRA,SINDHUDURG,2021-01-13,13,175,0,188
MAHARASHTRA,SINDHUDURG,2021-01-14,15,183,0,198
MAHARASHTRA,SINDHUDURG,2021-01-15,8,153,1,162
MAHARASHTRA,SOLAPUR,2021-01-11,65,1925,2,1992
MAHARASHTRA,SOLAPUR,2021-01-12,109,1603,3,1715
MAHARASHTRA,SOLAPUR,2021-01-13,182,2754,0,2936
MAHARASHTRA,SOLAPUR,2021-01-14,96,2803,2,2901
MAHARASHTRA,SOLAPUR,2021-01-15,88,2402,1,2491
MAHARASHTRA,THANE,2021-01-11,412,10621,13,11046
MAHARASHTRA,THANE,2021-01-12,488,9653,10,10151
MAHARASHTRA,THANE,2021-01-13,427,7969,20,8416
MAHARASHTRA,THANE,2021-01-14,389,8154,17,8560
MAHARASHTRA,THANE,2021-01-15,459,9381,16,9856
MAHARASHTRA,WARDHA,2021-01-11,45,590,15,650
MAHARASHTRA,WARDHA,2021-01-12,41,596,11,648
MAHARASHTRA,WARDHA,2021-01-13,47,596,13,656
MAHARASHTRA,WARDHA,2021-01-14,28,531,8,567
MAHARASHTRA,WARDHA,2021-01-15,29,482,16,527
MAHARASHTRA,WASHIM,2021-01-11,20,971,4,995
MAHARASHTRA,WASHIM,2021-01-12,8,963,10,981
MAHARASHTRA,WASHIM,2021-01-13,22,1279,3,1304
MAHARASHTRA,WASHIM,2021-01-14,16,1169,3,1188
MAHARASHTRA,WASHIM,2021-01-15,26,1245,4,1275
MAHARASHTRA,YAVATMAL,2021-01-11,59,527,1,587
MAHARASHTRA,YAVATMAL,2021-01-12,74,547,2,623
MAHARASHTRA,YAVATMAL,2021-01-13,102,528,2,632
MAHARASHTRA,YAVATMAL,2021-01-14,60,517,0,577
MAHARASHTRA,YAVATMAL,2021-01-15,57,300,1,358
MANIPUR,BISHNUPUR,2021-01-11,2,105,0,107
MANIPUR,BISHNUPUR,2021-01-12,6,92,0,98
MANIPUR,BISHNUPUR,2021-01-13,0,73,0,73
MANIPUR,BISHNUPUR,2021-01-14,0,66,0,66
MANIPUR,BISHNUPUR,2021-01-15,0,81,0,81
MANIPUR,CHANDEL,2021-01-11,0,41,0,41
MANIPUR,CHANDEL,2021-01-12,0,22,0,22
MANIPUR,CHANDEL,2021-01-13,1,38,0,39
MANIPUR,CHANDEL,2021-01-14,0,10,0,10
MANIPUR,CHANDEL,2021-01-15,0,103,0,103
MANIPUR,CHURACHANDPUR,2021-01-11,1,180,0,181
MANIPUR,CHURACHANDPUR,2021-01-12,11,160,0,171
MANIPUR,CHURACHANDPUR,2021-01-13,7,197,0,204
MANIPUR,CHURACHANDPUR,2021-01-14,6,132,0,138
MANIPUR,CHURACHANDPUR,2021-01-15,2,93,0,95
MANIPUR,IMPHAL EAST,2021-01-11,57,527,8,592
MANIPUR,IMPHAL EAST,2021-01-12,11,208,0,219
MANIPUR,IMPHAL EAST,2021-01-13,13,326,0,339
MANIPUR,IMPHAL EAST,2021-01-14,9,390,0,399
MANIPUR,IMPHAL EAST,2021-01-15,6,301,1,308
MANIPUR,IMPHAL WEST,2021-01-11,20,543,0,563
MANIPUR,IMPHAL WEST,2021-01-12,21,767,0,788
MANIPUR,IMPHAL WEST,2021-01-13,69,1029,0,1098
MANIPUR,IMPHAL WEST,2021-01-14,38,966,0,1004
MANIPUR,IMPHAL WEST,2021-01-15,26,902,0,928
MANIPUR,JIRIBAM,2021-01-11,0,4,0,4
MANIPUR,JIRIBAM,2021-01-12,0,9,0,9
MANIPUR,JIRIBAM,2021-01-14,0,22,0,22
MANIPUR,JIRIBAM,2021-01-15,0,1,0,1
MANIPUR,KAKCHING,2021-01-11,7,60,0,67
MANIPUR,KAKCHING,2021-01-12,2,74,0,76
MANIPUR,KAKCHING,2021-01-13,6,74,0,80
MANIPUR,KAKCHING,2021-01-14,0,42,0,42
MANIPUR,KAKCHING,2021-01-15,5,35,0,40
MANIPUR,KAMJONG,2021-01-11,0,10,0,10
MANIPUR,KAMJONG,2021-01-12,1,7,0,8
MANIPUR,KAMJONG,2021-01-13,4,8,0,12
MANIPUR,KAMJONG,2021-01-14,0,7,0,7
MANIPUR,KAMJONG,2021-01-15,0,3,0,3
MANIPUR,KANGPOKPI,2021-01-11,1,16,0,17
MANIPUR,KANGPOKPI,2021-01-12,2,40,0,42
MANIPUR,KANGPOKPI,2021-01-13,0,18,0,18
MANIPUR,KANGPOKPI,2021-01-14,3,22,0,25
MANIPUR,KANGPOKPI,2021-01-15,12,31,0,43
MANIPUR,NONEY,2021-01-11,1,12,0,13
MANIPUR,NONEY,2021-01-12,0,9,0,9
MANIPUR,NONEY,2021-01-13,2,2,0,4
MANIPUR,NONEY,2021-01-14,0,1,0,1
MANIPUR,NONEY,2021-01-15,0,3,0,3
MANIPUR,SENAPATI,2021-01-11,2,38,0,40
MANIPUR,SENAPATI,2021-01-12,1,16,0,17
MANIPUR,SENAPATI,2021-01-13,0,39,0,39
MANIPUR,SENAPATI,2021-01-14,2,28,0,30
MANIPUR,SENAPATI,2021-01-15,1,38,0,39
MANIPUR,TAMENGLONG,2021-01-11,7,237,0,244
MANIPUR,TAMENGLONG,2021-01-12,3,79,0,82
MANIPUR,TAMENGLONG,2021-01-13,0,77,0,77
MANIPUR,TAMENGLONG,2021-01-14,2,61,0,63
MANIPUR,TAMENGLONG,2021-01-15,1,32,0,33
MANIPUR,TENGNOUPAL,2021-01-11,5,29,0,34
MANIPUR,TENGNOUPAL,2021-01-12,0,1,0,1
MANIPUR,TENGNOUPAL,2021-01-13,0,10,0,10
MANIPUR,TENGNOUPAL,2021-01-14,1,3,0,4
MANIPUR,TENGNOUPAL,2021-01-15,0,5,0,5
MANIPUR,THOUBAL,2021-01-11,9,174,0,183
MANIPUR,THOUBAL,2021-01-12,5,136,0,141
MANIPUR,THOUBAL,2021-01-13,16,201,0,217
MANIPUR,THOUBAL,2021-01-14,7,143,0,150
MANIPUR,THOUBAL,2021-01-15,13,108,0,121
MANIPUR,UKHRUL,2021-01-11,4,172,0,176
MANIPUR,UKHRUL,2021-01-12,3,217,0,220
MANIPUR,UKHRUL,2021-01-13,3,188,0,191
MANIPUR,UKHRUL,2021-01-14,3,136,0,139
MANIPUR,UKHRUL,2021-01-15,1,181,0,182
MEGHALAYA,EAST GARO HILLS,2021-01-11,0,30,0,30
MEGHALAYA,EAST GARO HILLS,2021-01-12,0,34,0,34
MEGHALAYA,EAST GARO HILLS,2021-01-13,0,32,0,32
MEGHALAYA,EAST GARO HILLS,2021-01-14,0,15,0,15
MEGHALAYA,EAST GARO HILLS,2021-01-15,0,24,0,24
MEGHALAYA,EAST JAINTIA HILLS,2021-01-11,1,49,0,50
MEGHALAYA,EAST JAINTIA HILLS,2021-01-12,1,111,0,112
MEGHALAYA,EAST JAINTIA HILLS,2021-01-13,7,40,0,47
MEGHALAYA,EAST JAINTIA HILLS,2021-01-14,0,68,0,68
MEGHALAYA,EAST JAINTIA HILLS,2021-01-15,10,235,0,245
MEGHALAYA,EAST KHASI HILLS,2021-01-11,13,894,1,908
MEGHALAYA,EAST KHASI HILLS,2021-01-12,15,1007,4,1026
MEGHALAYA,EAST KHASI HILLS,2021-01-13,4,845,0,849
MEGHALAYA,EAST KHASI HILLS,2021-01-14,6,807,0,813
MEGHALAYA,EAST KHASI HILLS,2021-01-15,11,587,0,598
MEGHALAYA,NORTH GARO HILLS,2021-01-11,0,16,0,16
MEGHALAYA,NORTH GARO HILLS,2021-01-12,0,13,0,13
MEGHALAYA,NORTH GARO HILLS,2021-01-13,0,16,0,16
MEGHALAYA,NORTH GARO HILLS,2021-01-14,0,20,0,20
MEGHALAYA,NORTH GARO HILLS,2021-01-15,0,19,0,19
MEGHALAYA,RI BHOI,2021-01-11,3,148,0,151
MEGHALAYA,RI BHOI,2021-01-12,0,108,0,108
MEGHALAYA,RI BHOI,2021-01-13,2,106,0,108
MEGHALAYA,RI BHOI,2021-01-14,0,99,0,99
MEGHALAYA,RI BHOI,2021-01-15,0,61,0,61
MEGHALAYA,SOUTH GARO HILLS,2021-01-11,0,8,0,8
MEGHALAYA,SOUTH GARO HILLS,2021-01-12,0,25,0,25
MEGHALAYA,SOUTH GARO HILLS,2021-01-13,0,19,0,19
MEGHALAYA,SOUTH GARO HILLS,2021-01-14,0,16,0,16
MEGHALAYA,SOUTH GARO HILLS,2021-01-15,0,36,0,36
MEGHALAYA,SOUTH WEST GARO HILLS,2021-01-11,0,38,0,38
MEGHALAYA,SOUTH WEST GARO HILLS,2021-01-12,0,56,0,56
MEGHALAYA,SOUTH WEST GARO HILLS,2021-01-13,0,25,0,25
MEGHALAYA,SOUTH WEST GARO HILLS,2021-01-14,0,28,0,28
MEGHALAYA,SOUTH WEST GARO HILLS,2021-01-15,0,17,0,17
MEGHALAYA,SOUTH WEST KHASI HILLS,2021-01-11,0,18,0,18
MEGHALAYA,SOUTH WEST KHASI HILLS,2021-01-12,0,97,0,97
MEGHALAYA,SOUTH WEST KHASI HILLS,2021-01-13,0,83,0,83
MEGHALAYA,SOUTH WEST KHASI HILLS,2021-01-14,0,10,0,10
MEGHALAYA,SOUTH WEST KHASI HILLS,2021-01-15,0,6,0,6
MEGHALAYA,WEST GARO HILLS,2021-01-11,0,155,0,155
MEGHALAYA,WEST GARO HILLS,2021-01-12,0,172,0,172
MEGHALAYA,WEST GARO HILLS,2021-01-13,1,246,0,247
MEGHALAYA,WEST GARO HILLS,2021-01-14,0,154,0,154
MEGHALAYA,WEST GARO HILLS,2021-01-15,0,178,0,178
MEGHALAYA,WEST JAINTIA HILLS,2021-01-11,0,82,0,82
MEGHALAYA,WEST JAINTIA HILLS,2021-01-12,5,110,0,115
MEGHALAYA,WEST JAINTIA HILLS,2021-01-13,0,84,0,84
MEGHALAYA,WEST JAINTIA HILLS,2021-01-14,1,87,0,88
MEGHALAYA,WEST JAINTIA HILLS,2021-01-15,0,68,0,68
MEGHALAYA,WEST KHASI HILLS,2021-01-11,1,71,0,72
MEGHALAYA,WEST KHASI HILLS,2021-01-12,0,72,0,72
MEGHALAYA,WEST KHASI HILLS,2021-01-13,0,87,0,87
MEGHALAYA,WEST KHASI HILLS,2021-01-14,0,91,0,91
MEGHALAYA,WEST KHASI HILLS,2021-01-15,0,26,0,26
MIZORAM,AIZAWL,2021-01-11,3,755,0,758
MIZORAM,AIZAWL,2021-01-12,1,624,0,625
MIZORAM,AIZAWL,2021-01-13,6,557,0,563
MIZORAM,AIZAWL,2021-01-14,0,540,0,540
MIZORAM,AIZAWL,2021-01-15,3,514,0,517
MIZORAM,CHAMPHAI,2021-01-11,0,6,0,6
MIZORAM,CHAMPHAI,2021-01-12,0,11,0,11
MIZORAM,CHAMPHAI,2021-01-13,0,13,0,13
MIZORAM,CHAMPHAI,2021-01-14,0,47,0,47
MIZORAM,CHAMPHAI,2021-01-15,0,70,0,70
MIZORAM,HNAHTHIAL,2021-01-12,0,6,0,6
MIZORAM,HNAHTHIAL,2021-01-13,0,3,0,3
MIZORAM,HNAHTHIAL,2021-01-14,0,6,0,6
MIZORAM,HNAHTHIAL,2021-01-15,0,6,0,6
MIZORAM,KHAWZAWL,2021-01-12,1,9,0,10
MIZORAM,KHAWZAWL,2021-01-14,0,2,0,2
MIZORAM,KOLASIB,2021-01-11,2,77,0,79
MIZORAM,KOLASIB,2021-01-12,1,57,0,58
MIZORAM,KOLASIB,2021-01-13,0,19,0,19
MIZORAM,KOLASIB,2021-01-14,1,86,0,87
MIZORAM,KOLASIB,2021-01-15,0,40,0,40
MIZORAM,LAWNGTLAI,2021-01-11,0,31,0,31
MIZORAM,LAWNGTLAI,2021-01-12,0,3,0,3
MIZORAM,LAWNGTLAI,2021-01-13,1,53,0,54
MIZORAM,LAWNGTLAI,2021-01-14,0,28,0,28
MIZORAM,LAWNGTLAI,2021-01-15,1,76,0,77
MIZORAM,LUNGLEI,2021-01-11,1,42,0,43
MIZORAM,LUNGLEI,2021-01-12,1,70,0,71
MIZORAM,LUNGLEI,2021-01-13,0,39,0,39
MIZORAM,LUNGLEI,2021-01-14,0,24,0,24
MIZORAM,LUNGLEI,2021-01-15,0,42,0,42
MIZORAM,MAMIT,2021-01-11,0,46,0,46
MIZORAM,MAMIT,2021-01-12,0,87,0,87
MIZORAM,MAMIT,2021-01-13,0,80,0,80
MIZORAM,MAMIT,2021-01-14,0,83,0,83
MIZORAM,MAMIT,2021-01-15,0,40,0,40
MIZORAM,SAIHA,2021-01-11,0,1,0,1
MIZORAM,SAIHA,2021-01-12,0,10,0,10
MIZORAM,SAIHA,2021-01-13,0,1,0,1
MIZORAM,SAIHA,2021-01-14,0,6,0,6
MIZORAM,SAIHA,2021-01-15,0,10,0,10
MIZORAM,SAITUAL,2021-01-11,0,23,0,23
MIZORAM,SAITUAL,2021-01-12,0,11,0,11
MIZORAM,SAITUAL,2021-01-13,0,80,0,80
MIZORAM,SAITUAL,2021-01-14,0,8,0,8
MIZORAM,SAITUAL,2021-01-15,0,12,0,12
MIZORAM,SERCHHIP,2021-01-11,0,25,0,25
MIZORAM,SERCHHIP,2021-01-12,0,10,0,10
MIZORAM,SERCHHIP,2021-01-13,0,27,0,27
MIZORAM,SERCHHIP,2021-01-14,0,30,0,30
MIZORAM,SERCHHIP,2021-01-15,0,5,0,5
NAGALAND,DIMAPUR,2021-01-11,1,155,0,156
NAGALAND,DIMAPUR,2021-01-12,1,72,0,73
NAGALAND,DIMAPUR,2021-01-13,4,51,0,55
NAGALAND,DIMAPUR,2021-01-14,2,101,0,103
NAGALAND,DIMAPUR,2021-01-15,0,89,0,89
NAGALAND,KIPHIRE,2021-01-11,0,6,0,6
NAGALAND,KIPHIRE,2021-01-12,0,15,0,15
NAGALAND,KIPHIRE,2021-01-14,0,1,0,1
NAGALAND,KIPHIRE,2021-01-15,0,4,0,4
NAGALAND,KOHIMA,2021-01-11,14,13,0,27
NAGALAND,KOHIMA,2021-01-12,1,6,0,7
NAGALAND,KOHIMA,2021-01-13,20,3,0,23
NAGALAND,KOHIMA,2021-01-14,28,13,1,42
NAGALAND,KOHIMA,2021-01-15,0,5,0,5
NAGALAND,LONGLENG,2021-01-11,0,2,0,2
NAGALAND,LONGLENG,2021-01-15,0,1,0,1
NAGALAND,MOKOKCHUNG,2021-01-11,0,14,0,14
NAGALAND,MOKOKCHUNG,2021-01-12,1,18,0,19
NAGALAND,MOKOKCHUNG,2021-01-13,0,10,0,10
NAGALAND,MOKOKCHUNG,2021-01-14,2,12,0,14
NAGALAND,MOKOKCHUNG,2021-01-15,1,15,0,16
NAGALAND,MON,2021-01-11,0,2,0,2
NAGALAND,MON,2021-01-12,0,2,0,2
NAGALAND,MON,2021-01-13,0,2,0,2
NAGALAND,MON,2021-01-14,0,1,0,1
NAGALAND,PEREN,2021-01-11,0,3,0,3
NAGALAND,PEREN,2021-01-12,0,1,0,1
NAGALAND,PEREN,2021-01-13,0,2,0,2
NAGALAND,PEREN,2021-01-14,0,1,0,1
NAGALAND,PEREN,2021-01-15,0,1,0,1
NAGALAND,PHEK,2021-01-11,0,2,0,2
NAGALAND,PHEK,2021-01-12,0,7,0,7
NAGALAND,PHEK,2021-01-13,0,4,0,4
NAGALAND,PHEK,2021-01-14,0,2,0,2
NAGALAND,PHEK,2021-01-15,0,5,0,5
NAGALAND,TUENSANG,2021-01-12,0,1,0,1
NAGALAND,TUENSANG,2021-01-13,0,1,0,1
NAGALAND,TUENSANG,2021-01-14,0,3,0,3
NAGALAND,TUENSANG,2021-01-15,0,1,0,1
NAGALAND,WOKHA,2021-01-11,0,1,0,1
NAGALAND,WOKHA,2021-01-12,0,1,0,1
NAGALAND,WOKHA,2021-01-13,0,2,0,2
NAGALAND,WOKHA,2021-01-14,4,1,0,5
NAGALAND,WOKHA,2021-01-15,0,1,0,1
NAGALAND,ZUNHEBOTO,2021-01-11,0,2,0,2
NAGALAND,ZUNHEBOTO,2021-01-12,0,1,0,1
NAGALAND,ZUNHEBOTO,2021-01-14,6,3,0,9
ODISHA,ANUGUL,2021-01-11,16,694,0,710
ODISHA,ANUGUL,2021-01-12,21,650,0,671
ODISHA,ANUGUL,2021-01-13,38,495,0,533
ODISHA,ANUGUL,2021-01-14,16,605,0,621
ODISHA,ANUGUL,2021-01-15,7,710,0,717
ODISHA,BALANGIR,2021-01-11,8,1372,0,1380
ODISHA,BALANGIR,2021-01-12,6,1516,4,1526
ODISHA,BALANGIR,2021-01-13,4,1310,0,1314
ODISHA,BALANGIR,2021-01-14,6,1293,15,1314
ODISHA,BALANGIR,2021-01-15,1,1441,0,1442
ODISHA,BALESHWAR,2021-01-11,17,2298,6,2321
ODISHA,BALESHWAR,2021-01-12,9,2412,0,2421
ODISHA,BALESHWAR,2021-01-13,11,2207,0,2218
ODISHA,BALESHWAR,2021-01-14,9,2004,1,2014
ODISHA,BALESHWAR,2021-01-15,7,2324,19,2350
ODISHA,BARGARH,2021-01-11,18,969,0,987
ODISHA,BARGARH,2021-01-12,1,696,0,697
ODISHA,BARGARH,2021-01-13,2,728,0,730
ODISHA,BARGARH,2021-01-14,1,587,5,593
ODISHA,BARGARH,2021-01-15,7,676,0,683
ODISHA,BHADRAK,2021-01-11,1,1323,0,1324
ODISHA,BHADRAK,2021-01-12,2,1349,0,1351
ODISHA,BHADRAK,2021-01-13,5,852,0,857
ODISHA,BHADRAK,2021-01-14,1,1210,0,1211
ODISHA,BHADRAK,2021-01-15,4,1188,8,1200
ODISHA,BOUDH,2021-01-11,0,466,1,467
ODISHA,BOUDH,2021-01-12,0,206,0,206
ODISHA,BOUDH,2021-01-13,0,421,0,421
ODISHA,BOUDH,2021-01-14,1,553,0,554
ODISHA,BOUDH,2021-01-15,0,192,0,192
ODISHA,CUTTACK,2021-01-11,11,1493,1,1505
ODISHA,CUTTACK,2021-01-12,7,1347,0,1354
ODISHA,CUTTACK,2021-01-13,12,1553,0,1565
ODISHA,CUTTACK,2021-01-14,4,1188,0,1192
ODISHA,CUTTACK,2021-01-15,10,1611,1,1622
ODISHA,DEOGARH,2021-01-11,5,374,1,380
ODISHA,DEOGARH,2021-01-12,1,274,0,275
ODISHA,DEOGARH,2021-01-13,0,294,0,294
ODISHA,DEOGARH,2021-01-14,0,273,0,273
ODISHA,DEOGARH,2021-01-15,0,246,0,246
ODISHA,DHENKANAL,2021-01-11,0,753,0,753
ODISHA,DHENKANAL,2021-01-12,1,799,0,800
ODISHA,DHENKANAL,2021-01-13,0,1030,2,1032
ODISHA,DHENKANAL,2021-01-14,2,684,0,686
ODISHA,DHENKANAL,2021-01-15,1,1169,0,1170
ODISHA,GAJAPATI,2021-01-11,7,240,1,248
ODISHA,GAJAPATI,2021-01-12,7,271,0,278
ODISHA,GAJAPATI,2021-01-13,0,347,0,347
ODISHA,GAJAPATI,2021-01-14,3,307,1,311
ODISHA,GAJAPATI,2021-01-15,8,216,0,224
ODISHA,GANJAM,2021-01-11,3,1710,94,1807
ODISHA,GANJAM,2021-01-12,2,1839,210,2051
ODISHA,GANJAM,2021-01-13,0,1661,135,1796
ODISHA,GANJAM,2021-01-14,2,681,0,683
ODISHA,GANJAM,2021-01-15,0,2291,174,2465
ODISHA,JAGATSINGHAPUR,2021-01-11,1,1113,1,1115
ODISHA,JAGATSINGHAPUR,2021-01-12,2,679,0,681
ODISHA,JAGATSINGHAPUR,2021-01-13,0,797,0,797
ODISHA,JAGATSINGHAPUR,2021-01-14,1,712,0,713
ODISHA,JAGATSINGHAPUR,2021-01-15,1,667,0,668
ODISHA,JAJAPUR,2021-01-11,3,955,4,962
ODISHA,JAJAPUR,2021-01-12,0,974,1,975
ODISHA,JAJAPUR,2021-01-13,5,975,0,980
ODISHA,JAJAPUR,2021-01-14,9,702,0,711
ODISHA,JAJAPUR,2021-01-15,8,905,0,913
ODISHA,JHARSUGUDA,2021-01-11,13,657,5,675
ODISHA,JHARSUGUDA,2021-01-12,10,646,6,662
ODISHA,JHARSUGUDA,2021-01-13,32,670,3,705
ODISHA,JHARSUGUDA,2021-01-14,11,641,0,652
ODISHA,JHARSUGUDA,2021-01-15,6,575,2,583
ODISHA,KALAHANDI,2021-01-11,3,223,0,226
ODISHA,KALAHANDI,2021-01-12,3,247,0,250
ODISHA,KALAHANDI,2021-01-13,1,104,0,105
ODISHA,KALAHANDI,2021-01-14,2,294,0,296
ODISHA,KALAHANDI,2021-01-15,0,498,0,498
ODISHA,KANDHAMAL,2021-01-11,1,857,0,858
ODISHA,KANDHAMAL,2021-01-12,1,833,0,834
ODISHA,KANDHAMAL,2021-01-13,0,923,0,923
ODISHA,KANDHAMAL,2021-01-14,0,823,1,824
ODISHA,KANDHAMAL,2021-01-15,1,746,0,747
ODISHA,KENDRAPARA,2021-01-11,3,1381,1,1385
ODISHA,KENDRAPARA,2021-01-12,0,1215,1,1216
ODISHA,KENDRAPARA,2021-01-13,3,1130,0,1133
ODISHA,KENDRAPARA,2021-01-14,0,899,0,899
ODISHA,KENDRAPARA,2021-01-15,5,1432,1,1438
ODISHA,KENDUJHAR,2021-01-11,1,1114,0,1115
ODISHA,KENDUJHAR,2021-01-12,8,1056,0,1064
ODISHA,KENDUJHAR,2021-01-13,23,966,0,989
ODISHA,KENDUJHAR,2021-01-14,3,613,0,616
ODISHA,KENDUJHAR,2021-01-15,2,945,0,947
ODISHA,KHORDHA,2021-01-11,26,1646,4,1676
ODISHA,KHORDHA,2021-01-12,21,2026,4,2051
ODISHA,KHORDHA,2021-01-13,35,1785,1,1821
ODISHA,KHORDHA,2021-01-14,29,1979,0,2008
ODISHA,KHORDHA,2021-01-15,9,1994,4,2007
ODISHA,KORAPUT,2021-01-11,0,1186,0,1186
ODISHA,KORAPUT,2021-01-12,2,1153,0,1155
ODISHA,KORAPUT,2021-01-13,1,436,0,437
ODISHA,KORAPUT,2021-01-14,3,1385,0,1388
ODISHA,KORAPUT,2021-01-15,1,1790,0,1791
ODISHA,MALKANGIRI,2021-01-11,0,687,0,687
ODISHA,MALKANGIRI,2021-01-12,0,779,0,779
ODISHA,MALKANGIRI,2021-01-13,2,766,0,768
ODISHA,MALKANGIRI,2021-01-14,6,672,0,678
ODISHA,MALKANGIRI,2021-01-15,0,760,0,760
ODISHA,MAYURBHANJ,2021-01-11,10,1296,0,1306
ODISHA,MAYURBHANJ,2021-01-12,8,1395,0,1403
ODISHA,MAYURBHANJ,2021-01-13,3,1133,0,1136
ODISHA,MAYURBHANJ,2021-01-14,5,861,1,867
ODISHA,MAYURBHANJ,2021-01-15,3,840,0,843
ODISHA,NABARANGPUR,2021-01-11,1,696,0,697
ODISHA,NABARANGPUR,2021-01-12,0,840,0,840
ODISHA,NABARANGPUR,2021-01-13,2,965,2,969
ODISHA,NABARANGPUR,2021-01-14,1,586,0,587
ODISHA,NABARANGPUR,2021-01-15,0,711,0,711
ODISHA,NAYAGARH,2021-01-11,1,655,2,658
ODISHA,NAYAGARH,2021-01-12,0,622,0,622
ODISHA,NAYAGARH,2021-01-13,9,751,0,760
ODISHA,NAYAGARH,2021-01-14,1,834,0,835
ODISHA,NAYAGARH,2021-01-15,0,493,0,493
ODISHA,NUAPADA,2021-01-11,5,416,0,421
ODISHA,NUAPADA,2021-01-12,3,359,0,362
ODISHA,NUAPADA,2021-01-13,6,332,0,338
ODISHA,NUAPADA,2021-01-14,6,272,0,278
ODISHA,NUAPADA,2021-01-15,18,332,0,350
ODISHA,PURI,2021-01-11,2,1377,1,1380
ODISHA,PURI,2021-01-12,7,1476,0,1483
ODISHA,PURI,2021-01-13,14,1390,0,1404
ODISHA,PURI,2021-01-14,17,1813,0,1830
ODISHA,PURI,2021-01-15,8,1596,0,1604
ODISHA,RAYAGADA,2021-01-11,8,1098,0,1106
ODISHA,RAYAGADA,2021-01-12,0,850,0,850
ODISHA,RAYAGADA,2021-01-13,1,587,0,588
ODISHA,RAYAGADA,2021-01-14,1,758,0,759
ODISHA,RAYAGADA,2021-01-15,1,1244,0,1245
ODISHA,SAMBALPUR,2021-01-11,75,798,0,873
ODISHA,SAMBALPUR,2021-01-12,47,676,0,723
ODISHA,SAMBALPUR,2021-01-13,44,551,0,595
ODISHA,SAMBALPUR,2021-01-14,32,777,0,809
ODISHA,SAMBALPUR,2021-01-15,25,614,0,639
ODISHA,SONEPUR,2021-01-11,0,588,0,588
ODISHA,SONEPUR,2021-01-12,0,679,0,679
ODISHA,SONEPUR,2021-01-13,0,611,0,611
ODISHA,SONEPUR,2021-01-14,1,416,0,417
ODISHA,SONEPUR,2021-01-15,1,636,0,637
ODISHA,SUNDARGARH,2021-01-11,24,1629,1,1654
ODISHA,SUNDARGARH,2021-01-12,57,1279,0,1336
ODISHA,SUNDARGARH,2021-01-13,33,1071,0,1104
ODISHA,SUNDARGARH,2021-01-14,18,756,0,774
ODISHA,SUNDARGARH,2021-01-15,43,957,0,1000
PUDUCHERRY,KARAIKAL,2021-01-11,4,817,1,822
PUDUCHERRY,KARAIKAL,2021-01-12,5,642,0,647
PUDUCHERRY,KARAIKAL,2021-01-13,5,622,0,627
PUDUCHERRY,KARAIKAL,2021-01-14,0,281,0,281
PUDUCHERRY,KARAIKAL,2021-01-15,1,353,0,354
PUDUCHERRY,MAHE,2021-01-11,6,438,0,444
PUDUCHERRY,MAHE,2021-01-12,6,220,0,226
PUDUCHERRY,MAHE,2021-01-13,22,434,0,456
PUDUCHERRY,MAHE,2021-01-14,8,192,0,200
PUDUCHERRY,MAHE,2021-01-15,8,278,0,286
PUDUCHERRY,PONDICHERRY,2021-01-11,10,703,1,714
PUDUCHERRY,PONDICHERRY,2021-01-12,20,635,5,660
PUDUCHERRY,PONDICHERRY,2021-01-13,25,468,3,496
PUDUCHERRY,PONDICHERRY,2021-01-14,18,295,1,314
PUDUCHERRY,PONDICHERRY,2021-01-15,9,290,4,303
PUDUCHERRY,YANAM,2021-01-11,0,67,0,67
PUDUCHERRY,YANAM,2021-01-12,2,95,0,97
PUDUCHERRY,YANAM,2021-01-13,6,4,0,10
PUNJAB,AMRITSAR,2021-01-11,21,2223,1,2245
PUNJAB,AMRITSAR,2021-01-12,39,1819,0,1858
PUNJAB,AMRITSAR,2021-01-13,19,1023,4,1046
PUNJAB,AMRITSAR,2021-01-14,27,1341,0,1368
PUNJAB,AMRITSAR,2021-01-15,16,1633,3,1652
PUNJAB,BARNALA,2021-01-11,3,221,3,227
PUNJAB,BARNALA,2021-01-12,4,265,13,282
PUNJAB,BARNALA,2021-01-13,0,254,17,271
PUNJAB,BARNALA,2021-01-14,0,234,0,234
PUNJAB,BARNALA,2021-01-15,0,226,9,235
PUNJAB,BATHINDA,2021-01-11,10,549,5,564
PUNJAB,BATHINDA,2021-01-12,25,1030,18,1073
PUNJAB,BATHINDA,2021-01-13,12,1046,11,1069
PUNJAB,BATHINDA,2021-01-14,19,834,3,856
PUNJAB,BATHINDA,2021-01-15,17,1038,5,1060
PUNJAB,FARIDKOT,2021-01-11,8,127,2,137
PUNJAB,FARIDKOT,2021-01-12,7,237,1,245
PUNJAB,FARIDKOT,2021-01-13,13,159,0,172
PUNJAB,FARIDKOT,2021-01-14,8,197,2,207
PUNJAB,FARIDKOT,2021-01-15,16,182,2,200
PUNJAB,FATEHGARH SAHIB,2021-01-11,1,377,1,379
PUNJAB,FATEHGARH SAHIB,2021-01-12,5,175,2,182
PUNJAB,FATEHGARH SAHIB,2021-01-13,1,423,0,424
PUNJAB,FATEHGARH SAHIB,2021-01-14,2,117,2,121
PUNJAB,FATEHGARH SAHIB,2021-01-15,6,603,2,611
PUNJAB,FAZILKA,2021-01-11,7,127,4,138
PUNJAB,FAZILKA,2021-01-12,1,183,0,184
PUNJAB,FAZILKA,2021-01-13,1,209,2,212
PUNJAB,FAZILKA,2021-01-14,1,178,0,179
PUNJAB,FAZILKA,2021-01-15,2,364,3,369
PUNJAB,FIROZEPUR,2021-01-11,4,140,7,151
PUNJAB,FIROZEPUR,2021-01-12,1,258,0,259
PUNJAB,FIROZEPUR,2021-01-13,1,208,1,210
PUNJAB,FIROZEPUR,2021-01-14,0,159,0,159
PUNJAB,FIROZEPUR,2021-01-15,0,77,0,77
PUNJAB,GURDASPUR,2021-01-11,6,1423,9,1438
PUNJAB,GURDASPUR,2021-01-12,13,1544,10,1567
PUNJAB,GURDASPUR,2021-01-13,6,1303,23,1332
PUNJAB,GURDASPUR,2021-01-14,10,1315,3,1328
PUNJAB,GURDASPUR,2021-01-15,8,773,0,781
PUNJAB,HOSHIARPUR,2021-01-11,17,1640,13,1670
PUNJAB,HOSHIARPUR,2021-01-12,9,1493,0,1502
PUNJAB,HOSHIARPUR,2021-01-13,9,1100,3,1112
PUNJAB,HOSHIARPUR,2021-01-14,12,1337,3,1352
PUNJAB,HOSHIARPUR,2021-01-15,11,1003,0,1014
PUNJAB,JALANDHAR,2021-01-11,39,2639,116,2794
PUNJAB,JALANDHAR,2021-01-12,37,2662,85,2784
PUNJAB,JALANDHAR,2021-01-13,35,2734,59,2828
PUNJAB,JALANDHAR,2021-01-14,70,3551,127,3748
PUNJAB,JALANDHAR,2021-01-15,50,3803,81,3934
PUNJAB,KAPURTHALA,2021-01-11,13,719,1,733
PUNJAB,KAPURTHALA,2021-01-12,10,932,0,942
PUNJAB,KAPURTHALA,2021-01-13,20,1532,2,1554
PUNJAB,KAPURTHALA,2021-01-14,14,1353,3,1370
PUNJAB,KAPURTHALA,2021-01-15,5,495,0,500
PUNJAB,LUDHIANA,2021-01-11,40,2383,4,2427
PUNJAB,LUDHIANA,2021-01-12,42,1931,15,1988
PUNJAB,LUDHIANA,2021-01-13,39,2039,31,2109
PUNJAB,LUDHIANA,2021-01-14,44,2077,6,2127
PUNJAB,LUDHIANA,2021-01-15,54,2442,6,2502
PUNJAB,MANSA,2021-01-11,6,362,0,368
PUNJAB,MANSA,2021-01-12,9,83,1,93
PUNJAB,MANSA,2021-01-13,3,462,0,465
PUNJAB,MANSA,2021-01-14,0,345,0,345
PUNJAB,MANSA,2021-01-15,2,494,1,497
PUNJAB,MOGA,2021-01-11,1,123,0,124
PUNJAB,MOGA,2021-01-12,0,201,5,206
PUNJAB,MOGA,2021-01-13,4,233,1,238
PUNJAB,MOGA,2021-01-14,1,193,2,196
PUNJAB,MOGA,2021-01-15,3,152,0,155
PUNJAB,PATHANKOT,2021-01-11,5,466,0,471
PUNJAB,PATHANKOT,2021-01-12,5,554,2,561
PUNJAB,PATHANKOT,2021-01-13,8,182,1,191
PUNJAB,PATHANKOT,2021-01-14,6,575,0,581
PUNJAB,PATHANKOT,2021-01-15,4,443,1,448
PUNJAB,PATIALA,2021-01-11,23,915,1,939
PUNJAB,PATIALA,2021-01-12,22,1612,2,1636
PUNJAB,PATIALA,2021-01-13,21,1168,5,1194
PUNJAB,PATIALA,2021-01-14,20,1095,0,1115
PUNJAB,PATIALA,2021-01-15,25,1179,0,1204
PUNJAB,RUPNAGAR,2021-01-11,3,486,11,500
PUNJAB,RUPNAGAR,2021-01-12,11,719,6,736
PUNJAB,RUPNAGAR,2021-01-13,13,564,14,591
PUNJAB,RUPNAGAR,2021-01-14,6,413,1,420
PUNJAB,RUPNAGAR,2021-01-15,8,441,5,454
PUNJAB,S.A.S NAGAR,2021-01-11,46,1008,11,1065
PUNJAB,S.A.S NAGAR,2021-01-12,80,975,24,1079
PUNJAB,S.A.S NAGAR,2021-01-13,51,1021,16,1088
PUNJAB,S.A.S NAGAR,2021-01-14,34,746,9,789
PUNJAB,S.A.S NAGAR,2021-01-15,60,819,4,883
PUNJAB,SANGRUR,2021-01-11,5,892,0,897
PUNJAB,SANGRUR,2021-01-12,3,1147,4,1154
PUNJAB,SANGRUR,2021-01-13,1,972,3,976
PUNJAB,SANGRUR,2021-01-14,4,1076,7,1087
PUNJAB,SANGRUR,2021-01-15,6,1026,0,1032
PUNJAB,SHAHID BHAGAT SINGH NAGAR,2021-01-11,13,65,0,78
PUNJAB,SHAHID BHAGAT SINGH NAGAR,2021-01-12,11,736,0,747
PUNJAB,SHAHID BHAGAT SINGH NAGAR,2021-01-13,15,1920,2,1937
PUNJAB,SHAHID BHAGAT SINGH NAGAR,2021-01-14,14,902,0,916
PUNJAB,SHAHID BHAGAT SINGH NAGAR,2021-01-15,3,578,0,581
PUNJAB,SRI MUKTSAR SAHIB,2021-01-11,3,84,0,87
PUNJAB,SRI MUKTSAR SAHIB,2021-01-12,11,666,4,681
PUNJAB,SRI MUKTSAR SAHIB,2021-01-13,2,361,7,370
PUNJAB,SRI MUKTSAR SAHIB,2021-01-14,1,269,1,271
PUNJAB,SRI MUKTSAR SAHIB,2021-01-15,1,74,0,75
PUNJAB,TARN TARAN,2021-01-11,2,525,1,528
PUNJAB,TARN TARAN,2021-01-12,1,1010,1,1012
PUNJAB,TARN TARAN,2021-01-13,0,351,2,353
PUNJAB,TARN TARAN,2021-01-14,7,148,1,156
PUNJAB,TARN TARAN,2021-01-15,2,1742,0,1744
RAJASTHAN,AJMER,2021-01-11,6,66,765,837
RAJASTHAN,AJMER,2021-01-12,6,101,694,801
RAJASTHAN,AJMER,2021-01-13,7,77,740,824
RAJASTHAN,AJMER,2021-01-14,3,58,624,685
RAJASTHAN,AJMER,2021-01-15,6,62,663,731
RAJASTHAN,ALWAR,2021-01-11,215,2413,9,2637
RAJASTHAN,ALWAR,2021-01-12,221,2179,15,2415
RAJASTHAN,ALWAR,2021-01-13,240,1633,7,1880
RAJASTHAN,ALWAR,2021-01-14,203,1898,8,2109
RAJASTHAN,ALWAR,2021-01-15,0,636,4,640
RAJASTHAN,BANSWARA,2021-01-11,2,56,1,59
RAJASTHAN,BANSWARA,2021-01-12,4,36,0,40
RAJASTHAN,BANSWARA,2021-01-13,4,58,0,62
RAJASTHAN,BANSWARA,2021-01-14,4,28,0,32
RAJASTHAN,BANSWARA,2021-01-15,5,63,0,68
RAJASTHAN,BARAN,2021-01-11,8,183,0,191
RAJASTHAN,BARAN,2021-01-12,8,338,0,346
RAJASTHAN,BARAN,2021-01-13,4,127,0,131
RAJASTHAN,BARAN,2021-01-14,11,291,0,302
RAJASTHAN,BARAN,2021-01-15,7,296,0,303
RAJASTHAN,BARMER,2021-01-11,0,409,3,412
RAJASTHAN,BARMER,2021-01-12,14,250,1,265
RAJASTHAN,BARMER,2021-01-13,1,306,0,307
RAJASTHAN,BARMER,2021-01-14,0,407,0,407
RAJASTHAN,BARMER,2021-01-15,0,197,0,197
RAJASTHAN,BHARATPUR,2021-01-11,2,569,5,576
RAJASTHAN,BHARATPUR,2021-01-12,6,850,3,859
RAJASTHAN,BHARATPUR,2021-01-13,7,506,1,514
RAJASTHAN,BHARATPUR,2021-01-14,3,54,4,61
RAJASTHAN,BHARATPUR,2021-01-15,4,311,1,316
RAJASTHAN,BHILWARA,2021-01-11,7,149,7,163
RAJASTHAN,BHILWARA,2021-01-12,69,516,3,588
RAJASTHAN,BHILWARA,2021-01-13,30,646,1,677
RAJASTHAN,BHILWARA,2021-01-14,29,524,2,555
RAJASTHAN,BHILWARA,2021-01-15,19,409,8,436
RAJASTHAN,BIKANER,2021-01-11,4,710,1,715
RAJASTHAN,BIKANER,2021-01-12,21,374,1,396
RAJASTHAN,BIKANER,2021-01-13,11,384,2,397
RAJASTHAN,BIKANER,2021-01-14,1,347,1,349
RAJASTHAN,BIKANER,2021-01-15,3,552,1,556
RAJASTHAN,BUNDI,2021-01-11,1,113,1,115
RAJASTHAN,BUNDI,2021-01-12,0,242,1,243
RAJASTHAN,BUNDI,2021-01-13,0,205,1,206
RAJASTHAN,BUNDI,2021-01-14,1,34,0,35
RAJASTHAN,BUNDI,2021-01-15,2,139,0,141
RAJASTHAN,CHITTORGARH,2021-01-11,8,843,6,857
RAJASTHAN,CHITTORGARH,2021-01-12,3,185,3,191
RAJASTHAN,CHITTORGARH,2021-01-13,2,975,4,981
RAJASTHAN,CHITTORGARH,2021-01-14,15,898,8,921
RAJASTHAN,CHITTORGARH,2021-01-15,0,922,29,951
RAJASTHAN,CHURU,2021-01-11,0,469,5,474
RAJASTHAN,CHURU,2021-01-12,0,522,6,528
RAJASTHAN,CHURU,2021-01-13,1,398,5,404
RAJASTHAN,CHURU,2021-01-14,0,516,1,517
RAJASTHAN,CHURU,2021-01-15,2,161,0,163
RAJASTHAN,DAUSA,2021-01-11,1,248,9,258
RAJASTHAN,DAUSA,2021-01-12,2,490,24,516
RAJASTHAN,DAUSA,2021-01-13,5,358,20,383
RAJASTHAN,DAUSA,2021-01-14,0,33,3,36
RAJASTHAN,DAUSA,2021-01-15,0,517,7,524
RAJASTHAN,DHOLPUR,2021-01-11,2,452,9,463
RAJASTHAN,DHOLPUR,2021-01-12,6,592,21,619
RAJASTHAN,DHOLPUR,2021-01-13,0,453,5,458
RAJASTHAN,DHOLPUR,2021-01-14,0,13,0,13
RAJASTHAN,DHOLPUR,2021-01-15,1,318,5,324
RAJASTHAN,DUNGARPUR,2021-01-11,15,184,1,200
RAJASTHAN,DUNGARPUR,2021-01-12,38,312,0,350
RAJASTHAN,DUNGARPUR,2021-01-13,9,511,1,521
RAJASTHAN,DUNGARPUR,2021-01-14,10,302,0,312
RAJASTHAN,DUNGARPUR,2021-01-15,8,257,0,265
RAJASTHAN,GANGANAGAR,2021-01-11,0,24,1,25
RAJASTHAN,GANGANAGAR,2021-01-12,6,71,3,80
RAJASTHAN,GANGANAGAR,2021-01-13,6,71,0,77
RAJASTHAN,GANGANAGAR,2021-01-14,2,23,0,25
RAJASTHAN,GANGANAGAR,2021-01-15,11,40,4,55
RAJASTHAN,HANUMANGARH,2021-01-11,0,139,0,139
RAJASTHAN,HANUMANGARH,2021-01-12,6,641,4,651
RAJASTHAN,HANUMANGARH,2021-01-13,1,647,2,650
RAJASTHAN,HANUMANGARH,2021-01-14,3,706,0,709
RAJASTHAN,HANUMANGARH,2021-01-15,1,101,1,103
RAJASTHAN,JAIPUR,2021-01-11,181,2822,227,3230
RAJASTHAN,JAIPUR,2021-01-12,116,2831,279,3226
RAJASTHAN,JAIPUR,2021-01-13,151,2831,258,3240
RAJASTHAN,JAIPUR,2021-01-14,47,1818,231,2096
RAJASTHAN,JAIPUR,2021-01-15,58,2501,309,2868
RAJASTHAN,JAISALMER,2021-01-11,25,369,5,399
RAJASTHAN,JAISALMER,2021-01-12,39,380,1,420
RAJASTHAN,JAISALMER,2021-01-13,79,751,27,857
RAJASTHAN,JAISALMER,2021-01-14,1,516,1,518
RAJASTHAN,JAISALMER,2021-01-15,49,1174,1,1224
RAJASTHAN,JALORE,2021-01-11,8,1084,0,1092
RAJASTHAN,JALORE,2021-01-12,36,831,3,870
RAJASTHAN,JALORE,2021-01-13,18,1095,3,1116
RAJASTHAN,JALORE,2021-01-14,3,790,0,793
RAJASTHAN,JALORE,2021-01-15,60,1546,3,1609
RAJASTHAN,JHALAWAR,2021-01-11,44,645,13,702
RAJASTHAN,JHALAWAR,2021-01-12,30,736,3,769
RAJASTHAN,JHALAWAR,2021-01-13,1,590,0,591
RAJASTHAN,JHALAWAR,2021-01-14,0,269,0,269
RAJASTHAN,JHALAWAR,2021-01-15,0,111,0,111
RAJASTHAN,JHUNJHUNU,2021-01-11,1,88,3,92
RAJASTHAN,JHUNJHUNU,2021-01-12,4,114,6,124
RAJASTHAN,JHUNJHUNU,2021-01-13,1,78,3,82
RAJASTHAN,JHUNJHUNU,2021-01-14,0,90,0,90
RAJASTHAN,JHUNJHUNU,2021-01-15,0,64,5,69
RAJASTHAN,JODHPUR,2021-01-11,30,613,4,647
RAJASTHAN,JODHPUR,2021-01-12,28,890,3,921
RAJASTHAN,JODHPUR,2021-01-13,34,1034,2,1070
RAJASTHAN,JODHPUR,2021-01-14,40,805,4,849
RAJASTHAN,JODHPUR,2021-01-15,26,876,5,907
RAJASTHAN,KARAULI,2021-01-11,3,463,6,472
RAJASTHAN,KARAULI,2021-01-12,7,397,5,409
RAJASTHAN,KARAULI,2021-01-13,3,154,6,163
RAJASTHAN,KARAULI,2021-01-14,6,126,7,139
RAJASTHAN,KARAULI,2021-01-15,1,39,4,44
RAJASTHAN,KOTA,2021-01-11,111,2146,2,2259
RAJASTHAN,KOTA,2021-01-12,123,1437,7,1567
RAJASTHAN,KOTA,2021-01-13,109,1736,2,1847
RAJASTHAN,KOTA,2021-01-14,0,1236,3,1239
RAJASTHAN,KOTA,2021-01-15,143,1862,0,2005
RAJASTHAN,NAGAUR,2021-01-11,61,427,494,982
RAJASTHAN,NAGAUR,2021-01-12,19,488,179,686
RAJASTHAN,NAGAUR,2021-01-13,111,150,661,922
RAJASTHAN,NAGAUR,2021-01-14,2,244,377,623
RAJASTHAN,NAGAUR,2021-01-15,1,242,328,571
RAJASTHAN,PALI,2021-01-11,26,635,5,666
RAJASTHAN,PALI,2021-01-12,0,30,1,31
RAJASTHAN,PALI,2021-01-13,31,686,6,723
RAJASTHAN,PALI,2021-01-14,1,12,2,15
RAJASTHAN,PALI,2021-01-15,15,397,16,428
RAJASTHAN,PRATAPGARH,2021-01-11,1,10,0,11
RAJASTHAN,PRATAPGARH,2021-01-12,0,13,1,14
RAJASTHAN,PRATAPGARH,2021-01-13,1,5,0,6
RAJASTHAN,PRATAPGARH,2021-01-14,1,8,0,9
RAJASTHAN,PRATAPGARH,2021-01-15,0,7,0,7
RAJASTHAN,RAJSAMAND,2021-01-11,13,269,1,283
RAJASTHAN,RAJSAMAND,2021-01-12,18,161,1,180
RAJASTHAN,RAJSAMAND,2021-01-13,1,269,0,270
RAJASTHAN,RAJSAMAND,2021-01-14,4,182,0,186
RAJASTHAN,RAJSAMAND,2021-01-15,16,578,5,599
RAJASTHAN,SAWAI MADHOPUR,2021-01-11,5,238,6,249
RAJASTHAN,SAWAI MADHOPUR,2021-01-12,5,381,14,400
RAJASTHAN,SAWAI MADHOPUR,2021-01-13,13,308,9,330
RAJASTHAN,SAWAI MADHOPUR,2021-01-14,4,204,7,215
RAJASTHAN,SAWAI MADHOPUR,2021-01-15,59,361,4,424
RAJASTHAN,SIKAR,2021-01-11,3,139,5,147
RAJASTHAN,SIKAR,2021-01-12,6,120,8,134
RAJASTHAN,SIKAR,2021-01-13,2,56,12,70
RAJASTHAN,SIKAR,2021-01-14,0,135,10,145
RAJASTHAN,SIKAR,2021-01-15,2,155,11,168
RAJASTHAN,SIROHI,2021-01-11,0,157,0,157
RAJASTHAN,SIROHI,2021-01-12,14,168,0,182
RAJASTHAN,SIROHI,2021-01-13,15,207,0,222
RAJASTHAN,SIROHI,2021-01-14,0,6,0,6
RAJASTHAN,SIROHI,2021-01-15,12,256,0,268
RAJASTHAN,TONK,2021-01-11,0,167,19,186
RAJASTHAN,TONK,2021-01-12,0,204,15,219
RAJASTHAN,TONK,2021-01-13,2,103,6,111
RAJASTHAN,TONK,2021-01-14,1,123,11,135
RAJASTHAN,TONK,2021-01-15,1,177,7,185
RAJASTHAN,UDAIPUR,2021-01-11,109,926,2,1037
RAJASTHAN,UDAIPUR,2021-01-12,101,940,0,1041
RAJASTHAN,UDAIPUR,2021-01-13,101,746,0,847
RAJASTHAN,UDAIPUR,2021-01-14,114,810,0,924
RAJASTHAN,UDAIPUR,2021-01-15,86,1025,3,1114
SIKKIM,EAST DISTRICT,2021-01-11,7,110,0,117
SIKKIM,EAST DISTRICT,2021-01-12,7,204,0,211
SIKKIM,EAST DISTRICT,2021-01-13,13,216,0,229
SIKKIM,EAST DISTRICT,2021-01-14,15,178,0,193
SIKKIM,EAST DISTRICT,2021-01-15,3,128,0,131
SIKKIM,NORTH DISTRICT,2021-01-11,0,1,0,1
SIKKIM,NORTH DISTRICT,2021-01-12,0,2,0,2
SIKKIM,NORTH DISTRICT,2021-01-13,0,5,0,5
SIKKIM,NORTH DISTRICT,2021-01-14,0,4,0,4
SIKKIM,NORTH DISTRICT,2021-01-15,0,3,0,3
SIKKIM,SOUTH DISTRICT,2021-01-11,0,28,0,28
SIKKIM,SOUTH DISTRICT,2021-01-12,0,7,0,7
SIKKIM,SOUTH DISTRICT,2021-01-13,1,38,0,39
SIKKIM,SOUTH DISTRICT,2021-01-14,0,9,0,9
SIKKIM,SOUTH DISTRICT,2021-01-15,1,22,0,23
SIKKIM,WEST DISTRICT,2021-01-11,0,6,1,7
SIKKIM,WEST DISTRICT,2021-01-12,1,7,0,8
SIKKIM,WEST DISTRICT,2021-01-13,0,9,0,9
SIKKIM,WEST DISTRICT,2021-01-14,1,4,0,5
SIKKIM,WEST DISTRICT,2021-01-15,0,5,0,5
TAMIL NADU,ARIYALUR,2021-01-11,2,503,0,505
TAMIL NADU,ARIYALUR,2021-01-12,1,324,0,325
TAMIL NADU,ARIYALUR,2021-01-13,1,271,0,272
TAMIL NADU,ARIYALUR,2021-01-14,0,326,0,326
TAMIL NADU,ARIYALUR,2021-01-15,0,296,0,296
TAMIL NADU,CHENGALPATTU,2021-01-11,19,2862,0,2881
TAMIL NADU,CHENGALPATTU,2021-01-12,44,2813,0,2857
TAMIL NADU,CHENGALPATTU,2021-01-13,20,2816,0,2836
TAMIL NADU,CHENGALPATTU,2021-01-14,8,2367,0,2375
TAMIL NADU,CHENGALPATTU,2021-01-15,19,1756,0,1775
TAMIL NADU,CHENNAI,2021-01-11,166,8065,20,8251
TAMIL NADU,CHENNAI,2021-01-12,184,10148,35,10367
TAMIL NADU,CHENNAI,2021-01-13,169,9604,15,9788
TAMIL NADU,CHENNAI,2021-01-14,125,8492,19,8636
TAMIL NADU,CHENNAI,2021-01-15,156,6168,5,6329
TAMIL NADU,COIMBATORE,2021-01-11,56,2097,1,2154
TAMIL NADU,COIMBATORE,2021-01-12,59,1506,3,1568
TAMIL NADU,COIMBATORE,2021-01-13,95,2462,0,2557
TAMIL NADU,COIMBATORE,2021-01-14,75,1249,1,1325
TAMIL NADU,COIMBATORE,2021-01-15,54,1747,0,1801
TAMIL NADU,CUDDALORE,2021-01-11,7,1742,3,1752
TAMIL NADU,CUDDALORE,2021-01-12,4,1600,1,1605
TAMIL NADU,CUDDALORE,2021-01-13,3,1206,0,1209
TAMIL NADU,CUDDALORE,2021-01-14,9,485,0,494
TAMIL NADU,CUDDALORE,2021-01-15,2,721,0,723
TAMIL NADU,DHARMAPURI,2021-01-11,0,696,1,697
TAMIL NADU,DHARMAPURI,2021-01-12,3,939,0,942
TAMIL NADU,DHARMAPURI,2021-01-13,3,413,0,416
TAMIL NADU,DHARMAPURI,2021-01-14,4,1374,0,1378
TAMIL NADU,DHARMAPURI,2021-01-15,3,710,0,713
TAMIL NADU,DINDIGUL,2021-01-11,5,1669,1,1675
TAMIL NADU,DINDIGUL,2021-01-12,9,1090,0,1099
TAMIL NADU,DINDIGUL,2021-01-13,8,1001,0,1009
TAMIL NADU,DINDIGUL,2021-01-14,7,524,0,531
TAMIL NADU,DINDIGUL,2021-01-15,10,163,0,173
TAMIL NADU,ERODE,2021-01-11,12,545,0,557
TAMIL NADU,ERODE,2021-01-12,16,1475,0,1491
TAMIL NADU,ERODE,2021-01-13,21,1524,0,1545
TAMIL NADU,ERODE,2021-01-14,9,1137,0,1146
TAMIL NADU,ERODE,2021-01-15,11,536,0,547
TAMIL NADU,KALLAKURICHI,2021-01-11,0,422,0,422
TAMIL NADU,KALLAKURICHI,2021-01-12,4,758,0,762
TAMIL NADU,KALLAKURICHI,2021-01-13,3,622,0,625
TAMIL NADU,KALLAKURICHI,2021-01-14,0,1188,0,1188
TAMIL NADU,KALLAKURICHI,2021-01-15,0,759,0,759
TAMIL NADU,KANCHIPURAM,2021-01-11,13,2741,0,2754
TAMIL NADU,KANCHIPURAM,2021-01-12,19,2251,0,2270
TAMIL NADU,KANCHIPURAM,2021-01-13,9,2266,1,2276
TAMIL NADU,KANCHIPURAM,2021-01-14,5,1520,2,1527
TAMIL NADU,KANCHIPURAM,2021-01-15,8,1946,4,1958
TAMIL NADU,KANNIYAKUMARI,2021-01-11,18,2171,2,2191
TAMIL NADU,KANNIYAKUMARI,2021-01-12,8,2210,4,2222
TAMIL NADU,KANNIYAKUMARI,2021-01-13,16,1928,0,1944
TAMIL NADU,KANNIYAKUMARI,2021-01-14,7,901,2,910
TAMIL NADU,KANNIYAKUMARI,2021-01-15,9,1022,1,1032
TAMIL NADU,KARUR,2021-01-11,1,926,1,928
TAMIL NADU,KARUR,2021-01-12,8,1173,0,1181
TAMIL NADU,KARUR,2021-01-13,4,1199,0,1203
TAMIL NADU,KARUR,2021-01-14,6,1088,0,1094
TAMIL NADU,KARUR,2021-01-15,6,503,0,509
TAMIL NADU,KRISHNAGIRI,2021-01-11,4,2621,0,2625
TAMIL NADU,KRISHNAGIRI,2021-01-12,12,2603,0,2615
TAMIL NADU,KRISHNAGIRI,2021-01-13,12,1429,0,1441
TAMIL NADU,KRISHNAGIRI,2021-01-14,2,236,0,238
TAMIL NADU,KRISHNAGIRI,2021-01-15,3,600,0,603
TAMIL NADU,MADURAI,2021-01-11,8,4510,2,4520
TAMIL NADU,MADURAI,2021-01-12,11,4539,3,4553
TAMIL NADU,MADURAI,2021-01-13,17,3352,1,3370
TAMIL NADU,MADURAI,2021-01-14,12,1682,8,1702
TAMIL NADU,MADURAI,2021-01-15,13,1337,0,1350
TAMIL NADU,NAGAPATTINAM,2021-01-11,5,1249,1,1255
TAMIL NADU,NAGAPATTINAM,2021-01-12,6,575,0,581
TAMIL NADU,NAGAPATTINAM,2021-01-13,4,935,0,939
TAMIL NADU,NAGAPATTINAM,2021-01-14,3,490,0,493
TAMIL NADU,NAGAPATTINAM,2021-01-15,3,650,0,653
TAMIL NADU,NAMAKKAL,2021-01-11,4,1445,0,1449
TAMIL NADU,NAMAKKAL,2021-01-12,9,1939,1,1949
TAMIL NADU,NAMAKKAL,2021-01-13,6,1784,0,1790
TAMIL NADU,NAMAKKAL,2021-01-14,7,1144,1,1152
TAMIL NADU,NAMAKKAL,2021-01-15,6,748,0,754
TAMIL NADU,PERAMBALUR,2021-01-11,0,216,0,216
TAMIL NADU,PERAMBALUR,2021-01-12,0,350,0,350
TAMIL NADU,PERAMBALUR,2021-01-13,0,284,0,284
TAMIL NADU,PERAMBALUR,2021-01-14,0,252,0,252
TAMIL NADU,PERAMBALUR,2021-01-15,0,172,0,172
TAMIL NADU,PUDUKKOTTAI,2021-01-11,3,813,0,816
TAMIL NADU,PUDUKKOTTAI,2021-01-12,3,949,0,952
TAMIL NADU,PUDUKKOTTAI,2021-01-13,3,892,2,897
TAMIL NADU,PUDUKKOTTAI,2021-01-14,0,739,0,739
TAMIL NADU,PUDUKKOTTAI,2021-01-15,3,470,1,474
TAMIL NADU,RAMANATHAPURAM,2021-01-11,2,2035,0,2037
TAMIL NADU,RAMANATHAPURAM,2021-01-12,3,1545,2,1550
TAMIL NADU,RAMANATHAPURAM,2021-01-13,2,2127,0,2129
TAMIL NADU,RAMANATHAPURAM,2021-01-14,0,898,0,898
TAMIL NADU,RAMANATHAPURAM,2021-01-15,1,758,0,759
TAMIL NADU,RANIPET,2021-01-11,5,580,0,585
TAMIL NADU,RANIPET,2021-01-12,1,841,0,842
TAMIL NADU,RANIPET,2021-01-13,4,595,0,599
TAMIL NADU,RANIPET,2021-01-14,6,40,0,46
TAMIL NADU,RANIPET,2021-01-15,0,157,0,157
TAMIL NADU,SALEM,2021-01-11,21,1626,20,1667
TAMIL NADU,SALEM,2021-01-12,22,789,0,811
TAMIL NADU,SALEM,2021-01-13,25,1144,0,1169
TAMIL NADU,SALEM,2021-01-14,20,1098,0,1118
TAMIL NADU,SALEM,2021-01-15,14,1137,2,1153
TAMIL NADU,SIVAGANGA,2021-01-11,7,436,0,443
TAMIL NADU,SIVAGANGA,2021-01-12,2,681,0,683
TAMIL NADU,SIVAGANGA,2021-01-13,3,720,0,723
TAMIL NADU,SIVAGANGA,2021-01-14,1,236,1,238
TAMIL NADU,SIVAGANGA,2021-01-15,2,271,0,273
TAMIL NADU,TENKASI,2021-01-11,3,594,0,597
TAMIL NADU,TENKASI,2021-01-12,4,832,0,836
TAMIL NADU,TENKASI,2021-01-13,4,868,1,873
TAMIL NADU,TENKASI,2021-01-14,1,565,1,567
TAMIL NADU,TENKASI,2021-01-15,2,399,0,401
TAMIL NADU,THANJAVUR,2021-01-11,21,938,1,960
TAMIL NADU,THANJAVUR,2021-01-12,20,729,1,750
TAMIL NADU,THANJAVUR,2021-01-13,11,545,0,556
TAMIL NADU,THANJAVUR,2021-01-14,22,355,2,379
TAMIL NADU,THANJAVUR,2021-01-15,14,442,0,456
TAMIL NADU,THE NILGIRIS,2021-01-11,7,1034,0,1041
TAMIL NADU,THE NILGIRIS,2021-01-12,3,1381,0,1384
TAMIL NADU,THE NILGIRIS,2021-01-13,12,1130,1,1143
TAMIL NADU,THE NILGIRIS,2021-01-14,6,1093,4,1103
TAMIL NADU,THE NILGIRIS,2021-01-15,3,1078,0,1081
TAMIL NADU,THENI,2021-01-11,1,347,0,348
TAMIL NADU,THENI,2021-01-12,7,673,0,680
TAMIL NADU,THENI,2021-01-13,2,338,0,340
TAMIL NADU,THENI,2021-01-14,5,412,0,417
TAMIL NADU,THENI,2021-01-15,4,821,0,825
TAMIL NADU,THIRUVALLUR,2021-01-11,25,2366,2,2393
TAMIL NADU,THIRUVALLUR,2021-01-12,25,2037,9,2071
TAMIL NADU,THIRUVALLUR,2021-01-13,21,2178,1,2200
TAMIL NADU,THIRUVALLUR,2021-01-14,19,1779,7,1805
TAMIL NADU,THIRUVALLUR,2021-01-15,15,1964,9,1988
TAMIL NADU,THIRUVARUR,2021-01-11,2,1461,1,1464
TAMIL NADU,THIRUVARUR,2021-01-12,4,1208,0,1212
TAMIL NADU,THIRUVARUR,2021-01-13,5,589,0,594
TAMIL NADU,THIRUVARUR,2021-01-14,5,86,0,91
TAMIL NADU,THIRUVARUR,2021-01-15,2,112,0,114
TAMIL NADU,TIRUCHIRAPPALLI,2021-01-11,14,1152,2,1168
TAMIL NADU,TIRUCHIRAPPALLI,2021-01-12,16,1483,1,1500
TAMIL NADU,TIRUCHIRAPPALLI,2021-01-13,11,1561,0,1572
TAMIL NADU,TIRUCHIRAPPALLI,2021-01-14,19,1488,0,1507
TAMIL NADU,TIRUCHIRAPPALLI,2021-01-15,8,1227,0,1235
TAMIL NADU,TIRUNELVELI,2021-01-11,5,1304,0,1309
TAMIL NADU,TIRUNELVELI,2021-01-12,10,1179,0,1189
TAMIL NADU,TIRUNELVELI,2021-01-13,4,1030,0,1034
TAMIL NADU,TIRUNELVELI,2021-01-14,7,612,1,620
TAMIL NADU,TIRUNELVELI,2021-01-15,9,780,1,790
TAMIL NADU,TIRUPATHUR,2021-01-11,2,1293,0,1295
TAMIL NADU,TIRUPATHUR,2021-01-12,1,2346,2,2349
TAMIL NADU,TIRUPATHUR,2021-01-13,2,2605,1,2608
TAMIL NADU,TIRUPATHUR,2021-01-14,3,1901,1,1905
TAMIL NADU,TIRUPATHUR,2021-01-15,3,2324,1,2328
TAMIL NADU,TIRUPPUR,2021-01-11,18,1448,1,1467
TAMIL NADU,TIRUPPUR,2021-01-12,29,2754,1,2784
TAMIL NADU,TIRUPPUR,2021-01-13,33,2288,2,2323
TAMIL NADU,TIRUPPUR,2021-01-14,6,446,0,452
TAMIL NADU,TIRUPPUR,2021-01-15,13,1062,0,1075
TAMIL NADU,TIRUVANNAMALAI,2021-01-11,5,1276,0,1281
TAMIL NADU,TIRUVANNAMALAI,2021-01-12,7,1350,0,1357
TAMIL NADU,TIRUVANNAMALAI,2021-01-13,5,595,0,600
TAMIL NADU,TIRUVANNAMALAI,2021-01-14,7,272,0,279
TAMIL NADU,TIRUVANNAMALAI,2021-01-15,7,449,0,456
TAMIL NADU,TUTICORIN,2021-01-11,1,553,0,554
TAMIL NADU,TUTICORIN,2021-01-12,3,1146,0,1149
TAMIL NADU,TUTICORIN,2021-01-13,0,1125,0,1125
TAMIL NADU,TUTICORIN,2021-01-14,4,853,0,857
TAMIL NADU,TUTICORIN,2021-01-15,4,275,0,279
TAMIL NADU,VELLORE,2021-01-11,18,1352,0,1370
TAMIL NADU,VELLORE,2021-01-12,25,1621,1,1647
TAMIL NADU,VELLORE,2021-01-13,17,1394,0,1411
TAMIL NADU,VELLORE,2021-01-14,12,1635,0,1647
TAMIL NADU,VELLORE,2021-01-15,11,1013,2,1026
TAMIL NADU,VILLUPURAM,2021-01-11,2,573,1,576
TAMIL NADU,VILLUPURAM,2021-01-12,0,960,0,960
TAMIL NADU,VILLUPURAM,2021-01-13,12,1091,1,1104
TAMIL NADU,VILLUPURAM,2021-01-14,1,887,2,890
TAMIL NADU,VILLUPURAM,2021-01-15,2,537,1,540
TAMIL NADU,VIRUDHUNAGAR,2021-01-11,6,2334,2,2342
TAMIL NADU,VIRUDHUNAGAR,2021-01-12,4,1234,1,1239
TAMIL NADU,VIRUDHUNAGAR,2021-01-13,4,1172,0,1176
TAMIL NADU,VIRUDHUNAGAR,2021-01-14,3,1392,0,1395
TAMIL NADU,VIRUDHUNAGAR,2021-01-15,6,741,0,747
TELANGANA,ADILABAD,2021-01-11,0,332,0,332
TELANGANA,ADILABAD,2021-01-12,1,427,0,428
TELANGANA,ADILABAD,2021-01-13,0,466,0,466
TELANGANA,ADILABAD,2021-01-14,0,284,0,284
TELANGANA,ADILABAD,2021-01-15,0,512,0,512
TELANGANA,BHADRADRI KOTHAGUDEM,2021-01-11,0,1017,0,1017
TELANGANA,BHADRADRI KOTHAGUDEM,2021-01-12,0,935,0,935
TELANGANA,BHADRADRI KOTHAGUDEM,2021-01-13,0,541,0,541
TELANGANA,BHADRADRI KOTHAGUDEM,2021-01-14,0,375,0,375
TELANGANA,BHADRADRI KOTHAGUDEM,2021-01-15,0,583,0,583
TELANGANA,HYDERABAD,2021-01-11,40,5520,1,5561
TELANGANA,HYDERABAD,2021-01-12,43,6909,0,6952
TELANGANA,HYDERABAD,2021-01-13,33,5616,3,5652
TELANGANA,HYDERABAD,2021-01-14,33,5078,18,5129
TELANGANA,HYDERABAD,2021-01-15,33,6382,6,6421
TELANGANA,JAGITIAL,2021-01-11,0,439,0,439
TELANGANA,JAGITIAL,2021-01-12,0,593,0,593
TELANGANA,JAGITIAL,2021-01-13,0,269,0,269
TELANGANA,JAGITIAL,2021-01-14,0,211,0,211
TELANGANA,JAGITIAL,2021-01-15,0,374,0,374
TELANGANA,JANGOAN,2021-01-11,0,482,0,482
TELANGANA,JANGOAN,2021-01-12,0,715,0,715
TELANGANA,JANGOAN,2021-01-13,0,481,0,481
TELANGANA,JANGOAN,2021-01-14,0,288,0,288
TELANGANA,JANGOAN,2021-01-15,0,624,0,624
TELANGANA,JAYASHANKAR BHUPALAPALLY,2021-01-11,0,71,0,71
TELANGANA,JAYASHANKAR BHUPALAPALLY,2021-01-12,0,152,0,152
TELANGANA,JAYASHANKAR BHUPALAPALLY,2021-01-13,0,64,0,64
TELANGANA,JAYASHANKAR BHUPALAPALLY,2021-01-14,0,32,0,32
TELANGANA,JAYASHANKAR BHUPALAPALLY,2021-01-15,1,85,0,86
TELANGANA,JOGULAMBA GADWAL,2021-01-11,0,429,0,429
TELANGANA,JOGULAMBA GADWAL,2021-01-12,0,291,0,291
TELANGANA,JOGULAMBA GADWAL,2021-01-13,0,227,0,227
TELANGANA,JOGULAMBA GADWAL,2021-01-14,0,242,0,242
TELANGANA,JOGULAMBA GADWAL,2021-01-15,0,393,0,393
TELANGANA,KAMAREDDY,2021-01-11,0,492,0,492
TELANGANA,KAMAREDDY,2021-01-12,0,794,0,794
TELANGANA,KAMAREDDY,2021-01-13,0,438,0,438
TELANGANA,KAMAREDDY,2021-01-14,0,129,0,129
TELANGANA,KAMAREDDY,2021-01-15,0,646,0,646
TELANGANA,KARIMNAGAR,2021-01-11,5,893,0,898
TELANGANA,KARIMNAGAR,2021-01-12,4,1226,0,1230
TELANGANA,KARIMNAGAR,2021-01-13,0,661,0,661
TELANGANA,KARIMNAGAR,2021-01-14,0,563,0,563
TELANGANA,KARIMNAGAR,2021-01-15,2,961,0,963
TELANGANA,KHAMMAM,2021-01-11,0,495,0,495
TELANGANA,KHAMMAM,2021-01-12,1,912,0,913
TELANGANA,KHAMMAM,2021-01-13,0,432,0,432
TELANGANA,KHAMMAM,2021-01-14,0,172,0,172
TELANGANA,KHAMMAM,2021-01-15,0,621,0,621
TELANGANA,KUMURAM BHEEM ASIFABAD,2021-01-11,0,804,0,804
TELANGANA,KUMURAM BHEEM ASIFABAD,2021-01-12,0,572,0,572
TELANGANA,KUMURAM BHEEM ASIFABAD,2021-01-13,0,262,0,262
TELANGANA,KUMURAM BHEEM ASIFABAD,2021-01-14,0,719,0,719
TELANGANA,KUMURAM BHEEM ASIFABAD,2021-01-15,0,466,0,466
TELANGANA,MAHABUBABAD,2021-01-11,0,518,0,518
TELANGANA,MAHABUBABAD,2021-01-12,0,642,0,642
TELANGANA,MAHABUBABAD,2021-01-13,0,252,0,252
TELANGANA,MAHABUBABAD,2021-01-14,0,376,0,376
TELANGANA,MAHABUBABAD,2021-01-15,0,285,0,285
TELANGANA,MAHABUBNAGAR,2021-01-11,0,602,0,602
TELANGANA,MAHABUBNAGAR,2021-01-12,0,695,0,695
TELANGANA,MAHABUBNAGAR,2021-01-13,0,278,0,278
TELANGANA,MAHABUBNAGAR,2021-01-14,0,453,0,453
TELANGANA,MAHABUBNAGAR,2021-01-15,0,411,0,411
TELANGANA,MANCHERIAL,2021-01-11,0,446,0,446
TELANGANA,MANCHERIAL,2021-01-12,0,541,0,541
TELANGANA,MANCHERIAL,2021-01-13,0,430,0,430
TELANGANA,MANCHERIAL,2021-01-14,0,247,0,247
TELANGANA,MANCHERIAL,2021-01-15,0,471,0,471
TELANGANA,MEDAK,2021-01-11,1,203,0,204
TELANGANA,MEDAK,2021-01-12,6,275,0,281
TELANGANA,MEDAK,2021-01-13,0,188,0,188
TELANGANA,MEDAK,2021-01-14,2,152,0,154
TELANGANA,MEDAK,2021-01-15,1,207,0,208
TELANGANA,MEDCHAL MALKAJGIRI,2021-01-11,2,1122,0,1124
TELANGANA,MEDCHAL MALKAJGIRI,2021-01-12,0,1556,0,1556
TELANGANA,MEDCHAL MALKAJGIRI,2021-01-13,1,791,0,792
TELANGANA,MEDCHAL MALKAJGIRI,2021-01-14,0,439,0,439
TELANGANA,MEDCHAL MALKAJGIRI,2021-01-15,1,941,0,942
TELANGANA,MULUGU,2021-01-11,0,110,0,110
TELANGANA,MULUGU,2021-01-12,0,140,0,140
TELANGANA,MULUGU,2021-01-13,0,42,0,42
TELANGANA,MULUGU,2021-01-14,0,50,0,50
TELANGANA,MULUGU,2021-01-15,0,56,0,56
TELANGANA,NAGARKURNOOL,2021-01-11,0,743,0,743
TELANGANA,NAGARKURNOOL,2021-01-12,0,966,0,966
TELANGANA,NAGARKURNOOL,2021-01-13,1,812,0,813
TELANGANA,NAGARKURNOOL,2021-01-14,3,778,1,782
TELANGANA,NAGARKURNOOL,2021-01-15,3,747,0,750
TELANGANA,NALGONDA,2021-01-11,0,334,0,334
TELANGANA,NALGONDA,2021-01-12,0,516,0,516
TELANGANA,NALGONDA,2021-01-13,0,222,0,222
TELANGANA,NALGONDA,2021-01-14,0,146,0,146
TELANGANA,NALGONDA,2021-01-15,0,394,0,394
TELANGANA,NARAYANPET,2021-01-11,0,146,0,146
TELANGANA,NARAYANPET,2021-01-12,0,280,0,280
TELANGANA,NARAYANPET,2021-01-13,0,60,0,60
TELANGANA,NARAYANPET,2021-01-14,0,158,0,158
TELANGANA,NARAYANPET,2021-01-15,0,52,0,52
TELANGANA,NIRMAL,2021-01-11,0,400,0,400
TELANGANA,NIRMAL,2021-01-12,0,1061,0,1061
TELANGANA,NIRMAL,2021-01-13,0,691,0,691
TELANGANA,NIRMAL,2021-01-14,0,288,0,288
TELANGANA,NIRMAL,2021-01-15,0,510,0,510
TELANGANA,NIZAMABAD,2021-01-11,0,307,0,307
TELANGANA,NIZAMABAD,2021-01-12,2,370,0,372
TELANGANA,NIZAMABAD,2021-01-13,0,212,0,212
TELANGANA,NIZAMABAD,2021-01-14,1,130,0,131
TELANGANA,NIZAMABAD,2021-01-15,1,250,1,252
TELANGANA,PEDDAPALLI,2021-01-11,0,571,0,571
TELANGANA,PEDDAPALLI,2021-01-12,1,996,0,997
TELANGANA,PEDDAPALLI,2021-01-13,0,523,0,523
TELANGANA,PEDDAPALLI,2021-01-14,0,218,0,218
TELANGANA,PEDDAPALLI,2021-01-15,0,799,0,799
TELANGANA,RAJANNA SIRCILLA,2021-01-11,0,238,0,238
TELANGANA,RAJANNA SIRCILLA,2021-01-12,0,324,0,324
TELANGANA,RAJANNA SIRCILLA,2021-01-13,0,300,0,300
TELANGANA,RAJANNA SIRCILLA,2021-01-14,0,185,0,185
TELANGANA,RAJANNA SIRCILLA,2021-01-15,0,329,0,329
TELANGANA,RANGA REDDY,2021-01-11,9,1490,0,1499
TELANGANA,RANGA REDDY,2021-01-12,9,1989,0,1998
TELANGANA,RANGA REDDY,2021-01-13,4,1270,0,1274
TELANGANA,RANGA REDDY,2021-01-14,2,1013,2,1017
TELANGANA,RANGA REDDY,2021-01-15,0,1256,0,1256
TELANGANA,SANGAREDDY,2021-01-11,0,611,0,611
TELANGANA,SANGAREDDY,2021-01-12,0,1189,0,1189
TELANGANA,SANGAREDDY,2021-01-13,0,700,0,700
TELANGANA,SANGAREDDY,2021-01-14,0,721,0,721
TELANGANA,SANGAREDDY,2021-01-15,1,700,0,701
TELANGANA,SIDDIPET,2021-01-11,0,1786,0,1786
TELANGANA,SIDDIPET,2021-01-12,0,1917,0,1917
TELANGANA,SIDDIPET,2021-01-13,0,1409,0,1409
TELANGANA,SIDDIPET,2021-01-14,0,641,0,641
TELANGANA,SIDDIPET,2021-01-15,0,1385,0,1385
TELANGANA,SURYAPET,2021-01-11,0,721,0,721
TELANGANA,SURYAPET,2021-01-12,0,1280,0,1280
TELANGANA,SURYAPET,2021-01-13,0,593,0,593
TELANGANA,SURYAPET,2021-01-14,0,1020,0,1020
TELANGANA,SURYAPET,2021-01-15,0,917,0,917
TELANGANA,VIKARABAD,2021-01-11,0,413,0,413
TELANGANA,VIKARABAD,2021-01-12,0,642,0,642
TELANGANA,VIKARABAD,2021-01-13,0,334,0,334
TELANGANA,VIKARABAD,2021-01-14,0,278,0,278
TELANGANA,VIKARABAD,2021-01-15,0,330,0,330
TELANGANA,WANAPARTHY,2021-01-11,0,283,0,283
TELANGANA,WANAPARTHY,2021-01-12,0,336,0,336
TELANGANA,WANAPARTHY,2021-01-13,0,146,0,146
TELANGANA,WANAPARTHY,2021-01-14,0,149,0,149
TELANGANA,WANAPARTHY,2021-01-15,0,152,0,152
TELANGANA,WARANGAL RURAL,2021-01-11,0,365,0,365
TELANGANA,WARANGAL RURAL,2021-01-12,0,402,0,402
TELANGANA,WARANGAL RURAL,2021-01-13,7,221,0,228
TELANGANA,WARANGAL RURAL,2021-01-14,0,175,0,175
TELANGANA,WARANGAL RURAL,2021-01-15,2,373,0,375
TELANGANA,WARANGAL URBAN,2021-01-11,0,1455,0,1455
TELANGANA,WARANGAL URBAN,2021-01-12,1,1873,0,1874
TELANGANA,WARANGAL URBAN,2021-01-13,0,1082,0,1082
TELANGANA,WARANGAL URBAN,2021-01-14,0,976,1,977
TELANGANA,WARANGAL URBAN,2021-01-15,1,1557,0,1558
TELANGANA,YADADRI BHUVANAGIRI,2021-01-11,0,262,0,262
TELANGANA,YADADRI BHUVANAGIRI,2021-01-12,0,214,0,214
TELANGANA,YADADRI BHUVANAGIRI,2021-01-13,0,86,0,86
TELANGANA,YADADRI BHUVANAGIRI,2021-01-14,0,37,0,37
TELANGANA,YADADRI BHUVANAGIRI,2021-01-15,0,141,0,141
TRIPURA,DHALAI,2021-01-11,0,59,0,59
TRIPURA,DHALAI,2021-01-12,1,87,0,88
TRIPURA,DHALAI,2021-01-13,0,34,0,34
TRIPURA,DHALAI,2021-01-14,0,55,0,55
TRIPURA,DHALAI,2021-01-15,0,23,0,23
TRIPURA,GOMATI,2021-01-11,0,81,0,81
TRIPURA,GOMATI,2021-01-12,0,135,0,135
TRIPURA,GOMATI,2021-01-13,1,117,0,118
TRIPURA,GOMATI,2021-01-14,2,90,0,92
TRIPURA,GOMATI,2021-01-15,0,58,0,58
TRIPURA,KHOWAI,2021-01-11,0,42,0,42
TRIPURA,KHOWAI,2021-01-12,0,70,0,70
TRIPURA,KHOWAI,2021-01-13,0,29,0,29
TRIPURA,KHOWAI,2021-01-14,0,48,0,48
TRIPURA,KHOWAI,2021-01-15,0,25,0,25
TRIPURA,NORTH TRIPURA,2021-01-11,1,243,0,244
TRIPURA,NORTH TRIPURA,2021-01-12,0,161,0,161
TRIPURA,NORTH TRIPURA,2021-01-13,0,192,0,192
TRIPURA,NORTH TRIPURA,2021-01-14,0,100,0,100
TRIPURA,NORTH TRIPURA,2021-01-15,1,124,0,125
TRIPURA,SEPAHIJALA,2021-01-11,1,228,0,229
TRIPURA,SEPAHIJALA,2021-01-12,0,141,0,141
TRIPURA,SEPAHIJALA,2021-01-13,2,184,0,186
TRIPURA,SEPAHIJALA,2021-01-14,0,50,0,50
TRIPURA,SEPAHIJALA,2021-01-15,0,68,0,68
TRIPURA,SOUTH TRIPURA,2021-01-11,2,218,0,220
TRIPURA,SOUTH TRIPURA,2021-01-12,3,349,0,352
TRIPURA,SOUTH TRIPURA,2021-01-13,0,223,0,223
TRIPURA,SOUTH TRIPURA,2021-01-14,0,230,0,230
TRIPURA,SOUTH TRIPURA,2021-01-15,0,181,0,181
TRIPURA,UNAKOTI,2021-01-11,0,44,0,44
TRIPURA,UNAKOTI,2021-01-12,0,35,0,35
TRIPURA,UNAKOTI,2021-01-13,0,13,0,13
TRIPURA,UNAKOTI,2021-01-14,0,3,0,3
TRIPURA,UNAKOTI,2021-01-15,0,16,0,16
TRIPURA,WEST TRIPURA,2021-01-11,1,470,0,471
TRIPURA,WEST TRIPURA,2021-01-12,3,372,0,375
TRIPURA,WEST TRIPURA,2021-01-13,5,244,0,249
TRIPURA,WEST TRIPURA,2021-01-14,2,233,0,235
TRIPURA,WEST TRIPURA,2021-01-15,3,284,0,287
UTTAR PRADESH,AGRA,2021-01-11,17,2091,208,2316
UTTAR PRADESH,AGRA,2021-01-12,20,2133,12,2165
UTTAR PRADESH,AGRA,2021-01-13,8,1913,7,1928
UTTAR PRADESH,AGRA,2021-01-14,11,1578,21,1610
UTTAR PRADESH,AGRA,2021-01-15,13,1472,12,1497
UTTAR PRADESH,ALIGARH,2021-01-11,10,2374,1,2385
UTTAR PRADESH,ALIGARH,2021-01-12,2,2467,6,2475
UTTAR PRADESH,ALIGARH,2021-01-13,2,2045,8,2055
UTTAR PRADESH,ALIGARH,2021-01-14,6,2534,0,2540
UTTAR PRADESH,ALIGARH,2021-01-15,8,2596,4,2608
UTTAR PRADESH,AMBEDKAR NAGAR,2021-01-11,4,945,2,951
UTTAR PRADESH,AMBEDKAR NAGAR,2021-01-12,6,1256,1,1263
UTTAR PRADESH,AMBEDKAR NAGAR,2021-01-13,3,2289,1,2293
UTTAR PRADESH,AMBEDKAR NAGAR,2021-01-14,2,848,1,851
UTTAR PRADESH,AMBEDKAR NAGAR,2021-01-15,5,1485,0,1490
UTTAR PRADESH,AMETHI,2021-01-11,3,1300,0,1303
UTTAR PRADESH,AMETHI,2021-01-12,2,1504,31,1537
UTTAR PRADESH,AMETHI,2021-01-13,5,1169,11,1185
UTTAR PRADESH,AMETHI,2021-01-14,5,1242,2,1249
UTTAR PRADESH,AMETHI,2021-01-15,3,1109,147,1259
UTTAR PRADESH,AMROHA,2021-01-11,2,152,0,154
UTTAR PRADESH,AMROHA,2021-01-12,3,2213,2,2218
UTTAR PRADESH,AMROHA,2021-01-13,7,889,0,896
UTTAR PRADESH,AMROHA,2021-01-14,2,295,0,297
UTTAR PRADESH,AMROHA,2021-01-15,2,2274,0,2276
UTTAR PRADESH,AURAIYA,2021-01-11,2,318,15,335
UTTAR PRADESH,AURAIYA,2021-01-12,1,1686,22,1709
UTTAR PRADESH,AURAIYA,2021-01-13,0,658,26,684
UTTAR PRADESH,AURAIYA,2021-01-14,0,1235,51,1286
UTTAR PRADESH,AURAIYA,2021-01-15,0,677,37,714
UTTAR PRADESH,AYODHYA,2021-01-11,6,1251,159,1416
UTTAR PRADESH,AYODHYA,2021-01-12,5,2203,116,2324
UTTAR PRADESH,AYODHYA,2021-01-13,28,1811,11,1850
UTTAR PRADESH,AYODHYA,2021-01-14,25,1237,20,1282
UTTAR PRADESH,AYODHYA,2021-01-15,11,1905,12,1928
UTTAR PRADESH,AZAMGARH,2021-01-11,3,1446,31,1480
UTTAR PRADESH,AZAMGARH,2021-01-12,2,680,5,687
UTTAR PRADESH,AZAMGARH,2021-01-13,4,776,37,817
UTTAR PRADESH,AZAMGARH,2021-01-14,2,864,10,876
UTTAR PRADESH,AZAMGARH,2021-01-15,1,530,3,534
UTTAR PRADESH,BAGHPAT,2021-01-11,1,1239,15,1255
UTTAR PRADESH,BAGHPAT,2021-01-12,3,1218,68,1289
UTTAR PRADESH,BAGHPAT,2021-01-13,1,551,1,553
UTTAR PRADESH,BAGHPAT,2021-01-14,2,1209,49,1260
UTTAR PRADESH,BAGHPAT,2021-01-15,1,1888,5,1894
UTTAR PRADESH,BAHRAICH,2021-01-11,4,1604,6,1614
UTTAR PRADESH,BAHRAICH,2021-01-12,0,2034,10,2044
UTTAR PRADESH,BAHRAICH,2021-01-13,8,1595,41,1644
UTTAR PRADESH,BAHRAICH,2021-01-14,2,1623,21,1646
UTTAR PRADESH,BAHRAICH,2021-01-15,2,1938,34,1974
UTTAR PRADESH,BALLIA,2021-01-11,2,1069,0,1071
UTTAR PRADESH,BALLIA,2021-01-12,4,942,1,947
UTTAR PRADESH,BALLIA,2021-01-13,6,1005,2,1013
UTTAR PRADESH,BALLIA,2021-01-14,9,1264,2,1275
UTTAR PRADESH,BALLIA,2021-01-15,2,1126,21,1149
UTTAR PRADESH,BALRAMPUR,2021-01-11,3,1097,40,1140
UTTAR PRADESH,BALRAMPUR,2021-01-12,3,1283,1,1287
UTTAR PRADESH,BALRAMPUR,2021-01-13,2,1395,0,1397
UTTAR PRADESH,BALRAMPUR,2021-01-14,4,848,1,853
UTTAR PRADESH,BALRAMPUR,2021-01-15,3,911,0,914
UTTAR PRADESH,BANDA,2021-01-11,12,1967,16,1995
UTTAR PRADESH,BANDA,2021-01-12,23,1918,25,1966
UTTAR PRADESH,BANDA,2021-01-13,8,2168,6,2182
UTTAR PRADESH,BANDA,2021-01-14,4,1364,5,1373
UTTAR PRADESH,BANDA,2021-01-15,4,2256,54,2314
UTTAR PRADESH,BARABANKI,2021-01-11,3,1475,1,1479
UTTAR PRADESH,BARABANKI,2021-01-12,3,1424,1,1428
UTTAR PRADESH,BARABANKI,2021-01-13,4,1536,1,1541
UTTAR PRADESH,BARABANKI,2021-01-14,4,1461,1,1466
UTTAR PRADESH,BARABANKI,2021-01-15,15,1184,0,1199
UTTAR PRADESH,BAREILLY,2021-01-11,7,2219,1,2227
UTTAR PRADESH,BAREILLY,2021-01-12,20,2646,5,2671
UTTAR PRADESH,BAREILLY,2021-01-13,24,2686,4,2714
UTTAR PRADESH,BAREILLY,2021-01-14,14,1884,4,1902
UTTAR PRADESH,BAREILLY,2021-01-15,19,2893,6,2918
UTTAR PRADESH,BASTI,2021-01-11,4,1554,90,1648
UTTAR PRADESH,BASTI,2021-01-12,4,1283,15,1302
UTTAR PRADESH,BASTI,2021-01-13,4,1199,53,1256
UTTAR PRADESH,BASTI,2021-01-14,5,1215,42,1262
UTTAR PRADESH,BASTI,2021-01-15,21,1370,27,1418
UTTAR PRADESH,BHADOHI,2021-01-11,1,1493,3,1497
UTTAR PRADESH,BHADOHI,2021-01-12,0,1507,1,1508
UTTAR PRADESH,BHADOHI,2021-01-13,1,1517,1,1519
UTTAR PRADESH,BHADOHI,2021-01-14,3,1480,0,1483
UTTAR PRADESH,BHADOHI,2021-01-15,1,1151,1,1153
UTTAR PRADESH,BIJNOR,2021-01-11,3,928,7,938
UTTAR PRADESH,BIJNOR,2021-01-12,3,1422,1,1426
UTTAR PRADESH,BIJNOR,2021-01-13,4,1977,3,1984
UTTAR PRADESH,BIJNOR,2021-01-14,3,1623,1,1627
UTTAR PRADESH,BIJNOR,2021-01-15,2,1665,1,1668
UTTAR PRADESH,BUDAUN,2021-01-11,1,1793,37,1831
UTTAR PRADESH,BUDAUN,2021-01-12,5,4490,16,4511
UTTAR PRADESH,BUDAUN,2021-01-13,0,753,17,770
UTTAR PRADESH,BUDAUN,2021-01-14,0,1730,12,1742
UTTAR PRADESH,BUDAUN,2021-01-15,2,2911,19,2932
UTTAR PRADESH,BULANDSHAHR,2021-01-11,11,2472,18,2501
UTTAR PRADESH,BULANDSHAHR,2021-01-12,6,1471,0,1477
UTTAR PRADESH,BULANDSHAHR,2021-01-13,6,1768,1,1775
UTTAR PRADESH,BULANDSHAHR,2021-01-14,9,1526,2,1537
UTTAR PRADESH,BULANDSHAHR,2021-01-15,10,599,1,610
UTTAR PRADESH,CHANDAULI,2021-01-11,14,1751,7,1772
UTTAR PRADESH,CHANDAULI,2021-01-12,13,1902,16,1931
UTTAR PRADESH,CHANDAULI,2021-01-13,6,1403,9,1418
UTTAR PRADESH,CHANDAULI,2021-01-14,6,907,16,929
UTTAR PRADESH,CHANDAULI,2021-01-15,4,886,20,910
UTTAR PRADESH,CHITRAKOOT,2021-01-11,0,1088,0,1088
UTTAR PRADESH,CHITRAKOOT,2021-01-12,1,1953,22,1976
UTTAR PRADESH,CHITRAKOOT,2021-01-13,1,2601,0,2602
UTTAR PRADESH,CHITRAKOOT,2021-01-14,1,945,0,946
UTTAR PRADESH,CHITRAKOOT,2021-01-15,0,1378,10,1388
UTTAR PRADESH,DEORIA,2021-01-11,2,1326,17,1345
UTTAR PRADESH,DEORIA,2021-01-12,1,646,4,651
UTTAR PRADESH,DEORIA,2021-01-13,1,1495,15,1511
UTTAR PRADESH,DEORIA,2021-01-14,2,817,26,845
UTTAR PRADESH,DEORIA,2021-01-15,1,1089,213,1303
UTTAR PRADESH,ETAH,2021-01-11,3,1288,2,1293
UTTAR PRADESH,ETAH,2021-01-12,0,975,2,977
UTTAR PRADESH,ETAH,2021-01-13,1,1359,13,1373
UTTAR PRADESH,ETAH,2021-01-14,2,1429,10,1441
UTTAR PRADESH,ETAH,2021-01-15,0,1202,0,1202
UTTAR PRADESH,ETAWAH,2021-01-11,1,309,1,311
UTTAR PRADESH,ETAWAH,2021-01-12,1,2672,55,2728
UTTAR PRADESH,ETAWAH,2021-01-13,3,782,161,946
UTTAR PRADESH,ETAWAH,2021-01-14,0,2126,111,2237
UTTAR PRADESH,ETAWAH,2021-01-15,0,1157,67,1224
UTTAR PRADESH,FARRUKHABAD,2021-01-11,5,1613,19,1637
UTTAR PRADESH,FARRUKHABAD,2021-01-12,0,1079,22,1101
UTTAR PRADESH,FARRUKHABAD,2021-01-13,0,1005,48,1053
UTTAR PRADESH,FARRUKHABAD,2021-01-14,1,1020,47,1068
UTTAR PRADESH,FARRUKHABAD,2021-01-15,1,965,71,1037
UTTAR PRADESH,FATEHPUR,2021-01-11,1,2028,61,2090
UTTAR PRADESH,FATEHPUR,2021-01-12,0,2425,27,2452
UTTAR PRADESH,FATEHPUR,2021-01-13,5,1910,79,1994
UTTAR PRADESH,FATEHPUR,2021-01-14,1,1705,62,1768
UTTAR PRADESH,FATEHPUR,2021-01-15,1,1829,53,1883
UTTAR PRADESH,FIROZABAD,2021-01-11,2,610,2,614
UTTAR PRADESH,FIROZABAD,2021-01-12,3,2792,15,2810
UTTAR PRADESH,FIROZABAD,2021-01-13,2,2611,7,2620
UTTAR PRADESH,FIROZABAD,2021-01-14,3,1832,5,1840
UTTAR PRADESH,FIROZABAD,2021-01-15,3,1252,3,1258
UTTAR PRADESH,GAUTAM BUDDHA NAGAR,2021-01-11,79,1790,29,1898
UTTAR PRADESH,GAUTAM BUDDHA NAGAR,2021-01-12,54,2837,1,2892
UTTAR PRADESH,GAUTAM BUDDHA NAGAR,2021-01-13,67,2929,14,3010
UTTAR PRADESH,GAUTAM BUDDHA NAGAR,2021-01-14,50,2797,90,2937
UTTAR PRADESH,GAUTAM BUDDHA NAGAR,2021-01-15,55,3019,35,3109
UTTAR PRADESH,GHAZIABAD,2021-01-11,85,3739,100,3924
UTTAR PRADESH,GHAZIABAD,2021-01-12,65,2873,26,2964
UTTAR PRADESH,GHAZIABAD,2021-01-13,87,2225,53,2365
UTTAR PRADESH,GHAZIABAD,2021-01-14,82,3212,64,3358
UTTAR PRADESH,GHAZIABAD,2021-01-15,80,2299,11,2390
UTTAR PRADESH,GHAZIPUR,2021-01-11,10,1019,31,1060
UTTAR PRADESH,GHAZIPUR,2021-01-12,5,1117,0,1122
UTTAR PRADESH,GHAZIPUR,2021-01-13,5,921,17,943
UTTAR PRADESH,GHAZIPUR,2021-01-14,4,443,6,453
UTTAR PRADESH,GHAZIPUR,2021-01-15,6,845,29,880
UTTAR PRADESH,GONDA,2021-01-11,3,1558,59,1620
UTTAR PRADESH,GONDA,2021-01-12,1,1446,2,1449
UTTAR PRADESH,GONDA,2021-01-13,2,1285,1,1288
UTTAR PRADESH,GONDA,2021-01-14,1,1441,2,1444
UTTAR PRADESH,GONDA,2021-01-15,3,1260,1,1264
UTTAR PRADESH,GORAKHPUR,2021-01-11,9,2306,40,2355
UTTAR PRADESH,GORAKHPUR,2021-01-12,18,2499,81,2598
UTTAR PRADESH,GORAKHPUR,2021-01-13,6,2230,20,2256
UTTAR PRADESH,GORAKHPUR,2021-01-14,8,1980,10,1998
UTTAR PRADESH,GORAKHPUR,2021-01-15,19,1707,99,1825
UTTAR PRADESH,HAMIRPUR,2021-01-11,1,1414,1,1416
UTTAR PRADESH,HAMIRPUR,2021-01-12,0,1002,4,1006
UTTAR PRADESH,HAMIRPUR,2021-01-13,1,1163,0,1164
UTTAR PRADESH,HAMIRPUR,2021-01-14,1,1015,7,1023
UTTAR PRADESH,HAMIRPUR,2021-01-15,0,943,2,945
UTTAR PRADESH,HAPUR,2021-01-11,3,867,1,871
UTTAR PRADESH,HAPUR,2021-01-12,3,1610,1,1614
UTTAR PRADESH,HAPUR,2021-01-13,3,62,1,66
UTTAR PRADESH,HAPUR,2021-01-14,5,2242,1,2248
UTTAR PRADESH,HAPUR,2021-01-15,6,1622,21,1649
UTTAR PRADESH,HARDOI,2021-01-11,0,1459,2,1461
UTTAR PRADESH,HARDOI,2021-01-12,5,1735,19,1759
UTTAR PRADESH,HARDOI,2021-01-13,0,1298,4,1302
UTTAR PRADESH,HARDOI,2021-01-14,2,1411,24,1437
UTTAR PRADESH,HARDOI,2021-01-15,5,1234,5,1244
UTTAR PRADESH,HATHRAS,2021-01-11,1,1635,0,1636
UTTAR PRADESH,HATHRAS,2021-01-12,2,1261,5,1268
UTTAR PRADESH,HATHRAS,2021-01-13,2,1084,1,1087
UTTAR PRADESH,HATHRAS,2021-01-14,4,1141,3,1148
UTTAR PRADESH,HATHRAS,2021-01-15,2,368,4,374
UTTAR PRADESH,JALAUN,2021-01-11,3,1011,1,1015
UTTAR PRADESH,JALAUN,2021-01-12,5,1353,1,1359
UTTAR PRADESH,JALAUN,2021-01-13,2,1181,1,1184
UTTAR PRADESH,JALAUN,2021-01-14,5,756,1,762
UTTAR PRADESH,JALAUN,2021-01-15,3,878,1,882
UTTAR PRADESH,JAUNPUR,2021-01-11,4,405,2,411
UTTAR PRADESH,JAUNPUR,2021-01-12,2,2340,2,2344
UTTAR PRADESH,JAUNPUR,2021-01-13,4,821,0,825
UTTAR PRADESH,JAUNPUR,2021-01-14,2,1902,4,1908
UTTAR PRADESH,JAUNPUR,2021-01-15,1,1135,4,1140
UTTAR PRADESH,JHANSI,2021-01-11,25,3163,8,3196
UTTAR PRADESH,JHANSI,2021-01-12,3,2681,1,2685
UTTAR PRADESH,JHANSI,2021-01-13,10,2835,5,2850
UTTAR PRADESH,JHANSI,2021-01-14,10,3089,2,3101
UTTAR PRADESH,JHANSI,2021-01-15,15,2224,2,2241
UTTAR PRADESH,KANNAUJ,2021-01-11,1,1334,0,1335
UTTAR PRADESH,KANNAUJ,2021-01-12,3,1717,0,1720
UTTAR PRADESH,KANNAUJ,2021-01-13,0,1536,1,1537
UTTAR PRADESH,KANNAUJ,2021-01-14,4,1367,0,1371
UTTAR PRADESH,KANNAUJ,2021-01-15,1,1513,2,1516
UTTAR PRADESH,KANPUR DEHAT,2021-01-11,2,1142,3,1147
UTTAR PRADESH,KANPUR DEHAT,2021-01-12,2,1245,6,1253
UTTAR PRADESH,KANPUR DEHAT,2021-01-13,2,996,16,1014
UTTAR PRADESH,KANPUR DEHAT,2021-01-14,1,1197,1,1199
UTTAR PRADESH,KANPUR DEHAT,2021-01-15,1,837,5,843
UTTAR PRADESH,KANPUR NAGAR,2021-01-11,31,2741,6,2778
UTTAR PRADESH,KANPUR NAGAR,2021-01-12,24,3635,62,3721
UTTAR PRADESH,KANPUR NAGAR,2021-01-13,14,3459,12,3485
UTTAR PRADESH,KANPUR NAGAR,2021-01-14,13,2801,0,2814
UTTAR PRADESH,KANPUR NAGAR,2021-01-15,17,3055,8,3080
UTTAR PRADESH,KASGANJ,2021-01-11,1,2571,0,2572
UTTAR PRADESH,KASGANJ,2021-01-12,0,1552,25,1577
UTTAR PRADESH,KASGANJ,2021-01-13,1,1343,1,1345
UTTAR PRADESH,KASGANJ,2021-01-14,0,1450,26,1476
UTTAR PRADESH,KASGANJ,2021-01-15,0,348,1,349
UTTAR PRADESH,KAUSHAMBI,2021-01-11,1,1470,0,1471
UTTAR PRADESH,KAUSHAMBI,2021-01-12,0,1708,0,1708
UTTAR PRADESH,KAUSHAMBI,2021-01-13,0,1925,0,1925
UTTAR PRADESH,KAUSHAMBI,2021-01-14,0,1487,0,1487
UTTAR PRADESH,KAUSHAMBI,2021-01-15,0,1624,6,1630
UTTAR PRADESH,KHERI,2021-01-11,6,1357,16,1379
UTTAR PRADESH,KHERI,2021-01-12,9,1912,31,1952
UTTAR PRADESH,KHERI,2021-01-13,8,1832,6,1846
UTTAR PRADESH,KHERI,2021-01-14,8,2559,6,2573
UTTAR PRADESH,KHERI,2021-01-15,11,1689,124,1824
UTTAR PRADESH,KUSHI NAGAR,2021-01-11,1,1037,53,1091
UTTAR PRADESH,KUSHI NAGAR,2021-01-12,4,930,13,947
UTTAR PRADESH,KUSHI NAGAR,2021-01-13,1,1447,4,1452
UTTAR PRADESH,KUSHI NAGAR,2021-01-14,1,723,28,752
UTTAR PRADESH,KUSHI NAGAR,2021-01-15,0,1083,15,1098
UTTAR PRADESH,LALITPUR,2021-01-11,6,1452,2,1460
UTTAR PRADESH,LALITPUR,2021-01-12,6,1821,3,1830
UTTAR PRADESH,LALITPUR,2021-01-13,1,1611,1,1613
UTTAR PRADESH,LALITPUR,2021-01-14,2,729,0,731
UTTAR PRADESH,LALITPUR,2021-01-15,1,1581,0,1582
UTTAR PRADESH,LUCKNOW,2021-01-11,116,6517,124,6757
UTTAR PRADESH,LUCKNOW,2021-01-12,110,6762,276,7148
UTTAR PRADESH,LUCKNOW,2021-01-13,159,7696,345,8200
UTTAR PRADESH,LUCKNOW,2021-01-14,143,7072,345,7560
UTTAR PRADESH,LUCKNOW,2021-01-15,157,6486,133,6776
UTTAR PRADESH,MAHARAJGANJ,2021-01-11,6,1219,15,1240
UTTAR PRADESH,MAHARAJGANJ,2021-01-12,2,1504,21,1527
UTTAR PRADESH,MAHARAJGANJ,2021-01-13,1,1120,5,1126
UTTAR PRADESH,MAHARAJGANJ,2021-01-14,2,901,92,995
UTTAR PRADESH,MAHARAJGANJ,2021-01-15,0,1020,9,1029
UTTAR PRADESH,MAHOBA,2021-01-11,0,1013,0,1013
UTTAR PRADESH,MAHOBA,2021-01-12,0,754,5,759
UTTAR PRADESH,MAHOBA,2021-01-13,0,719,0,719
UTTAR PRADESH,MAHOBA,2021-01-14,1,665,10,676
UTTAR PRADESH,MAHOBA,2021-01-15,2,583,5,590
UTTAR PRADESH,MAINPURI,2021-01-11,7,997,0,1004
UTTAR PRADESH,MAINPURI,2021-01-12,3,1375,2,1380
UTTAR PRADESH,MAINPURI,2021-01-13,4,1598,3,1605
UTTAR PRADESH,MAINPURI,2021-01-14,10,1640,76,1726
UTTAR PRADESH,MAINPURI,2021-01-15,1,1561,7,1569
UTTAR PRADESH,MATHURA,2021-01-11,4,1480,8,1492
UTTAR PRADESH,MATHURA,2021-01-12,4,1795,3,1802
UTTAR PRADESH,MATHURA,2021-01-13,4,1400,0,1404
UTTAR PRADESH,MATHURA,2021-01-14,15,1488,8,1511
UTTAR PRADESH,MATHURA,2021-01-15,4,1459,6,1469
UTTAR PRADESH,MAU,2021-01-11,0,1385,15,1400
UTTAR PRADESH,MAU,2021-01-12,1,1144,21,1166
UTTAR PRADESH,MAU,2021-01-13,3,1257,46,1306
UTTAR PRADESH,MAU,2021-01-14,0,1014,0,1014
UTTAR PRADESH,MAU,2021-01-15,2,1051,15,1068
UTTAR PRADESH,MEERUT,2021-01-11,42,3491,9,3542
UTTAR PRADESH,MEERUT,2021-01-12,35,3627,5,3667
UTTAR PRADESH,MEERUT,2021-01-13,27,3691,35,3753
UTTAR PRADESH,MEERUT,2021-01-14,34,3903,13,3950
UTTAR PRADESH,MEERUT,2021-01-15,24,6679,7,6710
UTTAR PRADESH,MIRZAPUR,2021-01-11,3,2053,0,2056
UTTAR PRADESH,MIRZAPUR,2021-01-12,3,1811,0,1814
UTTAR PRADESH,MIRZAPUR,2021-01-13,1,1538,1,1540
UTTAR PRADESH,MIRZAPUR,2021-01-14,2,1577,0,1579
UTTAR PRADESH,MIRZAPUR,2021-01-15,2,1262,4,1268
UTTAR PRADESH,MORADABAD,2021-01-11,8,2307,65,2380
UTTAR PRADESH,MORADABAD,2021-01-12,5,2684,23,2712
UTTAR PRADESH,MORADABAD,2021-01-13,7,3355,36,3398
UTTAR PRADESH,MORADABAD,2021-01-14,11,2052,6,2069
UTTAR PRADESH,MORADABAD,2021-01-15,9,3821,0,3830
UTTAR PRADESH,MUZAFFARNAGAR,2021-01-11,32,901,2,935
UTTAR PRADESH,MUZAFFARNAGAR,2021-01-12,17,2528,11,2556
UTTAR PRADESH,MUZAFFARNAGAR,2021-01-13,32,2131,6,2169
UTTAR PRADESH,MUZAFFARNAGAR,2021-01-14,34,1450,2,1486
UTTAR PRADESH,MUZAFFARNAGAR,2021-01-15,29,1786,2,1817
UTTAR PRADESH,PILIBHIT,2021-01-11,4,1457,20,1481
UTTAR PRADESH,PILIBHIT,2021-01-12,5,1667,8,1680
UTTAR PRADESH,PILIBHIT,2021-01-13,4,1472,0,1476
UTTAR PRADESH,PILIBHIT,2021-01-14,1,1664,7,1672
UTTAR PRADESH,PILIBHIT,2021-01-15,3,1368,0,1371
UTTAR PRADESH,PRATAPGARH,2021-01-11,4,1341,242,1587
UTTAR PRADESH,PRATAPGARH,2021-01-12,3,1668,76,1747
UTTAR PRADESH,PRATAPGARH,2021-01-13,11,2690,50,2751
UTTAR PRADESH,PRATAPGARH,2021-01-14,6,1619,132,1757
UTTAR PRADESH,PRATAPGARH,2021-01-15,6,1941,31,1978
UTTAR PRADESH,PRAYAGRAJ,2021-01-11,20,5681,2,5703
UTTAR PRADESH,PRAYAGRAJ,2021-01-12,15,4767,3,4785
UTTAR PRADESH,PRAYAGRAJ,2021-01-13,32,3832,28,3892
UTTAR PRADESH,PRAYAGRAJ,2021-01-14,30,4095,8,4133
UTTAR PRADESH,PRAYAGRAJ,2021-01-15,59,3406,5,3470
UTTAR PRADESH,RAE BARELI,2021-01-11,8,2955,1,2964
UTTAR PRADESH,RAE BARELI,2021-01-12,2,2894,6,2902
UTTAR PRADESH,RAE BARELI,2021-01-13,5,2235,8,2248
UTTAR PRADESH,RAE BARELI,2021-01-14,7,1787,26,1820
UTTAR PRADESH,RAE BARELI,2021-01-15,13,1732,2,1747
UTTAR PRADESH,RAMPUR,2021-01-11,13,1643,17,1673
UTTAR PRADESH,RAMPUR,2021-01-12,0,1477,67,1544
UTTAR PRADESH,RAMPUR,2021-01-13,0,1566,10,1576
UTTAR PRADESH,RAMPUR,2021-01-14,2,1389,33,1424
UTTAR PRADESH,RAMPUR,2021-01-15,3,1703,10,1716
UTTAR PRADESH,SAHARANPUR,2021-01-11,9,2522,2,2533
UTTAR PRADESH,SAHARANPUR,2021-01-12,14,2114,13,2141
UTTAR PRADESH,SAHARANPUR,2021-01-13,12,4697,5,4714
UTTAR PRADESH,SAHARANPUR,2021-01-14,10,2721,16,2747
UTTAR PRADESH,SAHARANPUR,2021-01-15,12,2279,33,2324
UTTAR PRADESH,SAMBHAL,2021-01-11,0,1204,6,1210
UTTAR PRADESH,SAMBHAL,2021-01-12,3,1375,21,1399
UTTAR PRADESH,SAMBHAL,2021-01-13,1,1408,1,1410
UTTAR PRADESH,SAMBHAL,2021-01-14,3,877,11,891
UTTAR PRADESH,SAMBHAL,2021-01-15,2,1271,104,1377
UTTAR PRADESH,SANT KABEER NAGAR,2021-01-11,5,1195,131,1331
UTTAR PRADESH,SANT KABEER NAGAR,2021-01-12,10,1711,194,1915
UTTAR PRADESH,SANT KABEER NAGAR,2021-01-13,3,951,30,984
UTTAR PRADESH,SANT KABEER NAGAR,2021-01-14,0,1122,12,1134
UTTAR PRADESH,SANT KABEER NAGAR,2021-01-15,1,1237,0,1238
UTTAR PRADESH,SHAHJAHANPUR,2021-01-11,8,2135,20,2163
UTTAR PRADESH,SHAHJAHANPUR,2021-01-12,4,1594,52,1650
UTTAR PRADESH,SHAHJAHANPUR,2021-01-13,10,1756,5,1771
UTTAR PRADESH,SHAHJAHANPUR,2021-01-14,5,1253,2,1260
UTTAR PRADESH,SHAHJAHANPUR,2021-01-15,7,2319,0,2326
UTTAR PRADESH,SHAMLI,2021-01-11,2,1667,7,1676
UTTAR PRADESH,SHAMLI,2021-01-12,3,1147,3,1153
UTTAR PRADESH,SHAMLI,2021-01-13,0,1959,1,1960
UTTAR PRADESH,SHAMLI,2021-01-14,5,1793,0,1798
UTTAR PRADESH,SHAMLI,2021-01-15,3,1755,3,1761
UTTAR PRADESH,SHRAVASTI,2021-01-11,1,1047,1,1049
UTTAR PRADESH,SHRAVASTI,2021-01-12,3,1033,0,1036
UTTAR PRADESH,SHRAVASTI,2021-01-13,3,999,0,1002
UTTAR PRADESH,SHRAVASTI,2021-01-14,1,893,1,895
UTTAR PRADESH,SHRAVASTI,2021-01-15,2,847,0,849
UTTAR PRADESH,SIDDHARTH NAGAR,2021-01-11,4,915,63,982
UTTAR PRADESH,SIDDHARTH NAGAR,2021-01-12,2,1079,1,1082
UTTAR PRADESH,SIDDHARTH NAGAR,2021-01-13,1,942,2,945
UTTAR PRADESH,SIDDHARTH NAGAR,2021-01-14,5,1064,25,1094
UTTAR PRADESH,SIDDHARTH NAGAR,2021-01-15,3,868,3,874
UTTAR PRADESH,SITAPUR,2021-01-11,2,1423,81,1506
UTTAR PRADESH,SITAPUR,2021-01-12,4,1829,4,1837
UTTAR PRADESH,SITAPUR,2021-01-13,1,1761,11,1773
UTTAR PRADESH,SITAPUR,2021-01-14,3,1729,4,1736
UTTAR PRADESH,SITAPUR,2021-01-15,0,1696,7,1703
UTTAR PRADESH,SONBHADRA,2021-01-11,7,1896,14,1917
UTTAR PRADESH,SONBHADRA,2021-01-12,6,1247,0,1253
UTTAR PRADESH,SONBHADRA,2021-01-13,3,2258,43,2304
UTTAR PRADESH,SONBHADRA,2021-01-14,3,1987,37,2027
UTTAR PRADESH,SONBHADRA,2021-01-15,9,1682,16,1707
UTTAR PRADESH,SULTANPUR,2021-01-11,4,543,1,548
UTTAR PRADESH,SULTANPUR,2021-01-12,6,1047,24,1077
UTTAR PRADESH,SULTANPUR,2021-01-13,2,1181,22,1205
UTTAR PRADESH,SULTANPUR,2021-01-14,4,1170,4,1178
UTTAR PRADESH,SULTANPUR,2021-01-15,2,939,11,952
UTTAR PRADESH,UNNAO,2021-01-11,3,1480,10,1493
UTTAR PRADESH,UNNAO,2021-01-12,5,1712,32,1749
UTTAR PRADESH,UNNAO,2021-01-13,6,1665,39,1710
UTTAR PRADESH,UNNAO,2021-01-14,3,1412,23,1438
UTTAR PRADESH,UNNAO,2021-01-15,5,1559,93,1657
UTTAR PRADESH,VARANASI,2021-01-11,35,1762,71,1868
UTTAR PRADESH,VARANASI,2021-01-12,42,2539,141,2722
UTTAR PRADESH,VARANASI,2021-01-13,33,1731,149,1913
UTTAR PRADESH,VARANASI,2021-01-14,35,3151,48,3234
UTTAR PRADESH,VARANASI,2021-01-15,28,954,107,1089
UTTARAKHAND,ALMORA,2021-01-11,4,169,0,173
UTTARAKHAND,ALMORA,2021-01-12,7,162,0,169
UTTARAKHAND,ALMORA,2021-01-13,2,159,1,162
UTTARAKHAND,ALMORA,2021-01-14,6,149,0,155
UTTARAKHAND,ALMORA,2021-01-15,12,147,1,160
UTTARAKHAND,BAGESHWAR,2021-01-11,3,69,0,72
UTTARAKHAND,BAGESHWAR,2021-01-12,0,108,0,108
UTTARAKHAND,BAGESHWAR,2021-01-13,2,309,0,311
UTTARAKHAND,BAGESHWAR,2021-01-14,5,367,0,372
UTTARAKHAND,BAGESHWAR,2021-01-15,1,508,11,520
UTTARAKHAND,CHAMOLI,2021-01-11,2,87,0,89
UTTARAKHAND,CHAMOLI,2021-01-12,4,419,11,434
UTTARAKHAND,CHAMOLI,2021-01-13,5,551,14,570
UTTARAKHAND,CHAMOLI,2021-01-14,3,272,7,282
UTTARAKHAND,CHAMOLI,2021-01-15,2,346,8,356
UTTARAKHAND,CHAMPAWAT,2021-01-11,3,469,3,475
UTTARAKHAND,CHAMPAWAT,2021-01-12,1,595,0,596
UTTARAKHAND,CHAMPAWAT,2021-01-13,0,69,0,69
UTTARAKHAND,CHAMPAWAT,2021-01-14,3,383,3,389
UTTARAKHAND,CHAMPAWAT,2021-01-15,5,461,0,466
UTTARAKHAND,DEHRADUN,2021-01-11,70,2261,4,2335
UTTARAKHAND,DEHRADUN,2021-01-12,117,3209,14,3340
UTTARAKHAND,DEHRADUN,2021-01-13,91,2953,34,3078
UTTARAKHAND,DEHRADUN,2021-01-14,71,2229,3,2303
UTTARAKHAND,DEHRADUN,2021-01-15,84,3771,10,3865
UTTARAKHAND,HARIDWAR,2021-01-11,18,1460,21,1499
UTTARAKHAND,HARIDWAR,2021-01-12,17,2339,21,2377
UTTARAKHAND,HARIDWAR,2021-01-13,29,1899,12,1940
UTTARAKHAND,HARIDWAR,2021-01-14,34,2222,15,2271
UTTARAKHAND,HARIDWAR,2021-01-15,20,2294,24,2338
UTTARAKHAND,NAINITAL,2021-01-11,47,1159,11,1217
UTTARAKHAND,NAINITAL,2021-01-12,43,1603,20,1666
UTTARAKHAND,NAINITAL,2021-01-13,43,1063,8,1114
UTTARAKHAND,NAINITAL,2021-01-14,27,939,5,971
UTTARAKHAND,NAINITAL,2021-01-15,43,1208,5,1256
UTTARAKHAND,PAURI GARHWAL,2021-01-11,9,552,0,561
UTTARAKHAND,PAURI GARHWAL,2021-01-12,6,535,5,546
UTTARAKHAND,PAURI GARHWAL,2021-01-13,9,551,8,568
UTTARAKHAND,PAURI GARHWAL,2021-01-14,7,371,6,384
UTTARAKHAND,PAURI GARHWAL,2021-01-15,10,554,5,569
UTTARAKHAND,PITHORAGARH,2021-01-11,1,204,1,206
UTTARAKHAND,PITHORAGARH,2021-01-12,3,516,3,522
UTTARAKHAND,PITHORAGARH,2021-01-13,9,284,3,296
UTTARAKHAND,PITHORAGARH,2021-01-14,3,78,2,83
UTTARAKHAND,PITHORAGARH,2021-01-15,6,196,3,205
UTTARAKHAND,RUDRA PRAYAG,2021-01-11,2,64,1,67
UTTARAKHAND,RUDRA PRAYAG,2021-01-12,3,53,3,59
UTTARAKHAND,RUDRA PRAYAG,2021-01-13,0,124,4,128
UTTARAKHAND,RUDRA PRAYAG,2021-01-14,4,245,6,255
UTTARAKHAND,RUDRA PRAYAG,2021-01-15,1,232,1,234
UTTARAKHAND,TEHRI GARHWAL,2021-01-11,4,290,1,295
UTTARAKHAND,TEHRI GARHWAL,2021-01-12,4,552,9,565
UTTARAKHAND,TEHRI GARHWAL,2021-01-13,5,380,2,387
UTTARAKHAND,TEHRI GARHWAL,2021-01-14,8,289,0,297
UTTARAKHAND,TEHRI GARHWAL,2021-01-15,5,335,3,343
UTTARAKHAND,UDAM SINGH NAGAR,2021-01-11,15,2455,70,2540
UTTARAKHAND,UDAM SINGH NAGAR,2021-01-12,9,2218,18,2245
UTTARAKHAND,UDAM SINGH NAGAR,2021-01-13,11,1965,7,1983
UTTARAKHAND,UDAM SINGH NAGAR,2021-01-14,16,1702,44,1762
UTTARAKHAND,UDAM SINGH NAGAR,2021-01-15,12,2595,11,2618
UTTARAKHAND,UTTAR KASHI,2021-01-11,1,865,2,868
UTTARAKHAND,UTTAR KASHI,2021-01-12,6,1065,0,1071
UTTARAKHAND,UTTAR KASHI,2021-01-13,2,911,0,913
UTTARAKHAND,UTTAR KASHI,2021-01-14,3,466,1,470
UTTARAKHAND,UTTAR KASHI,2021-01-15,3,394,6,403
WEST BENGAL,24 PARAGANAS NORTH,2021-01-11,170,4748,27,4945
WEST BENGAL,24 PARAGANAS NORTH,2021-01-12,223,4514,34,4771
WEST BENGAL,24 PARAGANAS NORTH,2021-01-13,165,5106,44,5315
WEST BENGAL,24 PARAGANAS NORTH,2021-01-14,161,4625,47,4833
WEST BENGAL,24 PARAGANAS NORTH,2021-01-15,146,4738,25,4909
WEST BENGAL,24 PARAGANAS SOUTH,2021-01-11,33,3642,10,3685
WEST BENGAL,24 PARAGANAS SOUTH,2021-01-12,36,3283,120,3439
WEST BENGAL,24 PARAGANAS SOUTH,2021-01-13,29,3380,4,3413
WEST BENGAL,24 PARAGANAS SOUTH,2021-01-14,55,3749,16,3820
WEST BENGAL,24 PARAGANAS SOUTH,2021-01-15,19,3251,11,3281
WEST BENGAL,ALIPURDUAR,2021-01-11,4,616,0,620
WEST BENGAL,ALIPURDUAR,2021-01-12,0,983,0,983
WEST BENGAL,ALIPURDUAR,2021-01-13,3,718,0,721
WEST BENGAL,ALIPURDUAR,2021-01-14,1,783,0,784
WEST BENGAL,ALIPURDUAR,2021-01-15,2,451,0,453
WEST BENGAL,BANKURA,2021-01-11,11,959,14,984
WEST BENGAL,BANKURA,2021-01-12,11,788,12,811
WEST BENGAL,BANKURA,2021-01-13,11,843,8,862
WEST BENGAL,BANKURA,2021-01-14,7,700,1,708
WEST BENGAL,BANKURA,2021-01-15,11,713,1,725
WEST BENGAL,BIRBHUM,2021-01-11,13,1239,7,1259
WEST BENGAL,BIRBHUM,2021-01-12,13,1002,2,1017
WEST BENGAL,BIRBHUM,2021-01-13,11,1308,11,1330
WEST BENGAL,BIRBHUM,2021-01-14,13,1267,11,1291
WEST BENGAL,BIRBHUM,2021-01-15,12,1165,2,1179
WEST BENGAL,COOCHBEHAR,2021-01-11,6,2027,0,2033
WEST BENGAL,COOCHBEHAR,2021-01-12,5,1934,20,1959
WEST BENGAL,COOCHBEHAR,2021-01-13,3,2082,0,2085
WEST BENGAL,COOCHBEHAR,2021-01-14,1,2214,41,2256
WEST BENGAL,COOCHBEHAR,2021-01-15,4,1656,17,1677
WEST BENGAL,DARJEELING,2021-01-11,12,1056,0,1068
WEST BENGAL,DARJEELING,2021-01-12,40,785,2,827
WEST BENGAL,DARJEELING,2021-01-13,18,1451,1,1470
WEST BENGAL,DARJEELING,2021-01-14,23,1030,2,1055
WEST BENGAL,DARJEELING,2021-01-15,10,883,2,895
WEST BENGAL,DINAJPUR DAKSHIN,2021-01-11,4,802,0,806
WEST BENGAL,DINAJPUR DAKSHIN,2021-01-12,3,755,1,759
WEST BENGAL,DINAJPUR DAKSHIN,2021-01-13,0,725,1,726
WEST BENGAL,DINAJPUR DAKSHIN,2021-01-14,1,659,0,660
WEST BENGAL,DINAJPUR DAKSHIN,2021-01-15,1,524,1,526
WEST BENGAL,DINAJPUR UTTAR,2021-01-11,6,730,0,736
WEST BENGAL,DINAJPUR UTTAR,2021-01-12,8,469,0,477
WEST BENGAL,DINAJPUR UTTAR,2021-01-13,4,374,0,378
WEST BENGAL,DINAJPUR UTTAR,2021-01-14,7,352,0,359
WEST BENGAL,DINAJPUR UTTAR,2021-01-15,10,461,0,471
WEST BENGAL,HOOGHLY,2021-01-11,23,1520,60,1603
WEST BENGAL,HOOGHLY,2021-01-12,38,782,11,831
WEST BENGAL,HOOGHLY,2021-01-13,27,1353,99,1479
WEST BENGAL,HOOGHLY,2021-01-14,31,1041,2,1074
WEST BENGAL,HOOGHLY,2021-01-15,31,1182,48,1261
WEST BENGAL,HOWRAH,2021-01-11,31,1659,1,1691
WEST BENGAL,HOWRAH,2021-01-12,47,1621,6,1674
WEST BENGAL,HOWRAH,2021-01-13,28,1831,3,1862
WEST BENGAL,HOWRAH,2021-01-14,31,1456,6,1493
WEST BENGAL,HOWRAH,2021-01-15,29,1373,5,1407
WEST BENGAL,JALPAIGURI,2021-01-11,8,569,0,577
WEST BENGAL,JALPAIGURI,2021-01-12,10,592,0,602
WEST BENGAL,JALPAIGURI,2021-01-13,13,706,0,719
WEST BENGAL,JALPAIGURI,2021-01-14,5,545,0,550
WEST BENGAL,JALPAIGURI,2021-01-15,8,572,1,581
WEST BENGAL,JHARGRAM,2021-01-11,3,26,0,29
WEST BENGAL,JHARGRAM,2021-01-12,2,163,0,165
WEST BENGAL,JHARGRAM,2021-01-13,2,96,0,98
WEST BENGAL,JHARGRAM,2021-01-14,1,150,0,151
WEST BENGAL,JHARGRAM,2021-01-15,1,157,2,160
WEST BENGAL,KALIMPONG,2021-01-11,3,448,0,451
WEST BENGAL,KALIMPONG,2021-01-12,0,167,0,167
WEST BENGAL,KALIMPONG,2021-01-13,4,323,0,327
WEST BENGAL,KALIMPONG,2021-01-14,3,148,0,151
WEST BENGAL,KALIMPONG,2021-01-15,1,400,0,401
WEST BENGAL,KOLKATA,2021-01-11,230,2877,14,3121
WEST BENGAL,KOLKATA,2021-01-12,282,3137,16,3435
WEST BENGAL,KOLKATA,2021-01-13,182,3037,11,3230
WEST BENGAL,KOLKATA,2021-01-14,251,3757,12,4020
WEST BENGAL,KOLKATA,2021-01-15,214,3210,10,3434
WEST BENGAL,MALDAH,2021-01-11,3,860,11,874
WEST BENGAL,MALDAH,2021-01-12,1,694,8,703
WEST BENGAL,MALDAH,2021-01-13,7,737,2,746
WEST BENGAL,MALDAH,2021-01-14,16,674,9,699
WEST BENGAL,MALDAH,2021-01-15,5,855,1,861
WEST BENGAL,MEDINIPUR EAST,2021-01-11,19,1189,1,1209
WEST BENGAL,MEDINIPUR EAST,2021-01-12,18,862,3,883
WEST BENGAL,MEDINIPUR EAST,2021-01-13,14,1529,3,1546
WEST BENGAL,MEDINIPUR EAST,2021-01-14,5,1066,3,1074
WEST BENGAL,MEDINIPUR EAST,2021-01-15,16,1348,2,1366
WEST BENGAL,MEDINIPUR WEST,2021-01-11,13,760,1,774
WEST BENGAL,MEDINIPUR WEST,2021-01-12,6,436,1,443
WEST BENGAL,MEDINIPUR WEST,2021-01-13,9,508,4,521
WEST BENGAL,MEDINIPUR WEST,2021-01-14,6,553,12,571
WEST BENGAL,MEDINIPUR WEST,2021-01-15,8,478,5,491
WEST BENGAL,MURSHIDABAD,2021-01-11,6,1677,4,1687
WEST BENGAL,MURSHIDABAD,2021-01-12,23,1528,11,1562
WEST BENGAL,MURSHIDABAD,2021-01-13,7,1231,17,1255
WEST BENGAL,MURSHIDABAD,2021-01-14,13,1421,11,1445
WEST BENGAL,MURSHIDABAD,2021-01-15,6,1067,2,1075
WEST BENGAL,NADIA,2021-01-11,25,1159,17,1201
WEST BENGAL,NADIA,2021-01-12,26,995,12,1033
WEST BENGAL,NADIA,2021-01-13,17,1010,22,1049
WEST BENGAL,NADIA,2021-01-14,22,925,19,966
WEST BENGAL,NADIA,2021-01-15,17,945,20,982
WEST BENGAL,PASCHIM BARDHAMAN,2021-01-11,21,1016,1,1038
WEST BENGAL,PASCHIM BARDHAMAN,2021-01-12,26,953,9,988
WEST BENGAL,PASCHIM BARDHAMAN,2021-01-13,49,1181,9,1239
WEST BENGAL,PASCHIM BARDHAMAN,2021-01-14,33,998,2,1033
WEST BENGAL,PASCHIM BARDHAMAN,2021-01-15,28,1019,5,1052
WEST BENGAL,PURBA BARDHAMAN,2021-01-11,8,1958,0,1966
WEST BENGAL,PURBA BARDHAMAN,2021-01-12,8,1496,3,1507
WEST BENGAL,PURBA BARDHAMAN,2021-01-13,17,1457,1,1475
WEST BENGAL,PURBA BARDHAMAN,2021-01-14,3,857,2,862
WEST BENGAL,PURBA BARDHAMAN,2021-01-15,7,572,0,579
WEST BENGAL,PURULIA,2021-01-11,3,686,0,689
WEST BENGAL,PURULIA,2021-01-12,5,967,0,972
WEST BENGAL,PURULIA,2021-01-13,15,992,1,1008
WEST BENGAL,PURULIA,2021-01-14,2,755,0,757
WEST BENGAL,PURULIA,2021-01-15,5,323,0,328
ANDAMAN AND NICOBAR ISLANDS,NICOBARS,2021-01-06,0,27,0,27
ANDAMAN AND NICOBAR ISLANDS,NICOBARS,2021-01-07,0,18,0,18
ANDAMAN AND NICOBAR ISLANDS,NICOBARS,2021-01-08,0,8,0,8
ANDAMAN AND NICOBAR ISLANDS,NICOBARS,2021-01-09,0,113,0,113
ANDAMAN AND NICOBAR ISLANDS,NICOBARS,2021-01-10,0,11,0,11
ANDAMAN AND NICOBAR ISLANDS,NORTH AND MIDDLE ANDAMAN,2021-01-06,0,10,0,10
ANDAMAN AND NICOBAR ISLANDS,NORTH AND MIDDLE ANDAMAN,2021-01-07,0,9,0,9
ANDAMAN AND NICOBAR ISLANDS,NORTH AND MIDDLE ANDAMAN,2021-01-08,1,11,0,12
ANDAMAN AND NICOBAR ISLANDS,NORTH AND MIDDLE ANDAMAN,2021-01-09,0,13,0,13
ANDAMAN AND NICOBAR ISLANDS,NORTH AND MIDDLE ANDAMAN,2021-01-10,0,7,0,7
ANDAMAN AND NICOBAR ISLANDS,SOUTH ANDAMANS,2021-01-06,1,1010,0,1011
ANDAMAN AND NICOBAR ISLANDS,SOUTH ANDAMANS,2021-01-07,0,401,0,401
ANDAMAN AND NICOBAR ISLANDS,SOUTH ANDAMANS,2021-01-08,19,440,3,462
ANDAMAN AND NICOBAR ISLANDS,SOUTH ANDAMANS,2021-01-09,12,350,0,362
ANDAMAN AND NICOBAR ISLANDS,SOUTH ANDAMANS,2021-01-10,1,538,0,539
ANDHRA PRADESH,ANANTAPUR,2021-01-06,27,3755,0,3782
ANDHRA PRADESH,ANANTAPUR,2021-01-07,39,5191,0,5230
ANDHRA PRADESH,ANANTAPUR,2021-01-08,15,4144,1,4160
ANDHRA PRADESH,ANANTAPUR,2021-01-09,18,2784,0,2802
ANDHRA PRADESH,ANANTAPUR,2021-01-10,9,4132,0,4141
ANDHRA PRADESH,CHITTOOR,2021-01-06,43,4857,0,4900
ANDHRA PRADESH,CHITTOOR,2021-01-07,45,3534,0,3579
ANDHRA PRADESH,CHITTOOR,2021-01-08,24,4132,0,4156
ANDHRA PRADESH,CHITTOOR,2021-01-09,34,4374,0,4408
ANDHRA PRADESH,CHITTOOR,2021-01-10,22,2627,0,2649
ANDHRA PRADESH,EAST GODAVARI,2021-01-06,27,5424,0,5451
ANDHRA PRADESH,EAST GODAVARI,2021-01-07,35,4573,0,4608
ANDHRA PRADESH,EAST GODAVARI,2021-01-08,24,3554,0,3578
ANDHRA PRADESH,EAST GODAVARI,2021-01-09,19,1537,0,1556
ANDHRA PRADESH,EAST GODAVARI,2021-01-10,23,2800,0,2823
ANDHRA PRADESH,GUNTUR,2021-01-06,35,6185,0,6220
ANDHRA PRADESH,GUNTUR,2021-01-07,41,4986,0,5027
ANDHRA PRADESH,GUNTUR,2021-01-08,34,5466,1,5501
ANDHRA PRADESH,GUNTUR,2021-01-09,53,4595,0,4648
ANDHRA PRADESH,GUNTUR,2021-01-10,12,536,0,548
ANDHRA PRADESH,KRISHNA,2021-01-06,57,4477,0,4534
ANDHRA PRADESH,KRISHNA,2021-01-07,58,4787,0,4845
ANDHRA PRADESH,KRISHNA,2021-01-08,37,5844,0,5881
ANDHRA PRADESH,KRISHNA,2021-01-09,55,1549,0,1604
ANDHRA PRADESH,KRISHNA,2021-01-10,21,4643,0,4664
ANDHRA PRADESH,KURNOOL,2021-01-06,20,5158,0,5178
ANDHRA PRADESH,KURNOOL,2021-01-07,28,5001,1,5030
ANDHRA PRADESH,KURNOOL,2021-01-08,23,4054,0,4077
ANDHRA PRADESH,KURNOOL,2021-01-09,31,3093,0,3124
ANDHRA PRADESH,KURNOOL,2021-01-10,8,1040,0,1048
ANDHRA PRADESH,PRAKASAM,2021-01-06,7,1958,0,1965
ANDHRA PRADESH,PRAKASAM,2021-01-07,18,5096,0,5114
ANDHRA PRADESH,PRAKASAM,2021-01-08,11,4064,0,4075
ANDHRA PRADESH,PRAKASAM,2021-01-09,8,6808,0,6816
ANDHRA PRADESH,PRAKASAM,2021-01-10,4,4142,0,4146
ANDHRA PRADESH,SPSR NELLORE,2021-01-06,22,3422,0,3444
ANDHRA PRADESH,SPSR NELLORE,2021-01-07,30,6643,0,6673
ANDHRA PRADESH,SPSR NELLORE,2021-01-08,10,4246,0,4256
ANDHRA PRADESH,SPSR NELLORE,2021-01-09,11,5441,1,5453
ANDHRA PRADESH,SPSR NELLORE,2021-01-10,7,5840,0,5847
ANDHRA PRADESH,SRIKAKULAM,2021-01-06,10,2676,0,2686
ANDHRA PRADESH,SRIKAKULAM,2021-01-07,13,2779,0,2792
ANDHRA PRADESH,SRIKAKULAM,2021-01-08,9,2228,0,2237
ANDHRA PRADESH,SRIKAKULAM,2021-01-09,6,2323,0,2329
ANDHRA PRADESH,SRIKAKULAM,2021-01-10,2,2043,0,2045
ANDHRA PRADESH,VISAKHAPATANAM,2021-01-06,47,4895,0,4942
ANDHRA PRADESH,VISAKHAPATANAM,2021-01-07,26,5250,0,5276
ANDHRA PRADESH,VISAKHAPATANAM,2021-01-08,53,3787,0,3840
ANDHRA PRADESH,VISAKHAPATANAM,2021-01-09,37,3388,2,3427
ANDHRA PRADESH,VISAKHAPATANAM,2021-01-10,5,3833,0,3838
ANDHRA PRADESH,VIZIANAGARAM,2021-01-06,1,996,0,997
ANDHRA PRADESH,VIZIANAGARAM,2021-01-07,4,1929,0,1933
ANDHRA PRADESH,VIZIANAGARAM,2021-01-08,4,419,0,423
ANDHRA PRADESH,VIZIANAGARAM,2021-01-09,9,365,0,374
ANDHRA PRADESH,VIZIANAGARAM,2021-01-10,1,225,0,226
ANDHRA PRADESH,WEST GODAVARI,2021-01-06,18,3539,0,3557
ANDHRA PRADESH,WEST GODAVARI,2021-01-07,30,2070,0,2100
ANDHRA PRADESH,WEST GODAVARI,2021-01-08,30,1427,1,1458
ANDHRA PRADESH,WEST GODAVARI,2021-01-09,29,3150,0,3179
ANDHRA PRADESH,WEST GODAVARI,2021-01-10,11,1032,0,1043
ANDHRA PRADESH,Y.S.R.,2021-01-06,12,4166,0,4178
ANDHRA PRADESH,Y.S.R.,2021-01-07,16,3347,0,3363
ANDHRA PRADESH,Y.S.R.,2021-01-08,7,3645,0,3652
ANDHRA PRADESH,Y.S.R.,2021-01-09,15,3239,0,3254
ANDHRA PRADESH,Y.S.R.,2021-01-10,8,4035,0,4043
ARUNACHAL PRADESH,ANJAW,2021-01-06,0,3,0,3
ARUNACHAL PRADESH,ANJAW,2021-01-07,0,7,0,7
ARUNACHAL PRADESH,CHANGLANG,2021-01-06,0,1,0,1
ARUNACHAL PRADESH,CHANGLANG,2021-01-07,1,1,0,2
ARUNACHAL PRADESH,CHANGLANG,2021-01-08,0,2,0,2
ARUNACHAL PRADESH,CHANGLANG,2021-01-09,0,2,0,2
ARUNACHAL PRADESH,CHANGLANG,2021-01-10,0,1,0,1
ARUNACHAL PRADESH,DIBANG VALLEY,2021-01-06,0,1,0,1
ARUNACHAL PRADESH,DIBANG VALLEY,2021-01-08,0,1,0,1
ARUNACHAL PRADESH,DIBANG VALLEY,2021-01-09,0,2,0,2
ARUNACHAL PRADESH,EAST KAMENG,2021-01-08,0,1,0,1
ARUNACHAL PRADESH,EAST SIANG,2021-01-06,5,41,0,46
ARUNACHAL PRADESH,EAST SIANG,2021-01-07,2,25,0,27
ARUNACHAL PRADESH,EAST SIANG,2021-01-08,3,59,0,62
ARUNACHAL PRADESH,EAST SIANG,2021-01-09,0,21,0,21
ARUNACHAL PRADESH,KAMLE,2021-01-06,0,1,0,1
ARUNACHAL PRADESH,KAMLE,2021-01-10,0,25,0,25
ARUNACHAL PRADESH,KRA  DAADI,2021-01-06,0,1,0,1
ARUNACHAL PRADESH,KURUNG KUMEY,2021-01-06,0,1,0,1
ARUNACHAL PRADESH,LEPARADA,2021-01-07,0,1,0,1
ARUNACHAL PRADESH,LEPARADA,2021-01-09,0,1,0,1
ARUNACHAL PRADESH,LOHIT,2021-01-06,0,1,0,1
ARUNACHAL PRADESH,LOHIT,2021-01-07,0,3,0,3
ARUNACHAL PRADESH,LOHIT,2021-01-08,0,1,0,1
ARUNACHAL PRADESH,LOHIT,2021-01-09,3,26,0,29
ARUNACHAL PRADESH,LOHIT,2021-01-10,0,2,0,2
ARUNACHAL PRADESH,LONGDING,2021-01-08,0,2,0,2
ARUNACHAL PRADESH,LOWER DIBANG VALLEY,2021-01-06,0,35,0,35
ARUNACHAL PRADESH,LOWER DIBANG VALLEY,2021-01-07,0,43,0,43
ARUNACHAL PRADESH,LOWER DIBANG VALLEY,2021-01-08,0,24,0,24
ARUNACHAL PRADESH,LOWER SIANG,2021-01-08,0,29,0,29
ARUNACHAL PRADESH,LOWER SIANG,2021-01-09,0,24,0,24
ARUNACHAL PRADESH,LOWER SIANG,2021-01-10,1,7,0,8
ARUNACHAL PRADESH,LOWER SUBANSIRI,2021-01-06,0,50,0,50
ARUNACHAL PRADESH,LOWER SUBANSIRI,2021-01-07,0,60,0,60
ARUNACHAL PRADESH,LOWER SUBANSIRI,2021-01-08,0,47,0,47
ARUNACHAL PRADESH,LOWER SUBANSIRI,2021-01-09,0,2,0,2
ARUNACHAL PRADESH,LOWER SUBANSIRI,2021-01-10,0,1,0,1
ARUNACHAL PRADESH,NAMSAI,2021-01-06,0,3,0,3
ARUNACHAL PRADESH,NAMSAI,2021-01-08,0,4,0,4
ARUNACHAL PRADESH,NAMSAI,2021-01-09,0,3,0,3
ARUNACHAL PRADESH,PAKKE KESSANG,2021-01-09,2,0,0,2
ARUNACHAL PRADESH,PAPUM PARE,2021-01-06,0,27,0,27
ARUNACHAL PRADESH,PAPUM PARE,2021-01-07,0,28,0,28
ARUNACHAL PRADESH,PAPUM PARE,2021-01-08,0,37,0,37
ARUNACHAL PRADESH,PAPUM PARE,2021-01-09,2,33,0,35
ARUNACHAL PRADESH,PAPUM PARE,2021-01-10,0,1,0,1
ARUNACHAL PRADESH,SHI YOMI,2021-01-10,0,1,0,1
ARUNACHAL PRADESH,SIANG,2021-01-06,0,37,0,37
ARUNACHAL PRADESH,SIANG,2021-01-08,0,2,0,2
ARUNACHAL PRADESH,TAWANG,2021-01-06,1,35,0,36
ARUNACHAL PRADESH,TAWANG,2021-01-07,0,59,0,59
ARUNACHAL PRADESH,TAWANG,2021-01-08,0,32,0,32
ARUNACHAL PRADESH,TAWANG,2021-01-09,1,19,0,20
ARUNACHAL PRADESH,TAWANG,2021-01-10,0,69,0,69
ARUNACHAL PRADESH,TIRAP,2021-01-06,14,1,0,15
ARUNACHAL PRADESH,TIRAP,2021-01-07,0,2,0,2
ARUNACHAL PRADESH,TIRAP,2021-01-08,0,1,0,1
ARUNACHAL PRADESH,TIRAP,2021-01-10,0,1,0,1
ARUNACHAL PRADESH,UPPER SIANG,2021-01-08,1,0,0,1
ARUNACHAL PRADESH,UPPER SIANG,2021-01-09,0,1,0,1
ARUNACHAL PRADESH,UPPER SUBANSIRI,2021-01-06,0,1,0,1
ARUNACHAL PRADESH,UPPER SUBANSIRI,2021-01-08,0,2,0,2
ARUNACHAL PRADESH,UPPER SUBANSIRI,2021-01-10,0,1,0,1
ARUNACHAL PRADESH,WEST KAMENG,2021-01-06,0,172,0,172
ARUNACHAL PRADESH,WEST KAMENG,2021-01-07,1,110,0,111
ARUNACHAL PRADESH,WEST KAMENG,2021-01-08,0,59,0,59
ARUNACHAL PRADESH,WEST KAMENG,2021-01-09,0,153,0,153
ARUNACHAL PRADESH,WEST KAMENG,2021-01-10,0,80,0,80
ARUNACHAL PRADESH,WEST SIANG,2021-01-06,0,1,0,1
ARUNACHAL PRADESH,WEST SIANG,2021-01-07,0,1,0,1
ASSAM,BAKSA,2021-01-06,0,146,0,146
ASSAM,BAKSA,2021-01-07,0,71,0,71
ASSAM,BAKSA,2021-01-08,1,98,0,99
ASSAM,BAKSA,2021-01-09,0,74,0,74
ASSAM,BAKSA,2021-01-10,0,10,0,10
ASSAM,BARPETA,2021-01-06,0,258,0,258
ASSAM,BARPETA,2021-01-07,1,154,0,155
ASSAM,BARPETA,2021-01-08,2,191,0,193
ASSAM,BARPETA,2021-01-09,1,121,0,122
ASSAM,BARPETA,2021-01-10,1,62,0,63
ASSAM,BISWANATH,2021-01-06,2,147,0,149
ASSAM,BISWANATH,2021-01-07,1,166,0,167
ASSAM,BISWANATH,2021-01-08,0,159,0,159
ASSAM,BISWANATH,2021-01-09,0,79,0,79
ASSAM,BISWANATH,2021-01-10,0,9,0,9
ASSAM,BONGAIGAON,2021-01-06,0,579,0,579
ASSAM,BONGAIGAON,2021-01-07,1,545,0,546
ASSAM,BONGAIGAON,2021-01-08,0,440,0,440
ASSAM,BONGAIGAON,2021-01-09,2,338,0,340
ASSAM,BONGAIGAON,2021-01-10,0,95,0,95
ASSAM,CACHAR,2021-01-06,4,259,4,267
ASSAM,CACHAR,2021-01-07,1,236,8,245
ASSAM,CACHAR,2021-01-08,8,291,15,314
ASSAM,CACHAR,2021-01-09,4,103,4,111
ASSAM,CACHAR,2021-01-10,2,67,0,69
ASSAM,CHARAIDEO,2021-01-06,0,246,1,247
ASSAM,CHARAIDEO,2021-01-07,0,169,0,169
ASSAM,CHARAIDEO,2021-01-08,0,201,0,201
ASSAM,CHARAIDEO,2021-01-09,0,189,0,189
ASSAM,CHARAIDEO,2021-01-10,0,91,0,91
ASSAM,CHIRANG,2021-01-06,0,60,0,60
ASSAM,CHIRANG,2021-01-07,0,162,0,162
ASSAM,CHIRANG,2021-01-08,0,71,0,71
ASSAM,CHIRANG,2021-01-09,0,35,0,35
ASSAM,CHIRANG,2021-01-10,0,30,0,30
ASSAM,DARRANG,2021-01-06,0,410,0,410
ASSAM,DARRANG,2021-01-07,0,374,0,374
ASSAM,DARRANG,2021-01-08,1,333,0,334
ASSAM,DARRANG,2021-01-09,2,237,0,239
ASSAM,DARRANG,2021-01-10,0,87,0,87
ASSAM,DHEMAJI,2021-01-06,0,68,1,69
ASSAM,DHEMAJI,2021-01-07,0,85,0,85
ASSAM,DHEMAJI,2021-01-08,0,67,0,67
ASSAM,DHEMAJI,2021-01-09,0,62,0,62
ASSAM,DHEMAJI,2021-01-10,0,36,0,36
ASSAM,DHUBRI,2021-01-06,0,490,1,491
ASSAM,DHUBRI,2021-01-07,1,307,5,313
ASSAM,DHUBRI,2021-01-08,0,383,0,383
ASSAM,DHUBRI,2021-01-09,0,312,0,312
ASSAM,DHUBRI,2021-01-10,0,26,0,26
ASSAM,DIBRUGARH,2021-01-06,2,704,1,707
ASSAM,DIBRUGARH,2021-01-07,3,745,2,750
ASSAM,DIBRUGARH,2021-01-08,5,391,0,396
ASSAM,DIBRUGARH,2021-01-09,3,566,0,569
ASSAM,DIBRUGARH,2021-01-10,1,596,17,614
ASSAM,DIMA HASAO,2021-01-06,1,60,0,61
ASSAM,DIMA HASAO,2021-01-07,0,34,0,34
ASSAM,DIMA HASAO,2021-01-08,0,59,0,59
ASSAM,DIMA HASAO,2021-01-09,0,103,0,103
ASSAM,DIMA HASAO,2021-01-10,0,11,0,11
ASSAM,GOALPARA,2021-01-06,0,563,0,563
ASSAM,GOALPARA,2021-01-07,2,595,0,597
ASSAM,GOALPARA,2021-01-08,2,632,0,634
ASSAM,GOALPARA,2021-01-09,1,522,0,523
ASSAM,GOALPARA,2021-01-10,0,165,0,165
ASSAM,GOLAGHAT,2021-01-06,27,431,1,459
ASSAM,GOLAGHAT,2021-01-07,20,319,0,339
ASSAM,GOLAGHAT,2021-01-08,29,424,0,453
ASSAM,GOLAGHAT,2021-01-09,1,225,0,226
ASSAM,GOLAGHAT,2021-01-10,1,16,0,17
ASSAM,HAILAKANDI,2021-01-06,2,489,1,492
ASSAM,HAILAKANDI,2021-01-07,2,509,7,518
ASSAM,HAILAKANDI,2021-01-08,2,428,1,431
ASSAM,HAILAKANDI,2021-01-09,0,409,11,420
ASSAM,HAILAKANDI,2021-01-10,0,54,0,54
ASSAM,HOJAI,2021-01-06,1,185,0,186
ASSAM,HOJAI,2021-01-07,0,139,0,139
ASSAM,HOJAI,2021-01-08,0,144,0,144
ASSAM,HOJAI,2021-01-09,0,97,0,97
ASSAM,HOJAI,2021-01-10,0,22,0,22
ASSAM,JORHAT,2021-01-06,3,709,19,731
ASSAM,JORHAT,2021-01-07,3,588,0,591
ASSAM,JORHAT,2021-01-08,1,453,1,455
ASSAM,JORHAT,2021-01-09,5,404,0,409
ASSAM,JORHAT,2021-01-10,3,266,0,269
ASSAM,KAMRUP,2021-01-06,4,942,0,946
ASSAM,KAMRUP,2021-01-07,1,690,0,691
ASSAM,KAMRUP,2021-01-08,2,799,0,801
ASSAM,KAMRUP,2021-01-09,3,534,0,537
ASSAM,KAMRUP,2021-01-10,2,195,0,197
ASSAM,KAMRUP METRO,2021-01-06,39,3547,5,3591
ASSAM,KAMRUP METRO,2021-01-07,30,3394,0,3424
ASSAM,KAMRUP METRO,2021-01-08,20,3464,1,3485
ASSAM,KAMRUP METRO,2021-01-09,14,2741,0,2755
ASSAM,KAMRUP METRO,2021-01-10,17,2395,0,2412
ASSAM,KARBI ANGLONG,2021-01-06,0,87,0,87
ASSAM,KARBI ANGLONG,2021-01-07,0,51,0,51
ASSAM,KARBI ANGLONG,2021-01-08,7,146,0,153
ASSAM,KARBI ANGLONG,2021-01-09,1,51,0,52
ASSAM,KARBI ANGLONG,2021-01-10,0,1,0,1
ASSAM,KARIMGANJ,2021-01-06,8,533,1,542
ASSAM,KARIMGANJ,2021-01-07,8,396,0,404
ASSAM,KARIMGANJ,2021-01-08,14,525,1,540
ASSAM,KARIMGANJ,2021-01-09,1,200,0,201
ASSAM,KARIMGANJ,2021-01-10,1,99,0,100
ASSAM,KOKRAJHAR,2021-01-06,1,78,0,79
ASSAM,KOKRAJHAR,2021-01-07,0,110,0,110
ASSAM,KOKRAJHAR,2021-01-08,1,81,0,82
ASSAM,KOKRAJHAR,2021-01-09,1,63,0,64
ASSAM,KOKRAJHAR,2021-01-10,0,18,0,18
ASSAM,LAKHIMPUR,2021-01-06,0,411,1,412
ASSAM,LAKHIMPUR,2021-01-07,0,419,0,419
ASSAM,LAKHIMPUR,2021-01-08,0,405,0,405
ASSAM,LAKHIMPUR,2021-01-09,0,207,0,207
ASSAM,LAKHIMPUR,2021-01-10,1,88,0,89
ASSAM,MAJULI,2021-01-06,0,76,0,76
ASSAM,MAJULI,2021-01-07,0,71,0,71
ASSAM,MAJULI,2021-01-08,0,29,0,29
ASSAM,MAJULI,2021-01-09,0,4,0,4
ASSAM,MAJULI,2021-01-10,0,7,0,7
ASSAM,MARIGAON,2021-01-06,0,102,0,102
ASSAM,MARIGAON,2021-01-07,4,111,0,115
ASSAM,MARIGAON,2021-01-08,0,40,0,40
ASSAM,MARIGAON,2021-01-09,0,81,0,81
ASSAM,MARIGAON,2021-01-10,0,10,0,10
ASSAM,NAGAON,2021-01-06,0,1253,2,1255
ASSAM,NAGAON,2021-01-07,2,824,0,826
ASSAM,NAGAON,2021-01-08,0,692,0,692
ASSAM,NAGAON,2021-01-09,0,515,0,515
ASSAM,NAGAON,2021-01-10,0,176,0,176
ASSAM,NALBARI,2021-01-06,0,129,0,129
ASSAM,NALBARI,2021-01-07,0,43,0,43
ASSAM,NALBARI,2021-01-08,0,80,0,80
ASSAM,NALBARI,2021-01-09,0,74,0,74
ASSAM,NALBARI,2021-01-10,1,10,0,11
ASSAM,SIVASAGAR,2021-01-06,0,222,0,222
ASSAM,SIVASAGAR,2021-01-07,1,189,0,190
ASSAM,SIVASAGAR,2021-01-08,1,287,0,288
ASSAM,SIVASAGAR,2021-01-09,1,130,0,131
ASSAM,SIVASAGAR,2021-01-10,0,57,0,57
ASSAM,SONITPUR,2021-01-06,1,360,0,361
ASSAM,SONITPUR,2021-01-07,4,349,0,353
ASSAM,SONITPUR,2021-01-08,1,436,0,437
ASSAM,SONITPUR,2021-01-09,2,379,0,381
ASSAM,SONITPUR,2021-01-10,0,219,0,219
ASSAM,SOUTH SALMARA MANCACHAR,2021-01-06,0,112,0,112
ASSAM,SOUTH SALMARA MANCACHAR,2021-01-07,0,102,0,102
ASSAM,SOUTH SALMARA MANCACHAR,2021-01-08,0,65,0,65
ASSAM,SOUTH SALMARA MANCACHAR,2021-01-09,0,58,0,58
ASSAM,SOUTH SALMARA MANCACHAR,2021-01-10,1,17,0,18
ASSAM,TINSUKIA,2021-01-06,0,561,0,561
ASSAM,TINSUKIA,2021-01-07,1,362,0,363
ASSAM,TINSUKIA,2021-01-08,6,142,0,148
ASSAM,TINSUKIA,2021-01-09,3,144,0,147
ASSAM,TINSUKIA,2021-01-10,0,420,10,430
ASSAM,UDALGURI,2021-01-06,2,32,0,34
ASSAM,UDALGURI,2021-01-07,0,30,0,30
ASSAM,UDALGURI,2021-01-08,0,16,0,16
ASSAM,UDALGURI,2021-01-09,1,55,0,56
ASSAM,UDALGURI,2021-01-10,0,1,0,1
ASSAM,WEST KARBI ANGLONG,2021-01-06,0,16,0,16
ASSAM,WEST KARBI ANGLONG,2021-01-07,0,16,0,16
ASSAM,WEST KARBI ANGLONG,2021-01-08,0,28,0,28
ASSAM,WEST KARBI ANGLONG,2021-01-09,1,20,0,21
ASSAM,WEST KARBI ANGLONG,2021-01-10,0,1,0,1
BIHAR,ARARIA,2021-01-06,1,741,0,742
BIHAR,ARARIA,2021-01-07,6,1027,0,1033
BIHAR,ARARIA,2021-01-08,2,556,2,560
BIHAR,ARARIA,2021-01-09,0,757,0,757
BIHAR,ARARIA,2021-01-10,5,57,0,62
BIHAR,ARWAL,2021-01-06,0,1122,2,1124
BIHAR,ARWAL,2021-01-07,9,1378,1,1388
BIHAR,ARWAL,2021-01-08,3,1057,5,1065
BIHAR,ARWAL,2021-01-09,2,1016,18,1036
BIHAR,ARWAL,2021-01-10,0,559,0,559
BIHAR,AURANGABAD,2021-01-06,6,1089,42,1137
BIHAR,AURANGABAD,2021-01-07,0,1090,0,1090
BIHAR,AURANGABAD,2021-01-08,10,1155,178,1343
BIHAR,AURANGABAD,2021-01-09,3,1720,0,1723
BIHAR,AURANGABAD,2021-01-10,5,929,0,934
BIHAR,BANKA,2021-01-06,5,1918,0,1923
BIHAR,BANKA,2021-01-07,2,2514,72,2588
BIHAR,BANKA,2021-01-08,0,2478,91,2569
BIHAR,BANKA,2021-01-09,2,1966,0,1968
BIHAR,BANKA,2021-01-10,6,2029,50,2085
BIHAR,BEGUSARAI,2021-01-06,29,4322,0,4351
BIHAR,BEGUSARAI,2021-01-07,28,4139,0,4167
BIHAR,BEGUSARAI,2021-01-08,16,4874,0,4890
BIHAR,BEGUSARAI,2021-01-09,18,2882,0,2900
BIHAR,BEGUSARAI,2021-01-10,0,2086,1,2087
BIHAR,BHAGALPUR,2021-01-06,8,4346,198,4552
BIHAR,BHAGALPUR,2021-01-07,14,5332,190,5536
BIHAR,BHAGALPUR,2021-01-08,11,3068,68,3147
BIHAR,BHAGALPUR,2021-01-09,7,2827,96,2930
BIHAR,BHAGALPUR,2021-01-10,5,2326,19,2350
BIHAR,BHOJPUR,2021-01-06,8,1604,11,1623
BIHAR,BHOJPUR,2021-01-07,7,2048,94,2149
BIHAR,BHOJPUR,2021-01-08,0,1602,41,1643
BIHAR,BHOJPUR,2021-01-09,7,1947,13,1967
BIHAR,BHOJPUR,2021-01-10,1,1407,20,1428
BIHAR,BUXAR,2021-01-06,3,1645,41,1689
BIHAR,BUXAR,2021-01-07,7,2586,154,2747
BIHAR,BUXAR,2021-01-08,1,2470,118,2589
BIHAR,BUXAR,2021-01-09,8,1786,60,1854
BIHAR,BUXAR,2021-01-10,2,1615,8,1625
BIHAR,DARBHANGA,2021-01-06,8,2166,13,2187
BIHAR,DARBHANGA,2021-01-07,23,1868,23,1914
BIHAR,DARBHANGA,2021-01-08,12,2262,7,2281
BIHAR,DARBHANGA,2021-01-09,13,1487,2,1502
BIHAR,DARBHANGA,2021-01-10,2,1952,9,1963
BIHAR,GAYA,2021-01-06,7,4389,960,5356
BIHAR,GAYA,2021-01-07,6,4838,971,5815
BIHAR,GAYA,2021-01-08,11,4479,588,5078
BIHAR,GAYA,2021-01-09,11,3655,2,3668
BIHAR,GAYA,2021-01-10,1,2012,6,2019
BIHAR,GOPALGANJ,2021-01-06,6,4499,0,4505
BIHAR,GOPALGANJ,2021-01-07,4,2811,13,2828
BIHAR,GOPALGANJ,2021-01-08,19,1420,8,1447
BIHAR,GOPALGANJ,2021-01-09,0,1992,12,2004
BIHAR,GOPALGANJ,2021-01-10,3,1298,1,1302
BIHAR,JAMUI,2021-01-06,0,1443,1,1444
BIHAR,JAMUI,2021-01-07,0,1798,6,1804
BIHAR,JAMUI,2021-01-08,0,965,0,965
BIHAR,JAMUI,2021-01-09,0,1279,0,1279
BIHAR,JAMUI,2021-01-10,0,1102,0,1102
BIHAR,JEHANABAD,2021-01-06,1,1035,0,1036
BIHAR,JEHANABAD,2021-01-07,3,1264,0,1267
BIHAR,JEHANABAD,2021-01-08,7,1043,78,1128
BIHAR,JEHANABAD,2021-01-09,0,1839,29,1868
BIHAR,JEHANABAD,2021-01-10,9,984,60,1053
BIHAR,KAIMUR (BHABUA),2021-01-06,16,1367,2,1385
BIHAR,KAIMUR (BHABUA),2021-01-07,5,2465,0,2470
BIHAR,KAIMUR (BHABUA),2021-01-08,11,3768,0,3779
BIHAR,KAIMUR (BHABUA),2021-01-09,0,2952,0,2952
BIHAR,KAIMUR (BHABUA),2021-01-10,0,2047,0,2047
BIHAR,KATIHAR,2021-01-06,2,1436,1,1439
BIHAR,KATIHAR,2021-01-07,2,835,0,837
BIHAR,KATIHAR,2021-01-08,6,1014,0,1020
BIHAR,KATIHAR,2021-01-09,3,744,0,747
BIHAR,KATIHAR,2021-01-10,0,421,0,421
BIHAR,KHAGARIA,2021-01-06,0,987,0,987
BIHAR,KHAGARIA,2021-01-07,7,1356,0,1363
BIHAR,KHAGARIA,2021-01-08,6,825,0,831
BIHAR,KHAGARIA,2021-01-09,1,610,1,612
BIHAR,KHAGARIA,2021-01-10,1,1318,0,1319
BIHAR,KISHANGANJ,2021-01-06,10,1070,0,1080
BIHAR,KISHANGANJ,2021-01-07,3,1399,3,1405
BIHAR,KISHANGANJ,2021-01-08,3,1119,7,1129
BIHAR,KISHANGANJ,2021-01-09,2,767,0,769
BIHAR,KISHANGANJ,2021-01-10,2,580,0,582
BIHAR,LAKHISARAI,2021-01-06,1,1262,0,1263
BIHAR,LAKHISARAI,2021-01-07,1,1641,0,1642
BIHAR,LAKHISARAI,2021-01-08,11,1858,0,1869
BIHAR,LAKHISARAI,2021-01-09,5,2731,0,2736
BIHAR,LAKHISARAI,2021-01-10,0,804,0,804
BIHAR,MADHEPURA,2021-01-06,0,2983,0,2983
BIHAR,MADHEPURA,2021-01-07,2,2193,0,2195
BIHAR,MADHEPURA,2021-01-08,2,2685,0,2687
BIHAR,MADHEPURA,2021-01-09,1,2544,0,2545
BIHAR,MADHEPURA,2021-01-10,2,2416,0,2418
BIHAR,MADHUBANI,2021-01-06,9,1980,2,1991
BIHAR,MADHUBANI,2021-01-07,2,2471,0,2473
BIHAR,MADHUBANI,2021-01-08,11,1988,12,2011
BIHAR,MADHUBANI,2021-01-09,11,2291,10,2312
BIHAR,MADHUBANI,2021-01-10,0,876,1,877
BIHAR,MUNGER,2021-01-06,2,1198,14,1214
BIHAR,MUNGER,2021-01-07,28,1313,0,1341
BIHAR,MUNGER,2021-01-08,1,1717,8,1726
BIHAR,MUNGER,2021-01-09,0,1488,0,1488
BIHAR,MUNGER,2021-01-10,4,1094,1,1099
BIHAR,MUZAFFARPUR,2021-01-06,21,4154,2,4177
BIHAR,MUZAFFARPUR,2021-01-07,19,6165,1,6185
BIHAR,MUZAFFARPUR,2021-01-08,11,3018,0,3029
BIHAR,MUZAFFARPUR,2021-01-09,8,4432,2,4442
BIHAR,MUZAFFARPUR,2021-01-10,1,3054,1,3056
BIHAR,NALANDA,2021-01-06,14,4007,2,4023
BIHAR,NALANDA,2021-01-07,7,3468,4,3479
BIHAR,NALANDA,2021-01-08,14,3188,1,3203
BIHAR,NALANDA,2021-01-09,8,3672,1,3681
BIHAR,NALANDA,2021-01-10,3,3000,251,3254
BIHAR,NAWADA,2021-01-06,1,920,0,921
BIHAR,NAWADA,2021-01-07,0,1716,0,1716
BIHAR,NAWADA,2021-01-08,2,1665,0,1667
BIHAR,NAWADA,2021-01-09,0,1712,0,1712
BIHAR,NAWADA,2021-01-10,3,1766,0,1769
BIHAR,PASHCHIM CHAMPARAN,2021-01-06,3,1893,1,1897
BIHAR,PASHCHIM CHAMPARAN,2021-01-07,0,2368,1,2369
BIHAR,PASHCHIM CHAMPARAN,2021-01-08,3,1152,0,1155
BIHAR,PASHCHIM CHAMPARAN,2021-01-09,3,3107,165,3275
BIHAR,PASHCHIM CHAMPARAN,2021-01-10,3,2384,0,2387
BIHAR,PATNA,2021-01-06,203,5881,4,6088
BIHAR,PATNA,2021-01-07,246,6362,36,6644
BIHAR,PATNA,2021-01-08,286,5156,12,5454
BIHAR,PATNA,2021-01-09,195,5931,13,6139
BIHAR,PATNA,2021-01-10,136,4750,7,4893
BIHAR,PURBI CHAMPARAN,2021-01-06,3,4097,1,4101
BIHAR,PURBI CHAMPARAN,2021-01-07,3,3359,1,3363
BIHAR,PURBI CHAMPARAN,2021-01-08,8,3446,1,3455
BIHAR,PURBI CHAMPARAN,2021-01-09,3,2426,1,2430
BIHAR,PURBI CHAMPARAN,2021-01-10,10,2597,8,2615
BIHAR,PURNIA,2021-01-06,3,2224,32,2259
BIHAR,PURNIA,2021-01-07,12,2025,22,2059
BIHAR,PURNIA,2021-01-08,22,1631,99,1752
BIHAR,PURNIA,2021-01-09,1,958,0,959
BIHAR,PURNIA,2021-01-10,3,457,26,486
BIHAR,ROHTAS,2021-01-06,5,2830,1,2836
BIHAR,ROHTAS,2021-01-07,3,2119,0,2122
BIHAR,ROHTAS,2021-01-08,18,2928,0,2946
BIHAR,ROHTAS,2021-01-09,13,1681,0,1694
BIHAR,ROHTAS,2021-01-10,3,1355,0,1358
BIHAR,SAHARSA,2021-01-06,7,1106,2,1115
BIHAR,SAHARSA,2021-01-07,1,1233,0,1234
BIHAR,SAHARSA,2021-01-08,4,1601,1,1606
BIHAR,SAHARSA,2021-01-09,19,625,1,645
BIHAR,SAHARSA,2021-01-10,0,518,0,518
BIHAR,SAMASTIPUR,2021-01-06,4,2831,67,2902
BIHAR,SAMASTIPUR,2021-01-07,4,3010,45,3059
BIHAR,SAMASTIPUR,2021-01-08,5,3328,141,3474
BIHAR,SAMASTIPUR,2021-01-09,6,4175,122,4303
BIHAR,SAMASTIPUR,2021-01-10,4,3100,79,3183
BIHAR,SARAN,2021-01-06,1,2826,0,2827
BIHAR,SARAN,2021-01-07,9,3843,1,3853
BIHAR,SARAN,2021-01-08,4,3538,3,3545
BIHAR,SARAN,2021-01-09,8,3418,3,3429
BIHAR,SARAN,2021-01-10,16,1853,0,1869
BIHAR,SHEIKHPURA,2021-01-06,0,859,13,872
BIHAR,SHEIKHPURA,2021-01-07,1,418,3,422
BIHAR,SHEIKHPURA,2021-01-08,2,521,8,531
BIHAR,SHEIKHPURA,2021-01-09,0,770,0,770
BIHAR,SHEIKHPURA,2021-01-10,0,36,0,36
BIHAR,SHEOHAR,2021-01-06,6,762,0,768
BIHAR,SHEOHAR,2021-01-07,7,928,0,935
BIHAR,SHEOHAR,2021-01-08,7,790,1,798
BIHAR,SHEOHAR,2021-01-09,0,684,0,684
BIHAR,SHEOHAR,2021-01-10,5,613,0,618
BIHAR,SITAMARHI,2021-01-06,5,1852,0,1857
BIHAR,SITAMARHI,2021-01-07,5,2037,35,2077
BIHAR,SITAMARHI,2021-01-08,4,2912,0,2916
BIHAR,SITAMARHI,2021-01-09,2,2595,0,2597
BIHAR,SITAMARHI,2021-01-10,0,3055,43,3098
BIHAR,SIWAN,2021-01-06,2,2530,0,2532
BIHAR,SIWAN,2021-01-07,4,2320,0,2324
BIHAR,SIWAN,2021-01-08,11,2691,0,2702
BIHAR,SIWAN,2021-01-09,8,2433,0,2441
BIHAR,SIWAN,2021-01-10,7,1719,5,1731
BIHAR,SUPAUL,2021-01-06,0,2509,158,2667
BIHAR,SUPAUL,2021-01-07,1,1693,6,1700
BIHAR,SUPAUL,2021-01-08,2,1700,2,1704
BIHAR,SUPAUL,2021-01-09,0,1729,1,1730
BIHAR,SUPAUL,2021-01-10,6,1506,83,1595
BIHAR,VAISHALI,2021-01-06,1,4152,0,4153
BIHAR,VAISHALI,2021-01-07,11,3270,0,3281
BIHAR,VAISHALI,2021-01-08,15,3664,0,3679
BIHAR,VAISHALI,2021-01-09,6,4670,0,4676
BIHAR,VAISHALI,2021-01-10,2,1915,0,1917
CHANDIGARH,CHANDIGARH,2021-01-06,156,1344,34,1534
CHANDIGARH,CHANDIGARH,2021-01-07,60,1342,72,1474
CHANDIGARH,CHANDIGARH,2021-01-08,60,1229,23,1312
CHANDIGARH,CHANDIGARH,2021-01-09,73,1048,9,1130
CHANDIGARH,CHANDIGARH,2021-01-10,48,448,7,503
CHHATTISGARH,BALOD,2021-01-06,50,1063,2,1115
CHHATTISGARH,BALOD,2021-01-07,46,1067,0,1113
CHHATTISGARH,BALOD,2021-01-08,31,1036,1,1068
CHHATTISGARH,BALOD,2021-01-09,40,981,0,1021
CHHATTISGARH,BALOD,2021-01-10,31,830,0,861
CHHATTISGARH,BALODA BAZAR,2021-01-06,26,660,53,739
CHHATTISGARH,BALODA BAZAR,2021-01-07,26,508,37,571
CHHATTISGARH,BALODA BAZAR,2021-01-08,28,489,15,532
CHHATTISGARH,BALODA BAZAR,2021-01-09,27,612,1,640
CHHATTISGARH,BALODA BAZAR,2021-01-10,19,138,5,162
CHHATTISGARH,BALRAMPUR,2021-01-06,17,447,0,464
CHHATTISGARH,BALRAMPUR,2021-01-07,12,545,0,557
CHHATTISGARH,BALRAMPUR,2021-01-08,7,703,2,712
CHHATTISGARH,BALRAMPUR,2021-01-09,6,371,0,377
CHHATTISGARH,BALRAMPUR,2021-01-10,5,330,0,335
CHHATTISGARH,BASTAR,2021-01-06,7,1461,0,1468
CHHATTISGARH,BASTAR,2021-01-07,4,1589,0,1593
CHHATTISGARH,BASTAR,2021-01-08,8,1131,0,1139
CHHATTISGARH,BASTAR,2021-01-09,8,1340,0,1348
CHHATTISGARH,BASTAR,2021-01-10,4,553,0,557
CHHATTISGARH,BEMETARA,2021-01-06,16,416,0,432
CHHATTISGARH,BEMETARA,2021-01-07,31,529,0,560
CHHATTISGARH,BEMETARA,2021-01-08,13,550,0,563
CHHATTISGARH,BEMETARA,2021-01-09,10,619,0,629
CHHATTISGARH,BEMETARA,2021-01-10,17,436,2,455
CHHATTISGARH,BIJAPUR,2021-01-06,3,478,0,481
CHHATTISGARH,BIJAPUR,2021-01-07,2,340,0,342
CHHATTISGARH,BIJAPUR,2021-01-08,0,318,0,318
CHHATTISGARH,BIJAPUR,2021-01-09,0,141,0,141
CHHATTISGARH,BIJAPUR,2021-01-10,2,289,0,291
CHHATTISGARH,BILASPUR,2021-01-06,126,1320,10,1456
CHHATTISGARH,BILASPUR,2021-01-07,83,842,4,929
CHHATTISGARH,BILASPUR,2021-01-08,96,1243,15,1354
CHHATTISGARH,BILASPUR,2021-01-09,122,1215,4,1341
CHHATTISGARH,BILASPUR,2021-01-10,59,872,21,952
CHHATTISGARH,DANTEWADA,2021-01-06,9,253,0,262
CHHATTISGARH,DANTEWADA,2021-01-07,8,363,0,371
CHHATTISGARH,DANTEWADA,2021-01-08,5,384,0,389
CHHATTISGARH,DANTEWADA,2021-01-09,9,334,0,343
CHHATTISGARH,DANTEWADA,2021-01-10,0,311,0,311
CHHATTISGARH,DHAMTARI,2021-01-06,52,801,11,864
CHHATTISGARH,DHAMTARI,2021-01-07,33,758,7,798
CHHATTISGARH,DHAMTARI,2021-01-08,29,836,17,882
CHHATTISGARH,DHAMTARI,2021-01-09,44,806,13,863
CHHATTISGARH,DHAMTARI,2021-01-10,22,180,15,217
CHHATTISGARH,DURG,2021-01-06,144,1302,3,1449
CHHATTISGARH,DURG,2021-01-07,126,1263,1,1390
CHHATTISGARH,DURG,2021-01-08,122,1509,1,1632
CHHATTISGARH,DURG,2021-01-09,139,1289,3,1431
CHHATTISGARH,DURG,2021-01-10,120,1154,1,1275
CHHATTISGARH,GARIYABAND,2021-01-06,4,160,1,165
CHHATTISGARH,GARIYABAND,2021-01-07,13,614,1,628
CHHATTISGARH,GARIYABAND,2021-01-08,14,520,0,534
CHHATTISGARH,GARIYABAND,2021-01-09,11,471,6,488
CHHATTISGARH,GARIYABAND,2021-01-10,3,256,15,274
CHHATTISGARH,GAURELLA PENDRA MARWAHI,2021-01-06,9,353,2,364
CHHATTISGARH,GAURELLA PENDRA MARWAHI,2021-01-07,8,169,0,177
CHHATTISGARH,GAURELLA PENDRA MARWAHI,2021-01-08,1,258,0,259
CHHATTISGARH,GAURELLA PENDRA MARWAHI,2021-01-09,7,54,0,61
CHHATTISGARH,GAURELLA PENDRA MARWAHI,2021-01-10,11,42,0,53
CHHATTISGARH,JANJGIR CHAMPA,2021-01-06,45,1750,9,1804
CHHATTISGARH,JANJGIR CHAMPA,2021-01-07,59,1631,0,1690
CHHATTISGARH,JANJGIR CHAMPA,2021-01-08,63,2075,5,2143
CHHATTISGARH,JANJGIR CHAMPA,2021-01-09,62,1355,2,1419
CHHATTISGARH,JANJGIR CHAMPA,2021-01-10,23,960,0,983
CHHATTISGARH,JASHPUR,2021-01-06,28,562,0,590
CHHATTISGARH,JASHPUR,2021-01-07,33,400,3,436
CHHATTISGARH,JASHPUR,2021-01-08,29,697,3,729
CHHATTISGARH,JASHPUR,2021-01-09,50,572,5,627
CHHATTISGARH,JASHPUR,2021-01-10,16,254,3,273
CHHATTISGARH,KABIRDHAM,2021-01-06,7,704,0,711
CHHATTISGARH,KABIRDHAM,2021-01-07,20,714,0,734
CHHATTISGARH,KABIRDHAM,2021-01-08,2,439,0,441
CHHATTISGARH,KABIRDHAM,2021-01-09,10,730,0,740
CHHATTISGARH,KABIRDHAM,2021-01-10,15,300,1,316
CHHATTISGARH,KANKER,2021-01-06,12,691,0,703
CHHATTISGARH,KANKER,2021-01-07,25,778,0,803
CHHATTISGARH,KANKER,2021-01-08,12,752,0,764
CHHATTISGARH,KANKER,2021-01-09,26,570,0,596
CHHATTISGARH,KANKER,2021-01-10,2,442,0,444
CHHATTISGARH,KONDAGAON,2021-01-06,12,662,14,688
CHHATTISGARH,KONDAGAON,2021-01-07,7,790,8,805
CHHATTISGARH,KONDAGAON,2021-01-08,11,505,1,517
CHHATTISGARH,KONDAGAON,2021-01-09,13,576,22,611
CHHATTISGARH,KONDAGAON,2021-01-10,14,238,9,261
CHHATTISGARH,KORBA,2021-01-06,48,1199,2,1249
CHHATTISGARH,KORBA,2021-01-07,41,1725,0,1766
CHHATTISGARH,KORBA,2021-01-08,47,1151,2,1200
CHHATTISGARH,KORBA,2021-01-09,58,1805,0,1863
CHHATTISGARH,KORBA,2021-01-10,15,777,0,792
CHHATTISGARH,KOREA,2021-01-06,46,705,1,752
CHHATTISGARH,KOREA,2021-01-07,28,804,0,832
CHHATTISGARH,KOREA,2021-01-08,29,850,0,879
CHHATTISGARH,KOREA,2021-01-09,17,610,1,628
CHHATTISGARH,KOREA,2021-01-10,19,578,1,598
CHHATTISGARH,MAHASAMUND,2021-01-06,43,574,0,617
CHHATTISGARH,MAHASAMUND,2021-01-07,49,861,0,910
CHHATTISGARH,MAHASAMUND,2021-01-08,32,1014,1,1047
CHHATTISGARH,MAHASAMUND,2021-01-09,26,828,0,854
CHHATTISGARH,MAHASAMUND,2021-01-10,31,232,2,265
CHHATTISGARH,MUNGELI,2021-01-06,14,366,0,380
CHHATTISGARH,MUNGELI,2021-01-07,4,347,0,351
CHHATTISGARH,MUNGELI,2021-01-08,16,246,0,262
CHHATTISGARH,MUNGELI,2021-01-09,5,541,0,546
CHHATTISGARH,MUNGELI,2021-01-10,3,330,0,333
CHHATTISGARH,NARAYANPUR,2021-01-06,0,203,0,203
CHHATTISGARH,NARAYANPUR,2021-01-07,0,183,0,183
CHHATTISGARH,NARAYANPUR,2021-01-08,3,238,0,241
CHHATTISGARH,NARAYANPUR,2021-01-09,3,274,0,277
CHHATTISGARH,NARAYANPUR,2021-01-10,0,20,0,20
CHHATTISGARH,RAIGARH,2021-01-06,62,2186,1,2249
CHHATTISGARH,RAIGARH,2021-01-07,102,2651,7,2760
CHHATTISGARH,RAIGARH,2021-01-08,97,2136,2,2235
CHHATTISGARH,RAIGARH,2021-01-09,73,1900,9,1982
CHHATTISGARH,RAIGARH,2021-01-10,46,1486,24,1556
CHHATTISGARH,RAIPUR,2021-01-06,184,2930,12,3126
CHHATTISGARH,RAIPUR,2021-01-07,241,2374,26,2641
CHHATTISGARH,RAIPUR,2021-01-08,226,2522,16,2764
CHHATTISGARH,RAIPUR,2021-01-09,227,2204,38,2469
CHHATTISGARH,RAIPUR,2021-01-10,177,947,42,1166
CHHATTISGARH,RAJNANDGAON,2021-01-06,93,1628,3,1724
CHHATTISGARH,RAJNANDGAON,2021-01-07,75,1673,1,1749
CHHATTISGARH,RAJNANDGAON,2021-01-08,59,1259,0,1318
CHHATTISGARH,RAJNANDGAON,2021-01-09,80,1388,3,1471
CHHATTISGARH,RAJNANDGAON,2021-01-10,40,752,0,792
CHHATTISGARH,SUKMA,2021-01-06,4,143,0,147
CHHATTISGARH,SUKMA,2021-01-07,2,173,0,175
CHHATTISGARH,SUKMA,2021-01-08,7,428,0,435
CHHATTISGARH,SUKMA,2021-01-09,2,235,0,237
CHHATTISGARH,SUKMA,2021-01-10,4,369,0,373
CHHATTISGARH,SURAJPUR,2021-01-06,29,718,0,747
CHHATTISGARH,SURAJPUR,2021-01-07,38,824,1,863
CHHATTISGARH,SURAJPUR,2021-01-08,21,1006,0,1027
CHHATTISGARH,SURAJPUR,2021-01-09,22,838,0,860
CHHATTISGARH,SURAJPUR,2021-01-10,12,751,0,763
CHHATTISGARH,SURGUJA,2021-01-06,52,1156,0,1208
CHHATTISGARH,SURGUJA,2021-01-07,45,1246,1,1292
CHHATTISGARH,SURGUJA,2021-01-08,33,914,3,950
CHHATTISGARH,SURGUJA,2021-01-09,43,932,0,975
CHHATTISGARH,SURGUJA,2021-01-10,24,434,0,458
DADRA AND NAGAR HAVELI,DADRA AND NAGAR HAVELI,2021-01-06,0,252,0,252
DADRA AND NAGAR HAVELI,DADRA AND NAGAR HAVELI,2021-01-07,1,185,1,187
DADRA AND NAGAR HAVELI,DADRA AND NAGAR HAVELI,2021-01-08,0,293,0,293
DADRA AND NAGAR HAVELI,DADRA AND NAGAR HAVELI,2021-01-09,0,200,1,201
DADRA AND NAGAR HAVELI,DADRA AND NAGAR HAVELI,2021-01-10,1,104,0,105
DAMAN AND DIU,DAMAN,2021-01-06,0,112,0,112
DAMAN AND DIU,DAMAN,2021-01-07,0,125,0,125
DAMAN AND DIU,DAMAN,2021-01-08,0,77,0,77
DAMAN AND DIU,DAMAN,2021-01-09,0,99,0,99
DAMAN AND DIU,DAMAN,2021-01-10,1,150,0,151
DAMAN AND DIU,DIU,2021-01-06,0,33,0,33
DAMAN AND DIU,DIU,2021-01-07,0,43,0,43
DAMAN AND DIU,DIU,2021-01-08,0,31,0,31
DAMAN AND DIU,DIU,2021-01-09,0,12,0,12
DAMAN AND DIU,DIU,2021-01-10,0,29,0,29
DELHI,CENTRAL,2021-01-06,40,6393,158,6591
DELHI,CENTRAL,2021-01-07,20,6844,13,6877
DELHI,CENTRAL,2021-01-08,32,4330,89,4451
DELHI,CENTRAL,2021-01-09,30,7118,133,7281
DELHI,CENTRAL,2021-01-10,14,5480,204,5698
DELHI,EAST,2021-01-06,47,5364,12,5423
DELHI,EAST,2021-01-07,43,5267,5,5315
DELHI,EAST,2021-01-08,41,5026,6,5073
DELHI,EAST,2021-01-09,45,5877,2,5924
DELHI,EAST,2021-01-10,17,3481,1,3499
DELHI,NEW DELHI,2021-01-06,93,5095,31,5219
DELHI,NEW DELHI,2021-01-07,88,5694,31,5813
DELHI,NEW DELHI,2021-01-08,107,6374,27,6508
DELHI,NEW DELHI,2021-01-09,56,6556,12,6624
DELHI,NEW DELHI,2021-01-10,67,4926,47,5040
DELHI,NORTH,2021-01-06,68,9464,20,9552
DELHI,NORTH,2021-01-07,30,8715,36,8781
DELHI,NORTH,2021-01-08,29,7959,54,8042
DELHI,NORTH,2021-01-09,26,7477,55,7558
DELHI,NORTH,2021-01-10,23,6551,34,6608
DELHI,NORTH EAST,2021-01-06,17,4347,52,4416
DELHI,NORTH EAST,2021-01-07,21,4095,11,4127
DELHI,NORTH EAST,2021-01-08,14,4617,19,4650
DELHI,NORTH EAST,2021-01-09,11,3736,10,3757
DELHI,NORTH EAST,2021-01-10,11,3243,105,3359
DELHI,NORTH WEST,2021-01-06,62,7856,21,7939
DELHI,NORTH WEST,2021-01-07,71,7626,14,7711
DELHI,NORTH WEST,2021-01-08,72,10272,11,10355
DELHI,NORTH WEST,2021-01-09,42,9053,14,9109
DELHI,NORTH WEST,2021-01-10,30,6263,6,6299
DELHI,SHAHDARA,2021-01-06,18,6252,6,6276
DELHI,SHAHDARA,2021-01-07,14,6376,9,6399
DELHI,SHAHDARA,2021-01-08,29,8120,16,8165
DELHI,SHAHDARA,2021-01-09,11,6481,7,6499
DELHI,SHAHDARA,2021-01-10,8,4132,3,4143
DELHI,SOUTH,2021-01-06,85,6198,39,6322
DELHI,SOUTH,2021-01-07,108,6317,78,6503
DELHI,SOUTH,2021-01-08,110,5042,24,5176
DELHI,SOUTH,2021-01-09,99,6306,5,6410
DELHI,SOUTH,2021-01-10,89,4723,13,4825
DELHI,SOUTH EAST,2021-01-06,24,7602,11,7637
DELHI,SOUTH EAST,2021-01-07,25,7510,1,7536
DELHI,SOUTH EAST,2021-01-08,24,9019,11,9054
DELHI,SOUTH EAST,2021-01-09,17,6705,4,6726
DELHI,SOUTH EAST,2021-01-10,13,3614,11,3638
DELHI,SOUTH WEST,2021-01-06,52,9311,4,9367
DELHI,SOUTH WEST,2021-01-07,54,7804,35,7893
DELHI,SOUTH WEST,2021-01-08,60,9988,12,10060
DELHI,SOUTH WEST,2021-01-09,61,9072,9,9142
DELHI,SOUTH WEST,2021-01-10,48,6802,12,6862
DELHI,WEST,2021-01-06,61,8765,6,8832
DELHI,WEST,2021-01-07,54,8719,18,8791
DELHI,WEST,2021-01-08,66,8714,3,8783
DELHI,WEST,2021-01-09,50,8550,12,8612
DELHI,WEST,2021-01-10,35,6404,5,6444
GOA,NORTH GOA,2021-01-06,33,805,0,838
GOA,NORTH GOA,2021-01-07,41,945,1,987
GOA,NORTH GOA,2021-01-08,43,1119,0,1162
GOA,NORTH GOA,2021-01-09,41,970,3,1014
GOA,NORTH GOA,2021-01-10,27,526,1,554
GOA,SOUTH GOA,2021-01-06,54,775,0,829
GOA,SOUTH GOA,2021-01-07,77,903,0,980
GOA,SOUTH GOA,2021-01-08,52,882,1,935
GOA,SOUTH GOA,2021-01-09,52,1116,0,1168
GOA,SOUTH GOA,2021-01-10,15,446,0,461
GUJARAT,AHMADABAD,2021-01-06,133,9978,22,10133
GUJARAT,AHMADABAD,2021-01-07,107,8596,4,8707
GUJARAT,AHMADABAD,2021-01-08,139,8860,21,9020
GUJARAT,AHMADABAD,2021-01-09,116,6518,147,6781
GUJARAT,AHMADABAD,2021-01-10,67,3083,15,3165
GUJARAT,AMRELI,2021-01-06,38,1407,1,1446
GUJARAT,AMRELI,2021-01-07,18,1049,0,1067
GUJARAT,AMRELI,2021-01-08,9,1111,0,1120
GUJARAT,AMRELI,2021-01-09,4,657,0,661
GUJARAT,AMRELI,2021-01-10,5,450,0,455
GUJARAT,ANAND,2021-01-06,20,603,1,624
GUJARAT,ANAND,2021-01-07,13,424,0,437
GUJARAT,ANAND,2021-01-08,10,483,0,493
GUJARAT,ANAND,2021-01-09,12,355,0,367
GUJARAT,ANAND,2021-01-10,6,246,0,252
GUJARAT,ARVALLI,2021-01-06,3,783,6,792
GUJARAT,ARVALLI,2021-01-07,3,551,0,554
GUJARAT,ARVALLI,2021-01-08,2,415,0,417
GUJARAT,ARVALLI,2021-01-09,7,308,0,315
GUJARAT,ARVALLI,2021-01-10,2,65,1,68
GUJARAT,BANAS KANTHA,2021-01-06,9,540,0,549
GUJARAT,BANAS KANTHA,2021-01-07,6,401,0,407
GUJARAT,BANAS KANTHA,2021-01-08,5,403,0,408
GUJARAT,BANAS KANTHA,2021-01-09,10,437,0,447
GUJARAT,BANAS KANTHA,2021-01-10,4,277,0,281
GUJARAT,BHARUCH,2021-01-06,19,347,1,367
GUJARAT,BHARUCH,2021-01-07,25,452,0,477
GUJARAT,BHARUCH,2021-01-08,15,294,0,309
GUJARAT,BHARUCH,2021-01-09,17,324,0,341
GUJARAT,BHARUCH,2021-01-10,4,170,0,174
GUJARAT,BHAVNAGAR,2021-01-06,12,1369,0,1381
GUJARAT,BHAVNAGAR,2021-01-07,11,1215,0,1226
GUJARAT,BHAVNAGAR,2021-01-08,11,1137,1,1149
GUJARAT,BHAVNAGAR,2021-01-09,10,1072,0,1082
GUJARAT,BHAVNAGAR,2021-01-10,9,576,0,585
GUJARAT,BOTAD,2021-01-06,2,392,0,394
GUJARAT,BOTAD,2021-01-07,1,421,0,422
GUJARAT,BOTAD,2021-01-08,0,378,0,378
GUJARAT,BOTAD,2021-01-09,2,208,0,210
GUJARAT,BOTAD,2021-01-10,1,275,0,276
GUJARAT,CHHOTAUDEPUR,2021-01-06,11,346,0,357
GUJARAT,CHHOTAUDEPUR,2021-01-07,1,242,1,244
GUJARAT,CHHOTAUDEPUR,2021-01-08,1,330,0,331
GUJARAT,CHHOTAUDEPUR,2021-01-09,3,396,0,399
GUJARAT,CHHOTAUDEPUR,2021-01-10,0,60,0,60
GUJARAT,DANG,2021-01-06,4,77,0,81
GUJARAT,DANG,2021-01-07,2,104,0,106
GUJARAT,DANG,2021-01-08,0,138,0,138
GUJARAT,DANG,2021-01-09,17,222,0,239
GUJARAT,DANG,2021-01-10,4,81,0,85
GUJARAT,DEVBHUMI DWARKA,2021-01-06,6,226,1,233
GUJARAT,DEVBHUMI DWARKA,2021-01-07,3,178,1,182
GUJARAT,DEVBHUMI DWARKA,2021-01-08,4,141,0,145
GUJARAT,DEVBHUMI DWARKA,2021-01-09,17,49,0,66
GUJARAT,DEVBHUMI DWARKA,2021-01-10,6,28,2,36
GUJARAT,DOHAD,2021-01-06,12,466,1,479
GUJARAT,DOHAD,2021-01-07,18,786,0,804
GUJARAT,DOHAD,2021-01-08,12,509,0,521
GUJARAT,DOHAD,2021-01-09,46,734,0,780
GUJARAT,DOHAD,2021-01-10,11,447,0,458
GUJARAT,GANDHINAGAR,2021-01-06,20,1366,2,1388
GUJARAT,GANDHINAGAR,2021-01-07,11,1735,5,1751
GUJARAT,GANDHINAGAR,2021-01-08,14,1781,6,1801
GUJARAT,GANDHINAGAR,2021-01-09,18,1312,5,1335
GUJARAT,GANDHINAGAR,2021-01-10,10,1186,2,1198
GUJARAT,GIR SOMNATH,2021-01-06,3,324,0,327
GUJARAT,GIR SOMNATH,2021-01-07,6,412,0,418
GUJARAT,GIR SOMNATH,2021-01-08,10,358,0,368
GUJARAT,GIR SOMNATH,2021-01-09,13,232,0,245
GUJARAT,GIR SOMNATH,2021-01-10,4,138,0,142
GUJARAT,JAMNAGAR,2021-01-06,23,2002,1,2026
GUJARAT,JAMNAGAR,2021-01-07,34,1863,1,1898
GUJARAT,JAMNAGAR,2021-01-08,17,1654,4,1675
GUJARAT,JAMNAGAR,2021-01-09,17,1710,5,1732
GUJARAT,JAMNAGAR,2021-01-10,22,907,4,933
GUJARAT,JUNAGADH,2021-01-06,17,590,0,607
GUJARAT,JUNAGADH,2021-01-07,12,641,0,653
GUJARAT,JUNAGADH,2021-01-08,14,507,0,521
GUJARAT,JUNAGADH,2021-01-09,17,513,1,531
GUJARAT,JUNAGADH,2021-01-10,8,144,0,152
GUJARAT,KACHCHH,2021-01-06,15,608,0,623
GUJARAT,KACHCHH,2021-01-07,18,606,4,628
GUJARAT,KACHCHH,2021-01-08,21,566,18,605
GUJARAT,KACHCHH,2021-01-09,32,598,29,659
GUJARAT,KACHCHH,2021-01-10,34,330,3,367
GUJARAT,KHEDA,2021-01-06,36,1023,4,1063
GUJARAT,KHEDA,2021-01-07,14,778,4,796
GUJARAT,KHEDA,2021-01-08,9,628,0,637
GUJARAT,KHEDA,2021-01-09,15,790,2,807
GUJARAT,KHEDA,2021-01-10,6,371,2,379
GUJARAT,MAHESANA,2021-01-06,9,1146,1,1156
GUJARAT,MAHESANA,2021-01-07,6,1163,2,1171
GUJARAT,MAHESANA,2021-01-08,15,785,4,804
GUJARAT,MAHESANA,2021-01-09,15,655,6,676
GUJARAT,MAHESANA,2021-01-10,12,299,0,311
GUJARAT,MAHISAGAR,2021-01-06,6,471,0,477
GUJARAT,MAHISAGAR,2021-01-07,9,619,0,628
GUJARAT,MAHISAGAR,2021-01-08,4,387,0,391
GUJARAT,MAHISAGAR,2021-01-09,3,449,0,452
GUJARAT,MAHISAGAR,2021-01-10,10,197,1,208
GUJARAT,MORBI,2021-01-06,10,723,65,798
GUJARAT,MORBI,2021-01-07,7,726,37,770
GUJARAT,MORBI,2021-01-08,9,706,58,773
GUJARAT,MORBI,2021-01-09,12,543,42,597
GUJARAT,MORBI,2021-01-10,7,324,56,387
GUJARAT,NARMADA,2021-01-06,7,84,0,91
GUJARAT,NARMADA,2021-01-07,7,36,0,43
GUJARAT,NARMADA,2021-01-08,7,73,0,80
GUJARAT,NARMADA,2021-01-09,6,55,0,61
GUJARAT,NARMADA,2021-01-10,6,61,0,67
GUJARAT,NAVSARI,2021-01-06,6,529,0,535
GUJARAT,NAVSARI,2021-01-07,11,420,0,431
GUJARAT,NAVSARI,2021-01-08,7,444,0,451
GUJARAT,NAVSARI,2021-01-09,6,375,0,381
GUJARAT,NAVSARI,2021-01-10,3,329,0,332
GUJARAT,PANCH MAHALS,2021-01-06,6,763,0,769
GUJARAT,PANCH MAHALS,2021-01-07,13,798,1,812
GUJARAT,PANCH MAHALS,2021-01-08,11,633,0,644
GUJARAT,PANCH MAHALS,2021-01-09,11,564,1,576
GUJARAT,PANCH MAHALS,2021-01-10,7,454,0,461
GUJARAT,PATAN,2021-01-06,8,951,0,959
GUJARAT,PATAN,2021-01-07,5,700,2,707
GUJARAT,PATAN,2021-01-08,3,612,2,617
GUJARAT,PATAN,2021-01-09,4,534,1,539
GUJARAT,PATAN,2021-01-10,5,249,0,254
GUJARAT,PORBANDAR,2021-01-06,1,362,0,363
GUJARAT,PORBANDAR,2021-01-07,1,476,0,477
GUJARAT,PORBANDAR,2021-01-08,0,334,0,334
GUJARAT,PORBANDAR,2021-01-09,2,437,0,439
GUJARAT,PORBANDAR,2021-01-10,0,314,0,314
GUJARAT,RAJKOT,2021-01-06,61,2166,54,2281
GUJARAT,RAJKOT,2021-01-07,66,1448,86,1600
GUJARAT,RAJKOT,2021-01-08,85,1484,88,1657
GUJARAT,RAJKOT,2021-01-09,81,1567,78,1726
GUJARAT,RAJKOT,2021-01-10,42,1083,60,1185
GUJARAT,SABAR KANTHA,2021-01-06,10,435,7,452
GUJARAT,SABAR KANTHA,2021-01-07,9,244,5,258
GUJARAT,SABAR KANTHA,2021-01-08,5,315,8,328
GUJARAT,SABAR KANTHA,2021-01-09,7,192,18,217
GUJARAT,SABAR KANTHA,2021-01-10,10,148,6,164
GUJARAT,SURAT,2021-01-06,90,2586,4,2680
GUJARAT,SURAT,2021-01-07,72,2089,10,2171
GUJARAT,SURAT,2021-01-08,86,2114,8,2208
GUJARAT,SURAT,2021-01-09,75,1754,5,1834
GUJARAT,SURAT,2021-01-10,43,1178,0,1221
GUJARAT,SURENDRANAGAR,2021-01-06,3,906,0,909
GUJARAT,SURENDRANAGAR,2021-01-07,2,984,0,986
GUJARAT,SURENDRANAGAR,2021-01-08,1,755,1,757
GUJARAT,SURENDRANAGAR,2021-01-09,2,681,0,683
GUJARAT,SURENDRANAGAR,2021-01-10,2,400,1,403
GUJARAT,TAPI,2021-01-06,10,507,0,517
GUJARAT,TAPI,2021-01-07,3,330,0,333
GUJARAT,TAPI,2021-01-08,6,318,0,324
GUJARAT,TAPI,2021-01-09,5,240,0,245
GUJARAT,TAPI,2021-01-10,5,125,0,130
GUJARAT,VADODARA,2021-01-06,138,2830,14,2982
GUJARAT,VADODARA,2021-01-07,116,2316,27,2459
GUJARAT,VADODARA,2021-01-08,118,2201,5,2324
GUJARAT,VADODARA,2021-01-09,116,1773,23,1912
GUJARAT,VADODARA,2021-01-10,75,802,14,891
GUJARAT,VALSAD,2021-01-06,7,444,1,452
GUJARAT,VALSAD,2021-01-07,6,403,0,409
GUJARAT,VALSAD,2021-01-08,2,449,0,451
GUJARAT,VALSAD,2021-01-09,3,385,1,389
GUJARAT,VALSAD,2021-01-10,6,355,0,361
HARYANA,AMBALA,2021-01-06,31,1202,88,1321
HARYANA,AMBALA,2021-01-07,40,1090,8,1138
HARYANA,AMBALA,2021-01-08,27,824,14,865
HARYANA,AMBALA,2021-01-09,30,1121,19,1170
HARYANA,AMBALA,2021-01-10,18,206,3,227
HARYANA,BHIWANI,2021-01-06,2,1755,0,1757
HARYANA,BHIWANI,2021-01-07,8,1784,1,1793
HARYANA,BHIWANI,2021-01-08,6,1127,6,1139
HARYANA,BHIWANI,2021-01-09,1,945,0,946
HARYANA,BHIWANI,2021-01-10,0,440,0,440
HARYANA,CHARKI DADRI,2021-01-06,4,630,0,634
HARYANA,CHARKI DADRI,2021-01-07,3,603,1,607
HARYANA,CHARKI DADRI,2021-01-08,2,305,0,307
HARYANA,CHARKI DADRI,2021-01-09,1,553,1,555
HARYANA,CHARKI DADRI,2021-01-10,0,478,0,478
HARYANA,FARIDABAD,2021-01-06,47,1860,5,1912
HARYANA,FARIDABAD,2021-01-07,46,1669,3,1718
HARYANA,FARIDABAD,2021-01-08,25,2304,30,2359
HARYANA,FARIDABAD,2021-01-09,38,2362,3,2403
HARYANA,FARIDABAD,2021-01-10,29,1534,1,1564
HARYANA,FATEHABAD,2021-01-06,9,652,0,661
HARYANA,FATEHABAD,2021-01-07,15,899,1,915
HARYANA,FATEHABAD,2021-01-08,3,732,0,735
HARYANA,FATEHABAD,2021-01-09,2,257,0,259
HARYANA,FATEHABAD,2021-01-10,9,37,1,47
HARYANA,GURUGRAM,2021-01-06,110,3572,25,3707
HARYANA,GURUGRAM,2021-01-07,87,3027,13,3127
HARYANA,GURUGRAM,2021-01-08,123,4276,16,4415
HARYANA,GURUGRAM,2021-01-09,103,3083,21,3207
HARYANA,GURUGRAM,2021-01-10,79,3769,25,3873
HARYANA,HISAR,2021-01-06,15,3154,0,3169
HARYANA,HISAR,2021-01-07,12,2900,7,2919
HARYANA,HISAR,2021-01-08,13,3011,1,3025
HARYANA,HISAR,2021-01-09,12,2083,2,2097
HARYANA,HISAR,2021-01-10,13,2107,23,2143
HARYANA,JHAJJAR,2021-01-06,2,1559,0,1561
HARYANA,JHAJJAR,2021-01-07,3,2062,1,2066
HARYANA,JHAJJAR,2021-01-08,12,1670,0,1682
HARYANA,JHAJJAR,2021-01-09,4,2941,0,2945
HARYANA,JHAJJAR,2021-01-10,7,1351,1,1359
HARYANA,JIND,2021-01-06,6,1130,3,1139
HARYANA,JIND,2021-01-07,17,912,2,931
HARYANA,JIND,2021-01-08,8,1025,0,1033
HARYANA,JIND,2021-01-09,5,948,1,954
HARYANA,JIND,2021-01-10,3,757,0,760
HARYANA,KAITHAL,2021-01-06,8,545,2,555
HARYANA,KAITHAL,2021-01-07,10,427,3,440
HARYANA,KAITHAL,2021-01-08,5,273,5,283
HARYANA,KAITHAL,2021-01-09,3,457,8,468
HARYANA,KAITHAL,2021-01-10,1,41,0,42
HARYANA,KARNAL,2021-01-06,17,1651,2,1670
HARYANA,KARNAL,2021-01-07,16,1962,5,1983
HARYANA,KARNAL,2021-01-08,13,1995,10,2018
HARYANA,KARNAL,2021-01-09,17,1355,10,1382
HARYANA,KARNAL,2021-01-10,4,93,0,97
HARYANA,KURUKSHETRA,2021-01-06,19,1337,4,1360
HARYANA,KURUKSHETRA,2021-01-07,43,914,4,961
HARYANA,KURUKSHETRA,2021-01-08,15,1029,2,1046
HARYANA,KURUKSHETRA,2021-01-09,9,856,12,877
HARYANA,KURUKSHETRA,2021-01-10,1,1049,8,1058
HARYANA,MAHENDRAGARH,2021-01-06,0,536,1,537
HARYANA,MAHENDRAGARH,2021-01-07,0,676,5,681
HARYANA,MAHENDRAGARH,2021-01-08,2,655,2,659
HARYANA,MAHENDRAGARH,2021-01-09,1,647,1,649
HARYANA,MAHENDRAGARH,2021-01-10,2,91,4,97
HARYANA,NUH,2021-01-06,2,982,1,985
HARYANA,NUH,2021-01-07,0,811,1,812
HARYANA,NUH,2021-01-08,5,784,0,789
HARYANA,NUH,2021-01-09,3,101,1,105
HARYANA,NUH,2021-01-10,0,170,0,170
HARYANA,PALWAL,2021-01-06,4,246,2,252
HARYANA,PALWAL,2021-01-07,2,414,1,417
HARYANA,PALWAL,2021-01-08,3,158,0,161
HARYANA,PALWAL,2021-01-09,0,564,0,564
HARYANA,PALWAL,2021-01-10,0,32,0,32
HARYANA,PANCHKULA,2021-01-06,37,748,4,789
HARYANA,PANCHKULA,2021-01-07,53,741,21,815
HARYANA,PANCHKULA,2021-01-08,44,912,2,958
HARYANA,PANCHKULA,2021-01-09,29,648,0,677
HARYANA,PANCHKULA,2021-01-10,11,124,0,135
HARYANA,PANIPAT,2021-01-06,13,771,1,785
HARYANA,PANIPAT,2021-01-07,15,939,1,955
HARYANA,PANIPAT,2021-01-08,11,1103,1,1115
HARYANA,PANIPAT,2021-01-09,11,712,0,723
HARYANA,PANIPAT,2021-01-10,18,886,0,904
HARYANA,REWARI,2021-01-06,8,738,2,748
HARYANA,REWARI,2021-01-07,1,1023,1,1025
HARYANA,REWARI,2021-01-08,8,915,3,926
HARYANA,REWARI,2021-01-09,2,522,0,524
HARYANA,REWARI,2021-01-10,14,215,0,229
HARYANA,ROHTAK,2021-01-06,7,1486,1,1494
HARYANA,ROHTAK,2021-01-07,96,1375,3,1474
HARYANA,ROHTAK,2021-01-08,153,1267,1,1421
HARYANA,ROHTAK,2021-01-09,138,1174,5,1317
HARYANA,ROHTAK,2021-01-10,28,509,0,537
HARYANA,SIRSA,2021-01-06,13,1620,18,1651
HARYANA,SIRSA,2021-01-07,3,1717,7,1727
HARYANA,SIRSA,2021-01-08,8,1276,12,1296
HARYANA,SIRSA,2021-01-09,6,876,0,882
HARYANA,SIRSA,2021-01-10,1,653,9,663
HARYANA,SONIPAT,2021-01-06,12,1091,4,1107
HARYANA,SONIPAT,2021-01-07,22,1502,0,1524
HARYANA,SONIPAT,2021-01-08,18,1389,1,1408
HARYANA,SONIPAT,2021-01-09,5,1677,0,1682
HARYANA,SONIPAT,2021-01-10,22,1479,2,1503
HARYANA,YAMUNANAGAR,2021-01-06,11,1427,5,1443
HARYANA,YAMUNANAGAR,2021-01-07,28,1822,4,1854
HARYANA,YAMUNANAGAR,2021-01-08,16,586,0,602
HARYANA,YAMUNANAGAR,2021-01-09,12,466,0,478
HARYANA,YAMUNANAGAR,2021-01-10,9,339,1,349
HIMACHAL PRADESH,BILASPUR,2021-01-06,5,266,1,272
HIMACHAL PRADESH,BILASPUR,2021-01-07,7,457,1,465
HIMACHAL PRADESH,BILASPUR,2021-01-08,3,457,1,461
HIMACHAL PRADESH,BILASPUR,2021-01-09,6,454,5,465
HIMACHAL PRADESH,BILASPUR,2021-01-10,0,158,0,158
HIMACHAL PRADESH,CHAMBA,2021-01-06,17,671,3,691
HIMACHAL PRADESH,CHAMBA,2021-01-07,6,782,6,794
HIMACHAL PRADESH,CHAMBA,2021-01-08,8,462,7,477
HIMACHAL PRADESH,CHAMBA,2021-01-09,6,587,17,610
HIMACHAL PRADESH,CHAMBA,2021-01-10,2,201,0,203
HIMACHAL PRADESH,HAMIRPUR,2021-01-06,9,442,3,454
HIMACHAL PRADESH,HAMIRPUR,2021-01-07,38,354,14,406
HIMACHAL PRADESH,HAMIRPUR,2021-01-08,14,488,4,506
HIMACHAL PRADESH,HAMIRPUR,2021-01-09,3,329,4,336
HIMACHAL PRADESH,HAMIRPUR,2021-01-10,5,357,3,365
HIMACHAL PRADESH,KANGRA,2021-01-06,6,3375,2,3383
HIMACHAL PRADESH,KANGRA,2021-01-07,22,2759,4,2785
HIMACHAL PRADESH,KANGRA,2021-01-08,14,2888,3,2905
HIMACHAL PRADESH,KANGRA,2021-01-09,23,2165,0,2188
HIMACHAL PRADESH,KANGRA,2021-01-10,2,296,3,301
HIMACHAL PRADESH,KINNAUR,2021-01-06,3,3,0,6
HIMACHAL PRADESH,KINNAUR,2021-01-07,0,27,1,28
HIMACHAL PRADESH,KINNAUR,2021-01-08,0,43,0,43
HIMACHAL PRADESH,KINNAUR,2021-01-09,0,9,1,10
HIMACHAL PRADESH,KINNAUR,2021-01-10,0,2,0,2
HIMACHAL PRADESH,KULLU,2021-01-06,6,243,3,252
HIMACHAL PRADESH,KULLU,2021-01-07,2,166,8,176
HIMACHAL PRADESH,KULLU,2021-01-08,10,288,4,302
HIMACHAL PRADESH,KULLU,2021-01-09,5,260,3,268
HIMACHAL PRADESH,KULLU,2021-01-10,4,106,0,110
HIMACHAL PRADESH,LAHUL AND SPITI,2021-01-06,3,1,0,4
HIMACHAL PRADESH,LAHUL AND SPITI,2021-01-07,0,1,0,1
HIMACHAL PRADESH,LAHUL AND SPITI,2021-01-08,0,1,0,1
HIMACHAL PRADESH,LAHUL AND SPITI,2021-01-09,0,3,0,3
HIMACHAL PRADESH,LAHUL AND SPITI,2021-01-10,1,0,0,1
HIMACHAL PRADESH,MANDI,2021-01-06,30,536,23,589
HIMACHAL PRADESH,MANDI,2021-01-07,20,402,25,447
HIMACHAL PRADESH,MANDI,2021-01-08,9,286,9,304
HIMACHAL PRADESH,MANDI,2021-01-09,9,446,8,463
HIMACHAL PRADESH,MANDI,2021-01-10,4,111,10,125
HIMACHAL PRADESH,SHIMLA,2021-01-06,4,659,23,686
HIMACHAL PRADESH,SHIMLA,2021-01-07,4,542,10,556
HIMACHAL PRADESH,SHIMLA,2021-01-08,20,708,8,736
HIMACHAL PRADESH,SHIMLA,2021-01-09,25,635,12,672
HIMACHAL PRADESH,SHIMLA,2021-01-10,12,190,2,204
HIMACHAL PRADESH,SIRMAUR,2021-01-06,26,567,2,595
HIMACHAL PRADESH,SIRMAUR,2021-01-07,10,494,2,506
HIMACHAL PRADESH,SIRMAUR,2021-01-08,12,761,5,778
HIMACHAL PRADESH,SIRMAUR,2021-01-09,14,573,6,593
HIMACHAL PRADESH,SIRMAUR,2021-01-10,3,388,3,394
HIMACHAL PRADESH,SOLAN,2021-01-06,36,481,2,519
HIMACHAL PRADESH,SOLAN,2021-01-07,21,499,0,520
HIMACHAL PRADESH,SOLAN,2021-01-08,16,356,1,373
HIMACHAL PRADESH,SOLAN,2021-01-09,21,420,0,441
HIMACHAL PRADESH,SOLAN,2021-01-10,18,277,0,295
HIMACHAL PRADESH,UNA,2021-01-06,15,541,1,557
HIMACHAL PRADESH,UNA,2021-01-07,2,284,3,289
HIMACHAL PRADESH,UNA,2021-01-08,4,746,1,751
HIMACHAL PRADESH,UNA,2021-01-09,7,638,0,645
HIMACHAL PRADESH,UNA,2021-01-10,4,246,1,251
INDIA,INDIA,2021-01-06,12,3,0,15
INDIA,INDIA,2021-01-07,10,3,1,14
INDIA,INDIA,2021-01-08,12,3,0,15
INDIA,INDIA,2021-01-09,10,1,0,11
INDIA,INDIA,2021-01-10,9,1,0,10
JAMMU AND KASHMIR,ANANTNAG,2021-01-06,2,362,0,364
JAMMU AND KASHMIR,ANANTNAG,2021-01-07,4,452,2,458
JAMMU AND KASHMIR,ANANTNAG,2021-01-08,3,491,0,494
JAMMU AND KASHMIR,ANANTNAG,2021-01-09,7,286,0,293
JAMMU AND KASHMIR,ANANTNAG,2021-01-10,2,316,0,318
JAMMU AND KASHMIR,BANDIPORA,2021-01-06,1,107,0,108
JAMMU AND KASHMIR,BANDIPORA,2021-01-07,5,168,0,173
JAMMU AND KASHMIR,BANDIPORA,2021-01-08,29,325,0,354
JAMMU AND KASHMIR,BANDIPORA,2021-01-09,0,113,1,114
JAMMU AND KASHMIR,BANDIPORA,2021-01-10,1,50,0,51
JAMMU AND KASHMIR,BARAMULLA,2021-01-06,14,547,1,562
JAMMU AND KASHMIR,BARAMULLA,2021-01-07,18,602,1,621
JAMMU AND KASHMIR,BARAMULLA,2021-01-08,25,661,0,686
JAMMU AND KASHMIR,BARAMULLA,2021-01-09,31,504,1,536
JAMMU AND KASHMIR,BARAMULLA,2021-01-10,10,352,0,362
JAMMU AND KASHMIR,BUDGAM,2021-01-06,1,330,0,331
JAMMU AND KASHMIR,BUDGAM,2021-01-07,2,288,0,290
JAMMU AND KASHMIR,BUDGAM,2021-01-08,14,367,0,381
JAMMU AND KASHMIR,BUDGAM,2021-01-09,9,492,1,502
JAMMU AND KASHMIR,BUDGAM,2021-01-10,0,199,0,199
JAMMU AND KASHMIR,DODA,2021-01-06,25,180,0,205
JAMMU AND KASHMIR,DODA,2021-01-07,27,126,0,153
JAMMU AND KASHMIR,DODA,2021-01-08,10,58,0,68
JAMMU AND KASHMIR,DODA,2021-01-09,0,41,0,41
JAMMU AND KASHMIR,DODA,2021-01-10,1,47,0,48
JAMMU AND KASHMIR,GANDERBAL,2021-01-06,0,228,0,228
JAMMU AND KASHMIR,GANDERBAL,2021-01-07,0,331,0,331
JAMMU AND KASHMIR,GANDERBAL,2021-01-08,32,525,0,557
JAMMU AND KASHMIR,GANDERBAL,2021-01-09,9,291,0,300
JAMMU AND KASHMIR,GANDERBAL,2021-01-10,0,94,0,94
JAMMU AND KASHMIR,JAMMU,2021-01-06,87,1314,1,1402
JAMMU AND KASHMIR,JAMMU,2021-01-07,73,1213,1,1287
JAMMU AND KASHMIR,JAMMU,2021-01-08,62,887,0,949
JAMMU AND KASHMIR,JAMMU,2021-01-09,64,913,1,978
JAMMU AND KASHMIR,JAMMU,2021-01-10,54,903,2,959
JAMMU AND KASHMIR,KATHUA,2021-01-06,1,178,0,179
JAMMU AND KASHMIR,KATHUA,2021-01-07,1,81,1,83
JAMMU AND KASHMIR,KATHUA,2021-01-08,1,37,0,38
JAMMU AND KASHMIR,KATHUA,2021-01-09,3,141,0,144
JAMMU AND KASHMIR,KATHUA,2021-01-10,2,42,0,44
JAMMU AND KASHMIR,KISHTWAR,2021-01-06,0,188,0,188
JAMMU AND KASHMIR,KISHTWAR,2021-01-07,3,170,0,173
JAMMU AND KASHMIR,KISHTWAR,2021-01-08,1,150,0,151
JAMMU AND KASHMIR,KISHTWAR,2021-01-09,0,241,0,241
JAMMU AND KASHMIR,KISHTWAR,2021-01-10,3,254,0,257
JAMMU AND KASHMIR,KULGAM,2021-01-06,0,470,0,470
JAMMU AND KASHMIR,KULGAM,2021-01-07,0,629,0,629
JAMMU AND KASHMIR,KULGAM,2021-01-08,4,577,0,581
JAMMU AND KASHMIR,KULGAM,2021-01-09,0,625,1,626
JAMMU AND KASHMIR,KULGAM,2021-01-10,0,298,0,298
JAMMU AND KASHMIR,KUPWARA,2021-01-06,3,189,1,193
JAMMU AND KASHMIR,KUPWARA,2021-01-07,3,339,0,342
JAMMU AND KASHMIR,KUPWARA,2021-01-08,27,159,0,186
JAMMU AND KASHMIR,KUPWARA,2021-01-09,2,35,1,38
JAMMU AND KASHMIR,KUPWARA,2021-01-10,0,11,0,11
JAMMU AND KASHMIR,POONCH,2021-01-06,3,338,0,341
JAMMU AND KASHMIR,POONCH,2021-01-07,4,314,0,318
JAMMU AND KASHMIR,POONCH,2021-01-08,1,381,0,382
JAMMU AND KASHMIR,POONCH,2021-01-09,1,490,0,491
JAMMU AND KASHMIR,POONCH,2021-01-10,1,167,0,168
JAMMU AND KASHMIR,PULWAMA,2021-01-06,5,183,0,188
JAMMU AND KASHMIR,PULWAMA,2021-01-07,6,389,0,395
JAMMU AND KASHMIR,PULWAMA,2021-01-08,11,418,0,429
JAMMU AND KASHMIR,PULWAMA,2021-01-09,10,500,7,517
JAMMU AND KASHMIR,PULWAMA,2021-01-10,2,119,0,121
JAMMU AND KASHMIR,RAJOURI,2021-01-06,0,292,0,292
JAMMU AND KASHMIR,RAJOURI,2021-01-07,1,504,0,505
JAMMU AND KASHMIR,RAJOURI,2021-01-08,0,132,0,132
JAMMU AND KASHMIR,RAJOURI,2021-01-09,2,166,0,168
JAMMU AND KASHMIR,RAJOURI,2021-01-10,1,104,0,105
JAMMU AND KASHMIR,RAMBAN,2021-01-06,0,254,0,254
JAMMU AND KASHMIR,RAMBAN,2021-01-07,3,185,0,188
JAMMU AND KASHMIR,RAMBAN,2021-01-08,0,143,0,143
JAMMU AND KASHMIR,RAMBAN,2021-01-09,0,248,0,248
JAMMU AND KASHMIR,RAMBAN,2021-01-10,0,65,0,65
JAMMU AND KASHMIR,REASI,2021-01-06,12,214,0,226
JAMMU AND KASHMIR,REASI,2021-01-07,6,152,0,158
JAMMU AND KASHMIR,REASI,2021-01-08,6,179,0,185
JAMMU AND KASHMIR,REASI,2021-01-09,5,204,0,209
JAMMU AND KASHMIR,REASI,2021-01-10,2,101,0,103
JAMMU AND KASHMIR,SAMBA,2021-01-06,2,154,0,156
JAMMU AND KASHMIR,SAMBA,2021-01-07,1,155,0,156
JAMMU AND KASHMIR,SAMBA,2021-01-08,11,373,0,384
JAMMU AND KASHMIR,SAMBA,2021-01-09,9,378,0,387
JAMMU AND KASHMIR,SAMBA,2021-01-10,0,150,0,150
JAMMU AND KASHMIR,SHOPIAN,2021-01-06,0,18,0,18
JAMMU AND KASHMIR,SHOPIAN,2021-01-07,0,46,0,46
JAMMU AND KASHMIR,SHOPIAN,2021-01-08,3,46,0,49
JAMMU AND KASHMIR,SHOPIAN,2021-01-09,3,25,0,28
JAMMU AND KASHMIR,SHOPIAN,2021-01-10,0,13,0,13
JAMMU AND KASHMIR,SRINAGAR,2021-01-06,15,305,3,323
JAMMU AND KASHMIR,SRINAGAR,2021-01-07,46,1322,1,1369
JAMMU AND KASHMIR,SRINAGAR,2021-01-08,148,4176,2,4326
JAMMU AND KASHMIR,SRINAGAR,2021-01-09,44,1360,5,1409
JAMMU AND KASHMIR,SRINAGAR,2021-01-10,26,1796,0,1822
JAMMU AND KASHMIR,UDHAMPUR,2021-01-06,8,624,0,632
JAMMU AND KASHMIR,UDHAMPUR,2021-01-07,3,682,1,686
JAMMU AND KASHMIR,UDHAMPUR,2021-01-08,2,655,1,658
JAMMU AND KASHMIR,UDHAMPUR,2021-01-09,6,626,0,632
JAMMU AND KASHMIR,UDHAMPUR,2021-01-10,1,294,0,295
JHARKHAND,BOKARO,2021-01-06,15,642,4,661
JHARKHAND,BOKARO,2021-01-07,11,610,15,636
JHARKHAND,BOKARO,2021-01-08,16,605,19,640
JHARKHAND,BOKARO,2021-01-09,16,510,0,526
JHARKHAND,BOKARO,2021-01-10,3,79,6,88
JHARKHAND,CHATRA,2021-01-06,0,242,0,242
JHARKHAND,CHATRA,2021-01-07,0,289,0,289
JHARKHAND,CHATRA,2021-01-08,1,366,2,369
JHARKHAND,CHATRA,2021-01-09,0,198,1,199
JHARKHAND,CHATRA,2021-01-10,1,608,0,609
JHARKHAND,DEOGHAR,2021-01-06,2,575,3,580
JHARKHAND,DEOGHAR,2021-01-07,3,381,1,385
JHARKHAND,DEOGHAR,2021-01-08,3,515,4,522
JHARKHAND,DEOGHAR,2021-01-09,2,731,0,733
JHARKHAND,DEOGHAR,2021-01-10,2,773,1,776
JHARKHAND,DHANBAD,2021-01-06,8,664,0,672
JHARKHAND,DHANBAD,2021-01-07,8,462,2,472
JHARKHAND,DHANBAD,2021-01-08,25,935,0,960
JHARKHAND,DHANBAD,2021-01-09,36,623,0,659
JHARKHAND,DHANBAD,2021-01-10,4,106,0,110
JHARKHAND,DUMKA,2021-01-06,0,877,0,877
JHARKHAND,DUMKA,2021-01-07,1,682,0,683
JHARKHAND,DUMKA,2021-01-08,1,1565,1,1567
JHARKHAND,DUMKA,2021-01-09,2,1162,0,1164
JHARKHAND,DUMKA,2021-01-10,1,901,0,902
JHARKHAND,EAST SINGHBUM,2021-01-06,12,1945,65,2022
JHARKHAND,EAST SINGHBUM,2021-01-07,19,2749,3,2771
JHARKHAND,EAST SINGHBUM,2021-01-08,29,2874,5,2908
JHARKHAND,EAST SINGHBUM,2021-01-09,33,2387,1,2421
JHARKHAND,EAST SINGHBUM,2021-01-10,11,944,0,955
JHARKHAND,GARHWA,2021-01-06,3,234,22,259
JHARKHAND,GARHWA,2021-01-07,1,106,0,107
JHARKHAND,GARHWA,2021-01-08,6,147,0,153
JHARKHAND,GARHWA,2021-01-09,7,619,3,629
JHARKHAND,GARHWA,2021-01-10,4,600,0,604
JHARKHAND,GIRIDIH,2021-01-06,4,553,0,557
JHARKHAND,GIRIDIH,2021-01-07,7,809,0,816
JHARKHAND,GIRIDIH,2021-01-08,0,997,0,997
JHARKHAND,GIRIDIH,2021-01-09,3,841,1,845
JHARKHAND,GIRIDIH,2021-01-10,0,97,0,97
JHARKHAND,GODDA,2021-01-06,4,503,0,507
JHARKHAND,GODDA,2021-01-07,4,321,0,325
JHARKHAND,GODDA,2021-01-08,10,242,1,253
JHARKHAND,GODDA,2021-01-09,2,253,0,255
JHARKHAND,GODDA,2021-01-10,0,181,0,181
JHARKHAND,GUMLA,2021-01-06,4,788,1,793
JHARKHAND,GUMLA,2021-01-07,1,694,1,696
JHARKHAND,GUMLA,2021-01-08,3,476,1,480
JHARKHAND,GUMLA,2021-01-09,5,890,0,895
JHARKHAND,GUMLA,2021-01-10,5,80,0,85
JHARKHAND,HAZARIBAGH,2021-01-06,2,470,0,472
JHARKHAND,HAZARIBAGH,2021-01-07,7,301,0,308
JHARKHAND,HAZARIBAGH,2021-01-08,4,320,0,324
JHARKHAND,HAZARIBAGH,2021-01-09,6,374,1,381
JHARKHAND,HAZARIBAGH,2021-01-10,0,546,0,546
JHARKHAND,JAMTARA,2021-01-06,0,332,2,334
JHARKHAND,JAMTARA,2021-01-07,2,264,30,296
JHARKHAND,JAMTARA,2021-01-08,1,217,5,223
JHARKHAND,JAMTARA,2021-01-09,1,282,13,296
JHARKHAND,JAMTARA,2021-01-10,2,160,4,166
JHARKHAND,KHUNTI,2021-01-06,3,317,0,320
JHARKHAND,KHUNTI,2021-01-07,2,333,0,335
JHARKHAND,KHUNTI,2021-01-08,3,60,0,63
JHARKHAND,KHUNTI,2021-01-09,0,438,0,438
JHARKHAND,KHUNTI,2021-01-10,0,145,0,145
JHARKHAND,KODERMA,2021-01-06,15,290,0,305
JHARKHAND,KODERMA,2021-01-07,23,232,0,255
JHARKHAND,KODERMA,2021-01-08,2,179,0,181
JHARKHAND,KODERMA,2021-01-09,10,281,0,291
JHARKHAND,KODERMA,2021-01-10,0,236,0,236
JHARKHAND,LATEHAR,2021-01-06,11,383,0,394
JHARKHAND,LATEHAR,2021-01-07,0,368,0,368
JHARKHAND,LATEHAR,2021-01-08,1,523,1,525
JHARKHAND,LATEHAR,2021-01-09,8,366,1,375
JHARKHAND,LATEHAR,2021-01-10,5,110,0,115
JHARKHAND,LOHARDAGA,2021-01-06,3,396,0,399
JHARKHAND,LOHARDAGA,2021-01-07,2,504,1,507
JHARKHAND,LOHARDAGA,2021-01-08,3,342,0,345
JHARKHAND,LOHARDAGA,2021-01-09,2,125,0,127
JHARKHAND,LOHARDAGA,2021-01-10,0,59,0,59
JHARKHAND,PAKUR,2021-01-06,0,1151,0,1151
JHARKHAND,PAKUR,2021-01-07,0,1237,0,1237
JHARKHAND,PAKUR,2021-01-08,0,1029,0,1029
JHARKHAND,PAKUR,2021-01-09,0,976,0,976
JHARKHAND,PAKUR,2021-01-10,0,298,0,298
JHARKHAND,PALAMU,2021-01-06,2,1133,45,1180
JHARKHAND,PALAMU,2021-01-07,5,1099,2,1106
JHARKHAND,PALAMU,2021-01-08,3,628,3,634
JHARKHAND,PALAMU,2021-01-09,5,729,1,735
JHARKHAND,PALAMU,2021-01-10,11,344,0,355
JHARKHAND,RAMGARH,2021-01-06,2,617,0,619
JHARKHAND,RAMGARH,2021-01-07,8,441,0,449
JHARKHAND,RAMGARH,2021-01-08,3,472,1,476
JHARKHAND,RAMGARH,2021-01-09,3,169,1,173
JHARKHAND,RAMGARH,2021-01-10,1,80,0,81
JHARKHAND,RANCHI,2021-01-06,100,817,0,917
JHARKHAND,RANCHI,2021-01-07,98,1198,1,1297
JHARKHAND,RANCHI,2021-01-08,116,957,2,1075
JHARKHAND,RANCHI,2021-01-09,118,994,1,1113
JHARKHAND,RANCHI,2021-01-10,107,503,2,612
JHARKHAND,SAHEBGANJ,2021-01-06,0,729,0,729
JHARKHAND,SAHEBGANJ,2021-01-07,1,617,0,618
JHARKHAND,SAHEBGANJ,2021-01-08,0,534,0,534
JHARKHAND,SAHEBGANJ,2021-01-09,0,889,0,889
JHARKHAND,SAHEBGANJ,2021-01-10,0,215,0,215
JHARKHAND,SARAIKELA KHARSAWAN,2021-01-06,1,790,2,793
JHARKHAND,SARAIKELA KHARSAWAN,2021-01-07,4,953,18,975
JHARKHAND,SARAIKELA KHARSAWAN,2021-01-08,4,726,0,730
JHARKHAND,SARAIKELA KHARSAWAN,2021-01-09,0,1464,0,1464
JHARKHAND,SARAIKELA KHARSAWAN,2021-01-10,0,115,0,115
JHARKHAND,SIMDEGA,2021-01-06,1,133,0,134
JHARKHAND,SIMDEGA,2021-01-07,2,263,0,265
JHARKHAND,SIMDEGA,2021-01-08,0,128,0,128
JHARKHAND,SIMDEGA,2021-01-09,2,147,0,149
JHARKHAND,SIMDEGA,2021-01-10,4,107,0,111
JHARKHAND,WEST SINGHBHUM,2021-01-06,0,815,0,815
JHARKHAND,WEST SINGHBHUM,2021-01-07,0,603,23,626
JHARKHAND,WEST SINGHBHUM,2021-01-08,0,233,16,249
JHARKHAND,WEST SINGHBHUM,2021-01-09,2,423,0,425
JHARKHAND,WEST SINGHBHUM,2021-01-10,1,118,0,119
KARNATAKA,BAGALKOTE,2021-01-06,0,2808,0,2808
KARNATAKA,BAGALKOTE,2021-01-07,5,4120,4,4129
KARNATAKA,BAGALKOTE,2021-01-08,5,3474,1,3480
KARNATAKA,BAGALKOTE,2021-01-09,0,3282,2,3284
KARNATAKA,BAGALKOTE,2021-01-10,0,3782,3,3785
KARNATAKA,BALLARI,2021-01-06,19,3934,9,3962
KARNATAKA,BALLARI,2021-01-07,22,4282,11,4315
KARNATAKA,BALLARI,2021-01-08,15,4120,12,4147
KARNATAKA,BALLARI,2021-01-09,17,4201,30,4248
KARNATAKA,BALLARI,2021-01-10,5,2341,12,2358
KARNATAKA,BELAGAVI,2021-01-06,19,4239,9,4267
KARNATAKA,BELAGAVI,2021-01-07,26,2826,8,2860
KARNATAKA,BELAGAVI,2021-01-08,23,3457,3,3483
KARNATAKA,BELAGAVI,2021-01-09,16,3028,8,3052
KARNATAKA,BELAGAVI,2021-01-10,3,283,0,286
KARNATAKA,BENGALURU RURAL,2021-01-06,20,2803,1,2824
KARNATAKA,BENGALURU RURAL,2021-01-07,27,2547,1,2575
KARNATAKA,BENGALURU RURAL,2021-01-08,17,2634,0,2651
KARNATAKA,BENGALURU RURAL,2021-01-09,18,1825,4,1847
KARNATAKA,BENGALURU RURAL,2021-01-10,6,736,0,742
KARNATAKA,BENGALURU URBAN,2021-01-06,491,45214,139,45844
KARNATAKA,BENGALURU URBAN,2021-01-07,481,45553,111,46145
KARNATAKA,BENGALURU URBAN,2021-01-08,479,44224,85,44788
KARNATAKA,BENGALURU URBAN,2021-01-09,492,38921,17,39430
KARNATAKA,BENGALURU URBAN,2021-01-10,301,28856,66,29223
KARNATAKA,BIDAR,2021-01-06,12,2211,0,2223
KARNATAKA,BIDAR,2021-01-07,5,2776,0,2781
KARNATAKA,BIDAR,2021-01-08,4,1205,0,1209
KARNATAKA,BIDAR,2021-01-09,10,1912,1,1923
KARNATAKA,BIDAR,2021-01-10,9,1616,0,1625
KARNATAKA,CHAMARAJANAGARA,2021-01-06,6,1650,0,1656
KARNATAKA,CHAMARAJANAGARA,2021-01-07,4,1250,4,1258
KARNATAKA,CHAMARAJANAGARA,2021-01-08,4,1567,1,1572
KARNATAKA,CHAMARAJANAGARA,2021-01-09,7,1283,1,1291
KARNATAKA,CHAMARAJANAGARA,2021-01-10,3,477,0,480
KARNATAKA,CHIKKABALLAPURA,2021-01-06,9,3428,1,3438
KARNATAKA,CHIKKABALLAPURA,2021-01-07,29,3378,5,3412
KARNATAKA,CHIKKABALLAPURA,2021-01-08,25,3339,4,3368
KARNATAKA,CHIKKABALLAPURA,2021-01-09,50,3325,6,3381
KARNATAKA,CHIKKABALLAPURA,2021-01-10,33,3230,10,3273
KARNATAKA,CHIKKAMAGALURU,2021-01-06,9,2270,10,2289
KARNATAKA,CHIKKAMAGALURU,2021-01-07,17,3454,3,3474
KARNATAKA,CHIKKAMAGALURU,2021-01-08,16,2665,19,2700
KARNATAKA,CHIKKAMAGALURU,2021-01-09,15,1631,5,1651
KARNATAKA,CHIKKAMAGALURU,2021-01-10,3,2076,6,2085
KARNATAKA,CHITRADURGA,2021-01-06,5,2088,0,2093
KARNATAKA,CHITRADURGA,2021-01-07,8,2549,1,2558
KARNATAKA,CHITRADURGA,2021-01-08,21,2372,1,2394
KARNATAKA,CHITRADURGA,2021-01-09,5,2394,4,2403
KARNATAKA,CHITRADURGA,2021-01-10,6,2644,0,2650
KARNATAKA,DAKSHINA KANNADA,2021-01-06,58,4149,18,4225
KARNATAKA,DAKSHINA KANNADA,2021-01-07,42,3801,7,3850
KARNATAKA,DAKSHINA KANNADA,2021-01-08,38,4395,6,4439
KARNATAKA,DAKSHINA KANNADA,2021-01-09,48,3988,1,4037
KARNATAKA,DAKSHINA KANNADA,2021-01-10,10,1804,2,1816
KARNATAKA,DAVANGERE,2021-01-06,12,1876,6,1894
KARNATAKA,DAVANGERE,2021-01-07,14,2415,25,2454
KARNATAKA,DAVANGERE,2021-01-08,18,2778,18,2814
KARNATAKA,DAVANGERE,2021-01-09,17,3098,67,3182
KARNATAKA,DAVANGERE,2021-01-10,4,1395,14,1413
KARNATAKA,DHARWAD,2021-01-06,17,6673,48,6738
KARNATAKA,DHARWAD,2021-01-07,16,5781,44,5841
KARNATAKA,DHARWAD,2021-01-08,10,5168,51,5229
KARNATAKA,DHARWAD,2021-01-09,19,4296,6,4321
KARNATAKA,DHARWAD,2021-01-10,11,3434,10,3455
KARNATAKA,GADAG,2021-01-06,0,1517,101,1618
KARNATAKA,GADAG,2021-01-07,7,1675,78,1760
KARNATAKA,GADAG,2021-01-08,4,870,32,906
KARNATAKA,GADAG,2021-01-09,1,453,0,454
KARNATAKA,GADAG,2021-01-10,3,1335,18,1356
KARNATAKA,HASSAN,2021-01-06,32,2658,5,2695
KARNATAKA,HASSAN,2021-01-07,12,2290,9,2311
KARNATAKA,HASSAN,2021-01-08,31,3458,11,3500
KARNATAKA,HASSAN,2021-01-09,24,4987,4,5015
KARNATAKA,HASSAN,2021-01-10,17,4057,2,4076
KARNATAKA,HAVERI,2021-01-06,1,1940,0,1941
KARNATAKA,HAVERI,2021-01-07,1,415,0,416
KARNATAKA,HAVERI,2021-01-08,1,1484,0,1485
KARNATAKA,HAVERI,2021-01-09,2,1826,0,1828
KARNATAKA,HAVERI,2021-01-10,1,1182,0,1183
KARNATAKA,KALABURAGI,2021-01-06,23,3209,24,3256
KARNATAKA,KALABURAGI,2021-01-07,44,3094,1,3139
KARNATAKA,KALABURAGI,2021-01-08,16,2287,4,2307
KARNATAKA,KALABURAGI,2021-01-09,16,1045,5,1066
KARNATAKA,KALABURAGI,2021-01-10,12,2448,2,2462
KARNATAKA,KODAGU,2021-01-06,12,1694,14,1720
KARNATAKA,KODAGU,2021-01-07,10,1405,23,1438
KARNATAKA,KODAGU,2021-01-08,13,1294,48,1355
KARNATAKA,KODAGU,2021-01-09,8,660,14,682
KARNATAKA,KODAGU,2021-01-10,8,487,6,501
KARNATAKA,KOLAR,2021-01-06,18,2709,4,2731
KARNATAKA,KOLAR,2021-01-07,22,4549,1,4572
KARNATAKA,KOLAR,2021-01-08,71,2606,6,2683
KARNATAKA,KOLAR,2021-01-09,14,4903,66,4983
KARNATAKA,KOLAR,2021-01-10,6,2300,1,2307
KARNATAKA,KOPPAL,2021-01-06,0,2583,21,2604
KARNATAKA,KOPPAL,2021-01-07,5,2354,29,2388
KARNATAKA,KOPPAL,2021-01-08,2,1737,8,1747
KARNATAKA,KOPPAL,2021-01-09,6,1630,5,1641
KARNATAKA,KOPPAL,2021-01-10,3,1436,0,1439
KARNATAKA,MANDYA,2021-01-06,19,2719,1,2739
KARNATAKA,MANDYA,2021-01-07,18,3012,1,3031
KARNATAKA,MANDYA,2021-01-08,3,2031,0,2034
KARNATAKA,MANDYA,2021-01-09,4,1337,2,1343
KARNATAKA,MANDYA,2021-01-10,9,2355,1,2365
KARNATAKA,MYSURU,2021-01-06,42,8488,11,8541
KARNATAKA,MYSURU,2021-01-07,36,7331,22,7389
KARNATAKA,MYSURU,2021-01-08,47,7760,15,7822
KARNATAKA,MYSURU,2021-01-09,49,7135,18,7202
KARNATAKA,MYSURU,2021-01-10,41,6248,6,6295
KARNATAKA,RAICHUR,2021-01-06,3,2103,16,2122
KARNATAKA,RAICHUR,2021-01-07,10,2388,9,2407
KARNATAKA,RAICHUR,2021-01-08,15,1285,4,1304
KARNATAKA,RAICHUR,2021-01-09,7,1455,3,1465
KARNATAKA,RAICHUR,2021-01-10,4,457,0,461
KARNATAKA,RAMANAGARA,2021-01-06,3,1954,1,1958
KARNATAKA,RAMANAGARA,2021-01-07,3,708,0,711
KARNATAKA,RAMANAGARA,2021-01-08,0,1233,1,1234
KARNATAKA,RAMANAGARA,2021-01-09,1,760,0,761
KARNATAKA,RAMANAGARA,2021-01-10,1,1024,6,1031
KARNATAKA,SHIVAMOGGA,2021-01-06,33,2449,5,2487
KARNATAKA,SHIVAMOGGA,2021-01-07,17,2476,4,2497
KARNATAKA,SHIVAMOGGA,2021-01-08,21,3443,5,3469
KARNATAKA,SHIVAMOGGA,2021-01-09,6,1427,1,1434
KARNATAKA,SHIVAMOGGA,2021-01-10,5,2034,1,2040
KARNATAKA,TUMAKURU,2021-01-06,50,4031,43,4124
KARNATAKA,TUMAKURU,2021-01-07,24,4133,2,4159
KARNATAKA,TUMAKURU,2021-01-08,21,4617,2,4640
KARNATAKA,TUMAKURU,2021-01-09,24,3747,2,3773
KARNATAKA,TUMAKURU,2021-01-10,10,2144,0,2154
KARNATAKA,UDUPI,2021-01-06,3,3406,2,3411
KARNATAKA,UDUPI,2021-01-07,18,3011,1,3030
KARNATAKA,UDUPI,2021-01-08,19,2117,2,2138
KARNATAKA,UDUPI,2021-01-09,5,2130,2,2137
KARNATAKA,UDUPI,2021-01-10,4,1633,1,1638
KARNATAKA,UTTARA KANNADA,2021-01-06,13,2223,42,2278
KARNATAKA,UTTARA KANNADA,2021-01-07,21,3654,113,3788
KARNATAKA,UTTARA KANNADA,2021-01-08,10,2884,21,2915
KARNATAKA,UTTARA KANNADA,2021-01-09,16,2014,29,2059
KARNATAKA,UTTARA KANNADA,2021-01-10,4,1552,25,1581
KARNATAKA,VIJAYAPURA,2021-01-06,10,1538,1,1549
KARNATAKA,VIJAYAPURA,2021-01-07,15,3066,1,3082
KARNATAKA,VIJAYAPURA,2021-01-08,7,2183,1,2191
KARNATAKA,VIJAYAPURA,2021-01-09,1,2036,0,2037
KARNATAKA,VIJAYAPURA,2021-01-10,11,1602,0,1613
KARNATAKA,YADGIR,2021-01-06,1,1153,0,1154
KARNATAKA,YADGIR,2021-01-07,5,1892,0,1897
KARNATAKA,YADGIR,2021-01-08,3,1806,0,1809
KARNATAKA,YADGIR,2021-01-09,7,1678,0,1685
KARNATAKA,YADGIR,2021-01-10,5,1560,0,1565
KERALA,ALAPPUZHA,2021-01-06,261,2332,1,2594
KERALA,ALAPPUZHA,2021-01-07,240,1432,2,1674
KERALA,ALAPPUZHA,2021-01-08,134,1580,5,1719
KERALA,ALAPPUZHA,2021-01-09,187,1100,5,1292
KERALA,ALAPPUZHA,2021-01-10,116,819,7,942
KERALA,ERNAKULAM,2021-01-06,346,3301,13,3660
KERALA,ERNAKULAM,2021-01-07,347,1633,11,1991
KERALA,ERNAKULAM,2021-01-08,392,1900,6,2298
KERALA,ERNAKULAM,2021-01-09,433,1904,53,2390
KERALA,ERNAKULAM,2021-01-10,188,673,7,868
KERALA,IDUKKI,2021-01-06,209,1223,6,1438
KERALA,IDUKKI,2021-01-07,117,660,7,784
KERALA,IDUKKI,2021-01-08,143,723,13,879
KERALA,IDUKKI,2021-01-09,147,745,6,898
KERALA,IDUKKI,2021-01-10,90,562,16,668
KERALA,KANNUR,2021-01-06,73,1918,3,1994
KERALA,KANNUR,2021-01-07,62,629,3,694
KERALA,KANNUR,2021-01-08,129,702,8,839
KERALA,KANNUR,2021-01-09,80,935,7,1022
KERALA,KANNUR,2021-01-10,164,383,1,548
KERALA,KASARAGOD,2021-01-06,50,1321,0,1371
KERALA,KASARAGOD,2021-01-07,29,720,2,751
KERALA,KASARAGOD,2021-01-08,46,649,1,696
KERALA,KASARAGOD,2021-01-09,44,852,0,896
KERALA,KASARAGOD,2021-01-10,7,137,0,144
KERALA,KOLLAM,2021-01-06,146,2942,0,3088
KERALA,KOLLAM,2021-01-07,83,1610,1,1694
KERALA,KOLLAM,2021-01-08,161,1827,3,1991
KERALA,KOLLAM,2021-01-09,94,1494,6,1594
KERALA,KOLLAM,2021-01-10,96,853,0,949
KERALA,KOTTAYAM,2021-01-06,160,2574,9,2743
KERALA,KOTTAYAM,2021-01-07,236,1439,8,1683
KERALA,KOTTAYAM,2021-01-08,207,1134,12,1353
KERALA,KOTTAYAM,2021-01-09,182,1440,18,1640
KERALA,KOTTAYAM,2021-01-10,117,691,7,815
KERALA,KOZHIKODE,2021-01-06,311,3083,17,3411
KERALA,KOZHIKODE,2021-01-07,273,1625,7,1905
KERALA,KOZHIKODE,2021-01-08,383,1819,8,2210
KERALA,KOZHIKODE,2021-01-09,312,2095,15,2422
KERALA,KOZHIKODE,2021-01-10,242,1251,8,1501
KERALA,MALAPPURAM,2021-01-06,263,2699,0,2962
KERALA,MALAPPURAM,2021-01-07,284,1541,4,1829
KERALA,MALAPPURAM,2021-01-08,356,1677,3,2036
KERALA,MALAPPURAM,2021-01-09,355,1594,7,1956
KERALA,MALAPPURAM,2021-01-10,276,945,2,1223
KERALA,PALAKKAD,2021-01-06,119,2240,1,2360
KERALA,PALAKKAD,2021-01-07,90,1092,0,1182
KERALA,PALAKKAD,2021-01-08,88,1341,4,1433
KERALA,PALAKKAD,2021-01-09,72,746,0,818
KERALA,PALAKKAD,2021-01-10,80,372,0,452
KERALA,PATHANAMTHITTA,2021-01-06,371,2384,4,2759
KERALA,PATHANAMTHITTA,2021-01-07,186,1166,2,1354
KERALA,PATHANAMTHITTA,2021-01-08,347,1798,6,2151
KERALA,PATHANAMTHITTA,2021-01-09,344,2097,9,2450
KERALA,PATHANAMTHITTA,2021-01-10,35,589,0,624
KERALA,THIRUVANANTHAPURAM,2021-01-06,124,3629,0,3753
KERALA,THIRUVANANTHAPURAM,2021-01-07,128,1945,1,2074
KERALA,THIRUVANANTHAPURAM,2021-01-08,129,1392,0,1521
KERALA,THIRUVANANTHAPURAM,2021-01-09,147,1150,0,1297
KERALA,THIRUVANANTHAPURAM,2021-01-10,103,906,0,1009
KERALA,THRISSUR,2021-01-06,149,2426,0,2575
KERALA,THRISSUR,2021-01-07,120,698,0,818
KERALA,THRISSUR,2021-01-08,197,680,0,877
KERALA,THRISSUR,2021-01-09,116,729,0,845
KERALA,THRISSUR,2021-01-10,128,182,0,310
KERALA,WAYANAD,2021-01-06,85,659,7,751
KERALA,WAYANAD,2021-01-07,86,407,2,495
KERALA,WAYANAD,2021-01-08,59,306,1,366
KERALA,WAYANAD,2021-01-09,82,261,10,353
KERALA,WAYANAD,2021-01-10,14,112,0,126
LADAKH,KARGIL,2021-01-06,0,65,0,65
LADAKH,KARGIL,2021-01-07,0,54,0,54
LADAKH,KARGIL,2021-01-08,1,100,0,101
LADAKH,KARGIL,2021-01-09,0,47,0,47
LADAKH,KARGIL,2021-01-10,1,61,0,62
LADAKH,LEH LADAKH,2021-01-06,10,66,0,76
LADAKH,LEH LADAKH,2021-01-07,3,186,0,189
LADAKH,LEH LADAKH,2021-01-08,5,250,0,255
LADAKH,LEH LADAKH,2021-01-09,12,180,1,193
LADAKH,LEH LADAKH,2021-01-10,2,114,0,116
LAKSHADWEEP,LAKSHADWEEP DISTRICT,2021-01-06,0,114,0,114
LAKSHADWEEP,LAKSHADWEEP DISTRICT,2021-01-07,3,305,0,308
LAKSHADWEEP,LAKSHADWEEP DISTRICT,2021-01-08,0,68,0,68
LAKSHADWEEP,LAKSHADWEEP DISTRICT,2021-01-09,0,74,0,74
LAKSHADWEEP,LAKSHADWEEP DISTRICT,2021-01-10,0,63,0,63
MADHYA PRADESH,AGAR MALWA,2021-01-06,3,273,0,276
MADHYA PRADESH,AGAR MALWA,2021-01-07,0,238,0,238
MADHYA PRADESH,AGAR MALWA,2021-01-08,3,202,0,205
MADHYA PRADESH,AGAR MALWA,2021-01-09,3,173,0,176
MADHYA PRADESH,AGAR MALWA,2021-01-10,0,98,0,98
MADHYA PRADESH,ALIRAJPUR,2021-01-06,5,301,0,306
MADHYA PRADESH,ALIRAJPUR,2021-01-07,1,181,0,182
MADHYA PRADESH,ALIRAJPUR,2021-01-08,1,148,0,149
MADHYA PRADESH,ALIRAJPUR,2021-01-09,3,102,1,106
MADHYA PRADESH,ALIRAJPUR,2021-01-10,3,5,0,8
MADHYA PRADESH,ANUPPUR,2021-01-06,6,163,1,170
MADHYA PRADESH,ANUPPUR,2021-01-07,3,278,13,294
MADHYA PRADESH,ANUPPUR,2021-01-08,1,39,0,40
MADHYA PRADESH,ANUPPUR,2021-01-09,6,34,0,40
MADHYA PRADESH,ANUPPUR,2021-01-10,3,18,0,21
MADHYA PRADESH,ASHOKNAGAR,2021-01-06,6,108,3,117
MADHYA PRADESH,ASHOKNAGAR,2021-01-07,0,228,2,230
MADHYA PRADESH,ASHOKNAGAR,2021-01-08,1,287,0,288
MADHYA PRADESH,ASHOKNAGAR,2021-01-09,3,233,0,236
MADHYA PRADESH,ASHOKNAGAR,2021-01-10,3,24,0,27
MADHYA PRADESH,BALAGHAT,2021-01-06,12,479,1,492
MADHYA PRADESH,BALAGHAT,2021-01-07,9,344,0,353
MADHYA PRADESH,BALAGHAT,2021-01-08,15,469,1,485
MADHYA PRADESH,BALAGHAT,2021-01-09,7,479,2,488
MADHYA PRADESH,BALAGHAT,2021-01-10,11,478,0,489
MADHYA PRADESH,BARWANI,2021-01-06,10,221,0,231
MADHYA PRADESH,BARWANI,2021-01-07,7,170,0,177
MADHYA PRADESH,BARWANI,2021-01-08,7,120,0,127
MADHYA PRADESH,BARWANI,2021-01-09,11,314,13,338
MADHYA PRADESH,BARWANI,2021-01-10,8,269,0,277
MADHYA PRADESH,BETUL,2021-01-06,6,418,6,430
MADHYA PRADESH,BETUL,2021-01-07,17,314,0,331
MADHYA PRADESH,BETUL,2021-01-08,4,467,0,471
MADHYA PRADESH,BETUL,2021-01-09,32,459,4,495
MADHYA PRADESH,BETUL,2021-01-10,8,319,7,334
MADHYA PRADESH,BHIND,2021-01-06,3,420,1,424
MADHYA PRADESH,BHIND,2021-01-07,1,430,0,431
MADHYA PRADESH,BHIND,2021-01-08,2,344,0,346
MADHYA PRADESH,BHIND,2021-01-09,0,396,0,396
MADHYA PRADESH,BHIND,2021-01-10,0,203,1,204
MADHYA PRADESH,BHOPAL,2021-01-06,237,2203,29,2469
MADHYA PRADESH,BHOPAL,2021-01-07,210,2255,9,2474
MADHYA PRADESH,BHOPAL,2021-01-08,175,2449,32,2656
MADHYA PRADESH,BHOPAL,2021-01-09,187,2010,4,2201
MADHYA PRADESH,BHOPAL,2021-01-10,103,919,5,1027
MADHYA PRADESH,BURHANPUR,2021-01-06,4,344,0,348
MADHYA PRADESH,BURHANPUR,2021-01-07,0,63,0,63
MADHYA PRADESH,BURHANPUR,2021-01-08,1,92,0,93
MADHYA PRADESH,BURHANPUR,2021-01-09,1,103,3,107
MADHYA PRADESH,BURHANPUR,2021-01-10,0,103,0,103
MADHYA PRADESH,CHHATARPUR,2021-01-06,2,194,1,197
MADHYA PRADESH,CHHATARPUR,2021-01-07,11,303,0,314
MADHYA PRADESH,CHHATARPUR,2021-01-08,0,145,0,145
MADHYA PRADESH,CHHATARPUR,2021-01-09,4,301,0,305
MADHYA PRADESH,CHHATARPUR,2021-01-10,3,381,0,384
MADHYA PRADESH,CHHINDWARA,2021-01-06,17,407,16,440
MADHYA PRADESH,CHHINDWARA,2021-01-07,9,375,8,392
MADHYA PRADESH,CHHINDWARA,2021-01-08,10,252,2,264
MADHYA PRADESH,CHHINDWARA,2021-01-09,1,362,1,364
MADHYA PRADESH,CHHINDWARA,2021-01-10,8,276,6,290
MADHYA PRADESH,DAMOH,2021-01-06,5,190,0,195
MADHYA PRADESH,DAMOH,2021-01-07,6,343,1,350
MADHYA PRADESH,DAMOH,2021-01-08,2,109,0,111
MADHYA PRADESH,DAMOH,2021-01-09,3,287,0,290
MADHYA PRADESH,DAMOH,2021-01-10,6,260,0,266
MADHYA PRADESH,DATIA,2021-01-06,10,376,2,388
MADHYA PRADESH,DATIA,2021-01-07,3,382,1,386
MADHYA PRADESH,DATIA,2021-01-08,6,314,13,333
MADHYA PRADESH,DATIA,2021-01-09,4,255,0,259
MADHYA PRADESH,DATIA,2021-01-10,3,207,3,213
MADHYA PRADESH,DEWAS,2021-01-06,17,617,0,634
MADHYA PRADESH,DEWAS,2021-01-07,8,701,0,709
MADHYA PRADESH,DEWAS,2021-01-08,16,149,0,165
MADHYA PRADESH,DEWAS,2021-01-09,15,460,0,475
MADHYA PRADESH,DEWAS,2021-01-10,8,91,0,99
MADHYA PRADESH,DHAR,2021-01-06,20,450,0,470
MADHYA PRADESH,DHAR,2021-01-07,6,231,0,237
MADHYA PRADESH,DHAR,2021-01-08,7,121,0,128
MADHYA PRADESH,DHAR,2021-01-09,7,252,19,278
MADHYA PRADESH,DHAR,2021-01-10,13,386,0,399
MADHYA PRADESH,DINDORI,2021-01-06,1,242,0,243
MADHYA PRADESH,DINDORI,2021-01-07,0,238,0,238
MADHYA PRADESH,DINDORI,2021-01-08,0,125,40,165
MADHYA PRADESH,DINDORI,2021-01-09,0,156,0,156
MADHYA PRADESH,DINDORI,2021-01-10,4,143,0,147
MADHYA PRADESH,EAST NIMAR,2021-01-06,4,455,1,460
MADHYA PRADESH,EAST NIMAR,2021-01-07,0,216,0,216
MADHYA PRADESH,EAST NIMAR,2021-01-08,0,248,0,248
MADHYA PRADESH,EAST NIMAR,2021-01-09,1,378,4,383
MADHYA PRADESH,EAST NIMAR,2021-01-10,2,355,0,357
MADHYA PRADESH,GUNA,2021-01-06,12,209,0,221
MADHYA PRADESH,GUNA,2021-01-07,2,327,0,329
MADHYA PRADESH,GUNA,2021-01-08,3,344,1,348
MADHYA PRADESH,GUNA,2021-01-09,2,345,0,347
MADHYA PRADESH,GUNA,2021-01-10,7,240,0,247
MADHYA PRADESH,GWALIOR,2021-01-06,24,1863,6,1893
MADHYA PRADESH,GWALIOR,2021-01-07,14,1618,1,1633
MADHYA PRADESH,GWALIOR,2021-01-08,32,1450,3,1485
MADHYA PRADESH,GWALIOR,2021-01-09,27,1465,7,1499
MADHYA PRADESH,GWALIOR,2021-01-10,16,1586,4,1606
MADHYA PRADESH,HARDA,2021-01-06,1,185,3,189
MADHYA PRADESH,HARDA,2021-01-07,1,324,0,325
MADHYA PRADESH,HARDA,2021-01-08,0,294,9,303
MADHYA PRADESH,HARDA,2021-01-09,11,300,14,325
MADHYA PRADESH,HARDA,2021-01-10,7,294,0,301
MADHYA PRADESH,HOSHANGABAD,2021-01-06,12,436,6,454
MADHYA PRADESH,HOSHANGABAD,2021-01-07,25,443,3,471
MADHYA PRADESH,HOSHANGABAD,2021-01-08,13,362,8,383
MADHYA PRADESH,HOSHANGABAD,2021-01-09,17,361,6,384
MADHYA PRADESH,HOSHANGABAD,2021-01-10,12,346,1,359
MADHYA PRADESH,INDORE,2021-01-06,218,3396,2,3616
MADHYA PRADESH,INDORE,2021-01-07,196,3105,0,3301
MADHYA PRADESH,INDORE,2021-01-08,176,3328,1,3505
MADHYA PRADESH,INDORE,2021-01-09,169,3296,9,3474
MADHYA PRADESH,INDORE,2021-01-10,104,2509,0,2613
MADHYA PRADESH,JABALPUR,2021-01-06,92,549,0,641
MADHYA PRADESH,JABALPUR,2021-01-07,31,442,1,474
MADHYA PRADESH,JABALPUR,2021-01-08,99,288,5,392
MADHYA PRADESH,JABALPUR,2021-01-09,118,404,11,533
MADHYA PRADESH,JABALPUR,2021-01-10,35,270,0,305
MADHYA PRADESH,JHABUA,2021-01-06,11,582,0,593
MADHYA PRADESH,JHABUA,2021-01-07,2,239,0,241
MADHYA PRADESH,JHABUA,2021-01-08,8,158,0,166
MADHYA PRADESH,JHABUA,2021-01-09,3,121,2,126
MADHYA PRADESH,JHABUA,2021-01-10,11,720,0,731
MADHYA PRADESH,KATNI,2021-01-06,3,216,8,227
MADHYA PRADESH,KATNI,2021-01-07,4,244,0,248
MADHYA PRADESH,KATNI,2021-01-08,4,279,1,284
MADHYA PRADESH,KATNI,2021-01-09,9,266,5,280
MADHYA PRADESH,KATNI,2021-01-10,1,179,11,191
MADHYA PRADESH,KHARGONE,2021-01-06,31,632,0,663
MADHYA PRADESH,KHARGONE,2021-01-07,9,244,0,253
MADHYA PRADESH,KHARGONE,2021-01-08,12,256,0,268
MADHYA PRADESH,KHARGONE,2021-01-09,17,457,13,487
MADHYA PRADESH,KHARGONE,2021-01-10,10,318,0,328
MADHYA PRADESH,MANDLA,2021-01-06,1,139,1,141
MADHYA PRADESH,MANDLA,2021-01-07,1,27,0,28
MADHYA PRADESH,MANDLA,2021-01-08,0,123,0,123
MADHYA PRADESH,MANDLA,2021-01-09,6,255,33,294
MADHYA PRADESH,MANDLA,2021-01-10,1,152,0,153
MADHYA PRADESH,MANDSAUR,2021-01-06,12,224,50,286
MADHYA PRADESH,MANDSAUR,2021-01-07,2,184,0,186
MADHYA PRADESH,MANDSAUR,2021-01-08,2,159,3,164
MADHYA PRADESH,MANDSAUR,2021-01-09,4,222,0,226
MADHYA PRADESH,MANDSAUR,2021-01-10,8,130,1,139
MADHYA PRADESH,MORENA,2021-01-06,2,326,0,328
MADHYA PRADESH,MORENA,2021-01-07,3,551,0,554
MADHYA PRADESH,MORENA,2021-01-08,2,403,1,406
MADHYA PRADESH,MORENA,2021-01-09,2,463,2,467
MADHYA PRADESH,MORENA,2021-01-10,3,317,0,320
MADHYA PRADESH,NARSINGHPUR,2021-01-06,6,419,0,425
MADHYA PRADESH,NARSINGHPUR,2021-01-07,6,252,0,258
MADHYA PRADESH,NARSINGHPUR,2021-01-08,4,373,4,381
MADHYA PRADESH,NARSINGHPUR,2021-01-09,7,209,2,218
MADHYA PRADESH,NARSINGHPUR,2021-01-10,2,327,1,330
MADHYA PRADESH,NEEMUCH,2021-01-06,3,274,44,321
MADHYA PRADESH,NEEMUCH,2021-01-07,1,171,2,174
MADHYA PRADESH,NEEMUCH,2021-01-08,4,146,0,150
MADHYA PRADESH,NEEMUCH,2021-01-09,2,200,1,203
MADHYA PRADESH,NEEMUCH,2021-01-10,1,169,0,170
MADHYA PRADESH,NIWARI,2021-01-06,0,239,1,240
MADHYA PRADESH,NIWARI,2021-01-07,0,51,0,51
MADHYA PRADESH,NIWARI,2021-01-08,4,203,0,207
MADHYA PRADESH,NIWARI,2021-01-09,0,51,0,51
MADHYA PRADESH,NIWARI,2021-01-10,0,99,0,99
MADHYA PRADESH,PANNA,2021-01-06,8,157,0,165
MADHYA PRADESH,PANNA,2021-01-07,12,118,0,130
MADHYA PRADESH,PANNA,2021-01-08,6,217,0,223
MADHYA PRADESH,PANNA,2021-01-09,4,193,0,197
MADHYA PRADESH,PANNA,2021-01-10,0,100,0,100
MADHYA PRADESH,RAISEN,2021-01-06,11,294,1,306
MADHYA PRADESH,RAISEN,2021-01-07,9,259,0,268
MADHYA PRADESH,RAISEN,2021-01-08,3,214,0,217
MADHYA PRADESH,RAISEN,2021-01-09,5,142,0,147
MADHYA PRADESH,RAISEN,2021-01-10,3,92,0,95
MADHYA PRADESH,RAJGARH,2021-01-06,11,233,0,244
MADHYA PRADESH,RAJGARH,2021-01-07,2,245,0,247
MADHYA PRADESH,RAJGARH,2021-01-08,11,247,1,259
MADHYA PRADESH,RAJGARH,2021-01-09,15,233,7,255
MADHYA PRADESH,RAJGARH,2021-01-10,2,279,0,281
MADHYA PRADESH,RATLAM,2021-01-06,14,276,84,374
MADHYA PRADESH,RATLAM,2021-01-07,5,390,0,395
MADHYA PRADESH,RATLAM,2021-01-08,4,326,1,331
MADHYA PRADESH,RATLAM,2021-01-09,3,312,0,315
MADHYA PRADESH,RATLAM,2021-01-10,12,165,3,180
MADHYA PRADESH,REWA,2021-01-06,30,698,1,729
MADHYA PRADESH,REWA,2021-01-07,20,682,2,704
MADHYA PRADESH,REWA,2021-01-08,19,697,7,723
MADHYA PRADESH,REWA,2021-01-09,23,631,2,656
MADHYA PRADESH,REWA,2021-01-10,9,666,1,676
MADHYA PRADESH,SAGAR,2021-01-06,4,914,1,919
MADHYA PRADESH,SAGAR,2021-01-07,22,688,2,712
MADHYA PRADESH,SAGAR,2021-01-08,14,1023,1,1038
MADHYA PRADESH,SAGAR,2021-01-09,12,836,0,848
MADHYA PRADESH,SAGAR,2021-01-10,17,704,0,721
MADHYA PRADESH,SATNA,2021-01-06,8,319,1,328
MADHYA PRADESH,SATNA,2021-01-07,8,749,0,757
MADHYA PRADESH,SATNA,2021-01-08,14,582,0,596
MADHYA PRADESH,SATNA,2021-01-09,13,854,2,869
MADHYA PRADESH,SATNA,2021-01-10,4,173,0,177
MADHYA PRADESH,SEHORE,2021-01-06,3,475,0,478
MADHYA PRADESH,SEHORE,2021-01-07,12,349,3,364
MADHYA PRADESH,SEHORE,2021-01-08,12,476,0,488
MADHYA PRADESH,SEHORE,2021-01-09,5,273,2,280
MADHYA PRADESH,SEHORE,2021-01-10,1,457,0,458
MADHYA PRADESH,SEONI,2021-01-06,3,188,257,448
MADHYA PRADESH,SEONI,2021-01-07,16,133,264,413
MADHYA PRADESH,SEONI,2021-01-08,12,258,149,419
MADHYA PRADESH,SEONI,2021-01-09,4,306,0,310
MADHYA PRADESH,SEONI,2021-01-10,2,72,0,74
MADHYA PRADESH,SHAHDOL,2021-01-06,0,33,5,38
MADHYA PRADESH,SHAHDOL,2021-01-07,0,172,0,172
MADHYA PRADESH,SHAHDOL,2021-01-08,1,13,0,14
MADHYA PRADESH,SHAHDOL,2021-01-09,2,26,0,28
MADHYA PRADESH,SHAHDOL,2021-01-10,0,39,0,39
MADHYA PRADESH,SHAJAPUR,2021-01-06,10,488,0,498
MADHYA PRADESH,SHAJAPUR,2021-01-07,4,188,0,192
MADHYA PRADESH,SHAJAPUR,2021-01-08,3,240,0,243
MADHYA PRADESH,SHAJAPUR,2021-01-09,7,264,0,271
MADHYA PRADESH,SHAJAPUR,2021-01-10,7,78,0,85
MADHYA PRADESH,SHEOPUR,2021-01-06,0,167,0,167
MADHYA PRADESH,SHEOPUR,2021-01-07,2,64,1,67
MADHYA PRADESH,SHEOPUR,2021-01-08,3,250,0,253
MADHYA PRADESH,SHEOPUR,2021-01-09,3,45,0,48
MADHYA PRADESH,SHEOPUR,2021-01-10,14,298,1,313
MADHYA PRADESH,SHIVPURI,2021-01-06,17,229,0,246
MADHYA PRADESH,SHIVPURI,2021-01-07,9,318,1,328
MADHYA PRADESH,SHIVPURI,2021-01-08,7,265,0,272
MADHYA PRADESH,SHIVPURI,2021-01-09,8,219,13,240
MADHYA PRADESH,SHIVPURI,2021-01-10,2,158,1,161
MADHYA PRADESH,SIDHI,2021-01-06,3,78,0,81
MADHYA PRADESH,SIDHI,2021-01-07,3,37,0,40
MADHYA PRADESH,SIDHI,2021-01-08,2,252,1,255
MADHYA PRADESH,SIDHI,2021-01-09,1,383,0,384
MADHYA PRADESH,SIDHI,2021-01-10,1,329,0,330
MADHYA PRADESH,SINGRAULI,2021-01-06,0,279,0,279
MADHYA PRADESH,SINGRAULI,2021-01-07,5,259,0,264
MADHYA PRADESH,SINGRAULI,2021-01-08,4,165,0,169
MADHYA PRADESH,SINGRAULI,2021-01-09,2,151,1,154
MADHYA PRADESH,SINGRAULI,2021-01-10,4,227,0,231
MADHYA PRADESH,TIKAMGARH,2021-01-06,3,168,0,171
MADHYA PRADESH,TIKAMGARH,2021-01-07,2,73,0,75
MADHYA PRADESH,TIKAMGARH,2021-01-08,4,162,0,166
MADHYA PRADESH,TIKAMGARH,2021-01-09,4,211,0,215
MADHYA PRADESH,TIKAMGARH,2021-01-10,0,240,1,241
MADHYA PRADESH,UJJAIN,2021-01-06,37,656,1,694
MADHYA PRADESH,UJJAIN,2021-01-07,29,546,5,580
MADHYA PRADESH,UJJAIN,2021-01-08,33,547,0,580
MADHYA PRADESH,UJJAIN,2021-01-09,29,473,0,502
MADHYA PRADESH,UJJAIN,2021-01-10,16,553,1,570
MADHYA PRADESH,UMARIA,2021-01-06,3,141,7,151
MADHYA PRADESH,UMARIA,2021-01-07,0,57,0,57
MADHYA PRADESH,UMARIA,2021-01-08,3,48,0,51
MADHYA PRADESH,UMARIA,2021-01-09,6,49,0,55
MADHYA PRADESH,UMARIA,2021-01-10,2,10,0,12
MADHYA PRADESH,VIDISHA,2021-01-06,7,359,14,380
MADHYA PRADESH,VIDISHA,2021-01-07,0,137,0,137
MADHYA PRADESH,VIDISHA,2021-01-08,5,218,10,233
MADHYA PRADESH,VIDISHA,2021-01-09,6,80,0,86
MADHYA PRADESH,VIDISHA,2021-01-10,2,227,5,234
MAHARASHTRA,AHMEDNAGAR,2021-01-06,115,875,1,991
MAHARASHTRA,AHMEDNAGAR,2021-01-07,115,704,0,819
MAHARASHTRA,AHMEDNAGAR,2021-01-08,105,694,0,799
MAHARASHTRA,AHMEDNAGAR,2021-01-09,106,597,1,704
MAHARASHTRA,AHMEDNAGAR,2021-01-10,95,656,0,751
MAHARASHTRA,AKOLA,2021-01-06,39,652,1,692
MAHARASHTRA,AKOLA,2021-01-07,42,504,1,547
MAHARASHTRA,AKOLA,2021-01-08,50,401,0,451
MAHARASHTRA,AKOLA,2021-01-09,38,602,0,640
MAHARASHTRA,AKOLA,2021-01-10,43,540,3,586
MAHARASHTRA,AMRAVATI,2021-01-06,56,616,3,675
MAHARASHTRA,AMRAVATI,2021-01-07,69,624,1,694
MAHARASHTRA,AMRAVATI,2021-01-08,68,955,0,1023
MAHARASHTRA,AMRAVATI,2021-01-09,56,701,0,757
MAHARASHTRA,AMRAVATI,2021-01-10,47,763,1,811
MAHARASHTRA,AURANGABAD,2021-01-06,30,527,4,561
MAHARASHTRA,AURANGABAD,2021-01-07,66,579,4,649
MAHARASHTRA,AURANGABAD,2021-01-08,147,710,2,859
MAHARASHTRA,AURANGABAD,2021-01-09,16,304,0,320
MAHARASHTRA,AURANGABAD,2021-01-10,13,413,1,427
MAHARASHTRA,BEED,2021-01-06,33,549,0,582
MAHARASHTRA,BEED,2021-01-07,41,472,0,513
MAHARASHTRA,BEED,2021-01-08,34,473,0,507
MAHARASHTRA,BEED,2021-01-09,40,501,1,542
MAHARASHTRA,BEED,2021-01-10,37,383,1,421
MAHARASHTRA,BHANDARA,2021-01-06,51,446,0,497
MAHARASHTRA,BHANDARA,2021-01-07,44,251,0,295
MAHARASHTRA,BHANDARA,2021-01-08,25,406,1,432
MAHARASHTRA,BHANDARA,2021-01-09,40,340,1,381
MAHARASHTRA,BHANDARA,2021-01-10,31,179,0,210
MAHARASHTRA,BULDHANA,2021-01-06,47,266,6,319
MAHARASHTRA,BULDHANA,2021-01-07,55,318,2,375
MAHARASHTRA,BULDHANA,2021-01-08,41,474,5,520
MAHARASHTRA,BULDHANA,2021-01-09,48,356,2,406
MAHARASHTRA,BULDHANA,2021-01-10,28,262,3,293
MAHARASHTRA,CHANDRAPUR,2021-01-06,57,809,1,867
MAHARASHTRA,CHANDRAPUR,2021-01-07,67,841,2,910
MAHARASHTRA,CHANDRAPUR,2021-01-08,44,786,8,838
MAHARASHTRA,CHANDRAPUR,2021-01-09,47,509,2,558
MAHARASHTRA,CHANDRAPUR,2021-01-10,14,446,1,461
MAHARASHTRA,DHULE,2021-01-06,13,376,0,389
MAHARASHTRA,DHULE,2021-01-07,21,390,27,438
MAHARASHTRA,DHULE,2021-01-08,22,402,81,505
MAHARASHTRA,DHULE,2021-01-09,9,389,7,405
MAHARASHTRA,DHULE,2021-01-10,10,133,1,144
MAHARASHTRA,GADCHIROLI,2021-01-06,20,923,1,944
MAHARASHTRA,GADCHIROLI,2021-01-07,15,888,1,904
MAHARASHTRA,GADCHIROLI,2021-01-08,12,678,1,691
MAHARASHTRA,GADCHIROLI,2021-01-09,13,609,0,622
MAHARASHTRA,GADCHIROLI,2021-01-10,14,362,0,376
MAHARASHTRA,GONDIA,2021-01-06,33,371,3,407
MAHARASHTRA,GONDIA,2021-01-07,30,547,2,579
MAHARASHTRA,GONDIA,2021-01-08,17,410,1,428
MAHARASHTRA,GONDIA,2021-01-09,21,338,4,363
MAHARASHTRA,GONDIA,2021-01-10,16,99,0,115
MAHARASHTRA,HINGOLI,2021-01-06,5,197,0,202
MAHARASHTRA,HINGOLI,2021-01-07,11,236,0,247
MAHARASHTRA,HINGOLI,2021-01-08,1,89,0,90
MAHARASHTRA,HINGOLI,2021-01-09,16,302,0,318
MAHARASHTRA,HINGOLI,2021-01-10,7,98,0,105
MAHARASHTRA,JALGAON,2021-01-06,57,1260,0,1317
MAHARASHTRA,JALGAON,2021-01-07,37,1106,1,1144
MAHARASHTRA,JALGAON,2021-01-08,73,1135,0,1208
MAHARASHTRA,JALGAON,2021-01-09,86,924,1,1011
MAHARASHTRA,JALGAON,2021-01-10,45,366,0,411
MAHARASHTRA,JALNA,2021-01-06,13,308,0,321
MAHARASHTRA,JALNA,2021-01-07,0,248,0,248
MAHARASHTRA,JALNA,2021-01-08,37,295,0,332
MAHARASHTRA,JALNA,2021-01-09,15,352,0,367
MAHARASHTRA,JALNA,2021-01-10,18,284,5,307
MAHARASHTRA,KOLHAPUR,2021-01-06,6,954,21,981
MAHARASHTRA,KOLHAPUR,2021-01-07,9,1047,3,1059
MAHARASHTRA,KOLHAPUR,2021-01-08,9,646,3,658
MAHARASHTRA,KOLHAPUR,2021-01-09,22,1261,6,1289
MAHARASHTRA,KOLHAPUR,2021-01-10,18,604,1,623
MAHARASHTRA,LATUR,2021-01-06,29,1826,2,1857
MAHARASHTRA,LATUR,2021-01-07,24,1355,2,1381
MAHARASHTRA,LATUR,2021-01-08,50,1317,5,1372
MAHARASHTRA,LATUR,2021-01-09,42,1406,3,1451
MAHARASHTRA,LATUR,2021-01-10,48,1067,2,1117
MAHARASHTRA,MUMBAI,2021-01-06,626,14418,54,15098
MAHARASHTRA,MUMBAI,2021-01-07,568,12973,43,13584
MAHARASHTRA,MUMBAI,2021-01-08,534,13948,6,14488
MAHARASHTRA,MUMBAI,2021-01-09,662,12694,10,13366
MAHARASHTRA,MUMBAI,2021-01-10,399,8516,6,8921
MAHARASHTRA,MUMBAI SUBURBAN,2021-01-06,148,2840,1,2989
MAHARASHTRA,MUMBAI SUBURBAN,2021-01-07,164,2759,6,2929
MAHARASHTRA,MUMBAI SUBURBAN,2021-01-08,172,2803,7,2982
MAHARASHTRA,MUMBAI SUBURBAN,2021-01-09,203,2793,9,3005
MAHARASHTRA,MUMBAI SUBURBAN,2021-01-10,92,1853,2,1947
MAHARASHTRA,NAGPUR,2021-01-06,545,3264,14,3823
MAHARASHTRA,NAGPUR,2021-01-07,499,3647,23,4169
MAHARASHTRA,NAGPUR,2021-01-08,403,3243,19,3665
MAHARASHTRA,NAGPUR,2021-01-09,498,3319,21,3838
MAHARASHTRA,NAGPUR,2021-01-10,348,1904,20,2272
MAHARASHTRA,NANDED,2021-01-06,43,743,11,797
MAHARASHTRA,NANDED,2021-01-07,32,908,4,944
MAHARASHTRA,NANDED,2021-01-08,34,846,3,883
MAHARASHTRA,NANDED,2021-01-09,37,919,6,962
MAHARASHTRA,NANDED,2021-01-10,18,582,0,600
MAHARASHTRA,NANDURBAR,2021-01-06,30,165,2,197
MAHARASHTRA,NANDURBAR,2021-01-07,54,249,0,303
MAHARASHTRA,NANDURBAR,2021-01-08,50,241,0,291
MAHARASHTRA,NANDURBAR,2021-01-09,45,114,0,159
MAHARASHTRA,NANDURBAR,2021-01-10,118,58,1,177
MAHARASHTRA,NASHIK,2021-01-06,144,1276,1,1421
MAHARASHTRA,NASHIK,2021-01-07,319,1961,1,2281
MAHARASHTRA,NASHIK,2021-01-08,225,2176,3,2404
MAHARASHTRA,NASHIK,2021-01-09,225,2000,3,2228
MAHARASHTRA,NASHIK,2021-01-10,105,1479,0,1584
MAHARASHTRA,OSMANABAD,2021-01-06,18,396,1,415
MAHARASHTRA,OSMANABAD,2021-01-07,28,516,1,545
MAHARASHTRA,OSMANABAD,2021-01-08,19,355,0,374
MAHARASHTRA,OSMANABAD,2021-01-09,28,294,2,324
MAHARASHTRA,OSMANABAD,2021-01-10,35,282,1,318
MAHARASHTRA,PALGHAR,2021-01-06,65,1052,2,1119
MAHARASHTRA,PALGHAR,2021-01-07,31,1207,3,1241
MAHARASHTRA,PALGHAR,2021-01-08,60,778,3,841
MAHARASHTRA,PALGHAR,2021-01-09,38,801,1,840
MAHARASHTRA,PALGHAR,2021-01-10,31,412,0,443
MAHARASHTRA,PARBHANI,2021-01-06,4,957,0,961
MAHARASHTRA,PARBHANI,2021-01-07,17,615,0,632
MAHARASHTRA,PARBHANI,2021-01-08,20,748,2,770
MAHARASHTRA,PARBHANI,2021-01-09,13,573,0,586
MAHARASHTRA,PARBHANI,2021-01-10,10,483,0,493
MAHARASHTRA,PUNE,2021-01-06,759,7919,148,8826
MAHARASHTRA,PUNE,2021-01-07,670,7995,26,8691
MAHARASHTRA,PUNE,2021-01-08,669,8210,31,8910
MAHARASHTRA,PUNE,2021-01-09,685,7808,44,8537
MAHARASHTRA,PUNE,2021-01-10,368,5004,37,5409
MAHARASHTRA,RAIGAD,2021-01-06,116,1065,0,1181
MAHARASHTRA,RAIGAD,2021-01-07,110,1001,0,1111
MAHARASHTRA,RAIGAD,2021-01-08,90,1009,2,1101
MAHARASHTRA,RAIGAD,2021-01-09,81,1692,1,1774
MAHARASHTRA,RAIGAD,2021-01-10,67,740,1,808
MAHARASHTRA,RATNAGIRI,2021-01-06,12,368,0,380
MAHARASHTRA,RATNAGIRI,2021-01-07,16,374,0,390
MAHARASHTRA,RATNAGIRI,2021-01-08,7,329,0,336
MAHARASHTRA,RATNAGIRI,2021-01-09,18,229,1,248
MAHARASHTRA,RATNAGIRI,2021-01-10,11,194,0,205
MAHARASHTRA,SANGLI,2021-01-06,34,797,2,833
MAHARASHTRA,SANGLI,2021-01-07,29,811,3,843
MAHARASHTRA,SANGLI,2021-01-08,17,843,1,861
MAHARASHTRA,SANGLI,2021-01-09,33,738,1,772
MAHARASHTRA,SANGLI,2021-01-10,37,297,3,337
MAHARASHTRA,SATARA,2021-01-06,62,809,10,881
MAHARASHTRA,SATARA,2021-01-07,56,1148,38,1242
MAHARASHTRA,SATARA,2021-01-08,93,894,10,997
MAHARASHTRA,SATARA,2021-01-09,61,758,7,826
MAHARASHTRA,SATARA,2021-01-10,24,711,6,741
MAHARASHTRA,SINDHUDURG,2021-01-06,5,194,1,200
MAHARASHTRA,SINDHUDURG,2021-01-07,19,193,0,212
MAHARASHTRA,SINDHUDURG,2021-01-08,8,193,0,201
MAHARASHTRA,SINDHUDURG,2021-01-09,13,193,0,206
MAHARASHTRA,SINDHUDURG,2021-01-10,2,62,0,64
MAHARASHTRA,SOLAPUR,2021-01-06,103,2008,2,2113
MAHARASHTRA,SOLAPUR,2021-01-07,101,1991,1,2093
MAHARASHTRA,SOLAPUR,2021-01-08,106,2011,0,2117
MAHARASHTRA,SOLAPUR,2021-01-09,102,1999,0,2101
MAHARASHTRA,SOLAPUR,2021-01-10,72,793,3,868
MAHARASHTRA,THANE,2021-01-06,531,8941,20,9492
MAHARASHTRA,THANE,2021-01-07,585,13286,23,13894
MAHARASHTRA,THANE,2021-01-08,451,15113,9,15573
MAHARASHTRA,THANE,2021-01-09,506,9727,10,10243
MAHARASHTRA,THANE,2021-01-10,348,6743,12,7103
MAHARASHTRA,WARDHA,2021-01-06,70,699,4,773
MAHARASHTRA,WARDHA,2021-01-07,59,499,24,582
MAHARASHTRA,WARDHA,2021-01-08,60,638,26,724
MAHARASHTRA,WARDHA,2021-01-09,51,385,5,441
MAHARASHTRA,WARDHA,2021-01-10,18,142,1,161
MAHARASHTRA,WASHIM,2021-01-06,12,565,8,585
MAHARASHTRA,WASHIM,2021-01-07,6,366,7,379
MAHARASHTRA,WASHIM,2021-01-08,12,332,5,349
MAHARASHTRA,WASHIM,2021-01-09,17,258,4,279
MAHARASHTRA,WASHIM,2021-01-10,13,704,2,719
MAHARASHTRA,YAVATMAL,2021-01-06,67,416,5,488
MAHARASHTRA,YAVATMAL,2021-01-07,86,453,0,539
MAHARASHTRA,YAVATMAL,2021-01-08,67,367,0,434
MAHARASHTRA,YAVATMAL,2021-01-09,69,320,1,390
MAHARASHTRA,YAVATMAL,2021-01-10,47,235,13,295
MANIPUR,BISHNUPUR,2021-01-06,1,50,0,51
MANIPUR,BISHNUPUR,2021-01-07,0,128,0,128
MANIPUR,BISHNUPUR,2021-01-08,0,116,0,116
MANIPUR,BISHNUPUR,2021-01-09,0,101,0,101
MANIPUR,BISHNUPUR,2021-01-10,3,55,0,58
MANIPUR,CHANDEL,2021-01-06,0,13,1,14
MANIPUR,CHANDEL,2021-01-07,4,16,0,20
MANIPUR,CHANDEL,2021-01-08,0,33,0,33
MANIPUR,CHANDEL,2021-01-09,1,23,0,24
MANIPUR,CHANDEL,2021-01-10,1,25,0,26
MANIPUR,CHURACHANDPUR,2021-01-06,13,226,1,240
MANIPUR,CHURACHANDPUR,2021-01-07,1,63,0,64
MANIPUR,CHURACHANDPUR,2021-01-08,6,76,0,82
MANIPUR,CHURACHANDPUR,2021-01-09,6,45,0,51
MANIPUR,CHURACHANDPUR,2021-01-10,3,64,7,74
MANIPUR,IMPHAL EAST,2021-01-06,32,641,1,674
MANIPUR,IMPHAL EAST,2021-01-07,73,796,0,869
MANIPUR,IMPHAL EAST,2021-01-08,110,563,2,675
MANIPUR,IMPHAL EAST,2021-01-09,6,361,0,367
MANIPUR,IMPHAL EAST,2021-01-10,2,155,0,157
MANIPUR,IMPHAL WEST,2021-01-06,69,823,0,892
MANIPUR,IMPHAL WEST,2021-01-07,53,961,0,1014
MANIPUR,IMPHAL WEST,2021-01-08,109,1006,0,1115
MANIPUR,IMPHAL WEST,2021-01-09,23,850,1,874
MANIPUR,IMPHAL WEST,2021-01-10,15,589,0,604
MANIPUR,JIRIBAM,2021-01-06,1,66,0,67
MANIPUR,JIRIBAM,2021-01-07,0,12,0,12
MANIPUR,JIRIBAM,2021-01-08,0,1,0,1
MANIPUR,JIRIBAM,2021-01-09,0,19,0,19
MANIPUR,JIRIBAM,2021-01-10,0,30,0,30
MANIPUR,KAKCHING,2021-01-06,0,33,0,33
MANIPUR,KAKCHING,2021-01-07,3,42,0,45
MANIPUR,KAKCHING,2021-01-08,1,110,0,111
MANIPUR,KAKCHING,2021-01-09,11,138,0,149
MANIPUR,KAKCHING,2021-01-10,2,45,0,47
MANIPUR,KAMJONG,2021-01-06,0,1,0,1
MANIPUR,KAMJONG,2021-01-07,0,4,0,4
MANIPUR,KAMJONG,2021-01-08,0,6,0,6
MANIPUR,KAMJONG,2021-01-09,0,111,0,111
MANIPUR,KAMJONG,2021-01-10,0,8,0,8
MANIPUR,KANGPOKPI,2021-01-06,1,23,0,24
MANIPUR,KANGPOKPI,2021-01-07,0,23,0,23
MANIPUR,KANGPOKPI,2021-01-08,0,20,0,20
MANIPUR,KANGPOKPI,2021-01-09,0,38,0,38
MANIPUR,KANGPOKPI,2021-01-10,0,16,0,16
MANIPUR,NONEY,2021-01-06,0,5,0,5
MANIPUR,NONEY,2021-01-07,0,6,0,6
MANIPUR,NONEY,2021-01-08,0,16,0,16
MANIPUR,NONEY,2021-01-09,0,1,0,1
MANIPUR,SENAPATI,2021-01-06,0,17,0,17
MANIPUR,SENAPATI,2021-01-07,0,33,0,33
MANIPUR,SENAPATI,2021-01-08,1,19,0,20
MANIPUR,SENAPATI,2021-01-09,0,31,0,31
MANIPUR,SENAPATI,2021-01-10,0,20,0,20
MANIPUR,TAMENGLONG,2021-01-06,1,31,0,32
MANIPUR,TAMENGLONG,2021-01-07,2,46,0,48
MANIPUR,TAMENGLONG,2021-01-08,0,115,0,115
MANIPUR,TAMENGLONG,2021-01-09,0,44,0,44
MANIPUR,TAMENGLONG,2021-01-10,3,73,0,76
MANIPUR,TENGNOUPAL,2021-01-06,3,10,0,13
MANIPUR,TENGNOUPAL,2021-01-07,0,10,0,10
MANIPUR,TENGNOUPAL,2021-01-08,1,6,0,7
MANIPUR,TENGNOUPAL,2021-01-09,0,3,0,3
MANIPUR,TENGNOUPAL,2021-01-10,0,6,1,7
MANIPUR,THOUBAL,2021-01-06,2,148,0,150
MANIPUR,THOUBAL,2021-01-07,10,198,0,208
MANIPUR,THOUBAL,2021-01-08,11,200,0,211
MANIPUR,THOUBAL,2021-01-09,4,157,0,161
MANIPUR,THOUBAL,2021-01-10,1,90,0,91
MANIPUR,UKHRUL,2021-01-06,2,173,0,175
MANIPUR,UKHRUL,2021-01-07,1,165,0,166
MANIPUR,UKHRUL,2021-01-08,6,263,0,269
MANIPUR,UKHRUL,2021-01-09,5,209,0,214
MANIPUR,UKHRUL,2021-01-10,8,215,0,223
MEGHALAYA,EAST GARO HILLS,2021-01-06,0,86,0,86
MEGHALAYA,EAST GARO HILLS,2021-01-07,0,113,0,113
MEGHALAYA,EAST GARO HILLS,2021-01-08,0,24,0,24
MEGHALAYA,EAST GARO HILLS,2021-01-09,0,30,0,30
MEGHALAYA,EAST GARO HILLS,2021-01-10,0,2,0,2
MEGHALAYA,EAST JAINTIA HILLS,2021-01-06,0,205,0,205
MEGHALAYA,EAST JAINTIA HILLS,2021-01-07,1,205,0,206
MEGHALAYA,EAST JAINTIA HILLS,2021-01-08,1,145,0,146
MEGHALAYA,EAST JAINTIA HILLS,2021-01-09,3,48,0,51
MEGHALAYA,EAST JAINTIA HILLS,2021-01-10,0,15,0,15
MEGHALAYA,EAST KHASI HILLS,2021-01-06,6,512,0,518
MEGHALAYA,EAST KHASI HILLS,2021-01-07,9,856,0,865
MEGHALAYA,EAST KHASI HILLS,2021-01-08,11,640,0,651
MEGHALAYA,EAST KHASI HILLS,2021-01-09,18,779,0,797
MEGHALAYA,EAST KHASI HILLS,2021-01-10,4,287,0,291
MEGHALAYA,NORTH GARO HILLS,2021-01-06,0,21,0,21
MEGHALAYA,NORTH GARO HILLS,2021-01-07,1,8,0,9
MEGHALAYA,NORTH GARO HILLS,2021-01-08,2,19,0,21
MEGHALAYA,NORTH GARO HILLS,2021-01-09,0,8,0,8
MEGHALAYA,NORTH GARO HILLS,2021-01-10,0,3,0,3
MEGHALAYA,RI BHOI,2021-01-06,0,258,0,258
MEGHALAYA,RI BHOI,2021-01-07,0,149,0,149
MEGHALAYA,RI BHOI,2021-01-08,1,128,0,129
MEGHALAYA,RI BHOI,2021-01-09,0,44,0,44
MEGHALAYA,RI BHOI,2021-01-10,1,18,0,19
MEGHALAYA,SOUTH GARO HILLS,2021-01-06,0,13,0,13
MEGHALAYA,SOUTH GARO HILLS,2021-01-07,1,11,0,12
MEGHALAYA,SOUTH GARO HILLS,2021-01-08,0,25,0,25
MEGHALAYA,SOUTH GARO HILLS,2021-01-09,0,40,0,40
MEGHALAYA,SOUTH GARO HILLS,2021-01-10,0,9,0,9
MEGHALAYA,SOUTH WEST GARO HILLS,2021-01-06,0,51,0,51
MEGHALAYA,SOUTH WEST GARO HILLS,2021-01-07,0,20,0,20
MEGHALAYA,SOUTH WEST GARO HILLS,2021-01-08,0,44,0,44
MEGHALAYA,SOUTH WEST GARO HILLS,2021-01-09,0,17,0,17
MEGHALAYA,SOUTH WEST GARO HILLS,2021-01-10,0,1,0,1
MEGHALAYA,SOUTH WEST KHASI HILLS,2021-01-06,0,7,0,7
MEGHALAYA,SOUTH WEST KHASI HILLS,2021-01-07,0,6,0,6
MEGHALAYA,SOUTH WEST KHASI HILLS,2021-01-08,0,4,0,4
MEGHALAYA,SOUTH WEST KHASI HILLS,2021-01-09,0,13,0,13
MEGHALAYA,SOUTH WEST KHASI HILLS,2021-01-10,0,2,0,2
MEGHALAYA,WEST GARO HILLS,2021-01-06,0,79,0,79
MEGHALAYA,WEST GARO HILLS,2021-01-07,0,132,0,132
MEGHALAYA,WEST GARO HILLS,2021-01-08,0,161,0,161
MEGHALAYA,WEST GARO HILLS,2021-01-09,1,176,0,177
MEGHALAYA,WEST GARO HILLS,2021-01-10,0,15,0,15
MEGHALAYA,WEST JAINTIA HILLS,2021-01-06,0,81,0,81
MEGHALAYA,WEST JAINTIA HILLS,2021-01-07,0,98,0,98
MEGHALAYA,WEST JAINTIA HILLS,2021-01-08,16,87,0,103
MEGHALAYA,WEST JAINTIA HILLS,2021-01-09,2,87,0,89
MEGHALAYA,WEST JAINTIA HILLS,2021-01-10,1,32,0,33
MEGHALAYA,WEST KHASI HILLS,2021-01-06,0,95,0,95
MEGHALAYA,WEST KHASI HILLS,2021-01-07,0,89,0,89
MEGHALAYA,WEST KHASI HILLS,2021-01-08,0,56,0,56
MEGHALAYA,WEST KHASI HILLS,2021-01-09,0,57,0,57
MEGHALAYA,WEST KHASI HILLS,2021-01-10,1,31,0,32
MIZORAM,AIZAWL,2021-01-06,5,589,0,594
MIZORAM,AIZAWL,2021-01-07,4,611,0,615
MIZORAM,AIZAWL,2021-01-08,10,427,0,437
MIZORAM,AIZAWL,2021-01-09,11,465,0,476
MIZORAM,AIZAWL,2021-01-10,0,72,0,72
MIZORAM,CHAMPHAI,2021-01-06,0,43,0,43
MIZORAM,CHAMPHAI,2021-01-07,0,12,0,12
MIZORAM,CHAMPHAI,2021-01-08,0,2,0,2
MIZORAM,CHAMPHAI,2021-01-09,0,7,0,7
MIZORAM,HNAHTHIAL,2021-01-06,0,56,0,56
MIZORAM,HNAHTHIAL,2021-01-07,0,33,0,33
MIZORAM,HNAHTHIAL,2021-01-08,0,6,0,6
MIZORAM,KHAWZAWL,2021-01-06,0,2,0,2
MIZORAM,KHAWZAWL,2021-01-07,0,1,0,1
MIZORAM,KHAWZAWL,2021-01-08,0,26,0,26
MIZORAM,KHAWZAWL,2021-01-09,0,5,0,5
MIZORAM,KOLASIB,2021-01-06,1,105,0,106
MIZORAM,KOLASIB,2021-01-07,0,76,0,76
MIZORAM,KOLASIB,2021-01-08,0,47,0,47
MIZORAM,KOLASIB,2021-01-09,0,50,0,50
MIZORAM,KOLASIB,2021-01-10,0,18,0,18
MIZORAM,LAWNGTLAI,2021-01-06,0,37,0,37
MIZORAM,LAWNGTLAI,2021-01-07,0,3,0,3
MIZORAM,LAWNGTLAI,2021-01-08,3,67,0,70
MIZORAM,LAWNGTLAI,2021-01-09,4,39,0,43
MIZORAM,LUNGLEI,2021-01-06,2,72,0,74
MIZORAM,LUNGLEI,2021-01-07,0,64,0,64
MIZORAM,LUNGLEI,2021-01-08,1,52,0,53
MIZORAM,LUNGLEI,2021-01-09,1,55,0,56
MIZORAM,LUNGLEI,2021-01-10,2,44,0,46
MIZORAM,MAMIT,2021-01-06,0,86,0,86
MIZORAM,MAMIT,2021-01-07,0,84,0,84
MIZORAM,MAMIT,2021-01-08,0,37,0,37
MIZORAM,MAMIT,2021-01-09,0,6,0,6
MIZORAM,MAMIT,2021-01-10,0,14,0,14
MIZORAM,SAIHA,2021-01-06,0,2,0,2
MIZORAM,SAIHA,2021-01-07,0,3,0,3
MIZORAM,SAIHA,2021-01-08,0,5,0,5
MIZORAM,SAIHA,2021-01-09,0,8,0,8
MIZORAM,SAIHA,2021-01-10,0,24,0,24
MIZORAM,SAITUAL,2021-01-06,0,66,0,66
MIZORAM,SAITUAL,2021-01-07,0,2,0,2
MIZORAM,SAITUAL,2021-01-08,1,3,0,4
MIZORAM,SAITUAL,2021-01-10,0,5,0,5
MIZORAM,SERCHHIP,2021-01-06,0,28,0,28
MIZORAM,SERCHHIP,2021-01-07,0,23,0,23
MIZORAM,SERCHHIP,2021-01-08,0,24,0,24
MIZORAM,SERCHHIP,2021-01-09,0,9,0,9
NAGALAND,DIMAPUR,2021-01-06,1,114,0,115
NAGALAND,DIMAPUR,2021-01-07,0,101,0,101
NAGALAND,DIMAPUR,2021-01-08,1,78,0,79
NAGALAND,DIMAPUR,2021-01-09,0,26,0,26
NAGALAND,DIMAPUR,2021-01-10,0,3,0,3
NAGALAND,KIPHIRE,2021-01-06,0,4,0,4
NAGALAND,KIPHIRE,2021-01-07,0,6,0,6
NAGALAND,KIPHIRE,2021-01-09,0,1,0,1
NAGALAND,KOHIMA,2021-01-06,6,115,0,121
NAGALAND,KOHIMA,2021-01-07,0,32,0,32
NAGALAND,KOHIMA,2021-01-08,1,11,0,12
NAGALAND,KOHIMA,2021-01-09,0,3,0,3
NAGALAND,KOHIMA,2021-01-10,0,3,0,3
NAGALAND,LONGLENG,2021-01-06,0,1,0,1
NAGALAND,LONGLENG,2021-01-07,0,2,0,2
NAGALAND,LONGLENG,2021-01-08,0,4,0,4
NAGALAND,MOKOKCHUNG,2021-01-06,0,29,0,29
NAGALAND,MOKOKCHUNG,2021-01-07,0,13,0,13
NAGALAND,MOKOKCHUNG,2021-01-08,0,6,0,6
NAGALAND,MOKOKCHUNG,2021-01-09,2,11,0,13
NAGALAND,MOKOKCHUNG,2021-01-10,0,11,0,11
NAGALAND,MON,2021-01-06,0,5,0,5
NAGALAND,MON,2021-01-07,0,3,0,3
NAGALAND,MON,2021-01-08,0,1,0,1
NAGALAND,MON,2021-01-09,0,1,0,1
NAGALAND,PEREN,2021-01-06,0,10,0,10
NAGALAND,PEREN,2021-01-08,0,1,0,1
NAGALAND,PHEK,2021-01-06,0,1,0,1
NAGALAND,PHEK,2021-01-07,0,1,0,1
NAGALAND,PHEK,2021-01-09,0,1,0,1
NAGALAND,TUENSANG,2021-01-06,0,1,0,1
NAGALAND,WOKHA,2021-01-06,1,0,0,1
NAGALAND,WOKHA,2021-01-07,0,5,0,5
NAGALAND,WOKHA,2021-01-09,0,1,0,1
NAGALAND,ZUNHEBOTO,2021-01-06,0,1,0,1
NAGALAND,ZUNHEBOTO,2021-01-08,0,1,0,1
ODISHA,ANUGUL,2021-01-06,21,460,0,481
ODISHA,ANUGUL,2021-01-07,19,554,1,574
ODISHA,ANUGUL,2021-01-08,21,656,0,677
ODISHA,ANUGUL,2021-01-09,20,548,1,569
ODISHA,ANUGUL,2021-01-10,9,379,0,388
ODISHA,BALANGIR,2021-01-06,43,1773,9,1825
ODISHA,BALANGIR,2021-01-07,13,2400,0,2413
ODISHA,BALANGIR,2021-01-08,24,1912,7,1943
ODISHA,BALANGIR,2021-01-09,17,1686,1,1704
ODISHA,BALANGIR,2021-01-10,8,1171,7,1186
ODISHA,BALESHWAR,2021-01-06,10,1011,0,1021
ODISHA,BALESHWAR,2021-01-07,6,1306,0,1312
ODISHA,BALESHWAR,2021-01-08,4,1793,1,1798
ODISHA,BALESHWAR,2021-01-09,5,1760,0,1765
ODISHA,BALESHWAR,2021-01-10,19,1512,2,1533
ODISHA,BARGARH,2021-01-06,11,487,0,498
ODISHA,BARGARH,2021-01-07,3,1578,0,1581
ODISHA,BARGARH,2021-01-08,4,1525,6,1535
ODISHA,BARGARH,2021-01-09,13,1117,0,1130
ODISHA,BARGARH,2021-01-10,0,636,0,636
ODISHA,BHADRAK,2021-01-06,1,856,0,857
ODISHA,BHADRAK,2021-01-07,4,1403,0,1407
ODISHA,BHADRAK,2021-01-08,1,1229,0,1230
ODISHA,BHADRAK,2021-01-09,6,1343,0,1349
ODISHA,BHADRAK,2021-01-10,4,1095,0,1099
ODISHA,BOUDH,2021-01-06,0,350,0,350
ODISHA,BOUDH,2021-01-07,0,289,0,289
ODISHA,BOUDH,2021-01-08,0,143,0,143
ODISHA,BOUDH,2021-01-09,1,215,0,216
ODISHA,BOUDH,2021-01-10,1,279,0,280
ODISHA,CUTTACK,2021-01-06,10,632,0,642
ODISHA,CUTTACK,2021-01-07,12,1084,1,1097
ODISHA,CUTTACK,2021-01-08,22,1307,0,1329
ODISHA,CUTTACK,2021-01-09,7,1306,0,1313
ODISHA,CUTTACK,2021-01-10,3,410,0,413
ODISHA,DEOGARH,2021-01-06,0,148,0,148
ODISHA,DEOGARH,2021-01-07,0,235,0,235
ODISHA,DEOGARH,2021-01-08,1,246,0,247
ODISHA,DEOGARH,2021-01-09,2,196,0,198
ODISHA,DEOGARH,2021-01-10,1,203,0,204
ODISHA,DHENKANAL,2021-01-06,0,913,0,913
ODISHA,DHENKANAL,2021-01-07,1,792,0,793
ODISHA,DHENKANAL,2021-01-08,5,725,0,730
ODISHA,DHENKANAL,2021-01-09,1,641,0,642
ODISHA,DHENKANAL,2021-01-10,0,434,0,434
ODISHA,GAJAPATI,2021-01-06,0,247,0,247
ODISHA,GAJAPATI,2021-01-07,2,770,0,772
ODISHA,GAJAPATI,2021-01-08,16,875,0,891
ODISHA,GAJAPATI,2021-01-09,23,625,8,656
ODISHA,GAJAPATI,2021-01-10,15,40,0,55
ODISHA,GANJAM,2021-01-06,1,902,34,937
ODISHA,GANJAM,2021-01-07,6,1398,52,1456
ODISHA,GANJAM,2021-01-08,3,838,0,841
ODISHA,GANJAM,2021-01-09,1,1941,95,2037
ODISHA,GANJAM,2021-01-10,2,630,0,632
ODISHA,JAGATSINGHAPUR,2021-01-06,3,196,0,199
ODISHA,JAGATSINGHAPUR,2021-01-07,0,614,1,615
ODISHA,JAGATSINGHAPUR,2021-01-08,1,928,1,930
ODISHA,JAGATSINGHAPUR,2021-01-09,1,856,0,857
ODISHA,JAGATSINGHAPUR,2021-01-10,0,626,0,626
ODISHA,JAJAPUR,2021-01-06,14,821,1,836
ODISHA,JAJAPUR,2021-01-07,13,994,1,1008
ODISHA,JAJAPUR,2021-01-08,6,981,0,987
ODISHA,JAJAPUR,2021-01-09,4,798,1,803
ODISHA,JAJAPUR,2021-01-10,5,472,1,478
ODISHA,JHARSUGUDA,2021-01-06,6,356,3,365
ODISHA,JHARSUGUDA,2021-01-07,11,381,11,403
ODISHA,JHARSUGUDA,2021-01-08,12,662,7,681
ODISHA,JHARSUGUDA,2021-01-09,15,665,15,695
ODISHA,JHARSUGUDA,2021-01-10,15,597,3,615
ODISHA,KALAHANDI,2021-01-06,1,574,0,575
ODISHA,KALAHANDI,2021-01-07,1,561,0,562
ODISHA,KALAHANDI,2021-01-08,4,858,0,862
ODISHA,KALAHANDI,2021-01-09,3,780,0,783
ODISHA,KALAHANDI,2021-01-10,1,416,0,417
ODISHA,KANDHAMAL,2021-01-06,0,694,0,694
ODISHA,KANDHAMAL,2021-01-07,0,738,0,738
ODISHA,KANDHAMAL,2021-01-08,3,746,0,749
ODISHA,KANDHAMAL,2021-01-09,7,793,0,800
ODISHA,KANDHAMAL,2021-01-10,0,763,0,763
ODISHA,KENDRAPARA,2021-01-06,5,1668,0,1673
ODISHA,KENDRAPARA,2021-01-07,7,1594,0,1601
ODISHA,KENDRAPARA,2021-01-08,4,1298,0,1302
ODISHA,KENDRAPARA,2021-01-09,5,1239,0,1244
ODISHA,KENDRAPARA,2021-01-10,0,1056,0,1056
ODISHA,KENDUJHAR,2021-01-06,5,1382,0,1387
ODISHA,KENDUJHAR,2021-01-07,3,1133,0,1136
ODISHA,KENDUJHAR,2021-01-08,7,1307,0,1314
ODISHA,KENDUJHAR,2021-01-09,3,1204,0,1207
ODISHA,KENDUJHAR,2021-01-10,1,797,0,798
ODISHA,KHORDHA,2021-01-06,37,1908,3,1948
ODISHA,KHORDHA,2021-01-07,21,1754,2,1777
ODISHA,KHORDHA,2021-01-08,18,1983,1,2002
ODISHA,KHORDHA,2021-01-09,26,1778,7,1811
ODISHA,KHORDHA,2021-01-10,3,1322,2,1327
ODISHA,KORAPUT,2021-01-06,2,751,0,753
ODISHA,KORAPUT,2021-01-07,0,856,0,856
ODISHA,KORAPUT,2021-01-08,2,1113,0,1115
ODISHA,KORAPUT,2021-01-09,1,1275,0,1276
ODISHA,KORAPUT,2021-01-10,0,955,0,955
ODISHA,MALKANGIRI,2021-01-06,4,761,0,765
ODISHA,MALKANGIRI,2021-01-07,0,669,3,672
ODISHA,MALKANGIRI,2021-01-08,1,653,0,654
ODISHA,MALKANGIRI,2021-01-09,1,731,0,732
ODISHA,MALKANGIRI,2021-01-10,0,668,0,668
ODISHA,MAYURBHANJ,2021-01-06,14,748,0,762
ODISHA,MAYURBHANJ,2021-01-07,12,1107,0,1119
ODISHA,MAYURBHANJ,2021-01-08,8,1263,0,1271
ODISHA,MAYURBHANJ,2021-01-09,10,1147,0,1157
ODISHA,MAYURBHANJ,2021-01-10,6,913,0,919
ODISHA,NABARANGPUR,2021-01-06,0,751,0,751
ODISHA,NABARANGPUR,2021-01-07,0,1107,0,1107
ODISHA,NABARANGPUR,2021-01-08,1,915,0,916
ODISHA,NABARANGPUR,2021-01-09,0,785,0,785
ODISHA,NABARANGPUR,2021-01-10,1,529,0,530
ODISHA,NAYAGARH,2021-01-06,1,549,1,551
ODISHA,NAYAGARH,2021-01-07,1,619,0,620
ODISHA,NAYAGARH,2021-01-08,1,636,1,638
ODISHA,NAYAGARH,2021-01-09,0,518,0,518
ODISHA,NAYAGARH,2021-01-10,1,463,0,464
ODISHA,NUAPADA,2021-01-06,6,317,0,323
ODISHA,NUAPADA,2021-01-07,5,456,0,461
ODISHA,NUAPADA,2021-01-08,13,365,0,378
ODISHA,NUAPADA,2021-01-09,6,342,0,348
ODISHA,NUAPADA,2021-01-10,7,336,0,343
ODISHA,PURI,2021-01-06,4,1739,0,1743
ODISHA,PURI,2021-01-07,14,1588,0,1602
ODISHA,PURI,2021-01-08,3,1757,1,1761
ODISHA,PURI,2021-01-09,12,1659,1,1672
ODISHA,PURI,2021-01-10,20,1885,0,1905
ODISHA,RAYAGADA,2021-01-06,2,577,0,579
ODISHA,RAYAGADA,2021-01-07,0,740,0,740
ODISHA,RAYAGADA,2021-01-08,3,967,0,970
ODISHA,RAYAGADA,2021-01-09,6,1062,0,1068
ODISHA,RAYAGADA,2021-01-10,5,657,0,662
ODISHA,SAMBALPUR,2021-01-06,45,630,0,675
ODISHA,SAMBALPUR,2021-01-07,50,675,0,725
ODISHA,SAMBALPUR,2021-01-08,58,754,0,812
ODISHA,SAMBALPUR,2021-01-09,41,775,0,816
ODISHA,SAMBALPUR,2021-01-10,55,585,0,640
ODISHA,SONEPUR,2021-01-06,0,479,0,479
ODISHA,SONEPUR,2021-01-07,1,475,0,476
ODISHA,SONEPUR,2021-01-08,0,561,0,561
ODISHA,SONEPUR,2021-01-09,0,559,0,559
ODISHA,SONEPUR,2021-01-10,0,432,0,432
ODISHA,SUNDARGARH,2021-01-06,29,1382,1,1412
ODISHA,SUNDARGARH,2021-01-07,28,1952,0,1980
ODISHA,SUNDARGARH,2021-01-08,51,1468,1,1520
ODISHA,SUNDARGARH,2021-01-09,32,1163,1,1196
ODISHA,SUNDARGARH,2021-01-10,18,315,1,334
PUDUCHERRY,KARAIKAL,2021-01-06,6,644,0,650
PUDUCHERRY,KARAIKAL,2021-01-07,1,733,0,734
PUDUCHERRY,KARAIKAL,2021-01-08,6,761,0,767
PUDUCHERRY,KARAIKAL,2021-01-09,1,782,0,783
PUDUCHERRY,KARAIKAL,2021-01-10,1,453,0,454
PUDUCHERRY,MAHE,2021-01-06,9,448,0,457
PUDUCHERRY,MAHE,2021-01-07,7,578,0,585
PUDUCHERRY,MAHE,2021-01-08,6,301,0,307
PUDUCHERRY,MAHE,2021-01-09,3,322,0,325
PUDUCHERRY,MAHE,2021-01-10,4,219,0,223
PUDUCHERRY,PONDICHERRY,2021-01-06,18,602,2,622
PUDUCHERRY,PONDICHERRY,2021-01-07,10,729,1,740
PUDUCHERRY,PONDICHERRY,2021-01-08,24,694,1,719
PUDUCHERRY,PONDICHERRY,2021-01-09,25,572,2,599
PUDUCHERRY,PONDICHERRY,2021-01-10,18,407,2,427
PUDUCHERRY,YANAM,2021-01-06,1,169,0,170
PUDUCHERRY,YANAM,2021-01-07,0,101,0,101
PUDUCHERRY,YANAM,2021-01-08,1,47,0,48
PUDUCHERRY,YANAM,2021-01-09,0,128,0,128
PUNJAB,AMRITSAR,2021-01-06,30,1834,5,1869
PUNJAB,AMRITSAR,2021-01-07,26,804,8,838
PUNJAB,AMRITSAR,2021-01-08,30,1890,96,2016
PUNJAB,AMRITSAR,2021-01-09,17,1337,3,1357
PUNJAB,AMRITSAR,2021-01-10,44,1109,4,1157
PUNJAB,BARNALA,2021-01-06,3,311,21,335
PUNJAB,BARNALA,2021-01-07,2,279,2,283
PUNJAB,BARNALA,2021-01-08,1,272,15,288
PUNJAB,BARNALA,2021-01-09,0,221,0,221
PUNJAB,BARNALA,2021-01-10,0,254,24,278
PUNJAB,BATHINDA,2021-01-06,30,738,5,773
PUNJAB,BATHINDA,2021-01-07,15,932,5,952
PUNJAB,BATHINDA,2021-01-08,16,1030,7,1053
PUNJAB,BATHINDA,2021-01-09,19,743,3,765
PUNJAB,BATHINDA,2021-01-10,11,890,1,902
PUNJAB,FARIDKOT,2021-01-06,6,155,0,161
PUNJAB,FARIDKOT,2021-01-07,3,243,2,248
PUNJAB,FARIDKOT,2021-01-08,9,224,7,240
PUNJAB,FARIDKOT,2021-01-09,8,172,5,185
PUNJAB,FARIDKOT,2021-01-10,11,118,2,131
PUNJAB,FATEHGARH SAHIB,2021-01-06,2,381,2,385
PUNJAB,FATEHGARH SAHIB,2021-01-07,5,507,3,515
PUNJAB,FATEHGARH SAHIB,2021-01-08,2,54,1,57
PUNJAB,FATEHGARH SAHIB,2021-01-09,1,187,4,192
PUNJAB,FATEHGARH SAHIB,2021-01-10,5,286,0,291
PUNJAB,FAZILKA,2021-01-06,5,244,16,265
PUNJAB,FAZILKA,2021-01-07,2,196,0,198
PUNJAB,FAZILKA,2021-01-08,5,445,10,460
PUNJAB,FAZILKA,2021-01-09,5,236,0,241
PUNJAB,FAZILKA,2021-01-10,1,299,0,300
PUNJAB,FIROZEPUR,2021-01-06,3,344,2,349
PUNJAB,FIROZEPUR,2021-01-07,7,281,1,289
PUNJAB,FIROZEPUR,2021-01-08,2,308,1,311
PUNJAB,FIROZEPUR,2021-01-09,1,232,1,234
PUNJAB,FIROZEPUR,2021-01-10,4,172,0,176
PUNJAB,GURDASPUR,2021-01-06,13,729,2,744
PUNJAB,GURDASPUR,2021-01-07,9,1618,12,1639
PUNJAB,GURDASPUR,2021-01-08,10,1244,198,1452
PUNJAB,GURDASPUR,2021-01-09,6,1480,83,1569
PUNJAB,GURDASPUR,2021-01-10,6,1801,86,1893
PUNJAB,HOSHIARPUR,2021-01-06,18,2264,0,2282
PUNJAB,HOSHIARPUR,2021-01-07,21,2466,1,2488
PUNJAB,HOSHIARPUR,2021-01-08,26,1364,2,1392
PUNJAB,HOSHIARPUR,2021-01-09,13,1659,0,1672
PUNJAB,HOSHIARPUR,2021-01-10,19,2016,9,2044
PUNJAB,JALANDHAR,2021-01-06,28,3368,104,3500
PUNJAB,JALANDHAR,2021-01-07,55,3599,17,3671
PUNJAB,JALANDHAR,2021-01-08,34,3587,67,3688
PUNJAB,JALANDHAR,2021-01-09,33,1600,5,1638
PUNJAB,JALANDHAR,2021-01-10,25,2863,17,2905
PUNJAB,KAPURTHALA,2021-01-06,8,1300,4,1312
PUNJAB,KAPURTHALA,2021-01-07,7,596,1,604
PUNJAB,KAPURTHALA,2021-01-08,4,827,2,833
PUNJAB,KAPURTHALA,2021-01-09,7,612,23,642
PUNJAB,KAPURTHALA,2021-01-10,3,673,61,737
PUNJAB,LUDHIANA,2021-01-06,40,2066,7,2113
PUNJAB,LUDHIANA,2021-01-07,65,2474,15,2554
PUNJAB,LUDHIANA,2021-01-08,57,2765,7,2829
PUNJAB,LUDHIANA,2021-01-09,49,2125,9,2183
PUNJAB,LUDHIANA,2021-01-10,33,2042,18,2093
PUNJAB,MANSA,2021-01-06,3,595,1,599
PUNJAB,MANSA,2021-01-07,3,484,1,488
PUNJAB,MANSA,2021-01-08,11,403,1,415
PUNJAB,MANSA,2021-01-09,9,440,1,450
PUNJAB,MANSA,2021-01-10,4,472,0,476
PUNJAB,MOGA,2021-01-06,1,319,6,326
PUNJAB,MOGA,2021-01-07,1,295,4,300
PUNJAB,MOGA,2021-01-08,3,224,2,229
PUNJAB,MOGA,2021-01-09,8,212,8,228
PUNJAB,MOGA,2021-01-10,3,211,1,215
PUNJAB,PATHANKOT,2021-01-06,9,607,0,616
PUNJAB,PATHANKOT,2021-01-07,7,1072,31,1110
PUNJAB,PATHANKOT,2021-01-08,7,359,0,366
PUNJAB,PATHANKOT,2021-01-09,2,666,25,693
PUNJAB,PATHANKOT,2021-01-10,4,349,1,354
PUNJAB,PATIALA,2021-01-06,40,1731,2,1773
PUNJAB,PATIALA,2021-01-07,30,1443,7,1480
PUNJAB,PATIALA,2021-01-08,33,1416,2,1451
PUNJAB,PATIALA,2021-01-09,22,1690,0,1712
PUNJAB,PATIALA,2021-01-10,38,1717,1,1756
PUNJAB,RUPNAGAR,2021-01-06,15,832,2,849
PUNJAB,RUPNAGAR,2021-01-07,17,748,9,774
PUNJAB,RUPNAGAR,2021-01-08,8,913,7,928
PUNJAB,RUPNAGAR,2021-01-09,9,731,0,740
PUNJAB,RUPNAGAR,2021-01-10,13,724,0,737
PUNJAB,S.A.S NAGAR,2021-01-06,101,1333,10,1444
PUNJAB,S.A.S NAGAR,2021-01-07,78,851,32,961
PUNJAB,S.A.S NAGAR,2021-01-08,82,1105,8,1195
PUNJAB,S.A.S NAGAR,2021-01-09,92,936,13,1041
PUNJAB,S.A.S NAGAR,2021-01-10,27,330,3,360
PUNJAB,SANGRUR,2021-01-06,2,1215,0,1217
PUNJAB,SANGRUR,2021-01-07,4,1238,3,1245
PUNJAB,SANGRUR,2021-01-08,13,1383,1,1397
PUNJAB,SANGRUR,2021-01-09,7,1017,1,1025
PUNJAB,SANGRUR,2021-01-10,5,1055,8,1068
PUNJAB,SHAHID BHAGAT SINGH NAGAR,2021-01-06,10,786,2,798
PUNJAB,SHAHID BHAGAT SINGH NAGAR,2021-01-07,10,779,1,790
PUNJAB,SHAHID BHAGAT SINGH NAGAR,2021-01-08,6,731,0,737
PUNJAB,SHAHID BHAGAT SINGH NAGAR,2021-01-09,11,831,0,842
PUNJAB,SHAHID BHAGAT SINGH NAGAR,2021-01-10,7,933,1,941
PUNJAB,SRI MUKTSAR SAHIB,2021-01-06,4,532,12,548
PUNJAB,SRI MUKTSAR SAHIB,2021-01-07,1,384,0,385
PUNJAB,SRI MUKTSAR SAHIB,2021-01-08,0,427,5,432
PUNJAB,SRI MUKTSAR SAHIB,2021-01-09,3,439,1,443
PUNJAB,SRI MUKTSAR SAHIB,2021-01-10,4,272,4,280
PUNJAB,TARN TARAN,2021-01-06,0,297,1,298
PUNJAB,TARN TARAN,2021-01-07,0,295,2,297
PUNJAB,TARN TARAN,2021-01-08,2,533,0,535
PUNJAB,TARN TARAN,2021-01-09,0,979,0,979
PUNJAB,TARN TARAN,2021-01-10,6,887,0,893
RAJASTHAN,AJMER,2021-01-06,10,87,800,897
RAJASTHAN,AJMER,2021-01-07,7,79,587,673
RAJASTHAN,AJMER,2021-01-08,10,90,669,769
RAJASTHAN,AJMER,2021-01-09,11,97,772,880
RAJASTHAN,AJMER,2021-01-10,6,46,354,406
RAJASTHAN,ALWAR,2021-01-06,118,1216,10,1344
RAJASTHAN,ALWAR,2021-01-07,214,2180,11,2405
RAJASTHAN,ALWAR,2021-01-08,208,2015,12,2235
RAJASTHAN,ALWAR,2021-01-09,243,2120,14,2377
RAJASTHAN,ALWAR,2021-01-10,224,1993,16,2233
RAJASTHAN,BANSWARA,2021-01-06,0,174,0,174
RAJASTHAN,BANSWARA,2021-01-07,5,127,0,132
RAJASTHAN,BANSWARA,2021-01-08,1,63,2,66
RAJASTHAN,BANSWARA,2021-01-09,5,161,1,167
RAJASTHAN,BANSWARA,2021-01-10,1,25,0,26
RAJASTHAN,BARAN,2021-01-06,8,273,0,281
RAJASTHAN,BARAN,2021-01-07,36,285,0,321
RAJASTHAN,BARAN,2021-01-08,6,151,0,157
RAJASTHAN,BARAN,2021-01-09,17,129,0,146
RAJASTHAN,BARAN,2021-01-10,1,136,0,137
RAJASTHAN,BARMER,2021-01-06,1,368,4,373
RAJASTHAN,BARMER,2021-01-07,1,343,1,345
RAJASTHAN,BARMER,2021-01-08,1,419,2,422
RAJASTHAN,BARMER,2021-01-09,0,357,0,357
RAJASTHAN,BARMER,2021-01-10,3,115,0,118
RAJASTHAN,BHARATPUR,2021-01-06,6,1653,16,1675
RAJASTHAN,BHARATPUR,2021-01-07,1,861,2,864
RAJASTHAN,BHARATPUR,2021-01-08,3,1126,1,1130
RAJASTHAN,BHARATPUR,2021-01-09,8,719,3,730
RAJASTHAN,BHARATPUR,2021-01-10,19,1354,8,1381
RAJASTHAN,BHILWARA,2021-01-06,46,572,3,621
RAJASTHAN,BHILWARA,2021-01-07,52,427,3,482
RAJASTHAN,BHILWARA,2021-01-08,39,355,5,399
RAJASTHAN,BHILWARA,2021-01-09,33,409,3,445
RAJASTHAN,BHILWARA,2021-01-10,40,479,2,521
RAJASTHAN,BIKANER,2021-01-06,0,786,2,788
RAJASTHAN,BIKANER,2021-01-07,13,844,1,858
RAJASTHAN,BIKANER,2021-01-08,22,595,2,619
RAJASTHAN,BIKANER,2021-01-09,3,287,1,291
RAJASTHAN,BIKANER,2021-01-10,0,22,3,25
RAJASTHAN,BUNDI,2021-01-06,2,158,0,160
RAJASTHAN,BUNDI,2021-01-07,0,132,0,132
RAJASTHAN,BUNDI,2021-01-08,0,233,2,235
RAJASTHAN,BUNDI,2021-01-09,15,91,1,107
RAJASTHAN,BUNDI,2021-01-10,0,266,3,269
RAJASTHAN,CHITTORGARH,2021-01-06,16,941,6,963
RAJASTHAN,CHITTORGARH,2021-01-07,5,553,5,563
RAJASTHAN,CHITTORGARH,2021-01-08,10,561,5,576
RAJASTHAN,CHITTORGARH,2021-01-09,26,513,3,542
RAJASTHAN,CHITTORGARH,2021-01-10,12,650,3,665
RAJASTHAN,CHURU,2021-01-06,4,559,4,567
RAJASTHAN,CHURU,2021-01-07,2,577,0,579
RAJASTHAN,CHURU,2021-01-08,3,556,4,563
RAJASTHAN,CHURU,2021-01-09,4,506,5,515
RAJASTHAN,CHURU,2021-01-10,0,493,2,495
RAJASTHAN,DAUSA,2021-01-06,1,265,13,279
RAJASTHAN,DAUSA,2021-01-07,2,330,26,358
RAJASTHAN,DAUSA,2021-01-08,3,292,21,316
RAJASTHAN,DAUSA,2021-01-09,1,336,21,358
RAJASTHAN,DAUSA,2021-01-10,1,290,9,300
RAJASTHAN,DHOLPUR,2021-01-06,5,659,11,675
RAJASTHAN,DHOLPUR,2021-01-07,2,336,3,341
RAJASTHAN,DHOLPUR,2021-01-08,2,218,2,222
RAJASTHAN,DHOLPUR,2021-01-09,6,267,5,278
RAJASTHAN,DHOLPUR,2021-01-10,1,38,2,41
RAJASTHAN,DUNGARPUR,2021-01-06,22,382,0,404
RAJASTHAN,DUNGARPUR,2021-01-07,49,317,0,366
RAJASTHAN,DUNGARPUR,2021-01-08,20,248,1,269
RAJASTHAN,DUNGARPUR,2021-01-09,12,330,0,342
RAJASTHAN,DUNGARPUR,2021-01-10,11,265,1,277
RAJASTHAN,GANGANAGAR,2021-01-06,0,27,2,29
RAJASTHAN,GANGANAGAR,2021-01-07,1,32,2,35
RAJASTHAN,GANGANAGAR,2021-01-08,1,30,2,33
RAJASTHAN,GANGANAGAR,2021-01-09,0,17,3,20
RAJASTHAN,GANGANAGAR,2021-01-10,2,20,2,24
RAJASTHAN,HANUMANGARH,2021-01-06,7,654,2,663
RAJASTHAN,HANUMANGARH,2021-01-07,10,609,3,622
RAJASTHAN,HANUMANGARH,2021-01-08,3,761,1,765
RAJASTHAN,HANUMANGARH,2021-01-09,3,584,3,590
RAJASTHAN,HANUMANGARH,2021-01-10,3,1071,0,1074
RAJASTHAN,JAIPUR,2021-01-06,132,2752,335,3219
RAJASTHAN,JAIPUR,2021-01-07,174,3802,317,4293
RAJASTHAN,JAIPUR,2021-01-08,128,3007,232,3367
RAJASTHAN,JAIPUR,2021-01-09,175,3084,321,3580
RAJASTHAN,JAIPUR,2021-01-10,119,2198,377,2694
RAJASTHAN,JAISALMER,2021-01-06,17,171,0,188
RAJASTHAN,JAISALMER,2021-01-07,0,98,1,99
RAJASTHAN,JAISALMER,2021-01-08,0,120,0,120
RAJASTHAN,JAISALMER,2021-01-09,1,160,4,165
RAJASTHAN,JAISALMER,2021-01-10,13,255,1,269
RAJASTHAN,JALORE,2021-01-06,0,10,0,10
RAJASTHAN,JALORE,2021-01-07,39,247,2,288
RAJASTHAN,JALORE,2021-01-08,86,835,4,925
RAJASTHAN,JALORE,2021-01-09,18,1318,2,1338
RAJASTHAN,JALORE,2021-01-10,5,959,1,965
RAJASTHAN,JHALAWAR,2021-01-06,28,403,7,438
RAJASTHAN,JHALAWAR,2021-01-07,2,462,0,464
RAJASTHAN,JHALAWAR,2021-01-08,15,319,12,346
RAJASTHAN,JHALAWAR,2021-01-09,36,275,2,313
RAJASTHAN,JHALAWAR,2021-01-10,45,145,11,201
RAJASTHAN,JHUNJHUNU,2021-01-06,3,109,3,115
RAJASTHAN,JHUNJHUNU,2021-01-07,3,111,14,128
RAJASTHAN,JHUNJHUNU,2021-01-08,1,95,1,97
RAJASTHAN,JHUNJHUNU,2021-01-09,3,67,3,73
RAJASTHAN,JHUNJHUNU,2021-01-10,2,109,7,118
RAJASTHAN,JODHPUR,2021-01-06,72,1289,4,1365
RAJASTHAN,JODHPUR,2021-01-07,37,1053,0,1090
RAJASTHAN,JODHPUR,2021-01-08,44,891,3,938
RAJASTHAN,JODHPUR,2021-01-09,46,1087,3,1136
RAJASTHAN,JODHPUR,2021-01-10,65,827,2,894
RAJASTHAN,KARAULI,2021-01-06,2,222,7,231
RAJASTHAN,KARAULI,2021-01-07,3,266,3,272
RAJASTHAN,KARAULI,2021-01-08,1,238,4,243
RAJASTHAN,KARAULI,2021-01-09,2,377,2,381
RAJASTHAN,KARAULI,2021-01-10,5,498,9,512
RAJASTHAN,KOTA,2021-01-06,204,1589,2,1795
RAJASTHAN,KOTA,2021-01-07,112,1388,0,1500
RAJASTHAN,KOTA,2021-01-08,74,1836,3,1913
RAJASTHAN,KOTA,2021-01-09,62,960,3,1025
RAJASTHAN,KOTA,2021-01-10,6,1244,2,1252
RAJASTHAN,NAGAUR,2021-01-06,141,163,296,600
RAJASTHAN,NAGAUR,2021-01-07,166,485,449,1100
RAJASTHAN,NAGAUR,2021-01-08,182,439,300,921
RAJASTHAN,NAGAUR,2021-01-09,3,442,514,959
RAJASTHAN,NAGAUR,2021-01-10,4,132,73,209
RAJASTHAN,PALI,2021-01-06,24,408,3,435
RAJASTHAN,PALI,2021-01-07,73,1282,15,1370
RAJASTHAN,PALI,2021-01-08,11,539,9,559
RAJASTHAN,PALI,2021-01-09,2,24,13,39
RAJASTHAN,PALI,2021-01-10,16,574,3,593
RAJASTHAN,PRATAPGARH,2021-01-06,0,16,1,17
RAJASTHAN,PRATAPGARH,2021-01-07,0,10,0,10
RAJASTHAN,PRATAPGARH,2021-01-08,30,12,0,42
RAJASTHAN,PRATAPGARH,2021-01-09,2,14,0,16
RAJASTHAN,PRATAPGARH,2021-01-10,0,5,1,6
RAJASTHAN,RAJSAMAND,2021-01-06,31,246,1,278
RAJASTHAN,RAJSAMAND,2021-01-07,19,401,1,421
RAJASTHAN,RAJSAMAND,2021-01-08,30,552,6,588
RAJASTHAN,RAJSAMAND,2021-01-09,10,426,4,440
RAJASTHAN,RAJSAMAND,2021-01-10,9,312,0,321
RAJASTHAN,SAWAI MADHOPUR,2021-01-06,7,409,5,421
RAJASTHAN,SAWAI MADHOPUR,2021-01-07,3,397,13,413
RAJASTHAN,SAWAI MADHOPUR,2021-01-08,1,418,8,427
RAJASTHAN,SAWAI MADHOPUR,2021-01-09,3,283,9,295
RAJASTHAN,SAWAI MADHOPUR,2021-01-10,5,250,13,268
RAJASTHAN,SIKAR,2021-01-06,3,94,5,102
RAJASTHAN,SIKAR,2021-01-07,1,107,9,117
RAJASTHAN,SIKAR,2021-01-08,4,77,8,89
RAJASTHAN,SIKAR,2021-01-09,1,107,12,120
RAJASTHAN,SIKAR,2021-01-10,1,132,19,152
RAJASTHAN,SIROHI,2021-01-06,6,443,1,450
RAJASTHAN,SIROHI,2021-01-07,5,248,0,253
RAJASTHAN,SIROHI,2021-01-08,20,430,3,453
RAJASTHAN,SIROHI,2021-01-09,0,408,0,408
RAJASTHAN,SIROHI,2021-01-10,0,3,1,4
RAJASTHAN,TONK,2021-01-06,0,88,7,95
RAJASTHAN,TONK,2021-01-07,0,89,14,103
RAJASTHAN,TONK,2021-01-08,4,178,20,202
RAJASTHAN,TONK,2021-01-09,1,17,3,21
RAJASTHAN,TONK,2021-01-10,3,204,27,234
RAJASTHAN,UDAIPUR,2021-01-06,184,712,3,899
RAJASTHAN,UDAIPUR,2021-01-07,181,761,0,942
RAJASTHAN,UDAIPUR,2021-01-08,146,821,2,969
RAJASTHAN,UDAIPUR,2021-01-09,129,836,4,969
RAJASTHAN,UDAIPUR,2021-01-10,179,423,4,606
SIKKIM,EAST DISTRICT,2021-01-06,13,165,0,178
SIKKIM,EAST DISTRICT,2021-01-07,31,261,0,292
SIKKIM,EAST DISTRICT,2021-01-08,67,190,0,257
SIKKIM,EAST DISTRICT,2021-01-09,18,153,0,171
SIKKIM,EAST DISTRICT,2021-01-10,0,23,0,23
SIKKIM,NORTH DISTRICT,2021-01-06,0,3,0,3
SIKKIM,NORTH DISTRICT,2021-01-07,0,9,0,9
SIKKIM,NORTH DISTRICT,2021-01-09,0,4,0,4
SIKKIM,SOUTH DISTRICT,2021-01-06,3,49,1,53
SIKKIM,SOUTH DISTRICT,2021-01-07,1,17,0,18
SIKKIM,SOUTH DISTRICT,2021-01-08,1,30,0,31
SIKKIM,SOUTH DISTRICT,2021-01-09,0,10,0,10
SIKKIM,SOUTH DISTRICT,2021-01-10,0,1,0,1
SIKKIM,WEST DISTRICT,2021-01-06,1,3,0,4
SIKKIM,WEST DISTRICT,2021-01-07,2,3,0,5
SIKKIM,WEST DISTRICT,2021-01-08,0,3,0,3
SIKKIM,WEST DISTRICT,2021-01-09,0,6,0,6
SIKKIM,WEST DISTRICT,2021-01-10,0,6,0,6
TAMIL NADU,ARIYALUR,2021-01-06,2,682,0,684
TAMIL NADU,ARIYALUR,2021-01-07,0,420,0,420
TAMIL NADU,ARIYALUR,2021-01-08,4,545,1,550
TAMIL NADU,ARIYALUR,2021-01-09,1,426,0,427
TAMIL NADU,ARIYALUR,2021-01-10,1,296,0,297
TAMIL NADU,CHENGALPATTU,2021-01-06,30,3306,11,3347
TAMIL NADU,CHENGALPATTU,2021-01-07,43,2308,1,2352
TAMIL NADU,CHENGALPATTU,2021-01-08,26,3102,0,3128
TAMIL NADU,CHENGALPATTU,2021-01-09,14,2402,0,2416
TAMIL NADU,CHENGALPATTU,2021-01-10,25,2688,5,2718
TAMIL NADU,CHENNAI,2021-01-06,225,9722,110,10057
TAMIL NADU,CHENNAI,2021-01-07,256,9363,32,9651
TAMIL NADU,CHENNAI,2021-01-08,240,10239,79,10558
TAMIL NADU,CHENNAI,2021-01-09,203,10765,25,10993
TAMIL NADU,CHENNAI,2021-01-10,150,8614,11,8775
TAMIL NADU,COIMBATORE,2021-01-06,83,2196,0,2279
TAMIL NADU,COIMBATORE,2021-01-07,65,2466,7,2538
TAMIL NADU,COIMBATORE,2021-01-08,77,2734,0,2811
TAMIL NADU,COIMBATORE,2021-01-09,63,2330,0,2393
TAMIL NADU,COIMBATORE,2021-01-10,69,1818,0,1887
TAMIL NADU,CUDDALORE,2021-01-06,14,2388,1,2403
TAMIL NADU,CUDDALORE,2021-01-07,4,1846,0,1850
TAMIL NADU,CUDDALORE,2021-01-08,5,1890,1,1896
TAMIL NADU,CUDDALORE,2021-01-09,1,1075,1,1077
TAMIL NADU,CUDDALORE,2021-01-10,3,797,1,801
TAMIL NADU,DHARMAPURI,2021-01-06,10,1012,0,1022
TAMIL NADU,DHARMAPURI,2021-01-07,3,900,0,903
TAMIL NADU,DHARMAPURI,2021-01-08,2,878,0,880
TAMIL NADU,DHARMAPURI,2021-01-09,3,893,0,896
TAMIL NADU,DHARMAPURI,2021-01-10,4,757,0,761
TAMIL NADU,DINDIGUL,2021-01-06,12,1446,6,1464
TAMIL NADU,DINDIGUL,2021-01-07,11,1611,1,1623
TAMIL NADU,DINDIGUL,2021-01-08,4,1409,4,1417
TAMIL NADU,DINDIGUL,2021-01-09,11,1307,1,1319
TAMIL NADU,DINDIGUL,2021-01-10,7,1061,0,1068
TAMIL NADU,ERODE,2021-01-06,14,1407,0,1421
TAMIL NADU,ERODE,2021-01-07,23,2001,1,2025
TAMIL NADU,ERODE,2021-01-08,11,1321,0,1332
TAMIL NADU,ERODE,2021-01-09,22,1516,0,1538
TAMIL NADU,ERODE,2021-01-10,20,1387,0,1407
TAMIL NADU,KALLAKURICHI,2021-01-06,3,539,0,542
TAMIL NADU,KALLAKURICHI,2021-01-07,0,559,1,560
TAMIL NADU,KALLAKURICHI,2021-01-08,2,547,0,549
TAMIL NADU,KALLAKURICHI,2021-01-09,2,859,0,861
TAMIL NADU,KALLAKURICHI,2021-01-10,1,873,0,874
TAMIL NADU,KANCHIPURAM,2021-01-06,11,2695,3,2709
TAMIL NADU,KANCHIPURAM,2021-01-07,14,3006,4,3024
TAMIL NADU,KANCHIPURAM,2021-01-08,19,3283,6,3308
TAMIL NADU,KANCHIPURAM,2021-01-09,17,3255,3,3275
TAMIL NADU,KANCHIPURAM,2021-01-10,5,2013,1,2019
TAMIL NADU,KANNIYAKUMARI,2021-01-06,35,1242,3,1280
TAMIL NADU,KANNIYAKUMARI,2021-01-07,16,2005,0,2021
TAMIL NADU,KANNIYAKUMARI,2021-01-08,16,1539,2,1557
TAMIL NADU,KANNIYAKUMARI,2021-01-09,21,1437,4,1462
TAMIL NADU,KANNIYAKUMARI,2021-01-10,16,1968,4,1988
TAMIL NADU,KARUR,2021-01-06,3,1268,2,1273
TAMIL NADU,KARUR,2021-01-07,6,1322,7,1335
TAMIL NADU,KARUR,2021-01-08,4,1248,2,1254
TAMIL NADU,KARUR,2021-01-09,8,1224,1,1233
TAMIL NADU,KARUR,2021-01-10,5,1032,1,1038
TAMIL NADU,KRISHNAGIRI,2021-01-06,5,1439,0,1444
TAMIL NADU,KRISHNAGIRI,2021-01-07,5,1612,1,1618
TAMIL NADU,KRISHNAGIRI,2021-01-08,7,1456,1,1464
TAMIL NADU,KRISHNAGIRI,2021-01-09,5,2091,2,2098
TAMIL NADU,KRISHNAGIRI,2021-01-10,5,2482,0,2487
TAMIL NADU,MADURAI,2021-01-06,21,3119,3,3143
TAMIL NADU,MADURAI,2021-01-07,17,2658,0,2675
TAMIL NADU,MADURAI,2021-01-08,13,2404,0,2417
TAMIL NADU,MADURAI,2021-01-09,7,3378,0,3385
TAMIL NADU,MADURAI,2021-01-10,15,4603,4,4622
TAMIL NADU,NAGAPATTINAM,2021-01-06,8,940,0,948
TAMIL NADU,NAGAPATTINAM,2021-01-07,5,979,0,984
TAMIL NADU,NAGAPATTINAM,2021-01-08,16,1256,0,1272
TAMIL NADU,NAGAPATTINAM,2021-01-09,8,1703,0,1711
TAMIL NADU,NAGAPATTINAM,2021-01-10,4,1549,0,1553
TAMIL NADU,NAMAKKAL,2021-01-06,22,1567,5,1594
TAMIL NADU,NAMAKKAL,2021-01-07,15,1498,0,1513
TAMIL NADU,NAMAKKAL,2021-01-08,9,1835,0,1844
TAMIL NADU,NAMAKKAL,2021-01-09,13,1591,1,1605
TAMIL NADU,NAMAKKAL,2021-01-10,9,888,0,897
TAMIL NADU,PERAMBALUR,2021-01-06,0,355,0,355
TAMIL NADU,PERAMBALUR,2021-01-07,0,456,0,456
TAMIL NADU,PERAMBALUR,2021-01-08,0,308,0,308
TAMIL NADU,PERAMBALUR,2021-01-09,0,284,0,284
TAMIL NADU,PERAMBALUR,2021-01-10,0,271,0,271
TAMIL NADU,PUDUKKOTTAI,2021-01-06,6,1080,3,1089
TAMIL NADU,PUDUKKOTTAI,2021-01-07,2,857,0,859
TAMIL NADU,PUDUKKOTTAI,2021-01-08,6,1099,2,1107
TAMIL NADU,PUDUKKOTTAI,2021-01-09,8,805,0,813
TAMIL NADU,PUDUKKOTTAI,2021-01-10,3,351,0,354
TAMIL NADU,RAMANATHAPURAM,2021-01-06,3,1253,0,1256
TAMIL NADU,RAMANATHAPURAM,2021-01-07,2,1453,1,1456
TAMIL NADU,RAMANATHAPURAM,2021-01-08,0,2328,1,2329
TAMIL NADU,RAMANATHAPURAM,2021-01-09,1,1332,2,1335
TAMIL NADU,RAMANATHAPURAM,2021-01-10,0,1353,1,1354
TAMIL NADU,RANIPET,2021-01-06,8,1570,0,1578
TAMIL NADU,RANIPET,2021-01-07,11,1843,0,1854
TAMIL NADU,RANIPET,2021-01-08,3,1097,0,1100
TAMIL NADU,RANIPET,2021-01-09,4,848,2,854
TAMIL NADU,RANIPET,2021-01-10,2,80,0,82
TAMIL NADU,SALEM,2021-01-06,33,1009,19,1061
TAMIL NADU,SALEM,2021-01-07,12,707,2,721
TAMIL NADU,SALEM,2021-01-08,31,1360,0,1391
TAMIL NADU,SALEM,2021-01-09,42,1279,43,1364
TAMIL NADU,SALEM,2021-01-10,27,1606,39,1672
TAMIL NADU,SIVAGANGA,2021-01-06,1,1016,0,1017
TAMIL NADU,SIVAGANGA,2021-01-07,4,620,0,624
TAMIL NADU,SIVAGANGA,2021-01-08,5,903,0,908
TAMIL NADU,SIVAGANGA,2021-01-09,2,818,0,820
TAMIL NADU,SIVAGANGA,2021-01-10,2,275,0,277
TAMIL NADU,TENKASI,2021-01-06,4,809,1,814
TAMIL NADU,TENKASI,2021-01-07,0,902,0,902
TAMIL NADU,TENKASI,2021-01-08,4,849,0,853
TAMIL NADU,TENKASI,2021-01-09,3,818,0,821
TAMIL NADU,TENKASI,2021-01-10,1,767,0,768
TAMIL NADU,THANJAVUR,2021-01-06,16,998,2,1016
TAMIL NADU,THANJAVUR,2021-01-07,23,921,0,944
TAMIL NADU,THANJAVUR,2021-01-08,18,773,1,792
TAMIL NADU,THANJAVUR,2021-01-09,15,789,0,804
TAMIL NADU,THANJAVUR,2021-01-10,18,146,0,164
TAMIL NADU,THE NILGIRIS,2021-01-06,12,1250,0,1262
TAMIL NADU,THE NILGIRIS,2021-01-07,13,1212,0,1225
TAMIL NADU,THE NILGIRIS,2021-01-08,6,1220,1,1227
TAMIL NADU,THE NILGIRIS,2021-01-09,15,1238,0,1253
TAMIL NADU,THE NILGIRIS,2021-01-10,10,1210,0,1220
TAMIL NADU,THENI,2021-01-06,5,177,0,182
TAMIL NADU,THENI,2021-01-07,8,136,0,144
TAMIL NADU,THENI,2021-01-08,6,373,0,379
TAMIL NADU,THENI,2021-01-09,2,196,0,198
TAMIL NADU,THENI,2021-01-10,3,264,0,267
TAMIL NADU,THIRUVALLUR,2021-01-06,33,3541,3,3577
TAMIL NADU,THIRUVALLUR,2021-01-07,25,2797,4,2826
TAMIL NADU,THIRUVALLUR,2021-01-08,28,3174,4,3206
TAMIL NADU,THIRUVALLUR,2021-01-09,24,3292,14,3330
TAMIL NADU,THIRUVALLUR,2021-01-10,16,2312,10,2338
TAMIL NADU,THIRUVARUR,2021-01-06,4,1640,0,1644
TAMIL NADU,THIRUVARUR,2021-01-07,13,1145,0,1158
TAMIL NADU,THIRUVARUR,2021-01-08,6,1219,1,1226
TAMIL NADU,THIRUVARUR,2021-01-09,4,605,0,609
TAMIL NADU,THIRUVARUR,2021-01-10,5,136,0,141
TAMIL NADU,TIRUCHIRAPPALLI,2021-01-06,19,2174,1,2194
TAMIL NADU,TIRUCHIRAPPALLI,2021-01-07,22,1835,5,1862
TAMIL NADU,TIRUCHIRAPPALLI,2021-01-08,21,1728,7,1756
TAMIL NADU,TIRUCHIRAPPALLI,2021-01-09,16,1798,1,1815
TAMIL NADU,TIRUCHIRAPPALLI,2021-01-10,15,1594,2,1611
TAMIL NADU,TIRUNELVELI,2021-01-06,10,1664,0,1674
TAMIL NADU,TIRUNELVELI,2021-01-07,8,1689,0,1697
TAMIL NADU,TIRUNELVELI,2021-01-08,10,1249,3,1262
TAMIL NADU,TIRUNELVELI,2021-01-09,7,1126,1,1134
TAMIL NADU,TIRUNELVELI,2021-01-10,3,500,1,504
TAMIL NADU,TIRUPATHUR,2021-01-06,2,2163,11,2176
TAMIL NADU,TIRUPATHUR,2021-01-07,4,2444,0,2448
TAMIL NADU,TIRUPATHUR,2021-01-08,3,2442,2,2447
TAMIL NADU,TIRUPATHUR,2021-01-09,2,1953,0,1955
TAMIL NADU,TIRUPATHUR,2021-01-10,7,3015,0,3022
TAMIL NADU,TIRUPPUR,2021-01-06,35,2158,1,2194
TAMIL NADU,TIRUPPUR,2021-01-07,33,2534,1,2568
TAMIL NADU,TIRUPPUR,2021-01-08,16,1597,0,1613
TAMIL NADU,TIRUPPUR,2021-01-09,24,2536,1,2561
TAMIL NADU,TIRUPPUR,2021-01-10,18,933,0,951
TAMIL NADU,TIRUVANNAMALAI,2021-01-06,13,1400,2,1415
TAMIL NADU,TIRUVANNAMALAI,2021-01-07,2,1595,3,1600
TAMIL NADU,TIRUVANNAMALAI,2021-01-08,7,1574,3,1584
TAMIL NADU,TIRUVANNAMALAI,2021-01-09,10,1140,9,1159
TAMIL NADU,TIRUVANNAMALAI,2021-01-10,5,668,9,682
TAMIL NADU,TUTICORIN,2021-01-06,6,1229,1,1236
TAMIL NADU,TUTICORIN,2021-01-07,5,1198,0,1203
TAMIL NADU,TUTICORIN,2021-01-08,3,1232,0,1235
TAMIL NADU,TUTICORIN,2021-01-09,3,1065,0,1068
TAMIL NADU,TUTICORIN,2021-01-10,3,766,0,769
TAMIL NADU,VELLORE,2021-01-06,29,1903,0,1932
TAMIL NADU,VELLORE,2021-01-07,22,1599,2,1623
TAMIL NADU,VELLORE,2021-01-08,15,1996,2,2013
TAMIL NADU,VELLORE,2021-01-09,15,1739,1,1755
TAMIL NADU,VELLORE,2021-01-10,10,880,0,890
TAMIL NADU,VILLUPURAM,2021-01-06,0,2422,3,2425
TAMIL NADU,VILLUPURAM,2021-01-07,10,1071,1,1082
TAMIL NADU,VILLUPURAM,2021-01-08,1,1225,0,1226
TAMIL NADU,VILLUPURAM,2021-01-09,3,1186,0,1189
TAMIL NADU,VILLUPURAM,2021-01-10,4,833,0,837
TAMIL NADU,VIRUDHUNAGAR,2021-01-06,6,1645,3,1654
TAMIL NADU,VIRUDHUNAGAR,2021-01-07,13,1820,0,1833
TAMIL NADU,VIRUDHUNAGAR,2021-01-08,6,1302,0,1308
TAMIL NADU,VIRUDHUNAGAR,2021-01-09,7,2652,0,2659
TAMIL NADU,VIRUDHUNAGAR,2021-01-10,2,1940,1,1943
TELANGANA,ADILABAD,2021-01-06,0,546,0,546
TELANGANA,ADILABAD,2021-01-07,0,301,0,301
TELANGANA,ADILABAD,2021-01-08,0,525,0,525
TELANGANA,ADILABAD,2021-01-09,0,589,0,589
TELANGANA,ADILABAD,2021-01-10,1,234,0,235
TELANGANA,BHADRADRI KOTHAGUDEM,2021-01-06,0,1259,0,1259
TELANGANA,BHADRADRI KOTHAGUDEM,2021-01-07,0,1275,0,1275
TELANGANA,BHADRADRI KOTHAGUDEM,2021-01-08,0,744,0,744
TELANGANA,BHADRADRI KOTHAGUDEM,2021-01-09,0,1330,0,1330
TELANGANA,BHADRADRI KOTHAGUDEM,2021-01-10,0,626,0,626
TELANGANA,HYDERABAD,2021-01-06,35,7561,3,7599
TELANGANA,HYDERABAD,2021-01-07,67,6964,0,7031
TELANGANA,HYDERABAD,2021-01-08,34,5787,7,5828
TELANGANA,HYDERABAD,2021-01-09,48,7492,2,7542
TELANGANA,HYDERABAD,2021-01-10,30,5043,2,5075
TELANGANA,JAGITIAL,2021-01-06,0,574,0,574
TELANGANA,JAGITIAL,2021-01-07,0,612,0,612
TELANGANA,JAGITIAL,2021-01-08,0,497,0,497
TELANGANA,JAGITIAL,2021-01-09,0,459,0,459
TELANGANA,JAGITIAL,2021-01-10,0,195,0,195
TELANGANA,JANGOAN,2021-01-06,0,757,0,757
TELANGANA,JANGOAN,2021-01-07,0,710,0,710
TELANGANA,JANGOAN,2021-01-08,0,465,0,465
TELANGANA,JANGOAN,2021-01-09,0,660,0,660
TELANGANA,JANGOAN,2021-01-10,0,442,0,442
TELANGANA,JAYASHANKAR BHUPALAPALLY,2021-01-06,0,217,0,217
TELANGANA,JAYASHANKAR BHUPALAPALLY,2021-01-07,0,123,0,123
TELANGANA,JAYASHANKAR BHUPALAPALLY,2021-01-08,0,87,0,87
TELANGANA,JAYASHANKAR BHUPALAPALLY,2021-01-09,0,82,0,82
TELANGANA,JAYASHANKAR BHUPALAPALLY,2021-01-10,0,73,0,73
TELANGANA,JOGULAMBA GADWAL,2021-01-06,0,359,0,359
TELANGANA,JOGULAMBA GADWAL,2021-01-07,0,575,0,575
TELANGANA,JOGULAMBA GADWAL,2021-01-08,0,736,0,736
TELANGANA,JOGULAMBA GADWAL,2021-01-09,0,398,0,398
TELANGANA,JOGULAMBA GADWAL,2021-01-10,0,414,0,414
TELANGANA,KAMAREDDY,2021-01-06,0,589,0,589
TELANGANA,KAMAREDDY,2021-01-07,0,709,0,709
TELANGANA,KAMAREDDY,2021-01-08,0,192,0,192
TELANGANA,KAMAREDDY,2021-01-09,0,679,0,679
TELANGANA,KAMAREDDY,2021-01-10,0,97,0,97
TELANGANA,KARIMNAGAR,2021-01-06,7,1072,0,1079
TELANGANA,KARIMNAGAR,2021-01-07,1,1264,0,1265
TELANGANA,KARIMNAGAR,2021-01-08,0,800,0,800
TELANGANA,KARIMNAGAR,2021-01-09,7,1212,0,1219
TELANGANA,KARIMNAGAR,2021-01-10,2,654,0,656
TELANGANA,KHAMMAM,2021-01-06,1,1067,0,1068
TELANGANA,KHAMMAM,2021-01-07,0,1101,0,1101
TELANGANA,KHAMMAM,2021-01-08,0,543,0,543
TELANGANA,KHAMMAM,2021-01-09,0,768,0,768
TELANGANA,KHAMMAM,2021-01-10,0,245,0,245
TELANGANA,KUMURAM BHEEM ASIFABAD,2021-01-06,0,518,0,518
TELANGANA,KUMURAM BHEEM ASIFABAD,2021-01-07,0,660,0,660
TELANGANA,KUMURAM BHEEM ASIFABAD,2021-01-08,0,483,0,483
TELANGANA,KUMURAM BHEEM ASIFABAD,2021-01-09,0,634,0,634
TELANGANA,KUMURAM BHEEM ASIFABAD,2021-01-10,0,422,0,422
TELANGANA,MAHABUBABAD,2021-01-06,0,456,0,456
TELANGANA,MAHABUBABAD,2021-01-07,0,658,0,658
TELANGANA,MAHABUBABAD,2021-01-08,0,404,0,404
TELANGANA,MAHABUBABAD,2021-01-09,0,529,0,529
TELANGANA,MAHABUBABAD,2021-01-10,0,376,0,376
TELANGANA,MAHABUBNAGAR,2021-01-06,0,683,0,683
TELANGANA,MAHABUBNAGAR,2021-01-07,0,932,0,932
TELANGANA,MAHABUBNAGAR,2021-01-08,0,684,0,684
TELANGANA,MAHABUBNAGAR,2021-01-09,1,704,0,705
TELANGANA,MAHABUBNAGAR,2021-01-10,0,278,0,278
TELANGANA,MANCHERIAL,2021-01-06,0,718,0,718
TELANGANA,MANCHERIAL,2021-01-07,1,548,0,549
TELANGANA,MANCHERIAL,2021-01-08,1,474,0,475
TELANGANA,MANCHERIAL,2021-01-09,0,591,0,591
TELANGANA,MANCHERIAL,2021-01-10,0,308,0,308
TELANGANA,MEDAK,2021-01-06,0,330,0,330
TELANGANA,MEDAK,2021-01-07,1,355,0,356
TELANGANA,MEDAK,2021-01-08,0,207,0,207
TELANGANA,MEDAK,2021-01-09,0,342,1,343
TELANGANA,MEDAK,2021-01-10,0,103,0,103
TELANGANA,MEDCHAL MALKAJGIRI,2021-01-06,1,1463,0,1464
TELANGANA,MEDCHAL MALKAJGIRI,2021-01-07,0,1302,0,1302
TELANGANA,MEDCHAL MALKAJGIRI,2021-01-08,3,1112,0,1115
TELANGANA,MEDCHAL MALKAJGIRI,2021-01-09,1,1373,0,1374
TELANGANA,MEDCHAL MALKAJGIRI,2021-01-10,0,544,0,544
TELANGANA,MULUGU,2021-01-06,0,218,0,218
TELANGANA,MULUGU,2021-01-07,0,124,0,124
TELANGANA,MULUGU,2021-01-08,0,61,0,61
TELANGANA,MULUGU,2021-01-09,0,107,0,107
TELANGANA,MULUGU,2021-01-10,0,145,0,145
TELANGANA,NAGARKURNOOL,2021-01-06,9,1112,0,1121
TELANGANA,NAGARKURNOOL,2021-01-07,0,841,0,841
TELANGANA,NAGARKURNOOL,2021-01-08,0,975,1,976
TELANGANA,NAGARKURNOOL,2021-01-09,0,998,0,998
TELANGANA,NAGARKURNOOL,2021-01-10,0,782,0,782
TELANGANA,NALGONDA,2021-01-06,3,526,0,529
TELANGANA,NALGONDA,2021-01-07,0,460,0,460
TELANGANA,NALGONDA,2021-01-08,1,329,0,330
TELANGANA,NALGONDA,2021-01-09,1,434,0,435
TELANGANA,NALGONDA,2021-01-10,0,53,0,53
TELANGANA,NARAYANPET,2021-01-06,0,228,0,228
TELANGANA,NARAYANPET,2021-01-07,0,323,0,323
TELANGANA,NARAYANPET,2021-01-08,0,160,0,160
TELANGANA,NARAYANPET,2021-01-09,0,198,0,198
TELANGANA,NARAYANPET,2021-01-10,0,187,0,187
TELANGANA,NIRMAL,2021-01-06,0,771,0,771
TELANGANA,NIRMAL,2021-01-07,0,785,0,785
TELANGANA,NIRMAL,2021-01-08,0,693,0,693
TELANGANA,NIRMAL,2021-01-09,0,667,0,667
TELANGANA,NIRMAL,2021-01-10,0,142,0,142
TELANGANA,NIZAMABAD,2021-01-06,1,357,0,358
TELANGANA,NIZAMABAD,2021-01-07,0,269,0,269
TELANGANA,NIZAMABAD,2021-01-08,0,262,0,262
TELANGANA,NIZAMABAD,2021-01-09,3,335,0,338
TELANGANA,NIZAMABAD,2021-01-10,0,177,0,177
TELANGANA,PEDDAPALLI,2021-01-06,1,922,0,923
TELANGANA,PEDDAPALLI,2021-01-07,1,949,2,952
TELANGANA,PEDDAPALLI,2021-01-08,0,441,0,441
TELANGANA,PEDDAPALLI,2021-01-09,0,973,0,973
TELANGANA,PEDDAPALLI,2021-01-10,0,272,0,272
TELANGANA,RAJANNA SIRCILLA,2021-01-06,0,506,0,506
TELANGANA,RAJANNA SIRCILLA,2021-01-07,0,180,0,180
TELANGANA,RAJANNA SIRCILLA,2021-01-08,0,197,0,197
TELANGANA,RAJANNA SIRCILLA,2021-01-09,0,263,0,263
TELANGANA,RAJANNA SIRCILLA,2021-01-10,0,262,0,262
TELANGANA,RANGA REDDY,2021-01-06,8,2019,0,2027
TELANGANA,RANGA REDDY,2021-01-07,2,1957,0,1959
TELANGANA,RANGA REDDY,2021-01-08,14,1725,1,1740
TELANGANA,RANGA REDDY,2021-01-09,3,2097,0,2100
TELANGANA,RANGA REDDY,2021-01-10,0,1010,0,1010
TELANGANA,SANGAREDDY,2021-01-06,0,1146,0,1146
TELANGANA,SANGAREDDY,2021-01-07,1,945,0,946
TELANGANA,SANGAREDDY,2021-01-08,9,869,1,879
TELANGANA,SANGAREDDY,2021-01-09,0,1031,0,1031
TELANGANA,SANGAREDDY,2021-01-10,1,475,0,476
TELANGANA,SIDDIPET,2021-01-06,1,1896,0,1897
TELANGANA,SIDDIPET,2021-01-07,0,2307,0,2307
TELANGANA,SIDDIPET,2021-01-08,0,1684,0,1684
TELANGANA,SIDDIPET,2021-01-09,0,1979,0,1979
TELANGANA,SIDDIPET,2021-01-10,0,1712,0,1712
TELANGANA,SURYAPET,2021-01-06,0,1011,0,1011
TELANGANA,SURYAPET,2021-01-07,0,926,0,926
TELANGANA,SURYAPET,2021-01-08,0,960,0,960
TELANGANA,SURYAPET,2021-01-09,0,958,0,958
TELANGANA,SURYAPET,2021-01-10,0,732,0,732
TELANGANA,VIKARABAD,2021-01-06,0,660,0,660
TELANGANA,VIKARABAD,2021-01-07,0,459,0,459
TELANGANA,VIKARABAD,2021-01-08,0,577,0,577
TELANGANA,VIKARABAD,2021-01-09,0,590,0,590
TELANGANA,VIKARABAD,2021-01-10,0,226,0,226
TELANGANA,WANAPARTHY,2021-01-06,1,242,0,243
TELANGANA,WANAPARTHY,2021-01-07,0,273,0,273
TELANGANA,WANAPARTHY,2021-01-08,0,235,0,235
TELANGANA,WANAPARTHY,2021-01-09,0,325,0,325
TELANGANA,WANAPARTHY,2021-01-10,0,180,0,180
TELANGANA,WARANGAL RURAL,2021-01-06,0,650,0,650
TELANGANA,WARANGAL RURAL,2021-01-07,0,533,0,533
TELANGANA,WARANGAL RURAL,2021-01-08,0,354,0,354
TELANGANA,WARANGAL RURAL,2021-01-09,0,508,0,508
TELANGANA,WARANGAL RURAL,2021-01-10,0,196,0,196
TELANGANA,WARANGAL URBAN,2021-01-06,0,1921,0,1921
TELANGANA,WARANGAL URBAN,2021-01-07,1,2082,0,2083
TELANGANA,WARANGAL URBAN,2021-01-08,0,834,0,834
TELANGANA,WARANGAL URBAN,2021-01-09,0,1792,0,1792
TELANGANA,WARANGAL URBAN,2021-01-10,4,1308,0,1312
TELANGANA,YADADRI BHUVANAGIRI,2021-01-06,0,247,0,247
TELANGANA,YADADRI BHUVANAGIRI,2021-01-07,0,356,0,356
TELANGANA,YADADRI BHUVANAGIRI,2021-01-08,0,152,0,152
TELANGANA,YADADRI BHUVANAGIRI,2021-01-09,0,195,0,195
TELANGANA,YADADRI BHUVANAGIRI,2021-01-10,0,91,0,91
TRIPURA,DHALAI,2021-01-06,1,60,0,61
TRIPURA,DHALAI,2021-01-07,0,19,0,19
TRIPURA,DHALAI,2021-01-08,0,26,0,26
TRIPURA,DHALAI,2021-01-09,0,20,0,20
TRIPURA,DHALAI,2021-01-10,0,41,0,41
TRIPURA,GOMATI,2021-01-06,0,90,0,90
TRIPURA,GOMATI,2021-01-07,0,54,0,54
TRIPURA,GOMATI,2021-01-08,0,29,0,29
TRIPURA,GOMATI,2021-01-09,0,47,0,47
TRIPURA,GOMATI,2021-01-10,0,34,0,34
TRIPURA,KHOWAI,2021-01-06,0,105,0,105
TRIPURA,KHOWAI,2021-01-07,0,40,0,40
TRIPURA,KHOWAI,2021-01-08,1,26,0,27
TRIPURA,KHOWAI,2021-01-09,0,27,0,27
TRIPURA,KHOWAI,2021-01-10,0,27,0,27
TRIPURA,NORTH TRIPURA,2021-01-06,0,130,0,130
TRIPURA,NORTH TRIPURA,2021-01-07,1,166,0,167
TRIPURA,NORTH TRIPURA,2021-01-08,0,114,0,114
TRIPURA,NORTH TRIPURA,2021-01-09,0,144,0,144
TRIPURA,NORTH TRIPURA,2021-01-10,0,83,0,83
TRIPURA,SEPAHIJALA,2021-01-06,1,98,0,99
TRIPURA,SEPAHIJALA,2021-01-07,0,118,0,118
TRIPURA,SEPAHIJALA,2021-01-08,1,77,0,78
TRIPURA,SEPAHIJALA,2021-01-09,0,50,0,50
TRIPURA,SEPAHIJALA,2021-01-10,0,36,0,36
TRIPURA,SOUTH TRIPURA,2021-01-06,1,408,0,409
TRIPURA,SOUTH TRIPURA,2021-01-07,0,151,0,151
TRIPURA,SOUTH TRIPURA,2021-01-08,0,192,0,192
TRIPURA,SOUTH TRIPURA,2021-01-09,2,184,0,186
TRIPURA,SOUTH TRIPURA,2021-01-10,0,98,0,98
TRIPURA,UNAKOTI,2021-01-06,0,11,0,11
TRIPURA,UNAKOTI,2021-01-07,1,14,0,15
TRIPURA,UNAKOTI,2021-01-08,0,7,0,7
TRIPURA,UNAKOTI,2021-01-09,0,2,0,2
TRIPURA,UNAKOTI,2021-01-10,0,4,0,4
TRIPURA,WEST TRIPURA,2021-01-06,6,320,0,326
TRIPURA,WEST TRIPURA,2021-01-07,6,323,0,329
TRIPURA,WEST TRIPURA,2021-01-08,3,389,0,392
TRIPURA,WEST TRIPURA,2021-01-09,5,218,0,223
TRIPURA,WEST TRIPURA,2021-01-10,0,249,0,249
UTTAR PRADESH,AGRA,2021-01-06,29,2021,11,2061
UTTAR PRADESH,AGRA,2021-01-07,14,2004,9,2027
UTTAR PRADESH,AGRA,2021-01-08,13,2270,14,2297
UTTAR PRADESH,AGRA,2021-01-09,16,1464,23,1503
UTTAR PRADESH,AGRA,2021-01-10,7,700,4,711
UTTAR PRADESH,ALIGARH,2021-01-06,5,2606,9,2620
UTTAR PRADESH,ALIGARH,2021-01-07,4,2336,3,2343
UTTAR PRADESH,ALIGARH,2021-01-08,8,2991,54,3053
UTTAR PRADESH,ALIGARH,2021-01-09,4,3624,10,3638
UTTAR PRADESH,ALIGARH,2021-01-10,1,2443,1,2445
UTTAR PRADESH,AMBEDKAR NAGAR,2021-01-06,2,1866,5,1873
UTTAR PRADESH,AMBEDKAR NAGAR,2021-01-07,7,1353,1,1361
UTTAR PRADESH,AMBEDKAR NAGAR,2021-01-08,7,2043,2,2052
UTTAR PRADESH,AMBEDKAR NAGAR,2021-01-09,5,1464,3,1472
UTTAR PRADESH,AMBEDKAR NAGAR,2021-01-10,2,1038,0,1040
UTTAR PRADESH,AMETHI,2021-01-06,7,1577,0,1584
UTTAR PRADESH,AMETHI,2021-01-07,8,2359,20,2387
UTTAR PRADESH,AMETHI,2021-01-08,8,821,0,829
UTTAR PRADESH,AMETHI,2021-01-09,10,1903,20,1933
UTTAR PRADESH,AMETHI,2021-01-10,4,1228,0,1232
UTTAR PRADESH,AMROHA,2021-01-06,10,1272,1,1283
UTTAR PRADESH,AMROHA,2021-01-07,8,583,2,593
UTTAR PRADESH,AMROHA,2021-01-08,2,1933,0,1935
UTTAR PRADESH,AMROHA,2021-01-09,6,1153,0,1159
UTTAR PRADESH,AMROHA,2021-01-10,5,1530,6,1541
UTTAR PRADESH,AURAIYA,2021-01-06,2,365,42,409
UTTAR PRADESH,AURAIYA,2021-01-07,7,1278,25,1310
UTTAR PRADESH,AURAIYA,2021-01-08,2,1162,5,1169
UTTAR PRADESH,AURAIYA,2021-01-09,1,746,30,777
UTTAR PRADESH,AURAIYA,2021-01-10,1,352,13,366
UTTAR PRADESH,AYODHYA,2021-01-06,11,1199,0,1210
UTTAR PRADESH,AYODHYA,2021-01-07,4,1665,34,1703
UTTAR PRADESH,AYODHYA,2021-01-08,5,1548,133,1686
UTTAR PRADESH,AYODHYA,2021-01-09,14,2130,43,2187
UTTAR PRADESH,AYODHYA,2021-01-10,13,1707,131,1851
UTTAR PRADESH,AZAMGARH,2021-01-06,3,1144,28,1175
UTTAR PRADESH,AZAMGARH,2021-01-07,9,921,8,938
UTTAR PRADESH,AZAMGARH,2021-01-08,2,927,9,938
UTTAR PRADESH,AZAMGARH,2021-01-09,1,789,18,808
UTTAR PRADESH,AZAMGARH,2021-01-10,2,891,21,914
UTTAR PRADESH,BAGHPAT,2021-01-06,3,2324,26,2353
UTTAR PRADESH,BAGHPAT,2021-01-07,7,479,5,491
UTTAR PRADESH,BAGHPAT,2021-01-08,5,1395,16,1416
UTTAR PRADESH,BAGHPAT,2021-01-09,1,1422,63,1486
UTTAR PRADESH,BAGHPAT,2021-01-10,2,2266,6,2274
UTTAR PRADESH,BAHRAICH,2021-01-06,6,1873,11,1890
UTTAR PRADESH,BAHRAICH,2021-01-07,5,1991,134,2130
UTTAR PRADESH,BAHRAICH,2021-01-08,1,1902,23,1926
UTTAR PRADESH,BAHRAICH,2021-01-09,2,1861,27,1890
UTTAR PRADESH,BAHRAICH,2021-01-10,2,1625,22,1649
UTTAR PRADESH,BALLIA,2021-01-06,11,910,0,921
UTTAR PRADESH,BALLIA,2021-01-07,15,795,2,812
UTTAR PRADESH,BALLIA,2021-01-08,5,1184,6,1195
UTTAR PRADESH,BALLIA,2021-01-09,8,301,2,311
UTTAR PRADESH,BALLIA,2021-01-10,11,1447,91,1549
UTTAR PRADESH,BALRAMPUR,2021-01-06,2,1647,0,1649
UTTAR PRADESH,BALRAMPUR,2021-01-07,3,1700,0,1703
UTTAR PRADESH,BALRAMPUR,2021-01-08,4,1508,2,1514
UTTAR PRADESH,BALRAMPUR,2021-01-09,4,1392,0,1396
UTTAR PRADESH,BALRAMPUR,2021-01-10,2,960,0,962
UTTAR PRADESH,BANDA,2021-01-06,7,2412,8,2427
UTTAR PRADESH,BANDA,2021-01-07,9,2111,7,2127
UTTAR PRADESH,BANDA,2021-01-08,14,1985,17,2016
UTTAR PRADESH,BANDA,2021-01-09,9,2000,11,2020
UTTAR PRADESH,BANDA,2021-01-10,1,1987,8,1996
UTTAR PRADESH,BARABANKI,2021-01-06,6,1945,53,2004
UTTAR PRADESH,BARABANKI,2021-01-07,16,1710,5,1731
UTTAR PRADESH,BARABANKI,2021-01-08,2,1076,0,1078
UTTAR PRADESH,BARABANKI,2021-01-09,2,1315,11,1328
UTTAR PRADESH,BARABANKI,2021-01-10,4,1932,12,1948
UTTAR PRADESH,BAREILLY,2021-01-06,33,3150,98,3281
UTTAR PRADESH,BAREILLY,2021-01-07,27,2848,91,2966
UTTAR PRADESH,BAREILLY,2021-01-08,22,3003,13,3038
UTTAR PRADESH,BAREILLY,2021-01-09,20,2229,89,2338
UTTAR PRADESH,BAREILLY,2021-01-10,27,2371,0,2398
UTTAR PRADESH,BASTI,2021-01-06,3,1456,58,1517
UTTAR PRADESH,BASTI,2021-01-07,7,1283,30,1320
UTTAR PRADESH,BASTI,2021-01-08,1,1539,15,1555
UTTAR PRADESH,BASTI,2021-01-09,7,1058,61,1126
UTTAR PRADESH,BASTI,2021-01-10,0,1228,25,1253
UTTAR PRADESH,BHADOHI,2021-01-06,2,1499,1,1502
UTTAR PRADESH,BHADOHI,2021-01-07,2,1500,0,1502
UTTAR PRADESH,BHADOHI,2021-01-08,2,1456,17,1475
UTTAR PRADESH,BHADOHI,2021-01-09,5,1517,0,1522
UTTAR PRADESH,BHADOHI,2021-01-10,3,1477,0,1480
UTTAR PRADESH,BIJNOR,2021-01-06,13,1331,4,1348
UTTAR PRADESH,BIJNOR,2021-01-07,8,1661,3,1672
UTTAR PRADESH,BIJNOR,2021-01-08,13,1733,2,1748
UTTAR PRADESH,BIJNOR,2021-01-09,8,1637,2,1647
UTTAR PRADESH,BIJNOR,2021-01-10,6,1619,4,1629
UTTAR PRADESH,BUDAUN,2021-01-06,43,1569,25,1637
UTTAR PRADESH,BUDAUN,2021-01-07,22,1771,50,1843
UTTAR PRADESH,BUDAUN,2021-01-08,6,2343,34,2383
UTTAR PRADESH,BUDAUN,2021-01-09,3,719,23,745
UTTAR PRADESH,BUDAUN,2021-01-10,4,1393,17,1414
UTTAR PRADESH,BULANDSHAHR,2021-01-06,13,2159,24,2196
UTTAR PRADESH,BULANDSHAHR,2021-01-07,17,1708,5,1730
UTTAR PRADESH,BULANDSHAHR,2021-01-08,6,1615,4,1625
UTTAR PRADESH,BULANDSHAHR,2021-01-09,9,555,3,567
UTTAR PRADESH,BULANDSHAHR,2021-01-10,8,629,4,641
UTTAR PRADESH,CHANDAULI,2021-01-06,7,928,21,956
UTTAR PRADESH,CHANDAULI,2021-01-07,12,889,0,901
UTTAR PRADESH,CHANDAULI,2021-01-08,6,988,1,995
UTTAR PRADESH,CHANDAULI,2021-01-09,2,1541,19,1562
UTTAR PRADESH,CHANDAULI,2021-01-10,6,505,0,511
UTTAR PRADESH,CHITRAKOOT,2021-01-06,1,1912,1,1914
UTTAR PRADESH,CHITRAKOOT,2021-01-07,3,1392,0,1395
UTTAR PRADESH,CHITRAKOOT,2021-01-08,4,1225,7,1236
UTTAR PRADESH,CHITRAKOOT,2021-01-09,4,1118,39,1161
UTTAR PRADESH,CHITRAKOOT,2021-01-10,4,742,20,766
UTTAR PRADESH,DEORIA,2021-01-06,4,1281,18,1303
UTTAR PRADESH,DEORIA,2021-01-07,4,2578,12,2594
UTTAR PRADESH,DEORIA,2021-01-08,3,1840,48,1891
UTTAR PRADESH,DEORIA,2021-01-09,3,1378,2,1383
UTTAR PRADESH,DEORIA,2021-01-10,4,1240,15,1259
UTTAR PRADESH,ETAH,2021-01-06,1,1962,5,1968
UTTAR PRADESH,ETAH,2021-01-07,5,1326,7,1338
UTTAR PRADESH,ETAH,2021-01-08,0,946,0,946
UTTAR PRADESH,ETAH,2021-01-09,4,1206,5,1215
UTTAR PRADESH,ETAH,2021-01-10,2,1180,16,1198
UTTAR PRADESH,ETAWAH,2021-01-06,3,760,92,855
UTTAR PRADESH,ETAWAH,2021-01-07,3,798,104,905
UTTAR PRADESH,ETAWAH,2021-01-08,1,766,163,930
UTTAR PRADESH,ETAWAH,2021-01-09,3,3682,154,3839
UTTAR PRADESH,ETAWAH,2021-01-10,3,2864,113,2980
UTTAR PRADESH,FARRUKHABAD,2021-01-06,6,1022,86,1114
UTTAR PRADESH,FARRUKHABAD,2021-01-07,6,1339,59,1404
UTTAR PRADESH,FARRUKHABAD,2021-01-08,6,1172,78,1256
UTTAR PRADESH,FARRUKHABAD,2021-01-09,4,856,26,886
UTTAR PRADESH,FARRUKHABAD,2021-01-10,2,846,14,862
UTTAR PRADESH,FATEHPUR,2021-01-06,2,2214,13,2229
UTTAR PRADESH,FATEHPUR,2021-01-07,5,2198,22,2225
UTTAR PRADESH,FATEHPUR,2021-01-08,1,2063,7,2071
UTTAR PRADESH,FATEHPUR,2021-01-09,6,2371,52,2429
UTTAR PRADESH,FATEHPUR,2021-01-10,2,1468,162,1632
UTTAR PRADESH,FIROZABAD,2021-01-06,2,3655,6,3663
UTTAR PRADESH,FIROZABAD,2021-01-07,4,2269,6,2279
UTTAR PRADESH,FIROZABAD,2021-01-08,2,693,6,701
UTTAR PRADESH,FIROZABAD,2021-01-09,2,3523,5,3530
UTTAR PRADESH,FIROZABAD,2021-01-10,2,691,5,698
UTTAR PRADESH,GAUTAM BUDDHA NAGAR,2021-01-06,75,2300,22,2397
UTTAR PRADESH,GAUTAM BUDDHA NAGAR,2021-01-07,93,2362,2,2457
UTTAR PRADESH,GAUTAM BUDDHA NAGAR,2021-01-08,128,2474,36,2638
UTTAR PRADESH,GAUTAM BUDDHA NAGAR,2021-01-09,94,2160,11,2265
UTTAR PRADESH,GAUTAM BUDDHA NAGAR,2021-01-10,70,1759,24,1853
UTTAR PRADESH,GHAZIABAD,2021-01-06,106,4168,7,4281
UTTAR PRADESH,GHAZIABAD,2021-01-07,81,4043,15,4139
UTTAR PRADESH,GHAZIABAD,2021-01-08,88,3499,6,3593
UTTAR PRADESH,GHAZIABAD,2021-01-09,95,3887,61,4043
UTTAR PRADESH,GHAZIABAD,2021-01-10,63,3763,47,3873
UTTAR PRADESH,GHAZIPUR,2021-01-06,5,1462,35,1502
UTTAR PRADESH,GHAZIPUR,2021-01-07,7,955,5,967
UTTAR PRADESH,GHAZIPUR,2021-01-08,6,1019,12,1037
UTTAR PRADESH,GHAZIPUR,2021-01-09,7,1285,33,1325
UTTAR PRADESH,GHAZIPUR,2021-01-10,2,553,3,558
UTTAR PRADESH,GONDA,2021-01-06,1,1837,83,1921
UTTAR PRADESH,GONDA,2021-01-07,1,1496,63,1560
UTTAR PRADESH,GONDA,2021-01-08,0,1535,137,1672
UTTAR PRADESH,GONDA,2021-01-09,8,1693,259,1960
UTTAR PRADESH,GONDA,2021-01-10,1,1269,0,1270
UTTAR PRADESH,GORAKHPUR,2021-01-06,29,2697,12,2738
UTTAR PRADESH,GORAKHPUR,2021-01-07,23,3190,34,3247
UTTAR PRADESH,GORAKHPUR,2021-01-08,11,2998,37,3046
UTTAR PRADESH,GORAKHPUR,2021-01-09,10,3012,44,3066
UTTAR PRADESH,GORAKHPUR,2021-01-10,12,3088,80,3180
UTTAR PRADESH,HAMIRPUR,2021-01-06,0,1179,4,1183
UTTAR PRADESH,HAMIRPUR,2021-01-07,4,1417,12,1433
UTTAR PRADESH,HAMIRPUR,2021-01-08,1,1048,4,1053
UTTAR PRADESH,HAMIRPUR,2021-01-09,2,1296,2,1300
UTTAR PRADESH,HAMIRPUR,2021-01-10,0,918,10,928
UTTAR PRADESH,HAPUR,2021-01-06,5,530,30,565
UTTAR PRADESH,HAPUR,2021-01-07,1,137,9,147
UTTAR PRADESH,HAPUR,2021-01-08,6,4806,11,4823
UTTAR PRADESH,HAPUR,2021-01-09,7,1672,5,1684
UTTAR PRADESH,HAPUR,2021-01-10,1,1683,30,1714
UTTAR PRADESH,HARDOI,2021-01-06,7,1608,5,1620
UTTAR PRADESH,HARDOI,2021-01-07,6,1751,18,1775
UTTAR PRADESH,HARDOI,2021-01-08,9,1724,21,1754
UTTAR PRADESH,HARDOI,2021-01-09,9,1542,7,1558
UTTAR PRADESH,HARDOI,2021-01-10,3,1426,29,1458
UTTAR PRADESH,HATHRAS,2021-01-06,2,554,0,556
UTTAR PRADESH,HATHRAS,2021-01-07,0,2025,0,2025
UTTAR PRADESH,HATHRAS,2021-01-08,1,1354,1,1356
UTTAR PRADESH,HATHRAS,2021-01-09,0,829,0,829
UTTAR PRADESH,HATHRAS,2021-01-10,1,722,77,800
UTTAR PRADESH,JALAUN,2021-01-06,0,1735,8,1743
UTTAR PRADESH,JALAUN,2021-01-07,3,1631,1,1635
UTTAR PRADESH,JALAUN,2021-01-08,4,1419,2,1425
UTTAR PRADESH,JALAUN,2021-01-09,2,1346,5,1353
UTTAR PRADESH,JALAUN,2021-01-10,2,789,1,792
UTTAR PRADESH,JAUNPUR,2021-01-06,5,1555,0,1560
UTTAR PRADESH,JAUNPUR,2021-01-07,5,1383,24,1412
UTTAR PRADESH,JAUNPUR,2021-01-08,8,1618,3,1629
UTTAR PRADESH,JAUNPUR,2021-01-09,5,1690,4,1699
UTTAR PRADESH,JAUNPUR,2021-01-10,8,1633,9,1650
UTTAR PRADESH,JHANSI,2021-01-06,17,2692,1,2710
UTTAR PRADESH,JHANSI,2021-01-07,20,3506,4,3530
UTTAR PRADESH,JHANSI,2021-01-08,19,3976,2,3997
UTTAR PRADESH,JHANSI,2021-01-09,13,3662,5,3680
UTTAR PRADESH,JHANSI,2021-01-10,21,3572,0,3593
UTTAR PRADESH,KANNAUJ,2021-01-06,10,1371,0,1381
UTTAR PRADESH,KANNAUJ,2021-01-07,5,1724,0,1729
UTTAR PRADESH,KANNAUJ,2021-01-08,2,1770,0,1772
UTTAR PRADESH,KANNAUJ,2021-01-09,2,1591,4,1597
UTTAR PRADESH,KANNAUJ,2021-01-10,0,1446,2,1448
UTTAR PRADESH,KANPUR DEHAT,2021-01-06,0,997,1,998
UTTAR PRADESH,KANPUR DEHAT,2021-01-07,1,1344,8,1353
UTTAR PRADESH,KANPUR DEHAT,2021-01-08,5,893,3,901
UTTAR PRADESH,KANPUR DEHAT,2021-01-09,1,1704,5,1710
UTTAR PRADESH,KANPUR DEHAT,2021-01-10,1,791,2,794
UTTAR PRADESH,KANPUR NAGAR,2021-01-06,41,3879,70,3990
UTTAR PRADESH,KANPUR NAGAR,2021-01-07,30,3752,8,3790
UTTAR PRADESH,KANPUR NAGAR,2021-01-08,28,3593,13,3634
UTTAR PRADESH,KANPUR NAGAR,2021-01-09,28,3418,21,3467
UTTAR PRADESH,KANPUR NAGAR,2021-01-10,23,3152,10,3185
UTTAR PRADESH,KASGANJ,2021-01-06,1,3424,8,3433
UTTAR PRADESH,KASGANJ,2021-01-07,3,894,1,898
UTTAR PRADESH,KASGANJ,2021-01-08,0,1640,8,1648
UTTAR PRADESH,KASGANJ,2021-01-09,0,229,1,230
UTTAR PRADESH,KASGANJ,2021-01-10,0,874,5,879
UTTAR PRADESH,KAUSHAMBI,2021-01-06,1,1950,1,1952
UTTAR PRADESH,KAUSHAMBI,2021-01-07,0,1174,0,1174
UTTAR PRADESH,KAUSHAMBI,2021-01-08,0,1484,0,1484
UTTAR PRADESH,KAUSHAMBI,2021-01-09,0,2066,2,2068
UTTAR PRADESH,KAUSHAMBI,2021-01-10,0,1427,0,1427
UTTAR PRADESH,KHERI,2021-01-06,6,1290,2,1298
UTTAR PRADESH,KHERI,2021-01-07,8,2459,56,2523
UTTAR PRADESH,KHERI,2021-01-08,10,1714,6,1730
UTTAR PRADESH,KHERI,2021-01-09,4,1631,27,1662
UTTAR PRADESH,KHERI,2021-01-10,6,1651,1,1658
UTTAR PRADESH,KUSHI NAGAR,2021-01-06,0,1650,2,1652
UTTAR PRADESH,KUSHI NAGAR,2021-01-07,0,1812,13,1825
UTTAR PRADESH,KUSHI NAGAR,2021-01-08,2,909,30,941
UTTAR PRADESH,KUSHI NAGAR,2021-01-09,3,1639,25,1667
UTTAR PRADESH,KUSHI NAGAR,2021-01-10,6,1465,15,1486
UTTAR PRADESH,LALITPUR,2021-01-06,4,1759,5,1768
UTTAR PRADESH,LALITPUR,2021-01-07,9,1230,1,1240
UTTAR PRADESH,LALITPUR,2021-01-08,11,2436,7,2454
UTTAR PRADESH,LALITPUR,2021-01-09,14,1505,9,1528
UTTAR PRADESH,LALITPUR,2021-01-10,4,1441,0,1445
UTTAR PRADESH,LUCKNOW,2021-01-06,165,7996,231,8392
UTTAR PRADESH,LUCKNOW,2021-01-07,157,8369,242,8768
UTTAR PRADESH,LUCKNOW,2021-01-08,133,8222,284,8639
UTTAR PRADESH,LUCKNOW,2021-01-09,185,6568,283,7036
UTTAR PRADESH,LUCKNOW,2021-01-10,129,6627,176,6932
UTTAR PRADESH,MAHARAJGANJ,2021-01-06,6,2095,37,2138
UTTAR PRADESH,MAHARAJGANJ,2021-01-07,6,2550,40,2596
UTTAR PRADESH,MAHARAJGANJ,2021-01-08,5,1023,74,1102
UTTAR PRADESH,MAHARAJGANJ,2021-01-09,3,1726,81,1810
UTTAR PRADESH,MAHARAJGANJ,2021-01-10,0,709,7,716
UTTAR PRADESH,MAHOBA,2021-01-06,3,673,11,687
UTTAR PRADESH,MAHOBA,2021-01-07,2,1061,0,1063
UTTAR PRADESH,MAHOBA,2021-01-08,0,867,0,867
UTTAR PRADESH,MAHOBA,2021-01-09,1,929,2,932
UTTAR PRADESH,MAHOBA,2021-01-10,0,922,0,922
UTTAR PRADESH,MAINPURI,2021-01-06,6,1533,5,1544
UTTAR PRADESH,MAINPURI,2021-01-07,2,1398,4,1404
UTTAR PRADESH,MAINPURI,2021-01-08,0,1145,5,1150
UTTAR PRADESH,MAINPURI,2021-01-09,3,1162,4,1169
UTTAR PRADESH,MAINPURI,2021-01-10,3,1011,2,1016
UTTAR PRADESH,MATHURA,2021-01-06,8,1565,0,1573
UTTAR PRADESH,MATHURA,2021-01-07,11,1500,4,1515
UTTAR PRADESH,MATHURA,2021-01-08,7,1726,6,1739
UTTAR PRADESH,MATHURA,2021-01-09,1,1659,5,1665
UTTAR PRADESH,MATHURA,2021-01-10,3,1719,1,1723
UTTAR PRADESH,MAU,2021-01-06,2,1632,6,1640
UTTAR PRADESH,MAU,2021-01-07,1,1366,7,1374
UTTAR PRADESH,MAU,2021-01-08,2,1199,12,1213
UTTAR PRADESH,MAU,2021-01-09,4,1063,13,1080
UTTAR PRADESH,MAU,2021-01-10,0,1725,6,1731
UTTAR PRADESH,MEERUT,2021-01-06,65,4628,13,4706
UTTAR PRADESH,MEERUT,2021-01-07,32,4785,11,4828
UTTAR PRADESH,MEERUT,2021-01-08,33,4109,52,4194
UTTAR PRADESH,MEERUT,2021-01-09,46,3877,58,3981
UTTAR PRADESH,MEERUT,2021-01-10,28,3584,14,3626
UTTAR PRADESH,MIRZAPUR,2021-01-06,2,1695,0,1697
UTTAR PRADESH,MIRZAPUR,2021-01-07,5,1600,0,1605
UTTAR PRADESH,MIRZAPUR,2021-01-08,2,1492,0,1494
UTTAR PRADESH,MIRZAPUR,2021-01-09,1,1760,0,1761
UTTAR PRADESH,MIRZAPUR,2021-01-10,5,1616,0,1621
UTTAR PRADESH,MORADABAD,2021-01-06,15,2455,81,2551
UTTAR PRADESH,MORADABAD,2021-01-07,21,2320,76,2417
UTTAR PRADESH,MORADABAD,2021-01-08,8,3909,12,3929
UTTAR PRADESH,MORADABAD,2021-01-09,8,3050,44,3102
UTTAR PRADESH,MORADABAD,2021-01-10,12,2620,15,2647
UTTAR PRADESH,MUZAFFARNAGAR,2021-01-06,29,2163,10,2202
UTTAR PRADESH,MUZAFFARNAGAR,2021-01-07,53,1769,10,1832
UTTAR PRADESH,MUZAFFARNAGAR,2021-01-08,26,1934,5,1965
UTTAR PRADESH,MUZAFFARNAGAR,2021-01-09,17,2006,5,2028
UTTAR PRADESH,MUZAFFARNAGAR,2021-01-10,10,1928,2,1940
UTTAR PRADESH,PILIBHIT,2021-01-06,3,2193,5,2201
UTTAR PRADESH,PILIBHIT,2021-01-07,4,1500,2,1506
UTTAR PRADESH,PILIBHIT,2021-01-08,0,1895,2,1897
UTTAR PRADESH,PILIBHIT,2021-01-09,3,1529,60,1592
UTTAR PRADESH,PILIBHIT,2021-01-10,0,1162,6,1168
UTTAR PRADESH,PRATAPGARH,2021-01-06,2,1491,158,1651
UTTAR PRADESH,PRATAPGARH,2021-01-07,0,2666,60,2726
UTTAR PRADESH,PRATAPGARH,2021-01-08,2,1983,6,1991
UTTAR PRADESH,PRATAPGARH,2021-01-09,4,1458,1,1463
UTTAR PRADESH,PRATAPGARH,2021-01-10,4,2468,43,2515
UTTAR PRADESH,PRAYAGRAJ,2021-01-06,57,4955,6,5018
UTTAR PRADESH,PRAYAGRAJ,2021-01-07,29,5272,6,5307
UTTAR PRADESH,PRAYAGRAJ,2021-01-08,29,5138,4,5171
UTTAR PRADESH,PRAYAGRAJ,2021-01-09,34,4687,42,4763
UTTAR PRADESH,PRAYAGRAJ,2021-01-10,15,4378,6,4399
UTTAR PRADESH,RAE BARELI,2021-01-06,14,2941,8,2963
UTTAR PRADESH,RAE BARELI,2021-01-07,8,2375,112,2495
UTTAR PRADESH,RAE BARELI,2021-01-08,8,2503,9,2520
UTTAR PRADESH,RAE BARELI,2021-01-09,5,2669,7,2681
UTTAR PRADESH,RAE BARELI,2021-01-10,25,1258,109,1392
UTTAR PRADESH,RAMPUR,2021-01-06,9,1408,11,1428
UTTAR PRADESH,RAMPUR,2021-01-07,3,1358,26,1387
UTTAR PRADESH,RAMPUR,2021-01-08,6,1577,27,1610
UTTAR PRADESH,RAMPUR,2021-01-09,7,1723,19,1749
UTTAR PRADESH,RAMPUR,2021-01-10,1,1570,3,1574
UTTAR PRADESH,SAHARANPUR,2021-01-06,31,3013,7,3051
UTTAR PRADESH,SAHARANPUR,2021-01-07,31,3080,10,3121
UTTAR PRADESH,SAHARANPUR,2021-01-08,17,3130,8,3155
UTTAR PRADESH,SAHARANPUR,2021-01-09,22,2973,15,3010
UTTAR PRADESH,SAHARANPUR,2021-01-10,14,2153,1,2168
UTTAR PRADESH,SAMBHAL,2021-01-06,1,1651,57,1709
UTTAR PRADESH,SAMBHAL,2021-01-07,1,1072,24,1097
UTTAR PRADESH,SAMBHAL,2021-01-08,4,1845,5,1854
UTTAR PRADESH,SAMBHAL,2021-01-09,3,1289,60,1352
UTTAR PRADESH,SAMBHAL,2021-01-10,1,1164,15,1180
UTTAR PRADESH,SANT KABEER NAGAR,2021-01-06,6,1488,1,1495
UTTAR PRADESH,SANT KABEER NAGAR,2021-01-07,6,1185,163,1354
UTTAR PRADESH,SANT KABEER NAGAR,2021-01-08,8,1264,94,1366
UTTAR PRADESH,SANT KABEER NAGAR,2021-01-09,10,1239,96,1345
UTTAR PRADESH,SANT KABEER NAGAR,2021-01-10,9,1269,81,1359
UTTAR PRADESH,SHAHJAHANPUR,2021-01-06,4,912,5,921
UTTAR PRADESH,SHAHJAHANPUR,2021-01-07,8,1759,17,1784
UTTAR PRADESH,SHAHJAHANPUR,2021-01-08,1,1663,2,1666
UTTAR PRADESH,SHAHJAHANPUR,2021-01-09,3,1587,2,1592
UTTAR PRADESH,SHAHJAHANPUR,2021-01-10,5,1805,132,1942
UTTAR PRADESH,SHAMLI,2021-01-06,4,1387,29,1420
UTTAR PRADESH,SHAMLI,2021-01-07,2,1672,0,1674
UTTAR PRADESH,SHAMLI,2021-01-08,13,1784,2,1799
UTTAR PRADESH,SHAMLI,2021-01-09,9,1582,2,1593
UTTAR PRADESH,SHAMLI,2021-01-10,3,1326,0,1329
UTTAR PRADESH,SHRAVASTI,2021-01-06,3,1153,0,1156
UTTAR PRADESH,SHRAVASTI,2021-01-07,2,1117,0,1119
UTTAR PRADESH,SHRAVASTI,2021-01-08,4,1217,1,1222
UTTAR PRADESH,SHRAVASTI,2021-01-09,2,1183,0,1185
UTTAR PRADESH,SHRAVASTI,2021-01-10,3,998,20,1021
UTTAR PRADESH,SIDDHARTH NAGAR,2021-01-06,4,1247,0,1251
UTTAR PRADESH,SIDDHARTH NAGAR,2021-01-07,19,980,0,999
UTTAR PRADESH,SIDDHARTH NAGAR,2021-01-08,4,1148,96,1248
UTTAR PRADESH,SIDDHARTH NAGAR,2021-01-09,4,1104,0,1108
UTTAR PRADESH,SIDDHARTH NAGAR,2021-01-10,0,961,33,994
UTTAR PRADESH,SITAPUR,2021-01-06,4,2105,4,2113
UTTAR PRADESH,SITAPUR,2021-01-07,11,1853,5,1869
UTTAR PRADESH,SITAPUR,2021-01-08,3,1931,28,1962
UTTAR PRADESH,SITAPUR,2021-01-09,8,1971,8,1987
UTTAR PRADESH,SITAPUR,2021-01-10,0,1569,17,1586
UTTAR PRADESH,SONBHADRA,2021-01-06,2,1739,0,1741
UTTAR PRADESH,SONBHADRA,2021-01-07,13,2573,11,2597
UTTAR PRADESH,SONBHADRA,2021-01-08,7,1949,0,1956
UTTAR PRADESH,SONBHADRA,2021-01-09,11,2144,22,2177
UTTAR PRADESH,SONBHADRA,2021-01-10,2,1861,37,1900
UTTAR PRADESH,SULTANPUR,2021-01-06,8,1399,21,1428
UTTAR PRADESH,SULTANPUR,2021-01-07,10,1380,19,1409
UTTAR PRADESH,SULTANPUR,2021-01-08,10,1286,15,1311
UTTAR PRADESH,SULTANPUR,2021-01-09,15,1326,2,1343
UTTAR PRADESH,SULTANPUR,2021-01-10,7,1169,5,1181
UTTAR PRADESH,UNNAO,2021-01-06,3,1832,69,1904
UTTAR PRADESH,UNNAO,2021-01-07,5,1177,3,1185
UTTAR PRADESH,UNNAO,2021-01-08,6,1982,104,2092
UTTAR PRADESH,UNNAO,2021-01-09,6,2483,27,2516
UTTAR PRADESH,UNNAO,2021-01-10,2,1688,5,1695
UTTAR PRADESH,VARANASI,2021-01-06,68,2911,98,3077
UTTAR PRADESH,VARANASI,2021-01-07,44,2586,118,2748
UTTAR PRADESH,VARANASI,2021-01-08,70,2952,99,3121
UTTAR PRADESH,VARANASI,2021-01-09,44,2490,57,2591
UTTAR PRADESH,VARANASI,2021-01-10,18,2031,157,2206
UTTARAKHAND,ALMORA,2021-01-06,11,95,1,107
UTTARAKHAND,ALMORA,2021-01-07,9,185,0,194
UTTARAKHAND,ALMORA,2021-01-08,15,138,1,154
UTTARAKHAND,ALMORA,2021-01-09,60,78,0,138
UTTARAKHAND,ALMORA,2021-01-10,2,18,0,20
UTTARAKHAND,BAGESHWAR,2021-01-06,0,87,0,87
UTTARAKHAND,BAGESHWAR,2021-01-07,5,402,1,408
UTTARAKHAND,BAGESHWAR,2021-01-08,1,195,0,196
UTTARAKHAND,BAGESHWAR,2021-01-09,1,372,0,373
UTTARAKHAND,BAGESHWAR,2021-01-10,2,14,0,16
UTTARAKHAND,CHAMOLI,2021-01-06,5,474,9,488
UTTARAKHAND,CHAMOLI,2021-01-07,6,346,8,360
UTTARAKHAND,CHAMOLI,2021-01-08,8,260,10,278
UTTARAKHAND,CHAMOLI,2021-01-09,6,409,6,421
UTTARAKHAND,CHAMOLI,2021-01-10,2,167,0,169
UTTARAKHAND,CHAMPAWAT,2021-01-06,8,667,5,680
UTTARAKHAND,CHAMPAWAT,2021-01-07,2,465,0,467
UTTARAKHAND,CHAMPAWAT,2021-01-08,7,411,5,423
UTTARAKHAND,CHAMPAWAT,2021-01-09,2,402,2,406
UTTARAKHAND,CHAMPAWAT,2021-01-10,0,606,0,606
UTTARAKHAND,DEHRADUN,2021-01-06,99,2312,10,2421
UTTARAKHAND,DEHRADUN,2021-01-07,96,2762,8,2866
UTTARAKHAND,DEHRADUN,2021-01-08,108,4149,20,4277
UTTARAKHAND,DEHRADUN,2021-01-09,98,4115,12,4225
UTTARAKHAND,DEHRADUN,2021-01-10,56,1531,11,1598
UTTARAKHAND,HARIDWAR,2021-01-06,55,2606,9,2670
UTTARAKHAND,HARIDWAR,2021-01-07,28,2262,6,2296
UTTARAKHAND,HARIDWAR,2021-01-08,28,2202,12,2242
UTTARAKHAND,HARIDWAR,2021-01-09,40,2661,27,2728
UTTARAKHAND,HARIDWAR,2021-01-10,13,1048,20,1081
UTTARAKHAND,NAINITAL,2021-01-06,55,1570,7,1632
UTTARAKHAND,NAINITAL,2021-01-07,56,1293,9,1358
UTTARAKHAND,NAINITAL,2021-01-08,65,1340,14,1419
UTTARAKHAND,NAINITAL,2021-01-09,86,1058,11,1155
UTTARAKHAND,NAINITAL,2021-01-10,21,617,2,640
UTTARAKHAND,PAURI GARHWAL,2021-01-06,24,642,25,691
UTTARAKHAND,PAURI GARHWAL,2021-01-07,2,437,0,439
UTTARAKHAND,PAURI GARHWAL,2021-01-08,19,549,4,572
UTTARAKHAND,PAURI GARHWAL,2021-01-09,19,487,4,510
UTTARAKHAND,PAURI GARHWAL,2021-01-10,4,626,6,636
UTTARAKHAND,PITHORAGARH,2021-01-06,8,292,2,302
UTTARAKHAND,PITHORAGARH,2021-01-07,6,236,1,243
UTTARAKHAND,PITHORAGARH,2021-01-08,17,489,3,509
UTTARAKHAND,PITHORAGARH,2021-01-09,8,260,0,268
UTTARAKHAND,PITHORAGARH,2021-01-10,0,39,0,39
UTTARAKHAND,RUDRA PRAYAG,2021-01-06,5,210,3,218
UTTARAKHAND,RUDRA PRAYAG,2021-01-07,0,203,6,209
UTTARAKHAND,RUDRA PRAYAG,2021-01-08,9,172,0,181
UTTARAKHAND,RUDRA PRAYAG,2021-01-09,2,38,0,40
UTTARAKHAND,RUDRA PRAYAG,2021-01-10,3,268,0,271
UTTARAKHAND,TEHRI GARHWAL,2021-01-06,6,499,6,511
UTTARAKHAND,TEHRI GARHWAL,2021-01-07,6,441,0,447
UTTARAKHAND,TEHRI GARHWAL,2021-01-08,4,406,1,411
UTTARAKHAND,TEHRI GARHWAL,2021-01-09,10,652,6,668
UTTARAKHAND,TEHRI GARHWAL,2021-01-10,5,532,2,539
UTTARAKHAND,UDAM SINGH NAGAR,2021-01-06,15,2323,6,2344
UTTARAKHAND,UDAM SINGH NAGAR,2021-01-07,24,2354,46,2424
UTTARAKHAND,UDAM SINGH NAGAR,2021-01-08,14,2118,94,2226
UTTARAKHAND,UDAM SINGH NAGAR,2021-01-09,22,2546,4,2572
UTTARAKHAND,UDAM SINGH NAGAR,2021-01-10,20,2325,44,2389
UTTARAKHAND,UTTAR KASHI,2021-01-06,14,918,1,933
UTTARAKHAND,UTTAR KASHI,2021-01-07,7,442,2,451
UTTARAKHAND,UTTAR KASHI,2021-01-08,7,703,14,724
UTTARAKHAND,UTTAR KASHI,2021-01-09,3,958,2,963
UTTARAKHAND,UTTAR KASHI,2021-01-10,1,387,4,392
WEST BENGAL,24 PARAGANAS NORTH,2021-01-06,203,5279,48,5530
WEST BENGAL,24 PARAGANAS NORTH,2021-01-07,240,5474,48,5762
WEST BENGAL,24 PARAGANAS NORTH,2021-01-08,165,5110,38,5313
WEST BENGAL,24 PARAGANAS NORTH,2021-01-09,191,5279,29,5499
WEST BENGAL,24 PARAGANAS NORTH,2021-01-10,148,3379,27,3554
WEST BENGAL,24 PARAGANAS SOUTH,2021-01-06,59,4095,9,4163
WEST BENGAL,24 PARAGANAS SOUTH,2021-01-07,48,3928,11,3987
WEST BENGAL,24 PARAGANAS SOUTH,2021-01-08,43,3689,58,3790
WEST BENGAL,24 PARAGANAS SOUTH,2021-01-09,40,4450,20,4510
WEST BENGAL,24 PARAGANAS SOUTH,2021-01-10,38,2710,12,2760
WEST BENGAL,ALIPURDUAR,2021-01-06,0,515,0,515
WEST BENGAL,ALIPURDUAR,2021-01-07,1,1128,0,1129
WEST BENGAL,ALIPURDUAR,2021-01-08,1,698,0,699
WEST BENGAL,ALIPURDUAR,2021-01-09,2,787,0,789
WEST BENGAL,ALIPURDUAR,2021-01-10,1,387,0,388
WEST BENGAL,BANKURA,2021-01-06,17,972,2,991
WEST BENGAL,BANKURA,2021-01-07,20,795,26,841
WEST BENGAL,BANKURA,2021-01-08,26,872,4,902
WEST BENGAL,BANKURA,2021-01-09,17,1057,18,1092
WEST BENGAL,BANKURA,2021-01-10,21,782,0,803
WEST BENGAL,BIRBHUM,2021-01-06,20,1518,10,1548
WEST BENGAL,BIRBHUM,2021-01-07,24,1628,10,1662
WEST BENGAL,BIRBHUM,2021-01-08,9,1094,5,1108
WEST BENGAL,BIRBHUM,2021-01-09,14,1420,9,1443
WEST BENGAL,BIRBHUM,2021-01-10,6,809,5,820
WEST BENGAL,COOCHBEHAR,2021-01-06,10,2957,0,2967
WEST BENGAL,COOCHBEHAR,2021-01-07,8,2934,35,2977
WEST BENGAL,COOCHBEHAR,2021-01-08,7,2457,21,2485
WEST BENGAL,COOCHBEHAR,2021-01-09,4,2616,0,2620
WEST BENGAL,COOCHBEHAR,2021-01-10,2,2151,0,2153
WEST BENGAL,DARJEELING,2021-01-06,26,886,2,914
WEST BENGAL,DARJEELING,2021-01-07,23,895,4,922
WEST BENGAL,DARJEELING,2021-01-08,25,827,3,855
WEST BENGAL,DARJEELING,2021-01-09,21,559,3,583
WEST BENGAL,DARJEELING,2021-01-10,25,531,1,557
WEST BENGAL,DINAJPUR DAKSHIN,2021-01-06,1,966,0,967
WEST BENGAL,DINAJPUR DAKSHIN,2021-01-07,2,882,1,885
WEST BENGAL,DINAJPUR DAKSHIN,2021-01-08,5,933,4,942
WEST BENGAL,DINAJPUR DAKSHIN,2021-01-09,1,905,2,908
WEST BENGAL,DINAJPUR DAKSHIN,2021-01-10,0,750,1,751
WEST BENGAL,DINAJPUR UTTAR,2021-01-06,3,269,0,272
WEST BENGAL,DINAJPUR UTTAR,2021-01-07,2,366,0,368
WEST BENGAL,DINAJPUR UTTAR,2021-01-08,3,262,0,265
WEST BENGAL,DINAJPUR UTTAR,2021-01-09,6,332,0,338
WEST BENGAL,DINAJPUR UTTAR,2021-01-10,15,599,0,614
WEST BENGAL,HOOGHLY,2021-01-06,56,1769,52,1877
WEST BENGAL,HOOGHLY,2021-01-07,34,1643,23,1700
WEST BENGAL,HOOGHLY,2021-01-08,42,1479,85,1606
WEST BENGAL,HOOGHLY,2021-01-09,44,1350,28,1422
WEST BENGAL,HOOGHLY,2021-01-10,28,682,10,720
WEST BENGAL,HOWRAH,2021-01-06,41,1894,2,1937
WEST BENGAL,HOWRAH,2021-01-07,56,1921,2,1979
WEST BENGAL,HOWRAH,2021-01-08,41,1939,4,1984
WEST BENGAL,HOWRAH,2021-01-09,38,1878,7,1923
WEST BENGAL,HOWRAH,2021-01-10,24,1378,2,1404
WEST BENGAL,JALPAIGURI,2021-01-06,12,654,0,666
WEST BENGAL,JALPAIGURI,2021-01-07,24,720,2,746
WEST BENGAL,JALPAIGURI,2021-01-08,12,694,1,707
WEST BENGAL,JALPAIGURI,2021-01-09,12,261,0,273
WEST BENGAL,JALPAIGURI,2021-01-10,18,125,0,143
WEST BENGAL,JHARGRAM,2021-01-06,1,121,0,122
WEST BENGAL,JHARGRAM,2021-01-07,5,148,0,153
WEST BENGAL,JHARGRAM,2021-01-08,2,58,0,60
WEST BENGAL,JHARGRAM,2021-01-09,7,58,0,65
WEST BENGAL,JHARGRAM,2021-01-10,4,28,7,39
WEST BENGAL,KALIMPONG,2021-01-06,4,166,0,170
WEST BENGAL,KALIMPONG,2021-01-07,6,181,0,187
WEST BENGAL,KALIMPONG,2021-01-08,1,508,1,510
WEST BENGAL,KALIMPONG,2021-01-09,1,68,0,69
WEST BENGAL,KALIMPONG,2021-01-10,1,60,0,61
WEST BENGAL,KOLKATA,2021-01-06,357,3811,19,4187
WEST BENGAL,KOLKATA,2021-01-07,334,3682,47,4063
WEST BENGAL,KOLKATA,2021-01-08,264,3356,45,3665
WEST BENGAL,KOLKATA,2021-01-09,333,3373,20,3726
WEST BENGAL,KOLKATA,2021-01-10,218,1814,11,2043
WEST BENGAL,MALDAH,2021-01-06,6,796,16,818
WEST BENGAL,MALDAH,2021-01-07,4,929,4,937
WEST BENGAL,MALDAH,2021-01-08,8,1107,11,1126
WEST BENGAL,MALDAH,2021-01-09,7,859,5,871
WEST BENGAL,MALDAH,2021-01-10,3,305,8,316
WEST BENGAL,MEDINIPUR EAST,2021-01-06,23,1353,5,1381
WEST BENGAL,MEDINIPUR EAST,2021-01-07,44,1483,7,1534
WEST BENGAL,MEDINIPUR EAST,2021-01-08,14,1371,21,1406
WEST BENGAL,MEDINIPUR EAST,2021-01-09,17,1345,14,1376
WEST BENGAL,MEDINIPUR EAST,2021-01-10,11,1099,10,1120
WEST BENGAL,MEDINIPUR WEST,2021-01-06,26,713,12,751
WEST BENGAL,MEDINIPUR WEST,2021-01-07,14,723,9,746
WEST BENGAL,MEDINIPUR WEST,2021-01-08,17,909,7,933
WEST BENGAL,MEDINIPUR WEST,2021-01-09,21,675,10,706
WEST BENGAL,MEDINIPUR WEST,2021-01-10,7,275,6,288
WEST BENGAL,MURSHIDABAD,2021-01-06,15,1264,11,1290
WEST BENGAL,MURSHIDABAD,2021-01-07,13,1725,10,1748
WEST BENGAL,MURSHIDABAD,2021-01-08,5,1353,24,1382
WEST BENGAL,MURSHIDABAD,2021-01-09,7,2214,4,2225
WEST BENGAL,MURSHIDABAD,2021-01-10,11,1240,9,1260
WEST BENGAL,NADIA,2021-01-06,53,1068,27,1148
WEST BENGAL,NADIA,2021-01-07,36,1124,43,1203
WEST BENGAL,NADIA,2021-01-08,41,1043,26,1110
WEST BENGAL,NADIA,2021-01-09,35,1034,21,1090
WEST BENGAL,NADIA,2021-01-10,22,1082,31,1135
WEST BENGAL,PASCHIM BARDHAMAN,2021-01-06,47,1482,24,1553
WEST BENGAL,PASCHIM BARDHAMAN,2021-01-07,40,1194,12,1246
WEST BENGAL,PASCHIM BARDHAMAN,2021-01-08,36,1202,5,1243
WEST BENGAL,PASCHIM BARDHAMAN,2021-01-09,39,1108,14,1161
WEST BENGAL,PASCHIM BARDHAMAN,2021-01-10,21,835,2,858
WEST BENGAL,PURBA BARDHAMAN,2021-01-06,15,1405,8,1428
WEST BENGAL,PURBA BARDHAMAN,2021-01-07,31,1531,2,1564
WEST BENGAL,PURBA BARDHAMAN,2021-01-08,11,1557,9,1577
WEST BENGAL,PURBA BARDHAMAN,2021-01-09,17,1614,0,1631
WEST BENGAL,PURBA BARDHAMAN,2021-01-10,13,603,0,616
WEST BENGAL,PURULIA,2021-01-06,17,719,1,737
WEST BENGAL,PURULIA,2021-01-07,8,477,0,485
WEST BENGAL,PURULIA,2021-01-08,9,548,2,559
WEST BENGAL,PURULIA,2021-01-09,8,819,0,827
WEST BENGAL,PURULIA,2021-01-10,8,891,0,899
ANDAMAN AND NICOBAR ISLANDS,NICOBARS,2021-01-01,0,34,0,34
ANDAMAN AND NICOBAR ISLANDS,NICOBARS,2021-01-02,0,9,0,9
ANDAMAN AND NICOBAR ISLANDS,NICOBARS,2021-01-04,0,28,1,29
ANDAMAN AND NICOBAR ISLANDS,NICOBARS,2021-01-05,0,16,0,16
ANDAMAN AND NICOBAR ISLANDS,NORTH AND MIDDLE ANDAMAN,2021-01-01,0,4,0,4
ANDAMAN AND NICOBAR ISLANDS,NORTH AND MIDDLE ANDAMAN,2021-01-02,0,8,0,8
ANDAMAN AND NICOBAR ISLANDS,NORTH AND MIDDLE ANDAMAN,2021-01-03,0,8,0,8
ANDAMAN AND NICOBAR ISLANDS,NORTH AND MIDDLE ANDAMAN,2021-01-04,0,15,0,15
ANDAMAN AND NICOBAR ISLANDS,NORTH AND MIDDLE ANDAMAN,2021-01-05,0,10,0,10
ANDAMAN AND NICOBAR ISLANDS,SOUTH ANDAMANS,2021-01-01,4,453,0,457
ANDAMAN AND NICOBAR ISLANDS,SOUTH ANDAMANS,2021-01-02,1,542,0,543
ANDAMAN AND NICOBAR ISLANDS,SOUTH ANDAMANS,2021-01-03,0,537,0,537
ANDAMAN AND NICOBAR ISLANDS,SOUTH ANDAMANS,2021-01-04,2,722,0,724
ANDAMAN AND NICOBAR ISLANDS,SOUTH ANDAMANS,2021-01-05,2,1092,0,1094
ANDHRA PRADESH,ANANTAPUR,2021-01-01,13,5184,0,5197
ANDHRA PRADESH,ANANTAPUR,2021-01-02,10,3917,0,3927
ANDHRA PRADESH,ANANTAPUR,2021-01-03,23,2998,0,3021
ANDHRA PRADESH,ANANTAPUR,2021-01-04,15,2914,0,2929
ANDHRA PRADESH,ANANTAPUR,2021-01-05,14,4951,1,4966
ANDHRA PRADESH,CHITTOOR,2021-01-01,59,5033,0,5092
ANDHRA PRADESH,CHITTOOR,2021-01-02,61,3772,1,3834
ANDHRA PRADESH,CHITTOOR,2021-01-03,14,1722,0,1736
ANDHRA PRADESH,CHITTOOR,2021-01-04,86,4009,0,4095
ANDHRA PRADESH,CHITTOOR,2021-01-05,38,3362,0,3400
ANDHRA PRADESH,EAST GODAVARI,2021-01-01,19,2622,0,2641
ANDHRA PRADESH,EAST GODAVARI,2021-01-02,31,811,0,842
ANDHRA PRADESH,EAST GODAVARI,2021-01-03,16,1957,0,1973
ANDHRA PRADESH,EAST GODAVARI,2021-01-04,26,2181,0,2207
ANDHRA PRADESH,EAST GODAVARI,2021-01-05,43,4300,0,4343
ANDHRA PRADESH,GUNTUR,2021-01-01,31,5470,0,5501
ANDHRA PRADESH,GUNTUR,2021-01-02,26,1129,0,1155
ANDHRA PRADESH,GUNTUR,2021-01-03,14,1606,0,1620
ANDHRA PRADESH,GUNTUR,2021-01-04,61,3405,3,3469
ANDHRA PRADESH,GUNTUR,2021-01-05,42,6728,0,6770
ANDHRA PRADESH,KRISHNA,2021-01-01,35,3278,0,3313
ANDHRA PRADESH,KRISHNA,2021-01-02,52,3504,0,3556
ANDHRA PRADESH,KRISHNA,2021-01-03,27,2541,0,2568
ANDHRA PRADESH,KRISHNA,2021-01-04,47,3140,0,3187
ANDHRA PRADESH,KRISHNA,2021-01-05,54,3184,0,3238
ANDHRA PRADESH,KURNOOL,2021-01-01,12,3581,0,3593
ANDHRA PRADESH,KURNOOL,2021-01-02,25,3213,0,3238
ANDHRA PRADESH,KURNOOL,2021-01-03,11,1715,0,1726
ANDHRA PRADESH,KURNOOL,2021-01-04,9,3454,0,3463
ANDHRA PRADESH,KURNOOL,2021-01-05,11,4080,0,4091
ANDHRA PRADESH,PRAKASAM,2021-01-01,8,4908,0,4916
ANDHRA PRADESH,PRAKASAM,2021-01-02,3,2193,0,2196
ANDHRA PRADESH,PRAKASAM,2021-01-03,7,1833,0,1840
ANDHRA PRADESH,PRAKASAM,2021-01-04,12,2851,0,2863
ANDHRA PRADESH,PRAKASAM,2021-01-05,2,3806,0,3808
ANDHRA PRADESH,SPSR NELLORE,2021-01-01,7,2066,0,2073
ANDHRA PRADESH,SPSR NELLORE,2021-01-02,7,1004,0,1011
ANDHRA PRADESH,SPSR NELLORE,2021-01-03,7,1392,0,1399
ANDHRA PRADESH,SPSR NELLORE,2021-01-04,13,1617,0,1630
ANDHRA PRADESH,SPSR NELLORE,2021-01-05,17,2401,0,2418
ANDHRA PRADESH,SRIKAKULAM,2021-01-01,4,2638,0,2642
ANDHRA PRADESH,SRIKAKULAM,2021-01-02,7,1670,0,1677
ANDHRA PRADESH,SRIKAKULAM,2021-01-03,7,2707,0,2714
ANDHRA PRADESH,SRIKAKULAM,2021-01-04,6,2067,0,2073
ANDHRA PRADESH,SRIKAKULAM,2021-01-05,13,2861,0,2874
ANDHRA PRADESH,VISAKHAPATANAM,2021-01-01,30,2733,0,2763
ANDHRA PRADESH,VISAKHAPATANAM,2021-01-02,24,3473,1,3498
ANDHRA PRADESH,VISAKHAPATANAM,2021-01-03,15,3459,0,3474
ANDHRA PRADESH,VISAKHAPATANAM,2021-01-04,49,1830,0,1879
ANDHRA PRADESH,VISAKHAPATANAM,2021-01-05,61,3009,0,3070
ANDHRA PRADESH,VIZIANAGARAM,2021-01-01,4,1560,0,1564
ANDHRA PRADESH,VIZIANAGARAM,2021-01-02,3,1892,0,1895
ANDHRA PRADESH,VIZIANAGARAM,2021-01-03,2,353,0,355
ANDHRA PRADESH,VIZIANAGARAM,2021-01-04,17,2015,0,2032
ANDHRA PRADESH,VIZIANAGARAM,2021-01-05,4,2117,0,2121
ANDHRA PRADESH,WEST GODAVARI,2021-01-01,13,779,0,792
ANDHRA PRADESH,WEST GODAVARI,2021-01-02,33,1803,0,1836
ANDHRA PRADESH,WEST GODAVARI,2021-01-03,28,1853,0,1881
ANDHRA PRADESH,WEST GODAVARI,2021-01-04,25,2911,0,2936
ANDHRA PRADESH,WEST GODAVARI,2021-01-05,32,1965,0,1997
ANDHRA PRADESH,Y.S.R.,2021-01-01,14,4359,0,4373
ANDHRA PRADESH,Y.S.R.,2021-01-02,11,3262,0,3273
ANDHRA PRADESH,Y.S.R.,2021-01-03,5,3688,0,3693
ANDHRA PRADESH,Y.S.R.,2021-01-04,21,676,0,697
ANDHRA PRADESH,Y.S.R.,2021-01-05,16,3790,0,3806
ARUNACHAL PRADESH,ANJAW,2021-01-03,0,1,0,1
ARUNACHAL PRADESH,ANJAW,2021-01-05,0,1,0,1
ARUNACHAL PRADESH,CHANGLANG,2021-01-01,0,1,0,1
ARUNACHAL PRADESH,CHANGLANG,2021-01-02,0,4,0,4
ARUNACHAL PRADESH,CHANGLANG,2021-01-03,0,2,0,2
ARUNACHAL PRADESH,CHANGLANG,2021-01-04,0,3,0,3
ARUNACHAL PRADESH,DIBANG VALLEY,2021-01-01,0,1,0,1
ARUNACHAL PRADESH,EAST SIANG,2021-01-01,0,16,0,16
ARUNACHAL PRADESH,EAST SIANG,2021-01-02,1,38,0,39
ARUNACHAL PRADESH,EAST SIANG,2021-01-03,0,2,0,2
ARUNACHAL PRADESH,EAST SIANG,2021-01-04,3,45,0,48
ARUNACHAL PRADESH,EAST SIANG,2021-01-05,3,63,0,66
ARUNACHAL PRADESH,KAMLE,2021-01-03,0,1,0,1
ARUNACHAL PRADESH,KAMLE,2021-01-04,0,2,0,2
ARUNACHAL PRADESH,KAMLE,2021-01-05,0,1,0,1
ARUNACHAL PRADESH,KURUNG KUMEY,2021-01-02,0,1,0,1
ARUNACHAL PRADESH,LOHIT,2021-01-01,0,2,0,2
ARUNACHAL PRADESH,LOHIT,2021-01-02,0,27,0,27
ARUNACHAL PRADESH,LOHIT,2021-01-03,3,1,0,4
ARUNACHAL PRADESH,LOHIT,2021-01-04,0,1,0,1
ARUNACHAL PRADESH,LOHIT,2021-01-05,1,1,0,2
ARUNACHAL PRADESH,LONGDING,2021-01-02,0,1,0,1
ARUNACHAL PRADESH,LONGDING,2021-01-05,0,1,0,1
ARUNACHAL PRADESH,LOWER DIBANG VALLEY,2021-01-01,0,9,0,9
ARUNACHAL PRADESH,LOWER DIBANG VALLEY,2021-01-05,0,1,0,1
ARUNACHAL PRADESH,LOWER SIANG,2021-01-02,3,24,0,27
ARUNACHAL PRADESH,LOWER SIANG,2021-01-03,0,1,0,1
ARUNACHAL PRADESH,LOWER SIANG,2021-01-04,0,3,0,3
ARUNACHAL PRADESH,LOWER SIANG,2021-01-05,0,21,0,21
ARUNACHAL PRADESH,LOWER SUBANSIRI,2021-01-03,0,22,0,22
ARUNACHAL PRADESH,LOWER SUBANSIRI,2021-01-04,0,3,0,3
ARUNACHAL PRADESH,LOWER SUBANSIRI,2021-01-05,0,81,0,81
ARUNACHAL PRADESH,NAMSAI,2021-01-02,1,1,0,2
ARUNACHAL PRADESH,NAMSAI,2021-01-04,0,2,0,2
ARUNACHAL PRADESH,NAMSAI,2021-01-05,0,2,0,2
ARUNACHAL PRADESH,PAKKE KESSANG,2021-01-05,1,0,0,1
ARUNACHAL PRADESH,PAPUM PARE,2021-01-01,1,32,0,33
ARUNACHAL PRADESH,PAPUM PARE,2021-01-02,0,16,0,16
ARUNACHAL PRADESH,PAPUM PARE,2021-01-03,0,1,0,1
ARUNACHAL PRADESH,PAPUM PARE,2021-01-04,1,45,0,46
ARUNACHAL PRADESH,PAPUM PARE,2021-01-05,5,42,0,47
ARUNACHAL PRADESH,SHI YOMI,2021-01-01,0,1,0,1
ARUNACHAL PRADESH,SIANG,2021-01-01,0,1,0,1
ARUNACHAL PRADESH,SIANG,2021-01-04,0,1,0,1
ARUNACHAL PRADESH,TAWANG,2021-01-01,0,44,0,44
ARUNACHAL PRADESH,TAWANG,2021-01-02,0,23,0,23
ARUNACHAL PRADESH,TAWANG,2021-01-03,4,42,0,46
ARUNACHAL PRADESH,TAWANG,2021-01-04,1,29,0,30
ARUNACHAL PRADESH,TAWANG,2021-01-05,0,17,0,17
ARUNACHAL PRADESH,TIRAP,2021-01-03,0,1,0,1
ARUNACHAL PRADESH,TIRAP,2021-01-04,0,2,0,2
ARUNACHAL PRADESH,UPPER SUBANSIRI,2021-01-02,0,1,0,1
ARUNACHAL PRADESH,UPPER SUBANSIRI,2021-01-04,0,1,0,1
ARUNACHAL PRADESH,WEST KAMENG,2021-01-01,0,91,0,91
ARUNACHAL PRADESH,WEST KAMENG,2021-01-02,0,55,0,55
ARUNACHAL PRADESH,WEST KAMENG,2021-01-03,0,35,0,35
ARUNACHAL PRADESH,WEST KAMENG,2021-01-04,0,73,0,73
ARUNACHAL PRADESH,WEST KAMENG,2021-01-05,0,40,0,40
ARUNACHAL PRADESH,WEST SIANG,2021-01-01,0,1,0,1
ARUNACHAL PRADESH,WEST SIANG,2021-01-02,0,2,0,2
ARUNACHAL PRADESH,WEST SIANG,2021-01-04,0,6,0,6
ARUNACHAL PRADESH,WEST SIANG,2021-01-05,0,4,0,4
ASSAM,BAKSA,2021-01-01,0,34,0,34
ASSAM,BAKSA,2021-01-02,0,51,0,51
ASSAM,BAKSA,2021-01-03,0,15,0,15
ASSAM,BAKSA,2021-01-04,0,69,0,69
ASSAM,BAKSA,2021-01-05,1,86,0,87
ASSAM,BARPETA,2021-01-01,1,177,0,178
ASSAM,BARPETA,2021-01-02,2,248,0,250
ASSAM,BARPETA,2021-01-03,0,76,0,76
ASSAM,BARPETA,2021-01-04,1,206,0,207
ASSAM,BARPETA,2021-01-05,1,266,0,267
ASSAM,BISWANATH,2021-01-01,1,60,0,61
ASSAM,BISWANATH,2021-01-02,34,235,0,269
ASSAM,BISWANATH,2021-01-03,0,96,0,96
ASSAM,BISWANATH,2021-01-04,34,250,0,284
ASSAM,BISWANATH,2021-01-05,32,253,0,285
ASSAM,BONGAIGAON,2021-01-01,0,263,0,263
ASSAM,BONGAIGAON,2021-01-02,0,288,0,288
ASSAM,BONGAIGAON,2021-01-03,4,105,0,109
ASSAM,BONGAIGAON,2021-01-04,2,542,0,544
ASSAM,BONGAIGAON,2021-01-05,2,595,0,597
ASSAM,CACHAR,2021-01-01,7,833,4,844
ASSAM,CACHAR,2021-01-02,2,361,11,374
ASSAM,CACHAR,2021-01-03,0,180,3,183
ASSAM,CACHAR,2021-01-04,1,224,36,261
ASSAM,CACHAR,2021-01-05,4,268,7,279
ASSAM,CHARAIDEO,2021-01-01,0,78,0,78
ASSAM,CHARAIDEO,2021-01-02,0,185,0,185
ASSAM,CHARAIDEO,2021-01-03,0,61,1,62
ASSAM,CHARAIDEO,2021-01-04,1,251,0,252
ASSAM,CHARAIDEO,2021-01-05,1,175,0,176
ASSAM,CHIRANG,2021-01-01,0,75,0,75
ASSAM,CHIRANG,2021-01-02,0,138,0,138
ASSAM,CHIRANG,2021-01-03,1,3,0,4
ASSAM,CHIRANG,2021-01-04,0,142,0,142
ASSAM,CHIRANG,2021-01-05,0,192,0,192
ASSAM,DARRANG,2021-01-01,0,205,0,205
ASSAM,DARRANG,2021-01-02,1,431,0,432
ASSAM,DARRANG,2021-01-03,0,108,0,108
ASSAM,DARRANG,2021-01-04,0,521,0,521
ASSAM,DARRANG,2021-01-05,2,419,0,421
ASSAM,DHEMAJI,2021-01-01,0,23,0,23
ASSAM,DHEMAJI,2021-01-02,0,64,0,64
ASSAM,DHEMAJI,2021-01-03,0,19,0,19
ASSAM,DHEMAJI,2021-01-04,0,130,0,130
ASSAM,DHEMAJI,2021-01-05,0,76,0,76
ASSAM,DHUBRI,2021-01-01,0,355,1,356
ASSAM,DHUBRI,2021-01-02,1,413,0,414
ASSAM,DHUBRI,2021-01-03,0,31,0,31
ASSAM,DHUBRI,2021-01-04,1,396,0,397
ASSAM,DHUBRI,2021-01-05,0,439,0,439
ASSAM,DIBRUGARH,2021-01-01,3,327,1,331
ASSAM,DIBRUGARH,2021-01-02,5,737,0,742
ASSAM,DIBRUGARH,2021-01-03,2,233,0,235
ASSAM,DIBRUGARH,2021-01-04,3,699,1,703
ASSAM,DIBRUGARH,2021-01-05,1,810,4,815
ASSAM,DIMA HASAO,2021-01-01,0,45,0,45
ASSAM,DIMA HASAO,2021-01-02,1,81,0,82
ASSAM,DIMA HASAO,2021-01-03,1,40,0,41
ASSAM,DIMA HASAO,2021-01-04,1,84,0,85
ASSAM,DIMA HASAO,2021-01-05,2,90,0,92
ASSAM,GOALPARA,2021-01-01,1,542,0,543
ASSAM,GOALPARA,2021-01-02,1,602,0,603
ASSAM,GOALPARA,2021-01-03,0,201,0,201
ASSAM,GOALPARA,2021-01-04,1,752,0,753
ASSAM,GOALPARA,2021-01-05,0,528,0,528
ASSAM,GOLAGHAT,2021-01-01,0,101,0,101
ASSAM,GOLAGHAT,2021-01-02,9,428,0,437
ASSAM,GOLAGHAT,2021-01-03,0,54,0,54
ASSAM,GOLAGHAT,2021-01-04,17,474,0,491
ASSAM,GOLAGHAT,2021-01-05,26,426,1,453
ASSAM,HAILAKANDI,2021-01-01,3,401,10,414
ASSAM,HAILAKANDI,2021-01-02,2,353,3,358
ASSAM,HAILAKANDI,2021-01-03,0,207,11,218
ASSAM,HAILAKANDI,2021-01-04,1,493,2,496
ASSAM,HAILAKANDI,2021-01-05,2,423,6,431
ASSAM,HOJAI,2021-01-01,0,59,0,59
ASSAM,HOJAI,2021-01-02,0,152,0,152
ASSAM,HOJAI,2021-01-03,0,6,0,6
ASSAM,HOJAI,2021-01-04,0,260,0,260
ASSAM,HOJAI,2021-01-05,0,199,0,199
ASSAM,JORHAT,2021-01-01,0,333,5,338
ASSAM,JORHAT,2021-01-02,3,832,1,836
ASSAM,JORHAT,2021-01-03,0,454,3,457
ASSAM,JORHAT,2021-01-04,6,599,0,605
ASSAM,JORHAT,2021-01-05,4,614,7,625
ASSAM,KAMRUP,2021-01-01,1,533,0,534
ASSAM,KAMRUP,2021-01-02,4,1091,0,1095
ASSAM,KAMRUP,2021-01-03,1,269,0,270
ASSAM,KAMRUP,2021-01-04,5,1000,0,1005
ASSAM,KAMRUP,2021-01-05,4,999,0,1003
ASSAM,KAMRUP METRO,2021-01-01,21,3686,2,3709
ASSAM,KAMRUP METRO,2021-01-02,31,4107,1,4139
ASSAM,KAMRUP METRO,2021-01-03,3,2474,0,2477
ASSAM,KAMRUP METRO,2021-01-04,23,4408,1,4432
ASSAM,KAMRUP METRO,2021-01-05,24,4072,0,4096
ASSAM,KARBI ANGLONG,2021-01-01,0,55,0,55
ASSAM,KARBI ANGLONG,2021-01-02,0,179,0,179
ASSAM,KARBI ANGLONG,2021-01-03,0,9,0,9
ASSAM,KARBI ANGLONG,2021-01-04,0,181,0,181
ASSAM,KARBI ANGLONG,2021-01-05,0,113,0,113
ASSAM,KARIMGANJ,2021-01-01,0,379,0,379
ASSAM,KARIMGANJ,2021-01-02,0,400,2,402
ASSAM,KARIMGANJ,2021-01-03,0,62,2,64
ASSAM,KARIMGANJ,2021-01-04,2,439,1,442
ASSAM,KARIMGANJ,2021-01-05,1,492,0,493
ASSAM,KOKRAJHAR,2021-01-01,0,188,0,188
ASSAM,KOKRAJHAR,2021-01-02,0,177,0,177
ASSAM,KOKRAJHAR,2021-01-03,0,12,0,12
ASSAM,KOKRAJHAR,2021-01-04,0,188,0,188
ASSAM,KOKRAJHAR,2021-01-05,0,66,0,66
ASSAM,LAKHIMPUR,2021-01-01,0,688,0,688
ASSAM,LAKHIMPUR,2021-01-02,0,619,0,619
ASSAM,LAKHIMPUR,2021-01-03,0,200,0,200
ASSAM,LAKHIMPUR,2021-01-04,1,619,0,620
ASSAM,LAKHIMPUR,2021-01-05,2,417,0,419
ASSAM,MAJULI,2021-01-01,0,35,0,35
ASSAM,MAJULI,2021-01-02,0,95,0,95
ASSAM,MAJULI,2021-01-03,0,5,0,5
ASSAM,MAJULI,2021-01-04,0,84,0,84
ASSAM,MAJULI,2021-01-05,1,101,3,105
ASSAM,MARIGAON,2021-01-01,0,53,0,53
ASSAM,MARIGAON,2021-01-02,0,132,0,132
ASSAM,MARIGAON,2021-01-03,0,71,0,71
ASSAM,MARIGAON,2021-01-04,0,131,0,131
ASSAM,MARIGAON,2021-01-05,0,127,0,127
ASSAM,NAGAON,2021-01-01,3,2125,0,2128
ASSAM,NAGAON,2021-01-02,2,2587,0,2589
ASSAM,NAGAON,2021-01-03,0,699,0,699
ASSAM,NAGAON,2021-01-04,4,1949,0,1953
ASSAM,NAGAON,2021-01-05,1,983,0,984
ASSAM,NALBARI,2021-01-01,0,54,0,54
ASSAM,NALBARI,2021-01-02,0,174,0,174
ASSAM,NALBARI,2021-01-03,0,49,0,49
ASSAM,NALBARI,2021-01-04,0,198,0,198
ASSAM,NALBARI,2021-01-05,0,188,0,188
ASSAM,SIVASAGAR,2021-01-01,0,157,0,157
ASSAM,SIVASAGAR,2021-01-02,0,384,0,384
ASSAM,SIVASAGAR,2021-01-03,3,232,0,235
ASSAM,SIVASAGAR,2021-01-04,0,336,0,336
ASSAM,SIVASAGAR,2021-01-05,0,311,0,311
ASSAM,SONITPUR,2021-01-01,0,425,0,425
ASSAM,SONITPUR,2021-01-02,1,597,0,598
ASSAM,SONITPUR,2021-01-03,1,351,0,352
ASSAM,SONITPUR,2021-01-04,4,571,0,575
ASSAM,SONITPUR,2021-01-05,3,532,0,535
ASSAM,SOUTH SALMARA MANCACHAR,2021-01-01,0,33,0,33
ASSAM,SOUTH SALMARA MANCACHAR,2021-01-02,0,81,0,81
ASSAM,SOUTH SALMARA MANCACHAR,2021-01-03,0,10,0,10
ASSAM,SOUTH SALMARA MANCACHAR,2021-01-04,0,139,0,139
ASSAM,SOUTH SALMARA MANCACHAR,2021-01-05,0,96,0,96
ASSAM,TINSUKIA,2021-01-01,4,342,0,346
ASSAM,TINSUKIA,2021-01-02,3,335,0,338
ASSAM,TINSUKIA,2021-01-03,1,35,0,36
ASSAM,TINSUKIA,2021-01-04,1,409,0,410
ASSAM,TINSUKIA,2021-01-05,4,248,0,252
ASSAM,UDALGURI,2021-01-01,0,8,0,8
ASSAM,UDALGURI,2021-01-02,0,60,0,60
ASSAM,UDALGURI,2021-01-03,0,27,0,27
ASSAM,UDALGURI,2021-01-04,1,22,0,23
ASSAM,UDALGURI,2021-01-05,0,23,0,23
ASSAM,WEST KARBI ANGLONG,2021-01-01,0,3,0,3
ASSAM,WEST KARBI ANGLONG,2021-01-02,0,22,0,22
ASSAM,WEST KARBI ANGLONG,2021-01-03,0,10,0,10
ASSAM,WEST KARBI ANGLONG,2021-01-04,0,24,0,24
ASSAM,WEST KARBI ANGLONG,2021-01-05,0,12,0,12
BIHAR,ARARIA,2021-01-01,0,614,0,614
BIHAR,ARARIA,2021-01-02,5,861,0,866
BIHAR,ARARIA,2021-01-03,0,154,0,154
BIHAR,ARARIA,2021-01-04,0,973,1,974
BIHAR,ARARIA,2021-01-05,6,234,1,241
BIHAR,ARWAL,2021-01-01,1,1083,0,1084
BIHAR,ARWAL,2021-01-02,3,1980,0,1983
BIHAR,ARWAL,2021-01-03,2,438,0,440
BIHAR,ARWAL,2021-01-04,3,1495,0,1498
BIHAR,ARWAL,2021-01-05,5,1612,0,1617
BIHAR,AURANGABAD,2021-01-01,3,461,1,465
BIHAR,AURANGABAD,2021-01-02,4,1346,0,1350
BIHAR,AURANGABAD,2021-01-03,2,1625,0,1627
BIHAR,AURANGABAD,2021-01-04,74,1663,1,1738
BIHAR,AURANGABAD,2021-01-05,53,1081,0,1134
BIHAR,BANKA,2021-01-01,5,2184,73,2262
BIHAR,BANKA,2021-01-02,6,2117,35,2158
BIHAR,BANKA,2021-01-03,3,2310,45,2358
BIHAR,BANKA,2021-01-04,7,2339,0,2346
BIHAR,BANKA,2021-01-05,3,3019,24,3046
BIHAR,BEGUSARAI,2021-01-01,14,4804,1,4819
BIHAR,BEGUSARAI,2021-01-02,9,4633,1,4643
BIHAR,BEGUSARAI,2021-01-03,6,1801,1,1808
BIHAR,BEGUSARAI,2021-01-04,15,4078,1,4094
BIHAR,BEGUSARAI,2021-01-05,23,3810,6,3839
BIHAR,BHAGALPUR,2021-01-01,2,1153,0,1155
BIHAR,BHAGALPUR,2021-01-02,11,4374,184,4569
BIHAR,BHAGALPUR,2021-01-03,8,1998,30,2036
BIHAR,BHAGALPUR,2021-01-04,8,3206,358,3572
BIHAR,BHAGALPUR,2021-01-05,7,2770,43,2820
BIHAR,BHOJPUR,2021-01-01,4,1616,116,1736
BIHAR,BHOJPUR,2021-01-02,2,2315,10,2327
BIHAR,BHOJPUR,2021-01-03,4,1194,99,1297
BIHAR,BHOJPUR,2021-01-04,16,2938,48,3002
BIHAR,BHOJPUR,2021-01-05,6,1852,58,1916
BIHAR,BUXAR,2021-01-01,0,827,1,828
BIHAR,BUXAR,2021-01-02,2,1893,0,1895
BIHAR,BUXAR,2021-01-03,1,2198,1,2200
BIHAR,BUXAR,2021-01-04,2,1810,53,1865
BIHAR,BUXAR,2021-01-05,1,1138,42,1181
BIHAR,DARBHANGA,2021-01-01,10,1627,3,1640
BIHAR,DARBHANGA,2021-01-02,21,2336,1,2358
BIHAR,DARBHANGA,2021-01-03,6,2056,0,2062
BIHAR,DARBHANGA,2021-01-04,4,1888,28,1920
BIHAR,DARBHANGA,2021-01-05,21,1917,57,1995
BIHAR,GAYA,2021-01-01,4,3148,52,3204
BIHAR,GAYA,2021-01-02,5,3730,17,3752
BIHAR,GAYA,2021-01-03,2,2052,32,2086
BIHAR,GAYA,2021-01-04,4,4695,828,5527
BIHAR,GAYA,2021-01-05,4,2776,378,3158
BIHAR,GOPALGANJ,2021-01-01,3,1165,0,1168
BIHAR,GOPALGANJ,2021-01-02,0,1283,0,1283
BIHAR,GOPALGANJ,2021-01-03,21,1453,52,1526
BIHAR,GOPALGANJ,2021-01-04,3,1829,15,1847
BIHAR,GOPALGANJ,2021-01-05,3,2569,19,2591
BIHAR,JAMUI,2021-01-01,3,776,0,779
BIHAR,JAMUI,2021-01-02,2,1285,0,1287
BIHAR,JAMUI,2021-01-03,0,1002,0,1002
BIHAR,JAMUI,2021-01-04,0,1064,3,1067
BIHAR,JAMUI,2021-01-05,0,1292,0,1292
BIHAR,JEHANABAD,2021-01-01,3,1057,10,1070
BIHAR,JEHANABAD,2021-01-02,3,981,1,985
BIHAR,JEHANABAD,2021-01-03,9,827,3,839
BIHAR,JEHANABAD,2021-01-04,5,1064,34,1103
BIHAR,JEHANABAD,2021-01-05,3,1267,2,1272
BIHAR,KAIMUR (BHABUA),2021-01-01,17,2088,0,2105
BIHAR,KAIMUR (BHABUA),2021-01-02,9,2181,0,2190
BIHAR,KAIMUR (BHABUA),2021-01-03,4,2117,0,2121
BIHAR,KAIMUR (BHABUA),2021-01-04,7,2113,3,2123
BIHAR,KAIMUR (BHABUA),2021-01-05,2,1281,0,1283
BIHAR,KATIHAR,2021-01-01,1,1401,0,1402
BIHAR,KATIHAR,2021-01-02,9,1900,2,1911
BIHAR,KATIHAR,2021-01-03,3,1046,0,1049
BIHAR,KATIHAR,2021-01-04,6,1690,0,1696
BIHAR,KATIHAR,2021-01-05,2,1716,1,1719
BIHAR,KHAGARIA,2021-01-01,0,717,0,717
BIHAR,KHAGARIA,2021-01-02,0,1893,0,1893
BIHAR,KHAGARIA,2021-01-03,2,1782,0,1784
BIHAR,KHAGARIA,2021-01-04,10,1830,0,1840
BIHAR,KHAGARIA,2021-01-05,1,2105,1,2107
BIHAR,KISHANGANJ,2021-01-01,0,358,0,358
BIHAR,KISHANGANJ,2021-01-02,0,1319,0,1319
BIHAR,KISHANGANJ,2021-01-03,0,507,6,513
BIHAR,KISHANGANJ,2021-01-04,3,817,0,820
BIHAR,KISHANGANJ,2021-01-05,1,924,0,925
BIHAR,LAKHISARAI,2021-01-01,2,2701,0,2703
BIHAR,LAKHISARAI,2021-01-02,4,1792,0,1796
BIHAR,LAKHISARAI,2021-01-03,7,679,15,701
BIHAR,LAKHISARAI,2021-01-04,11,1949,0,1960
BIHAR,LAKHISARAI,2021-01-05,3,1189,0,1192
BIHAR,MADHEPURA,2021-01-01,2,956,0,958
BIHAR,MADHEPURA,2021-01-02,3,2056,0,2059
BIHAR,MADHEPURA,2021-01-03,0,2730,0,2730
BIHAR,MADHEPURA,2021-01-04,7,1754,0,1761
BIHAR,MADHEPURA,2021-01-05,3,2721,0,2724
BIHAR,MADHUBANI,2021-01-01,4,701,0,705
BIHAR,MADHUBANI,2021-01-02,5,1961,4,1970
BIHAR,MADHUBANI,2021-01-03,5,968,0,973
BIHAR,MADHUBANI,2021-01-04,10,2000,17,2027
BIHAR,MADHUBANI,2021-01-05,9,2060,19,2088
BIHAR,MUNGER,2021-01-01,2,1243,4,1249
BIHAR,MUNGER,2021-01-02,1,1517,56,1574
BIHAR,MUNGER,2021-01-03,0,739,0,739
BIHAR,MUNGER,2021-01-04,1,2154,15,2170
BIHAR,MUNGER,2021-01-05,4,1858,8,1870
BIHAR,MUZAFFARPUR,2021-01-01,11,3003,2,3016
BIHAR,MUZAFFARPUR,2021-01-02,18,3097,0,3115
BIHAR,MUZAFFARPUR,2021-01-03,21,3212,6,3239
BIHAR,MUZAFFARPUR,2021-01-04,19,3411,3,3433
BIHAR,MUZAFFARPUR,2021-01-05,10,3979,3,3992
BIHAR,NALANDA,2021-01-01,15,2643,1,2659
BIHAR,NALANDA,2021-01-02,16,3611,2,3629
BIHAR,NALANDA,2021-01-03,3,3388,1,3392
BIHAR,NALANDA,2021-01-04,14,3840,0,3854
BIHAR,NALANDA,2021-01-05,13,3618,41,3672
BIHAR,NAWADA,2021-01-01,2,1320,0,1322
BIHAR,NAWADA,2021-01-02,22,1430,1,1453
BIHAR,NAWADA,2021-01-03,0,1841,0,1841
BIHAR,NAWADA,2021-01-04,0,1044,2,1046
BIHAR,NAWADA,2021-01-05,1,1766,0,1767
BIHAR,PASHCHIM CHAMPARAN,2021-01-01,2,569,1,572
BIHAR,PASHCHIM CHAMPARAN,2021-01-02,2,1966,0,1968
BIHAR,PASHCHIM CHAMPARAN,2021-01-03,3,1527,1,1531
BIHAR,PASHCHIM CHAMPARAN,2021-01-04,4,2860,0,2864
BIHAR,PASHCHIM CHAMPARAN,2021-01-05,3,2172,0,2175
BIHAR,PATNA,2021-01-01,224,4683,17,4924
BIHAR,PATNA,2021-01-02,152,4696,6,4854
BIHAR,PATNA,2021-01-03,173,3384,3,3560
BIHAR,PATNA,2021-01-04,176,5030,4,5210
BIHAR,PATNA,2021-01-05,168,4888,4,5060
BIHAR,PURBI CHAMPARAN,2021-01-01,1,3019,1,3021
BIHAR,PURBI CHAMPARAN,2021-01-02,4,3734,1,3739
BIHAR,PURBI CHAMPARAN,2021-01-03,2,3181,6,3189
BIHAR,PURBI CHAMPARAN,2021-01-04,5,3915,1,3921
BIHAR,PURBI CHAMPARAN,2021-01-05,3,4267,0,4270
BIHAR,PURNIA,2021-01-01,5,1044,81,1130
BIHAR,PURNIA,2021-01-02,8,1962,0,1970
BIHAR,PURNIA,2021-01-03,2,901,0,903
BIHAR,PURNIA,2021-01-04,0,1614,9,1623
BIHAR,PURNIA,2021-01-05,6,1279,58,1343
BIHAR,ROHTAS,2021-01-01,0,1336,1,1337
BIHAR,ROHTAS,2021-01-02,13,2374,1,2388
BIHAR,ROHTAS,2021-01-03,2,2110,0,2112
BIHAR,ROHTAS,2021-01-04,7,2715,1,2723
BIHAR,ROHTAS,2021-01-05,14,1763,0,1777
BIHAR,SAHARSA,2021-01-01,0,418,1,419
BIHAR,SAHARSA,2021-01-02,9,1533,0,1542
BIHAR,SAHARSA,2021-01-03,2,472,0,474
BIHAR,SAHARSA,2021-01-04,6,1178,1,1185
BIHAR,SAHARSA,2021-01-05,8,906,0,914
BIHAR,SAMASTIPUR,2021-01-01,3,3105,100,3208
BIHAR,SAMASTIPUR,2021-01-02,1,3400,74,3475
BIHAR,SAMASTIPUR,2021-01-03,3,2707,101,2811
BIHAR,SAMASTIPUR,2021-01-04,6,3384,244,3634
BIHAR,SAMASTIPUR,2021-01-05,10,3009,215,3234
BIHAR,SARAN,2021-01-01,18,1677,0,1695
BIHAR,SARAN,2021-01-02,13,2348,0,2361
BIHAR,SARAN,2021-01-03,22,1863,1,1886
BIHAR,SARAN,2021-01-04,7,3523,2,3532
BIHAR,SARAN,2021-01-05,17,2868,2,2887
BIHAR,SHEIKHPURA,2021-01-01,0,485,0,485
BIHAR,SHEIKHPURA,2021-01-02,0,1156,11,1167
BIHAR,SHEIKHPURA,2021-01-03,0,32,0,32
BIHAR,SHEIKHPURA,2021-01-04,2,796,2,800
BIHAR,SHEIKHPURA,2021-01-05,1,774,2,777
BIHAR,SHEOHAR,2021-01-01,1,559,0,560
BIHAR,SHEOHAR,2021-01-02,0,1070,0,1070
BIHAR,SHEOHAR,2021-01-03,6,256,0,262
BIHAR,SHEOHAR,2021-01-04,7,1126,2,1135
BIHAR,SHEOHAR,2021-01-05,0,561,1,562
BIHAR,SITAMARHI,2021-01-01,6,892,31,929
BIHAR,SITAMARHI,2021-01-02,7,2336,0,2343
BIHAR,SITAMARHI,2021-01-03,6,2266,0,2272
BIHAR,SITAMARHI,2021-01-04,3,2273,1,2277
BIHAR,SITAMARHI,2021-01-05,6,1613,0,1619
BIHAR,SIWAN,2021-01-01,3,2084,0,2087
BIHAR,SIWAN,2021-01-02,8,2992,0,3000
BIHAR,SIWAN,2021-01-03,5,1152,0,1157
BIHAR,SIWAN,2021-01-04,3,2121,1,2125
BIHAR,SIWAN,2021-01-05,13,2914,0,2927
BIHAR,SUPAUL,2021-01-01,0,1527,0,1527
BIHAR,SUPAUL,2021-01-02,0,1744,40,1784
BIHAR,SUPAUL,2021-01-03,3,1829,1,1833
BIHAR,SUPAUL,2021-01-04,5,2187,48,2240
BIHAR,SUPAUL,2021-01-05,0,2067,0,2067
BIHAR,VAISHALI,2021-01-01,3,3066,0,3069
BIHAR,VAISHALI,2021-01-02,3,5010,0,5013
BIHAR,VAISHALI,2021-01-03,8,2477,0,2485
BIHAR,VAISHALI,2021-01-04,13,4431,15,4459
BIHAR,VAISHALI,2021-01-05,7,3161,0,3168
CHANDIGARH,CHANDIGARH,2021-01-01,78,710,3,791
CHANDIGARH,CHANDIGARH,2021-01-02,90,1022,10,1122
CHANDIGARH,CHANDIGARH,2021-01-03,24,423,5,452
CHANDIGARH,CHANDIGARH,2021-01-04,68,1317,10,1395
CHANDIGARH,CHANDIGARH,2021-01-05,136,1427,34,1597
CHHATTISGARH,BALOD,2021-01-01,92,783,0,875
CHHATTISGARH,BALOD,2021-01-02,42,1793,1,1836
CHHATTISGARH,BALOD,2021-01-03,40,747,0,787
CHHATTISGARH,BALOD,2021-01-04,31,1073,0,1104
CHHATTISGARH,BALOD,2021-01-05,51,1104,0,1155
CHHATTISGARH,BALODA BAZAR,2021-01-01,29,733,1,763
CHHATTISGARH,BALODA BAZAR,2021-01-02,47,838,71,956
CHHATTISGARH,BALODA BAZAR,2021-01-03,30,149,1,180
CHHATTISGARH,BALODA BAZAR,2021-01-04,50,840,8,898
CHHATTISGARH,BALODA BAZAR,2021-01-05,28,484,59,571
CHHATTISGARH,BALRAMPUR,2021-01-01,5,202,0,207
CHHATTISGARH,BALRAMPUR,2021-01-02,9,344,11,364
CHHATTISGARH,BALRAMPUR,2021-01-03,4,143,0,147
CHHATTISGARH,BALRAMPUR,2021-01-04,28,558,0,586
CHHATTISGARH,BALRAMPUR,2021-01-05,18,516,0,534
CHHATTISGARH,BASTAR,2021-01-01,6,1131,2,1139
CHHATTISGARH,BASTAR,2021-01-02,8,1147,0,1155
CHHATTISGARH,BASTAR,2021-01-03,4,523,0,527
CHHATTISGARH,BASTAR,2021-01-04,6,1293,0,1299
CHHATTISGARH,BASTAR,2021-01-05,6,964,1,971
CHHATTISGARH,BEMETARA,2021-01-01,20,263,0,283
CHHATTISGARH,BEMETARA,2021-01-02,19,585,0,604
CHHATTISGARH,BEMETARA,2021-01-03,10,27,1,38
CHHATTISGARH,BEMETARA,2021-01-04,33,487,0,520
CHHATTISGARH,BEMETARA,2021-01-05,17,316,0,333
CHHATTISGARH,BIJAPUR,2021-01-01,3,160,0,163
CHHATTISGARH,BIJAPUR,2021-01-02,0,257,0,257
CHHATTISGARH,BIJAPUR,2021-01-03,0,231,0,231
CHHATTISGARH,BIJAPUR,2021-01-04,1,168,0,169
CHHATTISGARH,BIJAPUR,2021-01-05,0,281,0,281
CHHATTISGARH,BILASPUR,2021-01-01,68,1085,6,1159
CHHATTISGARH,BILASPUR,2021-01-02,89,1227,12,1328
CHHATTISGARH,BILASPUR,2021-01-03,45,812,13,870
CHHATTISGARH,BILASPUR,2021-01-04,89,1396,6,1491
CHHATTISGARH,BILASPUR,2021-01-05,69,992,13,1074
CHHATTISGARH,DANTEWADA,2021-01-01,3,323,0,326
CHHATTISGARH,DANTEWADA,2021-01-02,9,270,0,279
CHHATTISGARH,DANTEWADA,2021-01-03,2,241,0,243
CHHATTISGARH,DANTEWADA,2021-01-04,5,259,0,264
CHHATTISGARH,DANTEWADA,2021-01-05,4,197,0,201
CHHATTISGARH,DHAMTARI,2021-01-01,46,640,9,695
CHHATTISGARH,DHAMTARI,2021-01-02,81,910,25,1016
CHHATTISGARH,DHAMTARI,2021-01-03,29,377,29,435
CHHATTISGARH,DHAMTARI,2021-01-04,50,1100,15,1165
CHHATTISGARH,DHAMTARI,2021-01-05,48,913,29,990
CHHATTISGARH,DURG,2021-01-01,131,894,2,1027
CHHATTISGARH,DURG,2021-01-02,113,1541,1,1655
CHHATTISGARH,DURG,2021-01-03,107,897,2,1006
CHHATTISGARH,DURG,2021-01-04,145,1253,1,1399
CHHATTISGARH,DURG,2021-01-05,123,1280,1,1404
CHHATTISGARH,GARIYABAND,2021-01-01,7,370,1,378
CHHATTISGARH,GARIYABAND,2021-01-02,12,380,2,394
CHHATTISGARH,GARIYABAND,2021-01-03,21,368,3,392
CHHATTISGARH,GARIYABAND,2021-01-04,12,288,4,304
CHHATTISGARH,GARIYABAND,2021-01-05,11,260,3,274
CHHATTISGARH,GAURELLA PENDRA MARWAHI,2021-01-01,7,135,0,142
CHHATTISGARH,GAURELLA PENDRA MARWAHI,2021-01-02,14,295,1,310
CHHATTISGARH,GAURELLA PENDRA MARWAHI,2021-01-03,2,239,0,241
CHHATTISGARH,GAURELLA PENDRA MARWAHI,2021-01-04,4,154,32,190
CHHATTISGARH,GAURELLA PENDRA MARWAHI,2021-01-05,5,349,2,356
CHHATTISGARH,JANJGIR CHAMPA,2021-01-01,92,1160,3,1255
CHHATTISGARH,JANJGIR CHAMPA,2021-01-02,74,1982,13,2069
CHHATTISGARH,JANJGIR CHAMPA,2021-01-03,28,960,2,990
CHHATTISGARH,JANJGIR CHAMPA,2021-01-04,75,2219,9,2303
CHHATTISGARH,JANJGIR CHAMPA,2021-01-05,31,2319,8,2358
CHHATTISGARH,JASHPUR,2021-01-01,15,356,0,371
CHHATTISGARH,JASHPUR,2021-01-02,41,401,0,442
CHHATTISGARH,JASHPUR,2021-01-03,19,139,0,158
CHHATTISGARH,JASHPUR,2021-01-04,33,328,11,372
CHHATTISGARH,JASHPUR,2021-01-05,30,317,0,347
CHHATTISGARH,KABIRDHAM,2021-01-01,24,567,0,591
CHHATTISGARH,KABIRDHAM,2021-01-02,12,893,0,905
CHHATTISGARH,KABIRDHAM,2021-01-03,16,445,0,461
CHHATTISGARH,KABIRDHAM,2021-01-04,25,418,0,443
CHHATTISGARH,KABIRDHAM,2021-01-05,14,646,0,660
CHHATTISGARH,KANKER,2021-01-01,9,362,0,371
CHHATTISGARH,KANKER,2021-01-02,20,781,0,801
CHHATTISGARH,KANKER,2021-01-03,5,382,1,388
CHHATTISGARH,KANKER,2021-01-04,27,518,0,545
CHHATTISGARH,KANKER,2021-01-05,23,750,0,773
CHHATTISGARH,KONDAGAON,2021-01-01,4,444,0,448
CHHATTISGARH,KONDAGAON,2021-01-02,10,535,2,547
CHHATTISGARH,KONDAGAON,2021-01-03,4,243,2,249
CHHATTISGARH,KONDAGAON,2021-01-04,7,654,5,666
CHHATTISGARH,KONDAGAON,2021-01-05,4,314,7,325
CHHATTISGARH,KORBA,2021-01-01,34,1135,2,1171
CHHATTISGARH,KORBA,2021-01-02,49,1362,0,1411
CHHATTISGARH,KORBA,2021-01-03,10,614,0,624
CHHATTISGARH,KORBA,2021-01-04,64,1095,2,1161
CHHATTISGARH,KORBA,2021-01-05,41,842,0,883
CHHATTISGARH,KOREA,2021-01-01,7,375,0,382
CHHATTISGARH,KOREA,2021-01-02,26,783,0,809
CHHATTISGARH,KOREA,2021-01-03,30,314,0,344
CHHATTISGARH,KOREA,2021-01-04,55,795,1,851
CHHATTISGARH,KOREA,2021-01-05,27,951,4,982
CHHATTISGARH,MAHASAMUND,2021-01-01,26,461,0,487
CHHATTISGARH,MAHASAMUND,2021-01-02,56,678,0,734
CHHATTISGARH,MAHASAMUND,2021-01-03,30,378,4,412
CHHATTISGARH,MAHASAMUND,2021-01-04,42,499,2,543
CHHATTISGARH,MAHASAMUND,2021-01-05,30,1106,0,1136
CHHATTISGARH,MUNGELI,2021-01-01,4,298,0,302
CHHATTISGARH,MUNGELI,2021-01-02,11,317,0,328
CHHATTISGARH,MUNGELI,2021-01-03,3,360,7,370
CHHATTISGARH,MUNGELI,2021-01-04,18,802,7,827
CHHATTISGARH,MUNGELI,2021-01-05,11,635,4,650
CHHATTISGARH,NARAYANPUR,2021-01-01,1,171,0,172
CHHATTISGARH,NARAYANPUR,2021-01-02,0,126,0,126
CHHATTISGARH,NARAYANPUR,2021-01-03,0,37,0,37
CHHATTISGARH,NARAYANPUR,2021-01-04,1,339,0,340
CHHATTISGARH,NARAYANPUR,2021-01-05,0,109,0,109
CHHATTISGARH,RAIGARH,2021-01-01,69,1700,19,1788
CHHATTISGARH,RAIGARH,2021-01-02,84,1837,2,1923
CHHATTISGARH,RAIGARH,2021-01-03,26,763,2,791
CHHATTISGARH,RAIGARH,2021-01-04,69,2137,2,2208
CHHATTISGARH,RAIGARH,2021-01-05,55,1729,0,1784
CHHATTISGARH,RAIPUR,2021-01-01,214,2019,17,2250
CHHATTISGARH,RAIPUR,2021-01-02,235,1962,19,2216
CHHATTISGARH,RAIPUR,2021-01-03,201,1047,18,1266
CHHATTISGARH,RAIPUR,2021-01-04,179,2100,5,2284
CHHATTISGARH,RAIPUR,2021-01-05,279,3023,9,3311
CHHATTISGARH,RAJNANDGAON,2021-01-01,90,854,0,944
CHHATTISGARH,RAJNANDGAON,2021-01-02,63,1260,0,1323
CHHATTISGARH,RAJNANDGAON,2021-01-03,49,548,0,597
CHHATTISGARH,RAJNANDGAON,2021-01-04,77,1135,4,1216
CHHATTISGARH,RAJNANDGAON,2021-01-05,84,1282,1,1367
CHHATTISGARH,SUKMA,2021-01-01,0,175,0,175
CHHATTISGARH,SUKMA,2021-01-02,5,251,0,256
CHHATTISGARH,SUKMA,2021-01-03,3,97,0,100
CHHATTISGARH,SUKMA,2021-01-04,4,178,0,182
CHHATTISGARH,SUKMA,2021-01-05,3,221,0,224
CHHATTISGARH,SURAJPUR,2021-01-01,30,572,1,603
CHHATTISGARH,SURAJPUR,2021-01-02,34,954,2,990
CHHATTISGARH,SURAJPUR,2021-01-03,17,638,2,657
CHHATTISGARH,SURAJPUR,2021-01-04,29,954,0,983
CHHATTISGARH,SURAJPUR,2021-01-05,46,970,0,1016
CHHATTISGARH,SURGUJA,2021-01-01,24,416,0,440
CHHATTISGARH,SURGUJA,2021-01-02,70,985,0,1055
CHHATTISGARH,SURGUJA,2021-01-03,56,485,0,541
CHHATTISGARH,SURGUJA,2021-01-04,52,826,0,878
CHHATTISGARH,SURGUJA,2021-01-05,66,1228,3,1297
DADRA AND NAGAR HAVELI,DADRA AND NAGAR HAVELI,2021-01-01,0,217,0,217
DADRA AND NAGAR HAVELI,DADRA AND NAGAR HAVELI,2021-01-02,1,272,0,273
DADRA AND NAGAR HAVELI,DADRA AND NAGAR HAVELI,2021-01-03,0,177,0,177
DADRA AND NAGAR HAVELI,DADRA AND NAGAR HAVELI,2021-01-04,0,206,0,206
DADRA AND NAGAR HAVELI,DADRA AND NAGAR HAVELI,2021-01-05,0,302,1,303
DAMAN AND DIU,DAMAN,2021-01-01,0,1,0,1
DAMAN AND DIU,DAMAN,2021-01-02,1,80,0,81
DAMAN AND DIU,DAMAN,2021-01-03,0,90,0,90
DAMAN AND DIU,DAMAN,2021-01-04,0,5,0,5
DAMAN AND DIU,DAMAN,2021-01-05,0,147,0,147
DAMAN AND DIU,DIU,2021-01-01,0,3,0,3
DAMAN AND DIU,DIU,2021-01-02,0,38,0,38
DAMAN AND DIU,DIU,2021-01-03,0,31,0,31
DAMAN AND DIU,DIU,2021-01-04,0,46,0,46
DAMAN AND DIU,DIU,2021-01-05,0,50,0,50
DELHI,CENTRAL,2021-01-01,40,4525,86,4651
DELHI,CENTRAL,2021-01-02,39,6029,128,6196
DELHI,CENTRAL,2021-01-03,37,4619,35,4691
DELHI,CENTRAL,2021-01-04,37,7645,35,7717
DELHI,CENTRAL,2021-01-05,34,6131,172,6337
DELHI,EAST,2021-01-01,30,6926,7,6963
DELHI,EAST,2021-01-02,59,6299,40,6398
DELHI,EAST,2021-01-03,47,2634,12,2693
DELHI,EAST,2021-01-04,44,7249,12,7305
DELHI,EAST,2021-01-05,42,4866,8,4916
DELHI,NEW DELHI,2021-01-01,123,4768,10,4901
DELHI,NEW DELHI,2021-01-02,82,5330,44,5456
DELHI,NEW DELHI,2021-01-03,58,4289,41,4388
DELHI,NEW DELHI,2021-01-04,74,5936,24,6034
DELHI,NEW DELHI,2021-01-05,120,6427,15,6562
DELHI,NORTH,2021-01-01,41,6967,17,7025
DELHI,NORTH,2021-01-02,25,6724,17,6766
DELHI,NORTH,2021-01-03,39,6036,36,6111
DELHI,NORTH,2021-01-04,35,8882,27,8944
DELHI,NORTH,2021-01-05,42,6545,94,6681
DELHI,NORTH EAST,2021-01-01,29,3989,19,4037
DELHI,NORTH EAST,2021-01-02,7,3518,18,3543
DELHI,NORTH EAST,2021-01-03,20,2478,16,2514
DELHI,NORTH EAST,2021-01-04,17,5574,5,5596
DELHI,NORTH EAST,2021-01-05,16,3968,8,3992
DELHI,NORTH WEST,2021-01-01,54,6606,18,6678
DELHI,NORTH WEST,2021-01-02,77,6597,11,6685
DELHI,NORTH WEST,2021-01-03,58,5830,9,5897
DELHI,NORTH WEST,2021-01-04,92,8233,9,8334
DELHI,NORTH WEST,2021-01-05,97,8146,149,8392
DELHI,SHAHDARA,2021-01-01,14,5101,5,5120
DELHI,SHAHDARA,2021-01-02,17,5353,5,5375
DELHI,SHAHDARA,2021-01-03,6,2370,9,2385
DELHI,SHAHDARA,2021-01-04,17,6988,2,7007
DELHI,SHAHDARA,2021-01-05,28,6770,13,6811
DELHI,SOUTH,2021-01-01,55,5103,2,5160
DELHI,SOUTH,2021-01-02,46,4988,17,5051
DELHI,SOUTH,2021-01-03,46,3759,13,3818
DELHI,SOUTH,2021-01-04,85,4714,24,4823
DELHI,SOUTH,2021-01-05,106,6765,39,6910
DELHI,SOUTH EAST,2021-01-01,49,6554,3,6606
DELHI,SOUTH EAST,2021-01-02,32,6087,3,6122
DELHI,SOUTH EAST,2021-01-03,52,4089,1,4142
DELHI,SOUTH EAST,2021-01-04,16,5656,2,5674
DELHI,SOUTH EAST,2021-01-05,29,7068,4,7101
DELHI,SOUTH WEST,2021-01-01,67,7930,5,8002
DELHI,SOUTH WEST,2021-01-02,63,8789,4,8856
DELHI,SOUTH WEST,2021-01-03,41,7203,5,7249
DELHI,SOUTH WEST,2021-01-04,51,9749,1,9801
DELHI,SOUTH WEST,2021-01-05,79,8106,5,8190
DELHI,WEST,2021-01-01,74,8173,5,8252
DELHI,WEST,2021-01-02,62,8265,5,8332
DELHI,WEST,2021-01-03,59,6347,8,6414
DELHI,WEST,2021-01-04,55,8550,17,8622
DELHI,WEST,2021-01-05,200,8658,13,8871
GOA,NORTH GOA,2021-01-01,25,744,1,770
GOA,NORTH GOA,2021-01-02,48,604,1,653
GOA,NORTH GOA,2021-01-03,15,485,0,500
GOA,NORTH GOA,2021-01-04,38,772,0,810
GOA,NORTH GOA,2021-01-05,47,993,1,1041
GOA,SOUTH GOA,2021-01-01,50,725,0,775
GOA,SOUTH GOA,2021-01-02,34,711,1,746
GOA,SOUTH GOA,2021-01-03,48,400,0,448
GOA,SOUTH GOA,2021-01-04,40,806,0,846
GOA,SOUTH GOA,2021-01-05,47,968,0,1015
GUJARAT,AHMADABAD,2021-01-01,93,10732,50,10875
GUJARAT,AHMADABAD,2021-01-02,118,11648,40,11806
GUJARAT,AHMADABAD,2021-01-03,87,8394,2,8483
GUJARAT,AHMADABAD,2021-01-04,115,10972,22,11109
GUJARAT,AHMADABAD,2021-01-05,104,10526,6,10636
GUJARAT,AMRELI,2021-01-01,6,593,0,599
GUJARAT,AMRELI,2021-01-02,21,467,1,489
GUJARAT,AMRELI,2021-01-03,86,251,0,337
GUJARAT,AMRELI,2021-01-04,27,814,1,842
GUJARAT,AMRELI,2021-01-05,9,942,0,951
GUJARAT,ANAND,2021-01-01,16,426,7,449
GUJARAT,ANAND,2021-01-02,17,495,0,512
GUJARAT,ANAND,2021-01-03,7,153,2,162
GUJARAT,ANAND,2021-01-04,15,576,0,591
GUJARAT,ANAND,2021-01-05,13,563,1,577
GUJARAT,ARVALLI,2021-01-01,9,449,5,463
GUJARAT,ARVALLI,2021-01-02,3,312,16,331
GUJARAT,ARVALLI,2021-01-03,4,195,0,199
GUJARAT,ARVALLI,2021-01-04,5,587,1,593
GUJARAT,ARVALLI,2021-01-05,5,613,4,622
GUJARAT,BANAS KANTHA,2021-01-01,6,391,4,401
GUJARAT,BANAS KANTHA,2021-01-02,8,509,0,517
GUJARAT,BANAS KANTHA,2021-01-03,4,308,0,312
GUJARAT,BANAS KANTHA,2021-01-04,10,662,0,672
GUJARAT,BANAS KANTHA,2021-01-05,34,421,0,455
GUJARAT,BHARUCH,2021-01-01,19,609,0,628
GUJARAT,BHARUCH,2021-01-02,14,575,2,591
GUJARAT,BHARUCH,2021-01-03,17,258,0,275
GUJARAT,BHARUCH,2021-01-04,16,422,0,438
GUJARAT,BHARUCH,2021-01-05,18,467,1,486
GUJARAT,BHAVNAGAR,2021-01-01,3,1257,1,1261
GUJARAT,BHAVNAGAR,2021-01-02,9,1653,0,1662
GUJARAT,BHAVNAGAR,2021-01-03,2,1423,0,1425
GUJARAT,BHAVNAGAR,2021-01-04,13,1201,1,1215
GUJARAT,BHAVNAGAR,2021-01-05,4,1494,0,1498
GUJARAT,BOTAD,2021-01-01,0,381,0,381
GUJARAT,BOTAD,2021-01-02,1,291,0,292
GUJARAT,BOTAD,2021-01-03,2,173,0,175
GUJARAT,BOTAD,2021-01-04,1,566,0,567
GUJARAT,BOTAD,2021-01-05,0,483,0,483
GUJARAT,CHHOTAUDEPUR,2021-01-01,1,476,0,477
GUJARAT,CHHOTAUDEPUR,2021-01-02,3,376,0,379
GUJARAT,CHHOTAUDEPUR,2021-01-03,0,93,0,93
GUJARAT,CHHOTAUDEPUR,2021-01-04,2,362,0,364
GUJARAT,CHHOTAUDEPUR,2021-01-05,0,346,0,346
GUJARAT,DANG,2021-01-01,1,103,0,104
GUJARAT,DANG,2021-01-02,0,116,0,116
GUJARAT,DANG,2021-01-03,4,88,0,92
GUJARAT,DANG,2021-01-04,0,54,0,54
GUJARAT,DANG,2021-01-05,3,124,0,127
GUJARAT,DEVBHUMI DWARKA,2021-01-01,4,92,0,96
GUJARAT,DEVBHUMI DWARKA,2021-01-02,7,281,2,290
GUJARAT,DEVBHUMI DWARKA,2021-01-03,0,123,1,124
GUJARAT,DEVBHUMI DWARKA,2021-01-04,8,150,0,158
GUJARAT,DEVBHUMI DWARKA,2021-01-05,0,330,3,333
GUJARAT,DOHAD,2021-01-01,11,647,0,658
GUJARAT,DOHAD,2021-01-02,9,432,0,441
GUJARAT,DOHAD,2021-01-03,0,179,0,179
GUJARAT,DOHAD,2021-01-04,38,476,0,514
GUJARAT,DOHAD,2021-01-05,3,506,0,509
GUJARAT,GANDHINAGAR,2021-01-01,17,1581,8,1606
GUJARAT,GANDHINAGAR,2021-01-02,23,1650,3,1676
GUJARAT,GANDHINAGAR,2021-01-03,7,819,0,826
GUJARAT,GANDHINAGAR,2021-01-04,14,2357,3,2374
GUJARAT,GANDHINAGAR,2021-01-05,14,1826,3,1843
GUJARAT,GIR SOMNATH,2021-01-01,8,300,0,308
GUJARAT,GIR SOMNATH,2021-01-02,4,379,0,383
GUJARAT,GIR SOMNATH,2021-01-03,4,300,0,304
GUJARAT,GIR SOMNATH,2021-01-04,4,428,0,432
GUJARAT,GIR SOMNATH,2021-01-05,4,314,0,318
GUJARAT,JAMNAGAR,2021-01-01,13,1499,13,1525
GUJARAT,JAMNAGAR,2021-01-02,17,1997,4,2018
GUJARAT,JAMNAGAR,2021-01-03,9,722,0,731
GUJARAT,JAMNAGAR,2021-01-04,22,1646,2,1670
GUJARAT,JAMNAGAR,2021-01-05,19,2077,2,2098
GUJARAT,JUNAGADH,2021-01-01,14,668,0,682
GUJARAT,JUNAGADH,2021-01-02,19,761,0,780
GUJARAT,JUNAGADH,2021-01-03,6,155,0,161
GUJARAT,JUNAGADH,2021-01-04,13,717,8,738
GUJARAT,JUNAGADH,2021-01-05,11,574,0,585
GUJARAT,KACHCHH,2021-01-01,29,737,3,769
GUJARAT,KACHCHH,2021-01-02,14,600,1,615
GUJARAT,KACHCHH,2021-01-03,29,267,2,298
GUJARAT,KACHCHH,2021-01-04,21,559,4,584
GUJARAT,KACHCHH,2021-01-05,12,577,0,589
GUJARAT,KHEDA,2021-01-01,19,735,2,756
GUJARAT,KHEDA,2021-01-02,45,742,1,788
GUJARAT,KHEDA,2021-01-03,18,378,1,397
GUJARAT,KHEDA,2021-01-04,37,830,6,873
GUJARAT,KHEDA,2021-01-05,22,1018,1,1041
GUJARAT,MAHESANA,2021-01-01,14,829,2,845
GUJARAT,MAHESANA,2021-01-02,9,936,1,946
GUJARAT,MAHESANA,2021-01-03,12,334,0,346
GUJARAT,MAHESANA,2021-01-04,4,873,0,877
GUJARAT,MAHESANA,2021-01-05,8,790,0,798
GUJARAT,MAHISAGAR,2021-01-01,3,350,0,353
GUJARAT,MAHISAGAR,2021-01-02,5,314,0,319
GUJARAT,MAHISAGAR,2021-01-03,2,380,0,382
GUJARAT,MAHISAGAR,2021-01-04,8,484,0,492
GUJARAT,MAHISAGAR,2021-01-05,4,595,0,599
GUJARAT,MORBI,2021-01-01,14,599,54,667
GUJARAT,MORBI,2021-01-02,13,569,42,624
GUJARAT,MORBI,2021-01-03,12,468,34,514
GUJARAT,MORBI,2021-01-04,21,791,35,847
GUJARAT,MORBI,2021-01-05,14,794,27,835
GUJARAT,NARMADA,2021-01-01,2,76,0,78
GUJARAT,NARMADA,2021-01-02,9,116,1,126
GUJARAT,NARMADA,2021-01-03,1,40,0,41
GUJARAT,NARMADA,2021-01-04,5,12,0,17
GUJARAT,NARMADA,2021-01-05,5,71,1,77
GUJARAT,NAVSARI,2021-01-01,7,461,1,469
GUJARAT,NAVSARI,2021-01-02,8,418,0,426
GUJARAT,NAVSARI,2021-01-03,1,277,0,278
GUJARAT,NAVSARI,2021-01-04,5,445,0,450
GUJARAT,NAVSARI,2021-01-05,12,508,0,520
GUJARAT,PANCH MAHALS,2021-01-01,17,802,3,822
GUJARAT,PANCH MAHALS,2021-01-02,16,601,0,617
GUJARAT,PANCH MAHALS,2021-01-03,14,464,0,478
GUJARAT,PANCH MAHALS,2021-01-04,10,575,0,585
GUJARAT,PANCH MAHALS,2021-01-05,9,704,0,713
GUJARAT,PATAN,2021-01-01,4,812,5,821
GUJARAT,PATAN,2021-01-02,4,533,1,538
GUJARAT,PATAN,2021-01-03,2,278,0,280
GUJARAT,PATAN,2021-01-04,1,892,1,894
GUJARAT,PATAN,2021-01-05,7,893,0,900
GUJARAT,PORBANDAR,2021-01-01,3,515,0,518
GUJARAT,PORBANDAR,2021-01-02,5,439,0,444
GUJARAT,PORBANDAR,2021-01-03,1,279,0,280
GUJARAT,PORBANDAR,2021-01-04,0,471,0,471
GUJARAT,PORBANDAR,2021-01-05,0,571,0,571
GUJARAT,RAJKOT,2021-01-01,50,2367,39,2456
GUJARAT,RAJKOT,2021-01-02,97,1801,79,1977
GUJARAT,RAJKOT,2021-01-03,40,1000,100,1140
GUJARAT,RAJKOT,2021-01-04,56,2035,60,2151
GUJARAT,RAJKOT,2021-01-05,71,2146,84,2301
GUJARAT,SABAR KANTHA,2021-01-01,11,295,0,306
GUJARAT,SABAR KANTHA,2021-01-02,7,313,11,331
GUJARAT,SABAR KANTHA,2021-01-03,5,171,1,177
GUJARAT,SABAR KANTHA,2021-01-04,4,271,11,286
GUJARAT,SABAR KANTHA,2021-01-05,8,350,1,359
GUJARAT,SURAT,2021-01-01,83,2128,2,2213
GUJARAT,SURAT,2021-01-02,55,2105,6,2166
GUJARAT,SURAT,2021-01-03,32,1330,2,1364
GUJARAT,SURAT,2021-01-04,80,2510,2,2592
GUJARAT,SURAT,2021-01-05,63,2137,6,2206
GUJARAT,SURENDRANAGAR,2021-01-01,1,948,43,992
GUJARAT,SURENDRANAGAR,2021-01-02,1,550,38,589
GUJARAT,SURENDRANAGAR,2021-01-03,0,456,0,456
GUJARAT,SURENDRANAGAR,2021-01-04,1,882,30,913
GUJARAT,SURENDRANAGAR,2021-01-05,3,980,80,1063
GUJARAT,TAPI,2021-01-01,7,345,0,352
GUJARAT,TAPI,2021-01-02,9,256,0,265
GUJARAT,TAPI,2021-01-03,6,261,0,267
GUJARAT,TAPI,2021-01-04,6,361,0,367
GUJARAT,TAPI,2021-01-05,4,384,0,388
GUJARAT,VADODARA,2021-01-01,104,2081,38,2223
GUJARAT,VADODARA,2021-01-02,126,1949,35,2110
GUJARAT,VADODARA,2021-01-03,90,1353,12,1455
GUJARAT,VADODARA,2021-01-04,116,2332,28,2476
GUJARAT,VADODARA,2021-01-05,117,2516,25,2658
GUJARAT,VALSAD,2021-01-01,1,407,1,409
GUJARAT,VALSAD,2021-01-02,7,345,0,352
GUJARAT,VALSAD,2021-01-03,2,367,1,370
GUJARAT,VALSAD,2021-01-04,5,456,0,461
GUJARAT,VALSAD,2021-01-05,7,569,0,576
HARYANA,AMBALA,2021-01-01,47,938,26,1011
HARYANA,AMBALA,2021-01-02,28,661,5,694
HARYANA,AMBALA,2021-01-03,37,226,4,267
HARYANA,AMBALA,2021-01-04,60,839,15,914
HARYANA,AMBALA,2021-01-05,32,907,100,1039
HARYANA,BHIWANI,2021-01-01,35,1357,1,1393
HARYANA,BHIWANI,2021-01-02,12,949,0,961
HARYANA,BHIWANI,2021-01-03,4,1541,0,1545
HARYANA,BHIWANI,2021-01-04,1,1500,0,1501
HARYANA,BHIWANI,2021-01-05,28,970,2,1000
HARYANA,CHARKI DADRI,2021-01-01,3,207,0,210
HARYANA,CHARKI DADRI,2021-01-02,2,397,0,399
HARYANA,CHARKI DADRI,2021-01-03,0,223,4,227
HARYANA,CHARKI DADRI,2021-01-04,9,936,1,946
HARYANA,CHARKI DADRI,2021-01-05,6,421,0,427
HARYANA,FARIDABAD,2021-01-01,37,1453,2,1492
HARYANA,FARIDABAD,2021-01-02,33,1542,2,1577
HARYANA,FARIDABAD,2021-01-03,32,1133,5,1170
HARYANA,FARIDABAD,2021-01-04,39,1650,0,1689
HARYANA,FARIDABAD,2021-01-05,44,2438,3,2485
HARYANA,FATEHABAD,2021-01-01,11,669,1,681
HARYANA,FATEHABAD,2021-01-02,25,721,1,747
HARYANA,FATEHABAD,2021-01-03,6,396,0,402
HARYANA,FATEHABAD,2021-01-04,4,946,0,950
HARYANA,FATEHABAD,2021-01-05,2,971,1,974
HARYANA,GURUGRAM,2021-01-01,88,3626,25,3739
HARYANA,GURUGRAM,2021-01-02,88,3004,10,3102
HARYANA,GURUGRAM,2021-01-03,80,2569,19,2668
HARYANA,GURUGRAM,2021-01-04,66,3257,27,3350
HARYANA,GURUGRAM,2021-01-05,132,4077,33,4242
HARYANA,HISAR,2021-01-01,9,1413,3,1425
HARYANA,HISAR,2021-01-02,25,1428,0,1453
HARYANA,HISAR,2021-01-03,19,1488,1,1508
HARYANA,HISAR,2021-01-04,21,3644,2,3667
HARYANA,HISAR,2021-01-05,8,2216,1,2225
HARYANA,JHAJJAR,2021-01-01,6,1650,4,1660
HARYANA,JHAJJAR,2021-01-02,3,2220,3,2226
HARYANA,JHAJJAR,2021-01-03,4,1220,10,1234
HARYANA,JHAJJAR,2021-01-04,2,2172,1,2175
HARYANA,JHAJJAR,2021-01-05,9,1499,2,1510
HARYANA,JIND,2021-01-01,5,1208,1,1214
HARYANA,JIND,2021-01-02,8,1027,0,1035
HARYANA,JIND,2021-01-03,3,757,1,761
HARYANA,JIND,2021-01-04,6,523,1,530
HARYANA,JIND,2021-01-05,17,954,1,972
HARYANA,KAITHAL,2021-01-01,19,572,5,596
HARYANA,KAITHAL,2021-01-02,4,517,6,527
HARYANA,KAITHAL,2021-01-03,5,298,0,303
HARYANA,KAITHAL,2021-01-04,6,112,0,118
HARYANA,KAITHAL,2021-01-05,10,448,4,462
HARYANA,KARNAL,2021-01-01,18,1320,1,1339
HARYANA,KARNAL,2021-01-02,21,1270,4,1295
HARYANA,KARNAL,2021-01-03,4,154,0,158
HARYANA,KARNAL,2021-01-04,28,1065,0,1093
HARYANA,KARNAL,2021-01-05,27,1508,1,1536
HARYANA,KURUKSHETRA,2021-01-01,12,1277,2,1291
HARYANA,KURUKSHETRA,2021-01-02,24,700,1,725
HARYANA,KURUKSHETRA,2021-01-03,5,326,0,331
HARYANA,KURUKSHETRA,2021-01-04,28,421,0,449
HARYANA,KURUKSHETRA,2021-01-05,86,760,21,867
HARYANA,MAHENDRAGARH,2021-01-01,4,413,1,418
HARYANA,MAHENDRAGARH,2021-01-02,1,345,1,347
HARYANA,MAHENDRAGARH,2021-01-03,5,429,4,438
HARYANA,MAHENDRAGARH,2021-01-04,3,150,1,154
HARYANA,MAHENDRAGARH,2021-01-05,1,146,1,148
HARYANA,NUH,2021-01-01,1,53,0,54
HARYANA,NUH,2021-01-02,2,199,0,201
HARYANA,NUH,2021-01-03,1,166,0,167
HARYANA,NUH,2021-01-04,1,341,1,343
HARYANA,NUH,2021-01-05,0,673,1,674
HARYANA,PALWAL,2021-01-01,3,301,9,313
HARYANA,PALWAL,2021-01-02,3,669,0,672
HARYANA,PALWAL,2021-01-03,3,136,1,140
HARYANA,PALWAL,2021-01-04,4,617,0,621
HARYANA,PALWAL,2021-01-05,0,72,1,73
HARYANA,PANCHKULA,2021-01-01,30,399,7,436
HARYANA,PANCHKULA,2021-01-02,41,308,0,349
HARYANA,PANCHKULA,2021-01-03,25,233,6,264
HARYANA,PANCHKULA,2021-01-04,45,625,3,673
HARYANA,PANCHKULA,2021-01-05,60,892,2,954
HARYANA,PANIPAT,2021-01-01,22,739,0,761
HARYANA,PANIPAT,2021-01-02,8,825,0,833
HARYANA,PANIPAT,2021-01-03,28,681,0,709
HARYANA,PANIPAT,2021-01-04,11,781,0,792
HARYANA,PANIPAT,2021-01-05,19,827,1,847
HARYANA,REWARI,2021-01-01,10,331,0,341
HARYANA,REWARI,2021-01-02,11,608,3,622
HARYANA,REWARI,2021-01-03,7,218,1,226
HARYANA,REWARI,2021-01-04,6,504,3,513
HARYANA,REWARI,2021-01-05,4,697,1,702
HARYANA,ROHTAK,2021-01-01,12,733,2,747
HARYANA,ROHTAK,2021-01-02,17,770,5,792
HARYANA,ROHTAK,2021-01-03,20,343,0,363
HARYANA,ROHTAK,2021-01-04,19,1209,1,1229
HARYANA,ROHTAK,2021-01-05,52,1902,4,1958
HARYANA,SIRSA,2021-01-01,1,1002,9,1012
HARYANA,SIRSA,2021-01-02,22,1037,3,1062
HARYANA,SIRSA,2021-01-03,2,233,0,235
HARYANA,SIRSA,2021-01-04,7,1573,7,1587
HARYANA,SIRSA,2021-01-05,4,1334,2,1340
HARYANA,SONIPAT,2021-01-01,10,849,0,859
HARYANA,SONIPAT,2021-01-02,19,944,1,964
HARYANA,SONIPAT,2021-01-03,14,584,5,603
HARYANA,SONIPAT,2021-01-04,8,1306,1,1315
HARYANA,SONIPAT,2021-01-05,17,1459,5,1481
HARYANA,YAMUNANAGAR,2021-01-01,19,440,0,459
HARYANA,YAMUNANAGAR,2021-01-02,14,617,0,631
HARYANA,YAMUNANAGAR,2021-01-03,1,564,0,565
HARYANA,YAMUNANAGAR,2021-01-04,14,736,1,751
HARYANA,YAMUNANAGAR,2021-01-05,23,892,0,915
HIMACHAL PRADESH,BILASPUR,2021-01-01,4,700,3,707
HIMACHAL PRADESH,BILASPUR,2021-01-02,13,697,1,711
HIMACHAL PRADESH,BILASPUR,2021-01-03,1,266,0,267
HIMACHAL PRADESH,BILASPUR,2021-01-04,8,566,0,574
HIMACHAL PRADESH,BILASPUR,2021-01-05,2,523,2,527
HIMACHAL PRADESH,CHAMBA,2021-01-01,9,717,13,739
HIMACHAL PRADESH,CHAMBA,2021-01-02,5,975,28,1008
HIMACHAL PRADESH,CHAMBA,2021-01-03,28,366,4,398
HIMACHAL PRADESH,CHAMBA,2021-01-04,5,963,9,977
HIMACHAL PRADESH,CHAMBA,2021-01-05,1,622,2,625
HIMACHAL PRADESH,HAMIRPUR,2021-01-01,8,564,2,574
HIMACHAL PRADESH,HAMIRPUR,2021-01-02,6,519,2,527
HIMACHAL PRADESH,HAMIRPUR,2021-01-03,0,465,3,468
HIMACHAL PRADESH,HAMIRPUR,2021-01-04,14,311,1,326
HIMACHAL PRADESH,HAMIRPUR,2021-01-05,13,764,4,781
HIMACHAL PRADESH,KANGRA,2021-01-01,30,2338,0,2368
HIMACHAL PRADESH,KANGRA,2021-01-02,24,2816,1,2841
HIMACHAL PRADESH,KANGRA,2021-01-03,17,687,1,705
HIMACHAL PRADESH,KANGRA,2021-01-04,29,2254,3,2286
HIMACHAL PRADESH,KANGRA,2021-01-05,18,3344,4,3366
HIMACHAL PRADESH,KINNAUR,2021-01-01,2,168,5,175
HIMACHAL PRADESH,KINNAUR,2021-01-02,0,79,0,79
HIMACHAL PRADESH,KINNAUR,2021-01-03,0,5,0,5
HIMACHAL PRADESH,KINNAUR,2021-01-04,4,217,0,221
HIMACHAL PRADESH,KINNAUR,2021-01-05,1,65,0,66
HIMACHAL PRADESH,KULLU,2021-01-01,6,410,5,421
HIMACHAL PRADESH,KULLU,2021-01-02,10,270,4,284
HIMACHAL PRADESH,KULLU,2021-01-03,1,85,1,87
HIMACHAL PRADESH,KULLU,2021-01-04,4,449,1,454
HIMACHAL PRADESH,KULLU,2021-01-05,7,270,3,280
HIMACHAL PRADESH,LAHUL AND SPITI,2021-01-01,5,18,2,25
HIMACHAL PRADESH,LAHUL AND SPITI,2021-01-03,0,1,0,1
HIMACHAL PRADESH,LAHUL AND SPITI,2021-01-04,1,0,0,1
HIMACHAL PRADESH,LAHUL AND SPITI,2021-01-05,0,1,0,1
HIMACHAL PRADESH,MANDI,2021-01-01,34,637,13,684
HIMACHAL PRADESH,MANDI,2021-01-02,36,714,27,777
HIMACHAL PRADESH,MANDI,2021-01-03,10,394,13,417
HIMACHAL PRADESH,MANDI,2021-01-04,17,864,35,916
HIMACHAL PRADESH,MANDI,2021-01-05,17,595,52,664
HIMACHAL PRADESH,SHIMLA,2021-01-01,21,946,22,989
HIMACHAL PRADESH,SHIMLA,2021-01-02,33,692,2,727
HIMACHAL PRADESH,SHIMLA,2021-01-03,13,559,3,575
HIMACHAL PRADESH,SHIMLA,2021-01-04,15,698,6,719
HIMACHAL PRADESH,SHIMLA,2021-01-05,15,762,7,784
HIMACHAL PRADESH,SIRMAUR,2021-01-01,12,483,18,513
HIMACHAL PRADESH,SIRMAUR,2021-01-02,11,241,18,270
HIMACHAL PRADESH,SIRMAUR,2021-01-03,4,586,6,596
HIMACHAL PRADESH,SIRMAUR,2021-01-04,15,244,1,260
HIMACHAL PRADESH,SIRMAUR,2021-01-05,6,674,3,683
HIMACHAL PRADESH,SOLAN,2021-01-01,27,494,0,521
HIMACHAL PRADESH,SOLAN,2021-01-02,21,413,0,434
HIMACHAL PRADESH,SOLAN,2021-01-03,19,323,0,342
HIMACHAL PRADESH,SOLAN,2021-01-04,18,362,2,382
HIMACHAL PRADESH,SOLAN,2021-01-05,22,481,2,505
HIMACHAL PRADESH,UNA,2021-01-01,4,210,0,214
HIMACHAL PRADESH,UNA,2021-01-02,10,325,1,336
HIMACHAL PRADESH,UNA,2021-01-03,5,417,0,422
HIMACHAL PRADESH,UNA,2021-01-04,18,667,0,685
HIMACHAL PRADESH,UNA,2021-01-05,3,633,0,636
INDIA,INDIA,2021-01-01,15,3,0,18
INDIA,INDIA,2021-01-02,17,2,0,19
INDIA,INDIA,2021-01-03,16,2,0,18
INDIA,INDIA,2021-01-04,10,2,0,12
INDIA,INDIA,2021-01-05,11,2,0,13
JAMMU AND KASHMIR,ANANTNAG,2021-01-01,16,637,0,653
JAMMU AND KASHMIR,ANANTNAG,2021-01-02,11,909,0,920
JAMMU AND KASHMIR,ANANTNAG,2021-01-03,3,324,0,327
JAMMU AND KASHMIR,ANANTNAG,2021-01-04,2,455,0,457
JAMMU AND KASHMIR,ANANTNAG,2021-01-05,3,382,0,385
JAMMU AND KASHMIR,BANDIPORA,2021-01-01,14,295,0,309
JAMMU AND KASHMIR,BANDIPORA,2021-01-02,15,352,0,367
JAMMU AND KASHMIR,BANDIPORA,2021-01-03,0,116,0,116
JAMMU AND KASHMIR,BANDIPORA,2021-01-04,19,291,9,319
JAMMU AND KASHMIR,BANDIPORA,2021-01-05,0,270,0,270
JAMMU AND KASHMIR,BARAMULLA,2021-01-01,26,664,0,690
JAMMU AND KASHMIR,BARAMULLA,2021-01-02,15,944,0,959
JAMMU AND KASHMIR,BARAMULLA,2021-01-03,27,699,0,726
JAMMU AND KASHMIR,BARAMULLA,2021-01-04,20,553,0,573
JAMMU AND KASHMIR,BARAMULLA,2021-01-05,8,430,0,438
JAMMU AND KASHMIR,BUDGAM,2021-01-01,14,545,0,559
JAMMU AND KASHMIR,BUDGAM,2021-01-02,17,743,0,760
JAMMU AND KASHMIR,BUDGAM,2021-01-03,2,608,0,610
JAMMU AND KASHMIR,BUDGAM,2021-01-04,5,616,0,621
JAMMU AND KASHMIR,BUDGAM,2021-01-05,0,127,0,127
JAMMU AND KASHMIR,DODA,2021-01-01,3,77,0,80
JAMMU AND KASHMIR,DODA,2021-01-02,9,91,0,100
JAMMU AND KASHMIR,DODA,2021-01-03,1,26,0,27
JAMMU AND KASHMIR,DODA,2021-01-04,7,76,0,83
JAMMU AND KASHMIR,DODA,2021-01-05,24,94,0,118
JAMMU AND KASHMIR,GANDERBAL,2021-01-01,11,415,0,426
JAMMU AND KASHMIR,GANDERBAL,2021-01-02,18,294,1,313
JAMMU AND KASHMIR,GANDERBAL,2021-01-03,1,95,0,96
JAMMU AND KASHMIR,GANDERBAL,2021-01-04,1,237,1,239
JAMMU AND KASHMIR,GANDERBAL,2021-01-05,3,276,0,279
JAMMU AND KASHMIR,JAMMU,2021-01-01,76,1299,1,1376
JAMMU AND KASHMIR,JAMMU,2021-01-02,95,1348,1,1444
JAMMU AND KASHMIR,JAMMU,2021-01-03,109,1987,0,2096
JAMMU AND KASHMIR,JAMMU,2021-01-04,124,1547,4,1675
JAMMU AND KASHMIR,JAMMU,2021-01-05,105,1022,0,1127
JAMMU AND KASHMIR,KATHUA,2021-01-01,7,147,0,154
JAMMU AND KASHMIR,KATHUA,2021-01-02,1,168,0,169
JAMMU AND KASHMIR,KATHUA,2021-01-03,0,66,0,66
JAMMU AND KASHMIR,KATHUA,2021-01-04,8,291,0,299
JAMMU AND KASHMIR,KATHUA,2021-01-05,11,205,0,216
JAMMU AND KASHMIR,KISHTWAR,2021-01-01,24,226,0,250
JAMMU AND KASHMIR,KISHTWAR,2021-01-02,3,259,0,262
JAMMU AND KASHMIR,KISHTWAR,2021-01-03,6,230,0,236
JAMMU AND KASHMIR,KISHTWAR,2021-01-04,10,341,0,351
JAMMU AND KASHMIR,KISHTWAR,2021-01-05,7,220,0,227
JAMMU AND KASHMIR,KULGAM,2021-01-01,2,1146,0,1148
JAMMU AND KASHMIR,KULGAM,2021-01-02,1,814,0,815
JAMMU AND KASHMIR,KULGAM,2021-01-03,0,548,0,548
JAMMU AND KASHMIR,KULGAM,2021-01-04,0,631,0,631
JAMMU AND KASHMIR,KULGAM,2021-01-05,0,580,0,580
JAMMU AND KASHMIR,KUPWARA,2021-01-01,3,179,0,182
JAMMU AND KASHMIR,KUPWARA,2021-01-02,6,287,0,293
JAMMU AND KASHMIR,KUPWARA,2021-01-03,0,150,0,150
JAMMU AND KASHMIR,KUPWARA,2021-01-04,1,254,1,256
JAMMU AND KASHMIR,KUPWARA,2021-01-05,0,333,0,333
JAMMU AND KASHMIR,POONCH,2021-01-01,4,421,0,425
JAMMU AND KASHMIR,POONCH,2021-01-02,5,535,0,540
JAMMU AND KASHMIR,POONCH,2021-01-03,0,192,0,192
JAMMU AND KASHMIR,POONCH,2021-01-04,10,550,0,560
JAMMU AND KASHMIR,POONCH,2021-01-05,0,296,0,296
JAMMU AND KASHMIR,PULWAMA,2021-01-01,13,496,1,510
JAMMU AND KASHMIR,PULWAMA,2021-01-02,17,895,2,914
JAMMU AND KASHMIR,PULWAMA,2021-01-03,0,174,0,174
JAMMU AND KASHMIR,PULWAMA,2021-01-04,4,391,2,397
JAMMU AND KASHMIR,PULWAMA,2021-01-05,28,298,2,328
JAMMU AND KASHMIR,RAJOURI,2021-01-01,1,190,0,191
JAMMU AND KASHMIR,RAJOURI,2021-01-02,1,211,0,212
JAMMU AND KASHMIR,RAJOURI,2021-01-03,2,172,1,175
JAMMU AND KASHMIR,RAJOURI,2021-01-04,9,238,0,247
JAMMU AND KASHMIR,RAJOURI,2021-01-05,1,157,0,158
JAMMU AND KASHMIR,RAMBAN,2021-01-01,2,374,1,377
JAMMU AND KASHMIR,RAMBAN,2021-01-02,2,256,0,258
JAMMU AND KASHMIR,RAMBAN,2021-01-03,2,162,0,164
JAMMU AND KASHMIR,RAMBAN,2021-01-04,2,146,2,150
JAMMU AND KASHMIR,RAMBAN,2021-01-05,3,212,0,215
JAMMU AND KASHMIR,REASI,2021-01-01,12,240,0,252
JAMMU AND KASHMIR,REASI,2021-01-02,6,173,0,179
JAMMU AND KASHMIR,REASI,2021-01-03,8,133,0,141
JAMMU AND KASHMIR,REASI,2021-01-04,12,243,0,255
JAMMU AND KASHMIR,REASI,2021-01-05,6,266,0,272
JAMMU AND KASHMIR,SAMBA,2021-01-01,12,240,1,253
JAMMU AND KASHMIR,SAMBA,2021-01-02,4,236,0,240
JAMMU AND KASHMIR,SAMBA,2021-01-03,1,536,0,537
JAMMU AND KASHMIR,SAMBA,2021-01-04,1,402,0,403
JAMMU AND KASHMIR,SAMBA,2021-01-05,3,140,0,143
JAMMU AND KASHMIR,SHOPIAN,2021-01-01,1,29,0,30
JAMMU AND KASHMIR,SHOPIAN,2021-01-02,3,26,0,29
JAMMU AND KASHMIR,SHOPIAN,2021-01-03,0,2,0,2
JAMMU AND KASHMIR,SHOPIAN,2021-01-04,0,37,0,37
JAMMU AND KASHMIR,SHOPIAN,2021-01-05,1,16,1,18
JAMMU AND KASHMIR,SRINAGAR,2021-01-01,102,2271,3,2376
JAMMU AND KASHMIR,SRINAGAR,2021-01-02,111,2294,11,2416
JAMMU AND KASHMIR,SRINAGAR,2021-01-03,1,75,0,76
JAMMU AND KASHMIR,SRINAGAR,2021-01-04,71,1155,16,1242
JAMMU AND KASHMIR,SRINAGAR,2021-01-05,38,361,0,399
JAMMU AND KASHMIR,UDHAMPUR,2021-01-01,9,680,0,689
JAMMU AND KASHMIR,UDHAMPUR,2021-01-02,13,730,0,743
JAMMU AND KASHMIR,UDHAMPUR,2021-01-03,1,241,0,242
JAMMU AND KASHMIR,UDHAMPUR,2021-01-04,11,999,0,1010
JAMMU AND KASHMIR,UDHAMPUR,2021-01-05,23,474,0,497
JHARKHAND,BOKARO,2021-01-01,22,459,0,481
JHARKHAND,BOKARO,2021-01-02,12,440,0,452
JHARKHAND,BOKARO,2021-01-03,7,58,1,66
JHARKHAND,BOKARO,2021-01-04,18,454,16,488
JHARKHAND,BOKARO,2021-01-05,13,360,0,373
JHARKHAND,CHATRA,2021-01-01,1,348,1,350
JHARKHAND,CHATRA,2021-01-02,2,551,2,555
JHARKHAND,CHATRA,2021-01-03,0,88,0,88
JHARKHAND,CHATRA,2021-01-04,1,458,0,459
JHARKHAND,CHATRA,2021-01-05,2,565,0,567
JHARKHAND,DEOGHAR,2021-01-01,3,172,0,175
JHARKHAND,DEOGHAR,2021-01-02,7,913,3,923
JHARKHAND,DEOGHAR,2021-01-03,3,638,0,641
JHARKHAND,DEOGHAR,2021-01-04,5,869,4,878
JHARKHAND,DEOGHAR,2021-01-05,7,944,1,952
JHARKHAND,DHANBAD,2021-01-01,3,137,0,140
JHARKHAND,DHANBAD,2021-01-02,0,290,1,291
JHARKHAND,DHANBAD,2021-01-03,6,47,0,53
JHARKHAND,DHANBAD,2021-01-04,0,161,0,161
JHARKHAND,DHANBAD,2021-01-05,18,552,0,570
JHARKHAND,DUMKA,2021-01-01,6,283,0,289
JHARKHAND,DUMKA,2021-01-02,0,374,0,374
JHARKHAND,DUMKA,2021-01-03,1,703,0,704
JHARKHAND,DUMKA,2021-01-04,1,1196,0,1197
JHARKHAND,DUMKA,2021-01-05,3,737,0,740
JHARKHAND,EAST SINGHBUM,2021-01-01,39,1451,34,1524
JHARKHAND,EAST SINGHBUM,2021-01-02,25,2703,9,2737
JHARKHAND,EAST SINGHBUM,2021-01-03,27,1998,5,2030
JHARKHAND,EAST SINGHBUM,2021-01-04,12,3142,3,3157
JHARKHAND,EAST SINGHBUM,2021-01-05,20,2248,1,2269
JHARKHAND,GARHWA,2021-01-01,5,252,21,278
JHARKHAND,GARHWA,2021-01-02,0,601,0,601
JHARKHAND,GARHWA,2021-01-03,11,31,0,42
JHARKHAND,GARHWA,2021-01-04,0,740,23,763
JHARKHAND,GARHWA,2021-01-05,3,653,24,680
JHARKHAND,GIRIDIH,2021-01-01,0,182,0,182
JHARKHAND,GIRIDIH,2021-01-02,2,434,0,436
JHARKHAND,GIRIDIH,2021-01-03,1,97,0,98
JHARKHAND,GIRIDIH,2021-01-04,1,1210,0,1211
JHARKHAND,GIRIDIH,2021-01-05,6,843,0,849
JHARKHAND,GODDA,2021-01-01,1,321,0,322
JHARKHAND,GODDA,2021-01-02,1,643,0,644
JHARKHAND,GODDA,2021-01-03,0,500,0,500
JHARKHAND,GODDA,2021-01-04,0,568,0,568
JHARKHAND,GODDA,2021-01-05,2,403,0,405
JHARKHAND,GUMLA,2021-01-01,0,45,0,45
JHARKHAND,GUMLA,2021-01-02,5,635,0,640
JHARKHAND,GUMLA,2021-01-03,1,181,0,182
JHARKHAND,GUMLA,2021-01-04,8,629,0,637
JHARKHAND,GUMLA,2021-01-05,9,497,0,506
JHARKHAND,HAZARIBAGH,2021-01-01,1,331,0,332
JHARKHAND,HAZARIBAGH,2021-01-02,11,518,0,529
JHARKHAND,HAZARIBAGH,2021-01-03,4,200,0,204
JHARKHAND,HAZARIBAGH,2021-01-04,12,523,0,535
JHARKHAND,HAZARIBAGH,2021-01-05,4,310,1,315
JHARKHAND,JAMTARA,2021-01-01,0,102,0,102
JHARKHAND,JAMTARA,2021-01-02,0,78,0,78
JHARKHAND,JAMTARA,2021-01-03,3,166,0,169
JHARKHAND,JAMTARA,2021-01-04,4,312,1,317
JHARKHAND,JAMTARA,2021-01-05,1,124,1,126
JHARKHAND,KHUNTI,2021-01-01,2,2,0,4
JHARKHAND,KHUNTI,2021-01-02,2,805,0,807
JHARKHAND,KHUNTI,2021-01-03,0,66,0,66
JHARKHAND,KHUNTI,2021-01-04,1,464,1,466
JHARKHAND,KHUNTI,2021-01-05,1,123,0,124
JHARKHAND,KODERMA,2021-01-01,0,4,6,10
JHARKHAND,KODERMA,2021-01-02,0,368,0,368
JHARKHAND,KODERMA,2021-01-03,2,253,0,255
JHARKHAND,KODERMA,2021-01-04,3,622,2,627
JHARKHAND,KODERMA,2021-01-05,3,476,0,479
JHARKHAND,LATEHAR,2021-01-01,0,22,0,22
JHARKHAND,LATEHAR,2021-01-02,2,154,0,156
JHARKHAND,LATEHAR,2021-01-03,1,141,0,142
JHARKHAND,LATEHAR,2021-01-04,3,906,0,909
JHARKHAND,LATEHAR,2021-01-05,3,796,0,799
JHARKHAND,LOHARDAGA,2021-01-01,1,68,0,69
JHARKHAND,LOHARDAGA,2021-01-02,3,339,0,342
JHARKHAND,LOHARDAGA,2021-01-03,0,76,0,76
JHARKHAND,LOHARDAGA,2021-01-04,1,118,0,119
JHARKHAND,LOHARDAGA,2021-01-05,4,153,1,158
JHARKHAND,PAKUR,2021-01-01,2,740,0,742
JHARKHAND,PAKUR,2021-01-02,0,1251,2,1253
JHARKHAND,PAKUR,2021-01-03,0,618,0,618
JHARKHAND,PAKUR,2021-01-04,0,368,0,368
JHARKHAND,PAKUR,2021-01-05,0,774,0,774
JHARKHAND,PALAMU,2021-01-01,0,89,43,132
JHARKHAND,PALAMU,2021-01-02,12,609,16,637
JHARKHAND,PALAMU,2021-01-03,38,451,4,493
JHARKHAND,PALAMU,2021-01-04,10,713,1,724
JHARKHAND,PALAMU,2021-01-05,15,780,7,802
JHARKHAND,RAMGARH,2021-01-01,6,373,0,379
JHARKHAND,RAMGARH,2021-01-02,8,449,0,457
JHARKHAND,RAMGARH,2021-01-03,8,210,0,218
JHARKHAND,RAMGARH,2021-01-04,13,498,0,511
JHARKHAND,RAMGARH,2021-01-05,5,439,0,444
JHARKHAND,RANCHI,2021-01-01,84,605,0,689
JHARKHAND,RANCHI,2021-01-02,102,1167,3,1272
JHARKHAND,RANCHI,2021-01-03,89,902,1,992
JHARKHAND,RANCHI,2021-01-04,79,673,2,754
JHARKHAND,RANCHI,2021-01-05,81,987,1,1069
JHARKHAND,SAHEBGANJ,2021-01-01,3,241,0,244
JHARKHAND,SAHEBGANJ,2021-01-02,2,725,0,727
JHARKHAND,SAHEBGANJ,2021-01-03,0,51,0,51
JHARKHAND,SAHEBGANJ,2021-01-04,2,585,0,587
JHARKHAND,SAHEBGANJ,2021-01-05,0,477,0,477
JHARKHAND,SARAIKELA KHARSAWAN,2021-01-01,0,530,0,530
JHARKHAND,SARAIKELA KHARSAWAN,2021-01-02,8,2319,0,2327
JHARKHAND,SARAIKELA KHARSAWAN,2021-01-03,1,120,0,121
JHARKHAND,SARAIKELA KHARSAWAN,2021-01-04,3,1413,1,1417
JHARKHAND,SARAIKELA KHARSAWAN,2021-01-05,0,1354,0,1354
JHARKHAND,SIMDEGA,2021-01-01,1,158,0,159
JHARKHAND,SIMDEGA,2021-01-02,6,259,0,265
JHARKHAND,SIMDEGA,2021-01-03,1,152,0,153
JHARKHAND,SIMDEGA,2021-01-04,2,284,0,286
JHARKHAND,SIMDEGA,2021-01-05,0,315,0,315
JHARKHAND,WEST SINGHBHUM,2021-01-01,0,366,0,366
JHARKHAND,WEST SINGHBHUM,2021-01-02,5,1583,1,1589
JHARKHAND,WEST SINGHBHUM,2021-01-03,3,462,0,465
JHARKHAND,WEST SINGHBHUM,2021-01-04,0,651,9,660
JHARKHAND,WEST SINGHBHUM,2021-01-05,0,865,0,865
KARNATAKA,BAGALKOTE,2021-01-01,1,2667,8,2676
KARNATAKA,BAGALKOTE,2021-01-02,3,2551,1,2555
KARNATAKA,BAGALKOTE,2021-01-03,0,3268,0,3268
KARNATAKA,BAGALKOTE,2021-01-04,2,3431,4,3437
KARNATAKA,BAGALKOTE,2021-01-05,2,3306,1,3309
KARNATAKA,BALLARI,2021-01-01,25,3986,8,4019
KARNATAKA,BALLARI,2021-01-02,9,3252,4,3265
KARNATAKA,BALLARI,2021-01-03,17,2924,11,2952
KARNATAKA,BALLARI,2021-01-04,14,4289,32,4335
KARNATAKA,BALLARI,2021-01-05,11,4362,7,4380
KARNATAKA,BELAGAVI,2021-01-01,18,3430,143,3591
KARNATAKA,BELAGAVI,2021-01-02,22,4603,10,4635
KARNATAKA,BELAGAVI,2021-01-03,14,2258,2,2274
KARNATAKA,BELAGAVI,2021-01-04,9,3651,9,3669
KARNATAKA,BELAGAVI,2021-01-05,15,4172,2,4189
KARNATAKA,BENGALURU RURAL,2021-01-01,17,2348,0,2365
KARNATAKA,BENGALURU RURAL,2021-01-02,21,2144,0,2165
KARNATAKA,BENGALURU RURAL,2021-01-03,8,1316,0,1324
KARNATAKA,BENGALURU RURAL,2021-01-04,8,1909,0,1917
KARNATAKA,BENGALURU RURAL,2021-01-05,31,2817,0,2848
KARNATAKA,BENGALURU URBAN,2021-01-01,367,43989,120,44476
KARNATAKA,BENGALURU URBAN,2021-01-02,504,46288,41,46833
KARNATAKA,BENGALURU URBAN,2021-01-03,334,29262,65,29661
KARNATAKA,BENGALURU URBAN,2021-01-04,448,43884,47,44379
KARNATAKA,BENGALURU URBAN,2021-01-05,511,44819,32,45362
KARNATAKA,BIDAR,2021-01-01,7,1867,1,1875
KARNATAKA,BIDAR,2021-01-02,2,1665,0,1667
KARNATAKA,BIDAR,2021-01-03,9,1317,0,1326
KARNATAKA,BIDAR,2021-01-04,3,1389,0,1392
KARNATAKA,BIDAR,2021-01-05,5,2692,0,2697
KARNATAKA,CHAMARAJANAGARA,2021-01-01,13,1857,8,1878
KARNATAKA,CHAMARAJANAGARA,2021-01-02,12,1958,1,1971
KARNATAKA,CHAMARAJANAGARA,2021-01-03,4,1348,0,1352
KARNATAKA,CHAMARAJANAGARA,2021-01-04,6,782,1,789
KARNATAKA,CHAMARAJANAGARA,2021-01-05,6,1642,2,1650
KARNATAKA,CHIKKABALLAPURA,2021-01-01,27,3461,12,3500
KARNATAKA,CHIKKABALLAPURA,2021-01-02,20,3579,6,3605
KARNATAKA,CHIKKABALLAPURA,2021-01-03,24,1758,2,1784
KARNATAKA,CHIKKABALLAPURA,2021-01-04,12,3289,2,3303
KARNATAKA,CHIKKABALLAPURA,2021-01-05,36,3467,2,3505
KARNATAKA,CHIKKAMAGALURU,2021-01-01,15,2879,1,2895
KARNATAKA,CHIKKAMAGALURU,2021-01-02,9,3256,12,3277
KARNATAKA,CHIKKAMAGALURU,2021-01-03,8,986,0,994
KARNATAKA,CHIKKAMAGALURU,2021-01-04,29,4015,9,4053
KARNATAKA,CHIKKAMAGALURU,2021-01-05,13,3391,7,3411
KARNATAKA,CHITRADURGA,2021-01-01,5,1149,0,1154
KARNATAKA,CHITRADURGA,2021-01-02,7,1648,2,1657
KARNATAKA,CHITRADURGA,2021-01-03,37,1357,2,1396
KARNATAKA,CHITRADURGA,2021-01-04,5,2160,0,2165
KARNATAKA,CHITRADURGA,2021-01-05,10,2561,4,2575
KARNATAKA,DAKSHINA KANNADA,2021-01-01,45,3453,3,3501
KARNATAKA,DAKSHINA KANNADA,2021-01-02,36,4739,4,4779
KARNATAKA,DAKSHINA KANNADA,2021-01-03,19,2538,2,2559
KARNATAKA,DAKSHINA KANNADA,2021-01-04,45,3952,4,4001
KARNATAKA,DAKSHINA KANNADA,2021-01-05,41,3999,4,4044
KARNATAKA,DAVANGERE,2021-01-01,3,1066,34,1103
KARNATAKA,DAVANGERE,2021-01-02,16,1925,162,2103
KARNATAKA,DAVANGERE,2021-01-03,6,1408,137,1551
KARNATAKA,DAVANGERE,2021-01-04,4,1745,132,1881
KARNATAKA,DAVANGERE,2021-01-05,12,1979,159,2150
KARNATAKA,DHARWAD,2021-01-01,10,3116,7,3133
KARNATAKA,DHARWAD,2021-01-02,8,2595,1,2604
KARNATAKA,DHARWAD,2021-01-03,16,2525,1,2542
KARNATAKA,DHARWAD,2021-01-04,15,2548,0,2563
KARNATAKA,DHARWAD,2021-01-05,17,4507,2,4526
KARNATAKA,GADAG,2021-01-01,2,563,4,569
KARNATAKA,GADAG,2021-01-02,6,473,0,479
KARNATAKA,GADAG,2021-01-03,1,3010,75,3086
KARNATAKA,GADAG,2021-01-04,4,1337,14,1355
KARNATAKA,GADAG,2021-01-05,3,4333,165,4501
KARNATAKA,HASSAN,2021-01-01,8,2912,0,2920
KARNATAKA,HASSAN,2021-01-02,18,3740,8,3766
KARNATAKA,HASSAN,2021-01-03,28,3163,11,3202
KARNATAKA,HASSAN,2021-01-04,36,3024,1,3061
KARNATAKA,HASSAN,2021-01-05,27,1822,5,1854
KARNATAKA,HAVERI,2021-01-01,4,1201,0,1205
KARNATAKA,HAVERI,2021-01-02,7,2332,0,2339
KARNATAKA,HAVERI,2021-01-03,0,2002,1,2003
KARNATAKA,HAVERI,2021-01-04,2,2017,0,2019
KARNATAKA,HAVERI,2021-01-05,0,2111,0,2111
KARNATAKA,KALABURAGI,2021-01-01,21,2574,62,2657
KARNATAKA,KALABURAGI,2021-01-02,15,2993,7,3015
KARNATAKA,KALABURAGI,2021-01-03,23,3077,2,3102
KARNATAKA,KALABURAGI,2021-01-04,22,3094,5,3121
KARNATAKA,KALABURAGI,2021-01-05,20,3171,15,3206
KARNATAKA,KODAGU,2021-01-01,18,1311,22,1351
KARNATAKA,KODAGU,2021-01-02,3,1452,21,1476
KARNATAKA,KODAGU,2021-01-03,9,1544,76,1629
KARNATAKA,KODAGU,2021-01-04,6,594,22,622
KARNATAKA,KODAGU,2021-01-05,11,1580,22,1613
KARNATAKA,KOLAR,2021-01-01,6,2718,0,2724
KARNATAKA,KOLAR,2021-01-02,10,2867,5,2882
KARNATAKA,KOLAR,2021-01-03,15,2667,0,2682
KARNATAKA,KOLAR,2021-01-04,24,3109,3,3136
KARNATAKA,KOLAR,2021-01-05,13,3288,4,3305
KARNATAKA,KOPPAL,2021-01-01,5,1660,12,1677
KARNATAKA,KOPPAL,2021-01-02,1,2012,7,2020
KARNATAKA,KOPPAL,2021-01-03,4,2047,14,2065
KARNATAKA,KOPPAL,2021-01-04,4,2010,10,2024
KARNATAKA,KOPPAL,2021-01-05,2,2318,0,2320
KARNATAKA,MANDYA,2021-01-01,15,3140,7,3162
KARNATAKA,MANDYA,2021-01-02,12,3408,4,3424
KARNATAKA,MANDYA,2021-01-03,14,1852,1,1867
KARNATAKA,MANDYA,2021-01-04,10,2834,2,2846
KARNATAKA,MANDYA,2021-01-05,15,3308,1,3324
KARNATAKA,MYSURU,2021-01-01,53,7629,1,7683
KARNATAKA,MYSURU,2021-01-02,34,2791,3,2828
KARNATAKA,MYSURU,2021-01-03,27,6901,11,6939
KARNATAKA,MYSURU,2021-01-04,48,6461,2,6511
KARNATAKA,MYSURU,2021-01-05,36,6942,34,7012
KARNATAKA,RAICHUR,2021-01-01,7,630,38,675
KARNATAKA,RAICHUR,2021-01-02,0,1409,14,1423
KARNATAKA,RAICHUR,2021-01-03,9,2397,63,2469
KARNATAKA,RAICHUR,2021-01-04,5,2607,17,2629
KARNATAKA,RAICHUR,2021-01-05,5,1976,15,1996
KARNATAKA,RAMANAGARA,2021-01-01,1,1237,1,1239
KARNATAKA,RAMANAGARA,2021-01-02,3,1884,0,1887
KARNATAKA,RAMANAGARA,2021-01-03,1,1610,0,1611
KARNATAKA,RAMANAGARA,2021-01-04,1,1154,0,1155
KARNATAKA,RAMANAGARA,2021-01-05,1,1318,0,1319
KARNATAKA,SHIVAMOGGA,2021-01-01,11,2035,2,2048
KARNATAKA,SHIVAMOGGA,2021-01-02,14,3787,11,3812
KARNATAKA,SHIVAMOGGA,2021-01-03,7,1583,0,1590
KARNATAKA,SHIVAMOGGA,2021-01-04,0,3174,0,3174
KARNATAKA,SHIVAMOGGA,2021-01-05,3,2784,1,2788
KARNATAKA,TUMAKURU,2021-01-01,21,2531,1,2553
KARNATAKA,TUMAKURU,2021-01-02,15,3015,24,3054
KARNATAKA,TUMAKURU,2021-01-03,11,3630,1,3642
KARNATAKA,TUMAKURU,2021-01-04,24,3763,1,3788
KARNATAKA,TUMAKURU,2021-01-05,13,4196,11,4220
KARNATAKA,UDUPI,2021-01-01,11,1709,5,1725
KARNATAKA,UDUPI,2021-01-02,20,2894,3,2917
KARNATAKA,UDUPI,2021-01-03,6,2101,3,2110
KARNATAKA,UDUPI,2021-01-04,25,3250,6,3281
KARNATAKA,UDUPI,2021-01-05,13,4573,4,4590
KARNATAKA,UTTARA KANNADA,2021-01-01,21,2114,61,2196
KARNATAKA,UTTARA KANNADA,2021-01-02,9,2113,66,2188
KARNATAKA,UTTARA KANNADA,2021-01-03,23,3041,142,3206
KARNATAKA,UTTARA KANNADA,2021-01-04,7,3343,107,3457
KARNATAKA,UTTARA KANNADA,2021-01-05,9,3607,74,3690
KARNATAKA,VIJAYAPURA,2021-01-01,6,2561,5,2572
KARNATAKA,VIJAYAPURA,2021-01-02,10,2633,0,2643
KARNATAKA,VIJAYAPURA,2021-01-03,7,3392,0,3399
KARNATAKA,VIJAYAPURA,2021-01-04,5,2209,1,2215
KARNATAKA,VIJAYAPURA,2021-01-05,13,1282,0,1295
KARNATAKA,YADGIR,2021-01-01,3,1230,0,1233
KARNATAKA,YADGIR,2021-01-02,2,1158,0,1160
KARNATAKA,YADGIR,2021-01-03,8,1830,0,1838
KARNATAKA,YADGIR,2021-01-04,5,1728,0,1733
KARNATAKA,YADGIR,2021-01-05,9,1840,0,1849
KERALA,ALAPPUZHA,2021-01-01,559,3635,27,4221
KERALA,ALAPPUZHA,2021-01-02,60,5648,0,5708
KERALA,ALAPPUZHA,2021-01-03,248,5986,5,6239
KERALA,ALAPPUZHA,2021-01-04,165,2640,9,2814
KERALA,ALAPPUZHA,2021-01-05,200,3397,6,3603
KERALA,ERNAKULAM,2021-01-01,1087,4689,28,5804
KERALA,ERNAKULAM,2021-01-02,61,11332,1,11394
KERALA,ERNAKULAM,2021-01-03,507,11011,35,11553
KERALA,ERNAKULAM,2021-01-04,301,4560,11,4872
KERALA,ERNAKULAM,2021-01-05,440,6240,16,6696
KERALA,IDUKKI,2021-01-01,268,1868,10,2146
KERALA,IDUKKI,2021-01-02,33,2899,1,2933
KERALA,IDUKKI,2021-01-03,219,3051,5,3275
KERALA,IDUKKI,2021-01-04,39,1132,1,1172
KERALA,IDUKKI,2021-01-05,146,2021,8,2175
KERALA,KANNUR,2021-01-01,394,2107,4,2505
KERALA,KANNUR,2021-01-02,12,5518,1,5531
KERALA,KANNUR,2021-01-03,143,5536,2,5681
KERALA,KANNUR,2021-01-04,65,1917,1,1983
KERALA,KANNUR,2021-01-05,103,2748,2,2853
KERALA,KASARAGOD,2021-01-01,175,1515,17,1707
KERALA,KASARAGOD,2021-01-02,16,2502,1,2519
KERALA,KASARAGOD,2021-01-03,42,2420,0,2462
KERALA,KASARAGOD,2021-01-04,18,899,0,917
KERALA,KASARAGOD,2021-01-05,53,1561,0,1614
KERALA,KOLLAM,2021-01-01,496,5648,4,6148
KERALA,KOLLAM,2021-01-02,21,8615,4,8640
KERALA,KOLLAM,2021-01-03,174,8328,0,8502
KERALA,KOLLAM,2021-01-04,109,2781,0,2890
KERALA,KOLLAM,2021-01-05,170,4576,0,4746
KERALA,KOTTAYAM,2021-01-01,742,4572,22,5336
KERALA,KOTTAYAM,2021-01-02,63,7839,2,7904
KERALA,KOTTAYAM,2021-01-03,173,6884,3,7060
KERALA,KOTTAYAM,2021-01-04,169,3159,3,3331
KERALA,KOTTAYAM,2021-01-05,284,3829,11,4124
KERALA,KOZHIKODE,2021-01-01,1027,4832,24,5883
KERALA,KOZHIKODE,2021-01-02,48,8725,2,8775
KERALA,KOZHIKODE,2021-01-03,614,9145,7,9766
KERALA,KOZHIKODE,2021-01-04,227,3088,1,3316
KERALA,KOZHIKODE,2021-01-05,395,5075,5,5475
KERALA,MALAPPURAM,2021-01-01,992,4067,4,5063
KERALA,MALAPPURAM,2021-01-02,209,6456,0,6665
KERALA,MALAPPURAM,2021-01-03,424,6354,5,6783
KERALA,MALAPPURAM,2021-01-04,253,3176,0,3429
KERALA,MALAPPURAM,2021-01-05,292,4102,3,4397
KERALA,PALAKKAD,2021-01-01,329,3194,0,3523
KERALA,PALAKKAD,2021-01-02,13,5739,0,5752
KERALA,PALAKKAD,2021-01-03,157,5734,1,5892
KERALA,PALAKKAD,2021-01-04,65,2124,0,2189
KERALA,PALAKKAD,2021-01-05,91,2900,0,2991
KERALA,PATHANAMTHITTA,2021-01-01,937,4673,7,5617
KERALA,PATHANAMTHITTA,2021-01-02,17,6003,0,6020
KERALA,PATHANAMTHITTA,2021-01-03,308,6244,1,6553
KERALA,PATHANAMTHITTA,2021-01-04,420,2783,2,3205
KERALA,PATHANAMTHITTA,2021-01-05,474,2902,0,3376
KERALA,THIRUVANANTHAPURAM,2021-01-01,523,5567,1,6091
KERALA,THIRUVANANTHAPURAM,2021-01-02,36,8216,0,8252
KERALA,THIRUVANANTHAPURAM,2021-01-03,203,9382,0,9585
KERALA,THIRUVANANTHAPURAM,2021-01-04,94,3464,1,3559
KERALA,THIRUVANANTHAPURAM,2021-01-05,165,4360,0,4525
KERALA,THRISSUR,2021-01-01,580,1584,2,2166
KERALA,THRISSUR,2021-01-02,38,10967,0,11005
KERALA,THRISSUR,2021-01-03,186,9198,1,9385
KERALA,THRISSUR,2021-01-04,103,3055,0,3158
KERALA,THRISSUR,2021-01-05,222,4630,0,4852
KERALA,WAYANAD,2021-01-01,171,1233,13,1417
KERALA,WAYANAD,2021-01-02,5,3029,2,3036
KERALA,WAYANAD,2021-01-03,59,2367,6,2432
KERALA,WAYANAD,2021-01-04,32,967,1,1000
KERALA,WAYANAD,2021-01-05,67,1550,3,1620
LADAKH,KARGIL,2021-01-01,0,77,0,77
LADAKH,KARGIL,2021-01-02,0,75,0,75
LADAKH,KARGIL,2021-01-03,0,72,0,72
LADAKH,KARGIL,2021-01-04,0,59,0,59
LADAKH,KARGIL,2021-01-05,0,96,0,96
LADAKH,LEH LADAKH,2021-01-01,30,157,0,187
LADAKH,LEH LADAKH,2021-01-02,3,212,2,217
LADAKH,LEH LADAKH,2021-01-03,1,175,0,176
LADAKH,LEH LADAKH,2021-01-04,13,196,0,209
LADAKH,LEH LADAKH,2021-01-05,13,299,0,312
LAKSHADWEEP,LAKSHADWEEP DISTRICT,2021-01-01,0,58,0,58
LAKSHADWEEP,LAKSHADWEEP DISTRICT,2021-01-02,0,70,0,70
LAKSHADWEEP,LAKSHADWEEP DISTRICT,2021-01-03,0,46,0,46
LAKSHADWEEP,LAKSHADWEEP DISTRICT,2021-01-04,0,41,0,41
LAKSHADWEEP,LAKSHADWEEP DISTRICT,2021-01-05,0,58,0,58
MADHYA PRADESH,AGAR MALWA,2021-01-01,2,219,0,221
MADHYA PRADESH,AGAR MALWA,2021-01-02,0,247,0,247
MADHYA PRADESH,AGAR MALWA,2021-01-03,0,85,0,85
MADHYA PRADESH,AGAR MALWA,2021-01-04,2,286,0,288
MADHYA PRADESH,AGAR MALWA,2021-01-05,4,416,0,420
MADHYA PRADESH,ALIRAJPUR,2021-01-01,6,58,0,64
MADHYA PRADESH,ALIRAJPUR,2021-01-02,8,278,0,286
MADHYA PRADESH,ALIRAJPUR,2021-01-03,0,13,0,13
MADHYA PRADESH,ALIRAJPUR,2021-01-04,4,233,0,237
MADHYA PRADESH,ALIRAJPUR,2021-01-05,2,199,8,209
MADHYA PRADESH,ANUPPUR,2021-01-01,0,62,0,62
MADHYA PRADESH,ANUPPUR,2021-01-02,2,104,2,108
MADHYA PRADESH,ANUPPUR,2021-01-03,12,140,16,168
MADHYA PRADESH,ANUPPUR,2021-01-04,17,374,4,395
MADHYA PRADESH,ANUPPUR,2021-01-05,11,222,1,234
MADHYA PRADESH,ASHOKNAGAR,2021-01-01,2,276,0,278
MADHYA PRADESH,ASHOKNAGAR,2021-01-02,5,236,0,241
MADHYA PRADESH,ASHOKNAGAR,2021-01-03,1,160,0,161
MADHYA PRADESH,ASHOKNAGAR,2021-01-04,1,196,0,197
MADHYA PRADESH,ASHOKNAGAR,2021-01-05,1,288,0,289
MADHYA PRADESH,BALAGHAT,2021-01-01,17,290,0,307
MADHYA PRADESH,BALAGHAT,2021-01-02,17,342,0,359
MADHYA PRADESH,BALAGHAT,2021-01-03,14,268,1,283
MADHYA PRADESH,BALAGHAT,2021-01-04,18,517,0,535
MADHYA PRADESH,BALAGHAT,2021-01-05,13,288,2,303
MADHYA PRADESH,BARWANI,2021-01-01,14,273,0,287
MADHYA PRADESH,BARWANI,2021-01-02,18,290,0,308
MADHYA PRADESH,BARWANI,2021-01-03,4,161,0,165
MADHYA PRADESH,BARWANI,2021-01-04,10,515,0,525
MADHYA PRADESH,BARWANI,2021-01-05,10,240,7,257
MADHYA PRADESH,BETUL,2021-01-01,22,432,4,458
MADHYA PRADESH,BETUL,2021-01-02,9,442,4,455
MADHYA PRADESH,BETUL,2021-01-03,19,388,1,408
MADHYA PRADESH,BETUL,2021-01-04,25,493,2,520
MADHYA PRADESH,BETUL,2021-01-05,10,173,1,184
MADHYA PRADESH,BHIND,2021-01-01,5,180,0,185
MADHYA PRADESH,BHIND,2021-01-02,5,365,0,370
MADHYA PRADESH,BHIND,2021-01-03,5,258,0,263
MADHYA PRADESH,BHIND,2021-01-04,9,384,0,393
MADHYA PRADESH,BHIND,2021-01-05,7,275,0,282
MADHYA PRADESH,BHOPAL,2021-01-01,184,1755,15,1954
MADHYA PRADESH,BHOPAL,2021-01-02,181,1890,15,2086
MADHYA PRADESH,BHOPAL,2021-01-03,186,2014,21,2221
MADHYA PRADESH,BHOPAL,2021-01-04,175,2378,13,2566
MADHYA PRADESH,BHOPAL,2021-01-05,206,2316,21,2543
MADHYA PRADESH,BURHANPUR,2021-01-01,0,269,0,269
MADHYA PRADESH,BURHANPUR,2021-01-02,0,171,0,171
MADHYA PRADESH,BURHANPUR,2021-01-03,0,271,0,271
MADHYA PRADESH,BURHANPUR,2021-01-04,0,288,0,288
MADHYA PRADESH,BURHANPUR,2021-01-05,3,108,0,111
MADHYA PRADESH,CHHATARPUR,2021-01-01,7,282,0,289
MADHYA PRADESH,CHHATARPUR,2021-01-02,10,173,0,183
MADHYA PRADESH,CHHATARPUR,2021-01-03,7,372,3,382
MADHYA PRADESH,CHHATARPUR,2021-01-04,5,290,0,295
MADHYA PRADESH,CHHATARPUR,2021-01-05,8,274,0,282
MADHYA PRADESH,CHHINDWARA,2021-01-01,8,312,12,332
MADHYA PRADESH,CHHINDWARA,2021-01-02,17,154,328,499
MADHYA PRADESH,CHHINDWARA,2021-01-03,13,282,4,299
MADHYA PRADESH,CHHINDWARA,2021-01-04,16,400,3,419
MADHYA PRADESH,CHHINDWARA,2021-01-05,10,172,165,347
MADHYA PRADESH,DAMOH,2021-01-01,4,102,0,106
MADHYA PRADESH,DAMOH,2021-01-02,5,290,0,295
MADHYA PRADESH,DAMOH,2021-01-03,2,99,0,101
MADHYA PRADESH,DAMOH,2021-01-04,11,328,4,343
MADHYA PRADESH,DAMOH,2021-01-05,5,322,0,327
MADHYA PRADESH,DATIA,2021-01-01,2,171,0,173
MADHYA PRADESH,DATIA,2021-01-02,6,435,4,445
MADHYA PRADESH,DATIA,2021-01-03,0,163,8,171
MADHYA PRADESH,DATIA,2021-01-04,10,147,11,168
MADHYA PRADESH,DATIA,2021-01-05,3,231,5,239
MADHYA PRADESH,DEWAS,2021-01-01,15,727,0,742
MADHYA PRADESH,DEWAS,2021-01-02,18,687,0,705
MADHYA PRADESH,DEWAS,2021-01-03,2,353,0,355
MADHYA PRADESH,DEWAS,2021-01-04,13,417,0,430
MADHYA PRADESH,DEWAS,2021-01-05,15,177,1,193
MADHYA PRADESH,DHAR,2021-01-01,16,423,0,439
MADHYA PRADESH,DHAR,2021-01-02,11,622,0,633
MADHYA PRADESH,DHAR,2021-01-03,11,99,0,110
MADHYA PRADESH,DHAR,2021-01-04,9,591,0,600
MADHYA PRADESH,DHAR,2021-01-05,14,365,11,390
MADHYA PRADESH,DINDORI,2021-01-01,4,111,0,115
MADHYA PRADESH,DINDORI,2021-01-02,4,332,1,337
MADHYA PRADESH,DINDORI,2021-01-03,1,209,0,210
MADHYA PRADESH,DINDORI,2021-01-04,1,134,0,135
MADHYA PRADESH,DINDORI,2021-01-05,0,242,0,242
MADHYA PRADESH,EAST NIMAR,2021-01-01,3,310,2,315
MADHYA PRADESH,EAST NIMAR,2021-01-02,4,477,9,490
MADHYA PRADESH,EAST NIMAR,2021-01-03,5,356,3,364
MADHYA PRADESH,EAST NIMAR,2021-01-04,8,387,2,397
MADHYA PRADESH,EAST NIMAR,2021-01-05,8,413,4,425
MADHYA PRADESH,GUNA,2021-01-01,9,173,0,182
MADHYA PRADESH,GUNA,2021-01-02,5,383,0,388
MADHYA PRADESH,GUNA,2021-01-03,6,268,0,274
MADHYA PRADESH,GUNA,2021-01-04,2,262,1,265
MADHYA PRADESH,GUNA,2021-01-05,5,376,0,381
MADHYA PRADESH,GWALIOR,2021-01-01,20,1559,1,1580
MADHYA PRADESH,GWALIOR,2021-01-02,35,1341,1,1377
MADHYA PRADESH,GWALIOR,2021-01-03,18,909,3,930
MADHYA PRADESH,GWALIOR,2021-01-04,21,2088,2,2111
MADHYA PRADESH,GWALIOR,2021-01-05,41,1458,1,1500
MADHYA PRADESH,HARDA,2021-01-01,2,188,2,192
MADHYA PRADESH,HARDA,2021-01-02,4,244,5,253
MADHYA PRADESH,HARDA,2021-01-03,6,304,2,312
MADHYA PRADESH,HARDA,2021-01-04,6,317,2,325
MADHYA PRADESH,HARDA,2021-01-05,5,301,6,312
MADHYA PRADESH,HOSHANGABAD,2021-01-01,18,472,10,500
MADHYA PRADESH,HOSHANGABAD,2021-01-02,13,269,2,284
MADHYA PRADESH,HOSHANGABAD,2021-01-03,7,251,0,258
MADHYA PRADESH,HOSHANGABAD,2021-01-04,8,563,0,571
MADHYA PRADESH,HOSHANGABAD,2021-01-05,13,433,3,449
MADHYA PRADESH,INDORE,2021-01-01,153,3233,3,3389
MADHYA PRADESH,INDORE,2021-01-02,211,3542,0,3753
MADHYA PRADESH,INDORE,2021-01-03,137,2799,0,2936
MADHYA PRADESH,INDORE,2021-01-04,217,4018,0,4235
MADHYA PRADESH,INDORE,2021-01-05,239,3847,6,4092
MADHYA PRADESH,JABALPUR,2021-01-01,32,470,2,504
MADHYA PRADESH,JABALPUR,2021-01-02,24,398,1,423
MADHYA PRADESH,JABALPUR,2021-01-03,33,347,2,382
MADHYA PRADESH,JABALPUR,2021-01-04,34,548,0,582
MADHYA PRADESH,JABALPUR,2021-01-05,24,686,3,713
MADHYA PRADESH,JHABUA,2021-01-01,8,398,0,406
MADHYA PRADESH,JHABUA,2021-01-02,6,491,0,497
MADHYA PRADESH,JHABUA,2021-01-03,5,336,0,341
MADHYA PRADESH,JHABUA,2021-01-04,0,487,0,487
MADHYA PRADESH,JHABUA,2021-01-05,6,498,3,507
MADHYA PRADESH,KATNI,2021-01-01,6,179,2,187
MADHYA PRADESH,KATNI,2021-01-02,5,233,4,242
MADHYA PRADESH,KATNI,2021-01-03,6,173,6,185
MADHYA PRADESH,KATNI,2021-01-04,3,322,9,334
MADHYA PRADESH,KATNI,2021-01-05,7,221,9,237
MADHYA PRADESH,KHARGONE,2021-01-01,13,743,0,756
MADHYA PRADESH,KHARGONE,2021-01-02,31,570,0,601
MADHYA PRADESH,KHARGONE,2021-01-03,16,313,0,329
MADHYA PRADESH,KHARGONE,2021-01-04,10,641,0,651
MADHYA PRADESH,KHARGONE,2021-01-05,15,403,13,431
MADHYA PRADESH,MANDLA,2021-01-01,0,95,0,95
MADHYA PRADESH,MANDLA,2021-01-02,0,416,0,416
MADHYA PRADESH,MANDLA,2021-01-03,0,172,1,173
MADHYA PRADESH,MANDLA,2021-01-04,2,70,1,73
MADHYA PRADESH,MANDLA,2021-01-05,3,225,0,228
MADHYA PRADESH,MANDSAUR,2021-01-01,27,454,17,498
MADHYA PRADESH,MANDSAUR,2021-01-02,16,320,0,336
MADHYA PRADESH,MANDSAUR,2021-01-03,21,288,6,315
MADHYA PRADESH,MANDSAUR,2021-01-04,15,293,5,313
MADHYA PRADESH,MANDSAUR,2021-01-05,11,289,9,309
MADHYA PRADESH,MORENA,2021-01-01,5,357,1,363
MADHYA PRADESH,MORENA,2021-01-02,1,429,1,431
MADHYA PRADESH,MORENA,2021-01-03,0,333,0,333
MADHYA PRADESH,MORENA,2021-01-04,3,402,0,405
MADHYA PRADESH,MORENA,2021-01-05,3,386,1,390
MADHYA PRADESH,NARSINGHPUR,2021-01-01,7,271,0,278
MADHYA PRADESH,NARSINGHPUR,2021-01-02,5,385,4,394
MADHYA PRADESH,NARSINGHPUR,2021-01-03,12,466,1,479
MADHYA PRADESH,NARSINGHPUR,2021-01-04,11,544,2,557
MADHYA PRADESH,NARSINGHPUR,2021-01-05,5,574,1,580
MADHYA PRADESH,NEEMUCH,2021-01-01,8,196,0,204
MADHYA PRADESH,NEEMUCH,2021-01-02,11,245,0,256
MADHYA PRADESH,NEEMUCH,2021-01-03,15,187,4,206
MADHYA PRADESH,NEEMUCH,2021-01-04,5,266,2,273
MADHYA PRADESH,NEEMUCH,2021-01-05,9,371,0,380
MADHYA PRADESH,NIWARI,2021-01-01,3,300,0,303
MADHYA PRADESH,NIWARI,2021-01-02,9,289,1,299
MADHYA PRADESH,NIWARI,2021-01-03,0,110,0,110
MADHYA PRADESH,NIWARI,2021-01-04,1,256,0,257
MADHYA PRADESH,NIWARI,2021-01-05,4,230,0,234
MADHYA PRADESH,PANNA,2021-01-01,4,202,0,206
MADHYA PRADESH,PANNA,2021-01-02,9,186,2,197
MADHYA PRADESH,PANNA,2021-01-03,1,80,0,81
MADHYA PRADESH,PANNA,2021-01-04,3,141,0,144
MADHYA PRADESH,PANNA,2021-01-05,4,296,0,300
MADHYA PRADESH,RAISEN,2021-01-01,4,76,0,80
MADHYA PRADESH,RAISEN,2021-01-02,2,141,0,143
MADHYA PRADESH,RAISEN,2021-01-03,1,89,0,90
MADHYA PRADESH,RAISEN,2021-01-04,11,318,0,329
MADHYA PRADESH,RAISEN,2021-01-05,5,175,0,180
MADHYA PRADESH,RAJGARH,2021-01-01,9,232,2,243
MADHYA PRADESH,RAJGARH,2021-01-02,5,247,1,253
MADHYA PRADESH,RAJGARH,2021-01-03,5,236,1,242
MADHYA PRADESH,RAJGARH,2021-01-04,1,315,0,316
MADHYA PRADESH,RAJGARH,2021-01-05,19,515,0,534
MADHYA PRADESH,RATLAM,2021-01-01,18,585,3,606
MADHYA PRADESH,RATLAM,2021-01-02,27,669,25,721
MADHYA PRADESH,RATLAM,2021-01-03,25,323,2,350
MADHYA PRADESH,RATLAM,2021-01-04,22,404,1,427
MADHYA PRADESH,RATLAM,2021-01-05,22,448,41,511
MADHYA PRADESH,REWA,2021-01-01,12,479,2,493
MADHYA PRADESH,REWA,2021-01-02,19,424,2,445
MADHYA PRADESH,REWA,2021-01-03,36,536,0,572
MADHYA PRADESH,REWA,2021-01-04,23,416,1,440
MADHYA PRADESH,REWA,2021-01-05,19,849,0,868
MADHYA PRADESH,SAGAR,2021-01-01,9,646,2,657
MADHYA PRADESH,SAGAR,2021-01-02,16,1457,1,1474
MADHYA PRADESH,SAGAR,2021-01-03,16,887,0,903
MADHYA PRADESH,SAGAR,2021-01-04,23,913,3,939
MADHYA PRADESH,SAGAR,2021-01-05,10,577,0,587
MADHYA PRADESH,SATNA,2021-01-01,15,426,0,441
MADHYA PRADESH,SATNA,2021-01-02,5,432,0,437
MADHYA PRADESH,SATNA,2021-01-03,7,265,1,273
MADHYA PRADESH,SATNA,2021-01-04,12,286,1,299
MADHYA PRADESH,SATNA,2021-01-05,9,278,0,287
MADHYA PRADESH,SEHORE,2021-01-01,4,400,0,404
MADHYA PRADESH,SEHORE,2021-01-02,14,337,0,351
MADHYA PRADESH,SEHORE,2021-01-03,3,381,1,385
MADHYA PRADESH,SEHORE,2021-01-04,10,414,0,424
MADHYA PRADESH,SEHORE,2021-01-05,9,327,0,336
MADHYA PRADESH,SEONI,2021-01-01,4,212,15,231
MADHYA PRADESH,SEONI,2021-01-02,7,165,112,284
MADHYA PRADESH,SEONI,2021-01-03,9,103,138,250
MADHYA PRADESH,SEONI,2021-01-04,2,244,128,374
MADHYA PRADESH,SEONI,2021-01-05,7,144,192,343
MADHYA PRADESH,SHAHDOL,2021-01-01,2,50,1,53
MADHYA PRADESH,SHAHDOL,2021-01-02,2,118,16,136
MADHYA PRADESH,SHAHDOL,2021-01-03,3,182,75,260
MADHYA PRADESH,SHAHDOL,2021-01-04,7,128,4,139
MADHYA PRADESH,SHAHDOL,2021-01-05,10,121,19,150
MADHYA PRADESH,SHAJAPUR,2021-01-01,2,217,0,219
MADHYA PRADESH,SHAJAPUR,2021-01-02,13,324,0,337
MADHYA PRADESH,SHAJAPUR,2021-01-03,1,169,0,170
MADHYA PRADESH,SHAJAPUR,2021-01-04,7,312,0,319
MADHYA PRADESH,SHAJAPUR,2021-01-05,4,302,0,306
MADHYA PRADESH,SHEOPUR,2021-01-01,3,43,2,48
MADHYA PRADESH,SHEOPUR,2021-01-02,5,262,0,267
MADHYA PRADESH,SHEOPUR,2021-01-03,1,52,0,53
MADHYA PRADESH,SHEOPUR,2021-01-04,7,334,0,341
MADHYA PRADESH,SHEOPUR,2021-01-05,5,81,1,87
MADHYA PRADESH,SHIVPURI,2021-01-01,5,271,1,277
MADHYA PRADESH,SHIVPURI,2021-01-02,23,488,1,512
MADHYA PRADESH,SHIVPURI,2021-01-03,14,159,2,175
MADHYA PRADESH,SHIVPURI,2021-01-04,10,298,0,308
MADHYA PRADESH,SHIVPURI,2021-01-05,12,283,0,295
MADHYA PRADESH,SIDHI,2021-01-01,3,234,0,237
MADHYA PRADESH,SIDHI,2021-01-02,2,320,0,322
MADHYA PRADESH,SIDHI,2021-01-03,4,316,0,320
MADHYA PRADESH,SIDHI,2021-01-04,2,58,0,60
MADHYA PRADESH,SIDHI,2021-01-05,6,73,0,79
MADHYA PRADESH,SINGRAULI,2021-01-01,4,255,1,260
MADHYA PRADESH,SINGRAULI,2021-01-02,2,407,0,409
MADHYA PRADESH,SINGRAULI,2021-01-03,5,181,0,186
MADHYA PRADESH,SINGRAULI,2021-01-04,7,252,0,259
MADHYA PRADESH,SINGRAULI,2021-01-05,3,3,0,6
MADHYA PRADESH,TIKAMGARH,2021-01-01,3,127,0,130
MADHYA PRADESH,TIKAMGARH,2021-01-02,3,410,2,415
MADHYA PRADESH,TIKAMGARH,2021-01-03,5,62,1,68
MADHYA PRADESH,TIKAMGARH,2021-01-04,1,183,0,184
MADHYA PRADESH,TIKAMGARH,2021-01-05,3,255,0,258
MADHYA PRADESH,UJJAIN,2021-01-01,35,262,0,297
MADHYA PRADESH,UJJAIN,2021-01-02,47,591,0,638
MADHYA PRADESH,UJJAIN,2021-01-03,25,848,2,875
MADHYA PRADESH,UJJAIN,2021-01-04,31,738,0,769
MADHYA PRADESH,UJJAIN,2021-01-05,27,683,1,711
MADHYA PRADESH,UMARIA,2021-01-01,0,91,5,96
MADHYA PRADESH,UMARIA,2021-01-02,3,109,0,112
MADHYA PRADESH,UMARIA,2021-01-03,3,62,0,65
MADHYA PRADESH,UMARIA,2021-01-04,5,51,1,57
MADHYA PRADESH,UMARIA,2021-01-05,1,160,6,167
MADHYA PRADESH,VIDISHA,2021-01-01,8,225,5,238
MADHYA PRADESH,VIDISHA,2021-01-02,11,175,3,189
MADHYA PRADESH,VIDISHA,2021-01-03,6,114,7,127
MADHYA PRADESH,VIDISHA,2021-01-04,5,196,0,201
MADHYA PRADESH,VIDISHA,2021-01-05,5,289,5,299
MAHARASHTRA,AHMEDNAGAR,2021-01-01,130,910,12,1052
MAHARASHTRA,AHMEDNAGAR,2021-01-02,120,874,15,1009
MAHARASHTRA,AHMEDNAGAR,2021-01-03,62,832,1,895
MAHARASHTRA,AHMEDNAGAR,2021-01-04,76,357,0,433
MAHARASHTRA,AHMEDNAGAR,2021-01-05,133,762,0,895
MAHARASHTRA,AKOLA,2021-01-01,32,353,2,387
MAHARASHTRA,AKOLA,2021-01-02,35,499,1,535
MAHARASHTRA,AKOLA,2021-01-03,58,465,1,524
MAHARASHTRA,AKOLA,2021-01-04,33,136,0,169
MAHARASHTRA,AKOLA,2021-01-05,84,882,0,966
MAHARASHTRA,AMRAVATI,2021-01-01,74,652,0,726
MAHARASHTRA,AMRAVATI,2021-01-02,111,906,1,1018
MAHARASHTRA,AMRAVATI,2021-01-03,36,800,0,836
MAHARASHTRA,AMRAVATI,2021-01-04,66,1021,0,1087
MAHARASHTRA,AMRAVATI,2021-01-05,61,766,0,827
MAHARASHTRA,AURANGABAD,2021-01-01,58,826,1,885
MAHARASHTRA,AURANGABAD,2021-01-02,31,806,0,837
MAHARASHTRA,AURANGABAD,2021-01-03,68,194,0,262
MAHARASHTRA,AURANGABAD,2021-01-04,33,272,0,305
MAHARASHTRA,AURANGABAD,2021-01-05,139,240,0,379
MAHARASHTRA,BEED,2021-01-01,45,492,1,538
MAHARASHTRA,BEED,2021-01-02,33,541,0,574
MAHARASHTRA,BEED,2021-01-03,26,452,0,478
MAHARASHTRA,BEED,2021-01-04,30,538,0,568
MAHARASHTRA,BEED,2021-01-05,37,670,0,707
MAHARASHTRA,BHANDARA,2021-01-01,46,278,0,324
MAHARASHTRA,BHANDARA,2021-01-02,36,139,2,177
MAHARASHTRA,BHANDARA,2021-01-03,36,183,1,220
MAHARASHTRA,BHANDARA,2021-01-04,72,382,3,457
MAHARASHTRA,BHANDARA,2021-01-05,42,366,1,409
MAHARASHTRA,BULDHANA,2021-01-01,58,505,7,570
MAHARASHTRA,BULDHANA,2021-01-02,33,847,1,881
MAHARASHTRA,BULDHANA,2021-01-03,57,704,0,761
MAHARASHTRA,BULDHANA,2021-01-04,38,245,0,283
MAHARASHTRA,BULDHANA,2021-01-05,6,14,0,20
MAHARASHTRA,CHANDRAPUR,2021-01-01,29,1235,3,1267
MAHARASHTRA,CHANDRAPUR,2021-01-02,40,1032,0,1072
MAHARASHTRA,CHANDRAPUR,2021-01-03,27,504,6,537
MAHARASHTRA,CHANDRAPUR,2021-01-04,66,973,0,1039
MAHARASHTRA,CHANDRAPUR,2021-01-05,58,1093,0,1151
MAHARASHTRA,DHULE,2021-01-01,10,315,3,328
MAHARASHTRA,DHULE,2021-01-02,26,305,0,331
MAHARASHTRA,DHULE,2021-01-03,2,210,1,213
MAHARASHTRA,DHULE,2021-01-04,19,330,0,349
MAHARASHTRA,DHULE,2021-01-05,9,352,0,361
MAHARASHTRA,GADCHIROLI,2021-01-01,11,480,1,492
MAHARASHTRA,GADCHIROLI,2021-01-02,11,609,0,620
MAHARASHTRA,GADCHIROLI,2021-01-03,18,136,2,156
MAHARASHTRA,GADCHIROLI,2021-01-04,9,546,0,555
MAHARASHTRA,GADCHIROLI,2021-01-05,13,779,3,795
MAHARASHTRA,GONDIA,2021-01-01,19,417,0,436
MAHARASHTRA,GONDIA,2021-01-02,21,410,6,437
MAHARASHTRA,GONDIA,2021-01-03,26,418,1,445
MAHARASHTRA,GONDIA,2021-01-04,34,289,0,323
MAHARASHTRA,GONDIA,2021-01-05,29,444,2,475
MAHARASHTRA,HINGOLI,2021-01-01,3,97,0,100
MAHARASHTRA,HINGOLI,2021-01-02,15,278,0,293
MAHARASHTRA,HINGOLI,2021-01-03,0,157,2,159
MAHARASHTRA,HINGOLI,2021-01-04,6,40,0,46
MAHARASHTRA,HINGOLI,2021-01-05,26,343,0,369
MAHARASHTRA,JALGAON,2021-01-01,42,1903,0,1945
MAHARASHTRA,JALGAON,2021-01-02,48,1210,0,1258
MAHARASHTRA,JALGAON,2021-01-03,43,875,1,919
MAHARASHTRA,JALGAON,2021-01-04,69,1017,1,1087
MAHARASHTRA,JALGAON,2021-01-05,66,1212,1,1279
MAHARASHTRA,JALNA,2021-01-01,22,311,0,333
MAHARASHTRA,JALNA,2021-01-02,16,252,0,268
MAHARASHTRA,JALNA,2021-01-03,30,214,0,244
MAHARASHTRA,JALNA,2021-01-04,15,369,0,384
MAHARASHTRA,JALNA,2021-01-05,26,294,0,320
MAHARASHTRA,KOLHAPUR,2021-01-01,8,1242,0,1250
MAHARASHTRA,KOLHAPUR,2021-01-02,12,901,7,920
MAHARASHTRA,KOLHAPUR,2021-01-03,14,1217,3,1234
MAHARASHTRA,KOLHAPUR,2021-01-04,10,348,1,359
MAHARASHTRA,KOLHAPUR,2021-01-05,20,883,0,903
MAHARASHTRA,LATUR,2021-01-01,27,1262,5,1294
MAHARASHTRA,LATUR,2021-01-02,27,1525,3,1555
MAHARASHTRA,LATUR,2021-01-03,23,966,9,998
MAHARASHTRA,LATUR,2021-01-04,48,947,0,995
MAHARASHTRA,LATUR,2021-01-05,28,1382,3,1413
MAHARASHTRA,MUMBAI,2021-01-01,483,11327,14,11824
MAHARASHTRA,MUMBAI,2021-01-02,530,11284,23,11837
MAHARASHTRA,MUMBAI,2021-01-03,458,9860,29,10347
MAHARASHTRA,MUMBAI,2021-01-04,511,11712,63,12286
MAHARASHTRA,MUMBAI,2021-01-05,673,14786,68,15527
MAHARASHTRA,MUMBAI SUBURBAN,2021-01-01,185,1998,5,2188
MAHARASHTRA,MUMBAI SUBURBAN,2021-01-02,163,2056,12,2231
MAHARASHTRA,MUMBAI SUBURBAN,2021-01-03,111,2193,0,2304
MAHARASHTRA,MUMBAI SUBURBAN,2021-01-04,114,2254,3,2371
MAHARASHTRA,MUMBAI SUBURBAN,2021-01-05,207,2736,9,2952
MAHARASHTRA,NAGPUR,2021-01-01,453,4410,45,4908
MAHARASHTRA,NAGPUR,2021-01-02,452,3996,64,4512
MAHARASHTRA,NAGPUR,2021-01-03,432,2934,36,3402
MAHARASHTRA,NAGPUR,2021-01-04,419,3878,95,4392
MAHARASHTRA,NAGPUR,2021-01-05,490,3470,34,3994
MAHARASHTRA,NANDED,2021-01-01,37,868,12,917
MAHARASHTRA,NANDED,2021-01-02,27,745,11,783
MAHARASHTRA,NANDED,2021-01-03,28,750,5,783
MAHARASHTRA,NANDED,2021-01-04,59,820,8,887
MAHARASHTRA,NANDED,2021-01-05,37,911,3,951
MAHARASHTRA,NANDURBAR,2021-01-01,50,141,0,191
MAHARASHTRA,NANDURBAR,2021-01-02,31,61,0,92
MAHARASHTRA,NANDURBAR,2021-01-03,42,116,0,158
MAHARASHTRA,NANDURBAR,2021-01-04,68,259,3,330
MAHARASHTRA,NANDURBAR,2021-01-05,66,167,0,233
MAHARASHTRA,NASHIK,2021-01-01,232,1207,2,1441
MAHARASHTRA,NASHIK,2021-01-02,144,2493,1,2638
MAHARASHTRA,NASHIK,2021-01-03,180,2034,6,2220
MAHARASHTRA,NASHIK,2021-01-04,163,1476,0,1639
MAHARASHTRA,NASHIK,2021-01-05,548,3030,1,3579
MAHARASHTRA,OSMANABAD,2021-01-01,21,404,1,426
MAHARASHTRA,OSMANABAD,2021-01-02,25,254,2,281
MAHARASHTRA,OSMANABAD,2021-01-03,28,450,0,478
MAHARASHTRA,OSMANABAD,2021-01-04,18,427,0,445
MAHARASHTRA,OSMANABAD,2021-01-05,21,270,1,292
MAHARASHTRA,PALGHAR,2021-01-01,50,586,3,639
MAHARASHTRA,PALGHAR,2021-01-02,41,775,4,820
MAHARASHTRA,PALGHAR,2021-01-03,37,446,0,483
MAHARASHTRA,PALGHAR,2021-01-04,45,927,2,974
MAHARASHTRA,PALGHAR,2021-01-05,65,1107,1,1173
MAHARASHTRA,PARBHANI,2021-01-01,7,561,1,569
MAHARASHTRA,PARBHANI,2021-01-02,8,993,0,1001
MAHARASHTRA,PARBHANI,2021-01-03,6,551,0,557
MAHARASHTRA,PARBHANI,2021-01-04,21,1168,0,1189
MAHARASHTRA,PARBHANI,2021-01-05,9,1180,0,1189
MAHARASHTRA,PUNE,2021-01-01,503,5238,34,5775
MAHARASHTRA,PUNE,2021-01-02,598,6740,80,7418
MAHARASHTRA,PUNE,2021-01-03,384,4541,15,4940
MAHARASHTRA,PUNE,2021-01-04,569,7366,161,8096
MAHARASHTRA,PUNE,2021-01-05,753,7938,84,8775
MAHARASHTRA,RAIGAD,2021-01-01,72,998,3,1073
MAHARASHTRA,RAIGAD,2021-01-02,111,1034,13,1158
MAHARASHTRA,RAIGAD,2021-01-03,93,759,1,853
MAHARASHTRA,RAIGAD,2021-01-04,126,1070,2,1198
MAHARASHTRA,RAIGAD,2021-01-05,146,1141,2,1289
MAHARASHTRA,RATNAGIRI,2021-01-01,13,169,1,183
MAHARASHTRA,RATNAGIRI,2021-01-02,17,498,0,515
MAHARASHTRA,RATNAGIRI,2021-01-03,13,367,0,380
MAHARASHTRA,RATNAGIRI,2021-01-04,11,318,0,329
MAHARASHTRA,RATNAGIRI,2021-01-05,19,207,0,226
MAHARASHTRA,SANGLI,2021-01-01,22,791,3,816
MAHARASHTRA,SANGLI,2021-01-02,24,917,1,942
MAHARASHTRA,SANGLI,2021-01-03,16,369,0,385
MAHARASHTRA,SANGLI,2021-01-04,25,833,0,858
MAHARASHTRA,SANGLI,2021-01-05,39,937,0,976
MAHARASHTRA,SATARA,2021-01-01,64,804,2,870
MAHARASHTRA,SATARA,2021-01-02,31,950,2,983
MAHARASHTRA,SATARA,2021-01-03,101,576,41,718
MAHARASHTRA,SATARA,2021-01-04,42,914,3,959
MAHARASHTRA,SATARA,2021-01-05,88,764,11,863
MAHARASHTRA,SINDHUDURG,2021-01-01,12,71,1,84
MAHARASHTRA,SINDHUDURG,2021-01-02,9,267,0,276
MAHARASHTRA,SINDHUDURG,2021-01-03,2,27,0,29
MAHARASHTRA,SINDHUDURG,2021-01-04,32,298,0,330
MAHARASHTRA,SINDHUDURG,2021-01-05,9,195,0,204
MAHARASHTRA,SOLAPUR,2021-01-01,76,1743,1,1820
MAHARASHTRA,SOLAPUR,2021-01-02,92,1933,2,2027
MAHARASHTRA,SOLAPUR,2021-01-03,63,967,1,1031
MAHARASHTRA,SOLAPUR,2021-01-04,82,1762,0,1844
MAHARASHTRA,SOLAPUR,2021-01-05,91,1914,2,2007
MAHARASHTRA,THANE,2021-01-01,430,18149,7,18586
MAHARASHTRA,THANE,2021-01-02,476,15857,18,16351
MAHARASHTRA,THANE,2021-01-03,381,5997,12,6390
MAHARASHTRA,THANE,2021-01-04,438,7684,11,8133
MAHARASHTRA,THANE,2021-01-05,578,13054,12,13644
MAHARASHTRA,WARDHA,2021-01-01,31,439,7,477
MAHARASHTRA,WARDHA,2021-01-02,62,509,15,586
MAHARASHTRA,WARDHA,2021-01-03,16,127,1,144
MAHARASHTRA,WARDHA,2021-01-04,65,658,9,732
MAHARASHTRA,WARDHA,2021-01-05,72,600,6,678
MAHARASHTRA,WASHIM,2021-01-01,15,265,3,283
MAHARASHTRA,WASHIM,2021-01-02,15,350,6,371
MAHARASHTRA,WASHIM,2021-01-03,12,271,5,288
MAHARASHTRA,WASHIM,2021-01-04,17,354,6,377
MAHARASHTRA,WASHIM,2021-01-05,12,347,1,360
MAHARASHTRA,YAVATMAL,2021-01-01,42,460,0,502
MAHARASHTRA,YAVATMAL,2021-01-02,55,583,4,642
MAHARASHTRA,YAVATMAL,2021-01-03,50,325,0,375
MAHARASHTRA,YAVATMAL,2021-01-04,62,425,1,488
MAHARASHTRA,YAVATMAL,2021-01-05,42,522,0,564
MANIPUR,BISHNUPUR,2021-01-01,1,59,0,60
MANIPUR,BISHNUPUR,2021-01-02,4,106,0,110
MANIPUR,BISHNUPUR,2021-01-03,2,84,0,86
MANIPUR,BISHNUPUR,2021-01-04,7,119,0,126
MANIPUR,BISHNUPUR,2021-01-05,3,150,0,153
MANIPUR,CHANDEL,2021-01-01,0,7,0,7
MANIPUR,CHANDEL,2021-01-02,0,21,0,21
MANIPUR,CHANDEL,2021-01-03,0,8,0,8
MANIPUR,CHANDEL,2021-01-04,31,9,0,40
MANIPUR,CHANDEL,2021-01-05,22,19,0,41
MANIPUR,CHURACHANDPUR,2021-01-01,0,9,0,9
MANIPUR,CHURACHANDPUR,2021-01-02,1,117,0,118
MANIPUR,CHURACHANDPUR,2021-01-03,1,10,0,11
MANIPUR,CHURACHANDPUR,2021-01-04,1,163,0,164
MANIPUR,CHURACHANDPUR,2021-01-05,1,60,0,61
MANIPUR,IMPHAL EAST,2021-01-01,3,68,0,71
MANIPUR,IMPHAL EAST,2021-01-02,17,533,0,550
MANIPUR,IMPHAL EAST,2021-01-03,3,221,0,224
MANIPUR,IMPHAL EAST,2021-01-04,16,485,0,501
MANIPUR,IMPHAL EAST,2021-01-05,20,481,1,502
MANIPUR,IMPHAL WEST,2021-01-01,10,272,0,282
MANIPUR,IMPHAL WEST,2021-01-02,39,656,0,695
MANIPUR,IMPHAL WEST,2021-01-03,23,473,0,496
MANIPUR,IMPHAL WEST,2021-01-04,52,608,0,660
MANIPUR,IMPHAL WEST,2021-01-05,43,1052,0,1095
MANIPUR,JIRIBAM,2021-01-01,0,7,0,7
MANIPUR,JIRIBAM,2021-01-03,0,11,0,11
MANIPUR,JIRIBAM,2021-01-05,6,67,0,73
MANIPUR,KAKCHING,2021-01-01,0,31,0,31
MANIPUR,KAKCHING,2021-01-02,1,45,0,46
MANIPUR,KAKCHING,2021-01-03,2,38,0,40
MANIPUR,KAKCHING,2021-01-04,0,41,0,41
MANIPUR,KAKCHING,2021-01-05,1,58,0,59
MANIPUR,KAMJONG,2021-01-02,0,3,0,3
MANIPUR,KAMJONG,2021-01-03,0,7,0,7
MANIPUR,KAMJONG,2021-01-05,0,1,0,1
MANIPUR,KANGPOKPI,2021-01-01,0,52,0,52
MANIPUR,KANGPOKPI,2021-01-02,1,13,0,14
MANIPUR,KANGPOKPI,2021-01-03,3,19,0,22
MANIPUR,KANGPOKPI,2021-01-04,0,16,0,16
MANIPUR,KANGPOKPI,2021-01-05,3,26,0,29
MANIPUR,NONEY,2021-01-01,5,133,0,138
MANIPUR,NONEY,2021-01-02,4,80,0,84
MANIPUR,NONEY,2021-01-03,0,8,0,8
MANIPUR,NONEY,2021-01-04,0,6,0,6
MANIPUR,NONEY,2021-01-05,0,24,0,24
MANIPUR,SENAPATI,2021-01-01,0,9,0,9
MANIPUR,SENAPATI,2021-01-02,0,24,0,24
MANIPUR,SENAPATI,2021-01-03,0,22,0,22
MANIPUR,SENAPATI,2021-01-04,0,21,0,21
MANIPUR,SENAPATI,2021-01-05,2,41,0,43
MANIPUR,TAMENGLONG,2021-01-01,2,11,0,13
MANIPUR,TAMENGLONG,2021-01-02,7,86,0,93
MANIPUR,TAMENGLONG,2021-01-03,3,36,0,39
MANIPUR,TAMENGLONG,2021-01-04,5,103,0,108
MANIPUR,TAMENGLONG,2021-01-05,9,53,0,62
MANIPUR,TENGNOUPAL,2021-01-01,0,2,0,2
MANIPUR,TENGNOUPAL,2021-01-02,0,5,0,5
MANIPUR,TENGNOUPAL,2021-01-03,0,7,0,7
MANIPUR,TENGNOUPAL,2021-01-04,0,3,0,3
MANIPUR,TENGNOUPAL,2021-01-05,2,5,0,7
MANIPUR,THOUBAL,2021-01-01,2,148,0,150
MANIPUR,THOUBAL,2021-01-02,4,121,0,125
MANIPUR,THOUBAL,2021-01-03,7,113,0,120
MANIPUR,THOUBAL,2021-01-04,2,122,0,124
MANIPUR,THOUBAL,2021-01-05,4,188,0,192
MANIPUR,UKHRUL,2021-01-01,2,59,0,61
MANIPUR,UKHRUL,2021-01-02,0,25,0,25
MANIPUR,UKHRUL,2021-01-03,0,98,0,98
MANIPUR,UKHRUL,2021-01-04,5,192,0,197
MANIPUR,UKHRUL,2021-01-05,3,156,0,159
MEGHALAYA,EAST GARO HILLS,2021-01-02,0,20,0,20
MEGHALAYA,EAST GARO HILLS,2021-01-03,1,0,0,1
MEGHALAYA,EAST GARO HILLS,2021-01-04,0,54,0,54
MEGHALAYA,EAST GARO HILLS,2021-01-05,0,35,0,35
MEGHALAYA,EAST JAINTIA HILLS,2021-01-01,0,6,0,6
MEGHALAYA,EAST JAINTIA HILLS,2021-01-02,0,15,0,15
MEGHALAYA,EAST JAINTIA HILLS,2021-01-03,2,27,0,29
MEGHALAYA,EAST JAINTIA HILLS,2021-01-04,0,145,0,145
MEGHALAYA,EAST JAINTIA HILLS,2021-01-05,0,39,0,39
MEGHALAYA,EAST KHASI HILLS,2021-01-01,0,73,0,73
MEGHALAYA,EAST KHASI HILLS,2021-01-02,10,474,1,485
MEGHALAYA,EAST KHASI HILLS,2021-01-03,16,115,0,131
MEGHALAYA,EAST KHASI HILLS,2021-01-04,8,915,0,923
MEGHALAYA,EAST KHASI HILLS,2021-01-05,16,726,0,742
MEGHALAYA,NORTH GARO HILLS,2021-01-02,0,3,0,3
MEGHALAYA,NORTH GARO HILLS,2021-01-04,0,32,0,32
MEGHALAYA,NORTH GARO HILLS,2021-01-05,1,49,0,50
MEGHALAYA,RI BHOI,2021-01-01,0,7,0,7
MEGHALAYA,RI BHOI,2021-01-02,1,52,0,53
MEGHALAYA,RI BHOI,2021-01-03,0,13,0,13
MEGHALAYA,RI BHOI,2021-01-04,0,73,0,73
MEGHALAYA,RI BHOI,2021-01-05,1,61,0,62
MEGHALAYA,SOUTH GARO HILLS,2021-01-02,0,2,0,2
MEGHALAYA,SOUTH GARO HILLS,2021-01-03,0,3,0,3
MEGHALAYA,SOUTH GARO HILLS,2021-01-04,0,14,0,14
MEGHALAYA,SOUTH GARO HILLS,2021-01-05,1,11,0,12
MEGHALAYA,SOUTH WEST GARO HILLS,2021-01-01,0,1,0,1
MEGHALAYA,SOUTH WEST GARO HILLS,2021-01-02,0,47,0,47
MEGHALAYA,SOUTH WEST GARO HILLS,2021-01-03,0,11,0,11
MEGHALAYA,SOUTH WEST GARO HILLS,2021-01-04,1,40,0,41
MEGHALAYA,SOUTH WEST GARO HILLS,2021-01-05,0,28,0,28
MEGHALAYA,SOUTH WEST KHASI HILLS,2021-01-02,0,8,0,8
MEGHALAYA,SOUTH WEST KHASI HILLS,2021-01-03,0,3,0,3
MEGHALAYA,SOUTH WEST KHASI HILLS,2021-01-04,0,10,0,10
MEGHALAYA,SOUTH WEST KHASI HILLS,2021-01-05,0,12,0,12
MEGHALAYA,WEST GARO HILLS,2021-01-01,0,17,0,17
MEGHALAYA,WEST GARO HILLS,2021-01-02,1,116,0,117
MEGHALAYA,WEST GARO HILLS,2021-01-03,0,72,0,72
MEGHALAYA,WEST GARO HILLS,2021-01-04,0,204,0,204
MEGHALAYA,WEST GARO HILLS,2021-01-05,0,277,0,277
MEGHALAYA,WEST JAINTIA HILLS,2021-01-01,1,34,0,35
MEGHALAYA,WEST JAINTIA HILLS,2021-01-02,0,95,0,95
MEGHALAYA,WEST JAINTIA HILLS,2021-01-03,1,30,0,31
MEGHALAYA,WEST JAINTIA HILLS,2021-01-04,0,55,1,56
MEGHALAYA,WEST JAINTIA HILLS,2021-01-05,8,82,0,90
MEGHALAYA,WEST KHASI HILLS,2021-01-01,0,8,0,8
MEGHALAYA,WEST KHASI HILLS,2021-01-02,1,89,0,90
MEGHALAYA,WEST KHASI HILLS,2021-01-03,0,24,0,24
MEGHALAYA,WEST KHASI HILLS,2021-01-04,0,116,0,116
MEGHALAYA,WEST KHASI HILLS,2021-01-05,1,99,0,100
MIZORAM,AIZAWL,2021-01-01,3,75,0,78
MIZORAM,AIZAWL,2021-01-02,0,147,0,147
MIZORAM,AIZAWL,2021-01-03,0,98,0,98
MIZORAM,AIZAWL,2021-01-04,8,624,0,632
MIZORAM,AIZAWL,2021-01-05,14,506,0,520
MIZORAM,CHAMPHAI,2021-01-01,0,1,0,1
MIZORAM,CHAMPHAI,2021-01-02,0,4,0,4
MIZORAM,CHAMPHAI,2021-01-03,0,1,0,1
MIZORAM,CHAMPHAI,2021-01-04,0,19,0,19
MIZORAM,CHAMPHAI,2021-01-05,0,46,0,46
MIZORAM,HNAHTHIAL,2021-01-04,0,10,0,10
MIZORAM,HNAHTHIAL,2021-01-05,0,25,0,25
MIZORAM,KHAWZAWL,2021-01-02,0,2,0,2
MIZORAM,KOLASIB,2021-01-01,0,26,0,26
MIZORAM,KOLASIB,2021-01-02,1,4,0,5
MIZORAM,KOLASIB,2021-01-03,0,1,0,1
MIZORAM,KOLASIB,2021-01-04,1,18,0,19
MIZORAM,KOLASIB,2021-01-05,0,50,0,50
MIZORAM,LAWNGTLAI,2021-01-01,1,0,0,1
MIZORAM,LAWNGTLAI,2021-01-02,1,28,0,29
MIZORAM,LAWNGTLAI,2021-01-03,0,24,0,24
MIZORAM,LAWNGTLAI,2021-01-04,0,19,0,19
MIZORAM,LAWNGTLAI,2021-01-05,0,3,0,3
MIZORAM,LUNGLEI,2021-01-01,0,43,0,43
MIZORAM,LUNGLEI,2021-01-02,1,99,0,100
MIZORAM,LUNGLEI,2021-01-03,0,77,0,77
MIZORAM,LUNGLEI,2021-01-04,3,56,0,59
MIZORAM,LUNGLEI,2021-01-05,0,85,0,85
MIZORAM,MAMIT,2021-01-01,0,2,0,2
MIZORAM,MAMIT,2021-01-02,0,30,0,30
MIZORAM,MAMIT,2021-01-03,0,5,0,5
MIZORAM,MAMIT,2021-01-04,0,114,0,114
MIZORAM,MAMIT,2021-01-05,0,57,0,57
MIZORAM,SAIHA,2021-01-02,0,5,0,5
MIZORAM,SAIHA,2021-01-05,0,2,0,2
MIZORAM,SAITUAL,2021-01-01,0,8,0,8
MIZORAM,SAITUAL,2021-01-02,0,11,0,11
MIZORAM,SAITUAL,2021-01-03,0,13,0,13
MIZORAM,SAITUAL,2021-01-04,0,33,0,33
MIZORAM,SAITUAL,2021-01-05,0,12,0,12
MIZORAM,SERCHHIP,2021-01-02,1,98,0,99
MIZORAM,SERCHHIP,2021-01-04,0,7,0,7
MIZORAM,SERCHHIP,2021-01-05,0,7,0,7
NAGALAND,DIMAPUR,2021-01-01,4,27,0,31
NAGALAND,DIMAPUR,2021-01-02,0,77,0,77
NAGALAND,DIMAPUR,2021-01-03,0,25,0,25
NAGALAND,DIMAPUR,2021-01-04,3,135,0,138
NAGALAND,DIMAPUR,2021-01-05,3,120,0,123
NAGALAND,KIPHIRE,2021-01-02,0,2,0,2
NAGALAND,KIPHIRE,2021-01-03,0,2,0,2
NAGALAND,KIPHIRE,2021-01-04,0,2,0,2
NAGALAND,KOHIMA,2021-01-01,0,10,0,10
NAGALAND,KOHIMA,2021-01-02,1,5,0,6
NAGALAND,KOHIMA,2021-01-03,0,2,0,2
NAGALAND,KOHIMA,2021-01-04,0,10,0,10
NAGALAND,KOHIMA,2021-01-05,0,17,0,17
NAGALAND,LONGLENG,2021-01-02,0,2,0,2
NAGALAND,LONGLENG,2021-01-04,0,2,0,2
NAGALAND,LONGLENG,2021-01-05,0,3,0,3
NAGALAND,MOKOKCHUNG,2021-01-01,0,5,0,5
NAGALAND,MOKOKCHUNG,2021-01-02,0,34,0,34
NAGALAND,MOKOKCHUNG,2021-01-03,0,13,0,13
NAGALAND,MOKOKCHUNG,2021-01-04,0,8,0,8
NAGALAND,MOKOKCHUNG,2021-01-05,1,4,0,5
NAGALAND,PEREN,2021-01-01,14,136,0,150
NAGALAND,PEREN,2021-01-03,0,1,0,1
NAGALAND,PEREN,2021-01-04,0,2,0,2
NAGALAND,PEREN,2021-01-05,0,2,0,2
NAGALAND,PHEK,2021-01-02,0,24,0,24
NAGALAND,PHEK,2021-01-04,0,6,0,6
NAGALAND,PHEK,2021-01-05,0,2,0,2
NAGALAND,TUENSANG,2021-01-02,0,1,0,1
NAGALAND,TUENSANG,2021-01-05,0,1,0,1
NAGALAND,WOKHA,2021-01-02,0,12,0,12
NAGALAND,WOKHA,2021-01-04,0,7,0,7
NAGALAND,ZUNHEBOTO,2021-01-05,0,4,0,4
ODISHA,ANUGUL,2021-01-01,34,202,0,236
ODISHA,ANUGUL,2021-01-02,7,374,0,381
ODISHA,ANUGUL,2021-01-03,22,226,0,248
ODISHA,ANUGUL,2021-01-04,30,432,0,462
ODISHA,ANUGUL,2021-01-05,18,499,0,517
ODISHA,BALANGIR,2021-01-01,14,347,0,361
ODISHA,BALANGIR,2021-01-02,12,528,0,540
ODISHA,BALANGIR,2021-01-03,5,611,0,616
ODISHA,BALANGIR,2021-01-04,8,1016,3,1027
ODISHA,BALANGIR,2021-01-05,5,1025,0,1030
ODISHA,BALESHWAR,2021-01-01,2,195,0,197
ODISHA,BALESHWAR,2021-01-02,3,407,0,410
ODISHA,BALESHWAR,2021-01-03,1,611,1,613
ODISHA,BALESHWAR,2021-01-04,14,1036,0,1050
ODISHA,BALESHWAR,2021-01-05,10,1059,1,1070
ODISHA,BARGARH,2021-01-01,3,382,2,387
ODISHA,BARGARH,2021-01-02,4,462,1,467
ODISHA,BARGARH,2021-01-03,8,378,0,386
ODISHA,BARGARH,2021-01-04,3,535,1,539
ODISHA,BARGARH,2021-01-05,4,455,0,459
ODISHA,BHADRAK,2021-01-01,0,525,2,527
ODISHA,BHADRAK,2021-01-02,0,1066,2,1068
ODISHA,BHADRAK,2021-01-03,2,741,0,743
ODISHA,BHADRAK,2021-01-04,5,1167,0,1172
ODISHA,BHADRAK,2021-01-05,7,920,0,927
ODISHA,BOUDH,2021-01-01,1,268,0,269
ODISHA,BOUDH,2021-01-02,0,225,0,225
ODISHA,BOUDH,2021-01-03,0,248,0,248
ODISHA,BOUDH,2021-01-04,0,489,0,489
ODISHA,BOUDH,2021-01-05,0,155,0,155
ODISHA,CUTTACK,2021-01-01,4,223,1,228
ODISHA,CUTTACK,2021-01-02,4,449,1,454
ODISHA,CUTTACK,2021-01-03,8,223,0,231
ODISHA,CUTTACK,2021-01-04,22,578,0,600
ODISHA,CUTTACK,2021-01-05,15,739,1,755
ODISHA,DEOGARH,2021-01-01,2,225,0,227
ODISHA,DEOGARH,2021-01-02,2,121,0,123
ODISHA,DEOGARH,2021-01-03,1,202,3,206
ODISHA,DEOGARH,2021-01-04,1,170,0,171
ODISHA,DEOGARH,2021-01-05,2,222,0,224
ODISHA,DHENKANAL,2021-01-01,3,77,0,80
ODISHA,DHENKANAL,2021-01-02,5,259,0,264
ODISHA,DHENKANAL,2021-01-03,0,306,0,306
ODISHA,DHENKANAL,2021-01-04,1,539,0,540
ODISHA,DHENKANAL,2021-01-05,4,596,0,600
ODISHA,GAJAPATI,2021-01-01,0,261,2,263
ODISHA,GAJAPATI,2021-01-02,0,61,0,61
ODISHA,GAJAPATI,2021-01-03,0,160,1,161
ODISHA,GAJAPATI,2021-01-04,3,73,0,76
ODISHA,GAJAPATI,2021-01-05,0,278,0,278
ODISHA,GANJAM,2021-01-01,3,499,0,502
ODISHA,GANJAM,2021-01-02,4,598,39,641
ODISHA,GANJAM,2021-01-03,3,715,0,718
ODISHA,GANJAM,2021-01-04,6,641,2,649
ODISHA,GANJAM,2021-01-05,3,777,21,801
ODISHA,JAGATSINGHAPUR,2021-01-01,0,63,0,63
ODISHA,JAGATSINGHAPUR,2021-01-02,4,124,0,128
ODISHA,JAGATSINGHAPUR,2021-01-03,2,72,0,74
ODISHA,JAGATSINGHAPUR,2021-01-04,3,248,0,251
ODISHA,JAGATSINGHAPUR,2021-01-05,5,334,0,339
ODISHA,JAJAPUR,2021-01-01,6,329,0,335
ODISHA,JAJAPUR,2021-01-02,13,869,0,882
ODISHA,JAJAPUR,2021-01-03,8,217,0,225
ODISHA,JAJAPUR,2021-01-04,15,915,0,930
ODISHA,JAJAPUR,2021-01-05,11,806,0,817
ODISHA,JHARSUGUDA,2021-01-01,9,321,17,347
ODISHA,JHARSUGUDA,2021-01-02,13,250,39,302
ODISHA,JHARSUGUDA,2021-01-03,1,260,0,261
ODISHA,JHARSUGUDA,2021-01-04,7,374,15,396
ODISHA,JHARSUGUDA,2021-01-05,18,463,26,507
ODISHA,KALAHANDI,2021-01-01,0,73,0,73
ODISHA,KALAHANDI,2021-01-02,0,399,0,399
ODISHA,KALAHANDI,2021-01-03,1,323,0,324
ODISHA,KALAHANDI,2021-01-04,1,453,0,454
ODISHA,KALAHANDI,2021-01-05,2,475,0,477
ODISHA,KANDHAMAL,2021-01-01,0,353,0,353
ODISHA,KANDHAMAL,2021-01-02,1,472,0,473
ODISHA,KANDHAMAL,2021-01-03,0,486,0,486
ODISHA,KANDHAMAL,2021-01-04,0,708,0,708
ODISHA,KANDHAMAL,2021-01-05,0,611,0,611
ODISHA,KENDRAPARA,2021-01-01,6,944,0,950
ODISHA,KENDRAPARA,2021-01-02,10,1022,0,1032
ODISHA,KENDRAPARA,2021-01-03,4,745,0,749
ODISHA,KENDRAPARA,2021-01-04,8,1469,1,1478
ODISHA,KENDRAPARA,2021-01-05,9,1548,1,1558
ODISHA,KENDUJHAR,2021-01-01,2,327,0,329
ODISHA,KENDUJHAR,2021-01-02,1,577,0,578
ODISHA,KENDUJHAR,2021-01-03,2,395,0,397
ODISHA,KENDUJHAR,2021-01-04,3,912,1,916
ODISHA,KENDUJHAR,2021-01-05,5,951,0,956
ODISHA,KHORDHA,2021-01-01,14,650,6,670
ODISHA,KHORDHA,2021-01-02,21,1353,2,1376
ODISHA,KHORDHA,2021-01-03,17,974,1,992
ODISHA,KHORDHA,2021-01-04,21,1698,3,1722
ODISHA,KHORDHA,2021-01-05,20,1723,1,1744
ODISHA,KORAPUT,2021-01-01,0,361,0,361
ODISHA,KORAPUT,2021-01-02,1,327,0,328
ODISHA,KORAPUT,2021-01-03,0,224,0,224
ODISHA,KORAPUT,2021-01-04,2,470,0,472
ODISHA,KORAPUT,2021-01-05,1,575,0,576
ODISHA,MALKANGIRI,2021-01-01,0,425,0,425
ODISHA,MALKANGIRI,2021-01-02,1,473,0,474
ODISHA,MALKANGIRI,2021-01-03,0,437,0,437
ODISHA,MALKANGIRI,2021-01-04,0,609,0,609
ODISHA,MALKANGIRI,2021-01-05,0,802,0,802
ODISHA,MAYURBHANJ,2021-01-01,12,281,0,293
ODISHA,MAYURBHANJ,2021-01-02,3,173,0,176
ODISHA,MAYURBHANJ,2021-01-03,7,162,0,169
ODISHA,MAYURBHANJ,2021-01-04,10,450,0,460
ODISHA,MAYURBHANJ,2021-01-05,8,528,0,536
ODISHA,NABARANGPUR,2021-01-01,0,64,0,64
ODISHA,NABARANGPUR,2021-01-02,0,353,0,353
ODISHA,NABARANGPUR,2021-01-03,2,450,0,452
ODISHA,NABARANGPUR,2021-01-04,3,841,1,845
ODISHA,NABARANGPUR,2021-01-05,3,622,0,625
ODISHA,NAYAGARH,2021-01-01,1,237,0,238
ODISHA,NAYAGARH,2021-01-02,0,445,1,446
ODISHA,NAYAGARH,2021-01-03,0,135,0,135
ODISHA,NAYAGARH,2021-01-04,1,308,1,310
ODISHA,NAYAGARH,2021-01-05,0,391,0,391
ODISHA,NUAPADA,2021-01-01,13,306,0,319
ODISHA,NUAPADA,2021-01-02,8,411,0,419
ODISHA,NUAPADA,2021-01-03,8,220,0,228
ODISHA,NUAPADA,2021-01-04,1,369,0,370
ODISHA,NUAPADA,2021-01-05,4,479,0,483
ODISHA,PURI,2021-01-01,1,788,0,789
ODISHA,PURI,2021-01-02,24,1303,0,1327
ODISHA,PURI,2021-01-03,8,1493,0,1501
ODISHA,PURI,2021-01-04,14,1541,1,1556
ODISHA,PURI,2021-01-05,2,1737,0,1739
ODISHA,RAYAGADA,2021-01-01,0,105,0,105
ODISHA,RAYAGADA,2021-01-02,0,86,1,87
ODISHA,RAYAGADA,2021-01-03,0,163,0,163
ODISHA,RAYAGADA,2021-01-04,0,220,1,221
ODISHA,RAYAGADA,2021-01-05,1,460,0,461
ODISHA,SAMBALPUR,2021-01-01,42,453,0,495
ODISHA,SAMBALPUR,2021-01-02,43,719,0,762
ODISHA,SAMBALPUR,2021-01-03,36,525,0,561
ODISHA,SAMBALPUR,2021-01-04,50,639,1,690
ODISHA,SAMBALPUR,2021-01-05,71,682,0,753
ODISHA,SONEPUR,2021-01-01,0,73,0,73
ODISHA,SONEPUR,2021-01-02,0,251,0,251
ODISHA,SONEPUR,2021-01-03,0,261,0,261
ODISHA,SONEPUR,2021-01-04,0,331,0,331
ODISHA,SONEPUR,2021-01-05,0,397,0,397
ODISHA,SUNDARGARH,2021-01-01,16,489,4,509
ODISHA,SUNDARGARH,2021-01-02,24,736,2,762
ODISHA,SUNDARGARH,2021-01-03,26,339,13,378
ODISHA,SUNDARGARH,2021-01-04,38,1191,3,1232
ODISHA,SUNDARGARH,2021-01-05,19,997,0,1016
PUDUCHERRY,KARAIKAL,2021-01-01,6,508,0,514
PUDUCHERRY,KARAIKAL,2021-01-02,5,641,0,646
PUDUCHERRY,KARAIKAL,2021-01-03,2,576,0,578
PUDUCHERRY,KARAIKAL,2021-01-04,9,706,1,716
PUDUCHERRY,KARAIKAL,2021-01-05,8,719,2,729
PUDUCHERRY,MAHE,2021-01-01,15,231,0,246
PUDUCHERRY,MAHE,2021-01-02,18,336,0,354
PUDUCHERRY,MAHE,2021-01-03,5,50,0,55
PUDUCHERRY,MAHE,2021-01-04,12,332,0,344
PUDUCHERRY,MAHE,2021-01-05,8,598,0,606
PUDUCHERRY,PONDICHERRY,2021-01-01,23,324,0,347
PUDUCHERRY,PONDICHERRY,2021-01-02,33,646,1,680
PUDUCHERRY,PONDICHERRY,2021-01-03,35,454,8,497
PUDUCHERRY,PONDICHERRY,2021-01-04,27,901,3,931
PUDUCHERRY,PONDICHERRY,2021-01-05,26,786,4,816
PUDUCHERRY,YANAM,2021-01-01,0,7,0,7
PUDUCHERRY,YANAM,2021-01-02,0,104,0,104
PUDUCHERRY,YANAM,2021-01-03,0,67,0,67
PUDUCHERRY,YANAM,2021-01-04,2,113,0,115
PUDUCHERRY,YANAM,2021-01-05,1,201,0,202
PUNJAB,AMRITSAR,2021-01-01,9,1468,0,1477
PUNJAB,AMRITSAR,2021-01-02,23,1217,3,1243
PUNJAB,AMRITSAR,2021-01-03,22,1218,2,1242
PUNJAB,AMRITSAR,2021-01-04,24,1334,3,1361
PUNJAB,AMRITSAR,2021-01-05,15,1103,1,1119
PUNJAB,BARNALA,2021-01-01,1,290,0,291
PUNJAB,BARNALA,2021-01-02,3,213,10,226
PUNJAB,BARNALA,2021-01-03,4,241,164,409
PUNJAB,BARNALA,2021-01-04,1,54,2,57
PUNJAB,BARNALA,2021-01-05,2,270,0,272
PUNJAB,BATHINDA,2021-01-01,21,669,5,695
PUNJAB,BATHINDA,2021-01-02,23,592,4,619
PUNJAB,BATHINDA,2021-01-03,13,526,4,543
PUNJAB,BATHINDA,2021-01-04,11,584,5,600
PUNJAB,BATHINDA,2021-01-05,23,884,1,908
PUNJAB,FARIDKOT,2021-01-01,10,108,0,118
PUNJAB,FARIDKOT,2021-01-02,7,190,0,197
PUNJAB,FARIDKOT,2021-01-03,11,168,3,182
PUNJAB,FARIDKOT,2021-01-04,8,103,0,111
PUNJAB,FARIDKOT,2021-01-05,1,250,4,255
PUNJAB,FATEHGARH SAHIB,2021-01-01,5,167,0,172
PUNJAB,FATEHGARH SAHIB,2021-01-02,4,309,0,313
PUNJAB,FATEHGARH SAHIB,2021-01-03,1,45,0,46
PUNJAB,FATEHGARH SAHIB,2021-01-04,0,227,0,227
PUNJAB,FATEHGARH SAHIB,2021-01-05,1,87,0,88
PUNJAB,FAZILKA,2021-01-01,3,477,0,480
PUNJAB,FAZILKA,2021-01-02,3,498,1,502
PUNJAB,FAZILKA,2021-01-03,0,423,4,427
PUNJAB,FAZILKA,2021-01-04,1,69,1,71
PUNJAB,FAZILKA,2021-01-05,4,244,0,248
PUNJAB,FIROZEPUR,2021-01-01,1,118,1,120
PUNJAB,FIROZEPUR,2021-01-02,3,352,1,356
PUNJAB,FIROZEPUR,2021-01-03,7,394,1,402
PUNJAB,FIROZEPUR,2021-01-04,1,123,0,124
PUNJAB,FIROZEPUR,2021-01-05,3,433,0,436
PUNJAB,GURDASPUR,2021-01-01,7,944,2,953
PUNJAB,GURDASPUR,2021-01-02,15,1050,0,1065
PUNJAB,GURDASPUR,2021-01-03,9,1230,2,1241
PUNJAB,GURDASPUR,2021-01-04,7,1515,38,1560
PUNJAB,GURDASPUR,2021-01-05,5,1503,0,1508
PUNJAB,HOSHIARPUR,2021-01-01,27,944,0,971
PUNJAB,HOSHIARPUR,2021-01-02,13,1016,2,1031
PUNJAB,HOSHIARPUR,2021-01-03,8,1923,1,1932
PUNJAB,HOSHIARPUR,2021-01-04,21,1519,2,1542
PUNJAB,HOSHIARPUR,2021-01-05,19,2141,25,2185
PUNJAB,JALANDHAR,2021-01-01,40,1164,12,1216
PUNJAB,JALANDHAR,2021-01-02,29,3431,105,3565
PUNJAB,JALANDHAR,2021-01-03,23,2274,91,2388
PUNJAB,JALANDHAR,2021-01-04,26,1304,43,1373
PUNJAB,JALANDHAR,2021-01-05,42,2318,28,2388
PUNJAB,KAPURTHALA,2021-01-01,5,183,0,188
PUNJAB,KAPURTHALA,2021-01-02,10,1150,2,1162
PUNJAB,KAPURTHALA,2021-01-03,12,878,1,891
PUNJAB,KAPURTHALA,2021-01-04,10,618,3,631
PUNJAB,KAPURTHALA,2021-01-05,2,650,2,654
PUNJAB,LUDHIANA,2021-01-01,61,2018,5,2084
PUNJAB,LUDHIANA,2021-01-02,37,2503,13,2553
PUNJAB,LUDHIANA,2021-01-03,31,1893,4,1928
PUNJAB,LUDHIANA,2021-01-04,44,2073,5,2122
PUNJAB,LUDHIANA,2021-01-05,39,1577,6,1622
PUNJAB,MANSA,2021-01-01,4,302,0,306
PUNJAB,MANSA,2021-01-02,0,189,0,189
PUNJAB,MANSA,2021-01-03,4,445,1,450
PUNJAB,MANSA,2021-01-04,7,250,0,257
PUNJAB,MANSA,2021-01-05,8,504,0,512
PUNJAB,MOGA,2021-01-01,1,202,0,203
PUNJAB,MOGA,2021-01-02,4,168,0,172
PUNJAB,MOGA,2021-01-03,0,248,5,253
PUNJAB,MOGA,2021-01-04,6,87,0,93
PUNJAB,MOGA,2021-01-05,5,321,1,327
PUNJAB,PATHANKOT,2021-01-01,5,815,3,823
PUNJAB,PATHANKOT,2021-01-02,4,358,0,362
PUNJAB,PATHANKOT,2021-01-03,3,610,2,615
PUNJAB,PATHANKOT,2021-01-04,6,359,0,365
PUNJAB,PATHANKOT,2021-01-05,19,284,0,303
PUNJAB,PATIALA,2021-01-01,28,647,0,675
PUNJAB,PATIALA,2021-01-02,37,1575,0,1612
PUNJAB,PATIALA,2021-01-03,29,383,0,412
PUNJAB,PATIALA,2021-01-04,21,880,0,901
PUNJAB,PATIALA,2021-01-05,30,1035,4,1069
PUNJAB,RUPNAGAR,2021-01-01,15,579,1,595
PUNJAB,RUPNAGAR,2021-01-02,7,673,1,681
PUNJAB,RUPNAGAR,2021-01-03,7,636,2,645
PUNJAB,RUPNAGAR,2021-01-04,17,608,1,626
PUNJAB,RUPNAGAR,2021-01-05,10,721,63,794
PUNJAB,S.A.S NAGAR,2021-01-01,62,558,4,624
PUNJAB,S.A.S NAGAR,2021-01-02,59,677,6,742
PUNJAB,S.A.S NAGAR,2021-01-03,71,493,5,569
PUNJAB,S.A.S NAGAR,2021-01-04,93,937,13,1043
PUNJAB,S.A.S NAGAR,2021-01-05,87,1101,11,1199
PUNJAB,SANGRUR,2021-01-01,0,1153,0,1153
PUNJAB,SANGRUR,2021-01-02,4,924,1,929
PUNJAB,SANGRUR,2021-01-03,1,969,3,973
PUNJAB,SANGRUR,2021-01-04,2,925,2,929
PUNJAB,SANGRUR,2021-01-05,6,929,0,935
PUNJAB,SHAHID BHAGAT SINGH NAGAR,2021-01-01,5,419,0,424
PUNJAB,SHAHID BHAGAT SINGH NAGAR,2021-01-02,14,451,1,466
PUNJAB,SHAHID BHAGAT SINGH NAGAR,2021-01-03,3,876,1,880
PUNJAB,SHAHID BHAGAT SINGH NAGAR,2021-01-04,5,68,0,73
PUNJAB,SHAHID BHAGAT SINGH NAGAR,2021-01-05,20,1080,2,1102
PUNJAB,SRI MUKTSAR SAHIB,2021-01-01,4,490,0,494
PUNJAB,SRI MUKTSAR SAHIB,2021-01-02,1,278,0,279
PUNJAB,SRI MUKTSAR SAHIB,2021-01-03,2,457,17,476
PUNJAB,SRI MUKTSAR SAHIB,2021-01-04,1,409,4,414
PUNJAB,SRI MUKTSAR SAHIB,2021-01-05,6,112,0,118
PUNJAB,TARN TARAN,2021-01-01,0,643,1,644
PUNJAB,TARN TARAN,2021-01-02,1,382,0,383
PUNJAB,TARN TARAN,2021-01-03,1,437,0,438
PUNJAB,TARN TARAN,2021-01-04,0,581,0,581
PUNJAB,TARN TARAN,2021-01-05,1,797,0,798
RAJASTHAN,AJMER,2021-01-01,13,65,560,638
RAJASTHAN,AJMER,2021-01-02,10,80,748,838
RAJASTHAN,AJMER,2021-01-03,14,61,370,445
RAJASTHAN,AJMER,2021-01-04,10,74,733,817
RAJASTHAN,AJMER,2021-01-05,15,96,711,822
RAJASTHAN,ALWAR,2021-01-01,59,1315,7,1381
RAJASTHAN,ALWAR,2021-01-02,188,1128,6,1322
RAJASTHAN,ALWAR,2021-01-03,168,1516,11,1695
RAJASTHAN,ALWAR,2021-01-04,93,1253,16,1362
RAJASTHAN,ALWAR,2021-01-05,146,812,5,963
RAJASTHAN,BANSWARA,2021-01-01,2,88,0,90
RAJASTHAN,BANSWARA,2021-01-02,1,54,0,55
RAJASTHAN,BANSWARA,2021-01-03,1,148,0,149
RAJASTHAN,BANSWARA,2021-01-04,1,29,0,30
RAJASTHAN,BANSWARA,2021-01-05,3,77,0,80
RAJASTHAN,BARAN,2021-01-01,6,186,0,192
RAJASTHAN,BARAN,2021-01-02,5,158,0,163
RAJASTHAN,BARAN,2021-01-03,8,215,0,223
RAJASTHAN,BARAN,2021-01-04,7,149,0,156
RAJASTHAN,BARAN,2021-01-05,9,110,0,119
RAJASTHAN,BARMER,2021-01-01,3,480,0,483
RAJASTHAN,BARMER,2021-01-02,5,420,1,426
RAJASTHAN,BARMER,2021-01-03,2,183,1,186
RAJASTHAN,BARMER,2021-01-04,0,445,1,446
RAJASTHAN,BARMER,2021-01-05,2,124,0,126
RAJASTHAN,BHARATPUR,2021-01-01,2,1069,3,1074
RAJASTHAN,BHARATPUR,2021-01-02,35,1575,6,1616
RAJASTHAN,BHARATPUR,2021-01-03,6,884,5,895
RAJASTHAN,BHARATPUR,2021-01-04,8,700,2,710
RAJASTHAN,BHARATPUR,2021-01-05,11,877,8,896
RAJASTHAN,BHILWARA,2021-01-01,61,420,0,481
RAJASTHAN,BHILWARA,2021-01-02,28,278,2,308
RAJASTHAN,BHILWARA,2021-01-03,61,393,3,457
RAJASTHAN,BHILWARA,2021-01-04,27,271,2,300
RAJASTHAN,BHILWARA,2021-01-05,68,636,4,708
RAJASTHAN,BIKANER,2021-01-01,34,262,3,299
RAJASTHAN,BIKANER,2021-01-02,0,533,0,533
RAJASTHAN,BIKANER,2021-01-03,1,53,0,54
RAJASTHAN,BIKANER,2021-01-04,6,726,5,737
RAJASTHAN,BIKANER,2021-01-05,3,878,1,882
RAJASTHAN,BUNDI,2021-01-01,0,318,0,318
RAJASTHAN,BUNDI,2021-01-02,2,188,0,190
RAJASTHAN,BUNDI,2021-01-03,1,160,0,161
RAJASTHAN,BUNDI,2021-01-04,3,142,2,147
RAJASTHAN,BUNDI,2021-01-05,39,80,0,119
RAJASTHAN,CHITTORGARH,2021-01-01,12,572,10,594
RAJASTHAN,CHITTORGARH,2021-01-02,17,620,4,641
RAJASTHAN,CHITTORGARH,2021-01-03,18,609,6,633
RAJASTHAN,CHITTORGARH,2021-01-04,17,1127,13,1157
RAJASTHAN,CHITTORGARH,2021-01-05,24,735,0,759
RAJASTHAN,CHURU,2021-01-01,2,576,8,586
RAJASTHAN,CHURU,2021-01-02,2,451,4,457
RAJASTHAN,CHURU,2021-01-03,5,363,4,372
RAJASTHAN,CHURU,2021-01-04,4,101,2,107
RAJASTHAN,CHURU,2021-01-05,3,432,2,437
RAJASTHAN,DAUSA,2021-01-01,0,319,26,345
RAJASTHAN,DAUSA,2021-01-02,5,324,17,346
RAJASTHAN,DAUSA,2021-01-03,2,214,27,243
RAJASTHAN,DAUSA,2021-01-04,1,65,8,74
RAJASTHAN,DAUSA,2021-01-05,3,304,14,321
RAJASTHAN,DHOLPUR,2021-01-01,12,182,3,197
RAJASTHAN,DHOLPUR,2021-01-02,4,18,0,22
RAJASTHAN,DHOLPUR,2021-01-03,0,77,0,77
RAJASTHAN,DHOLPUR,2021-01-04,5,482,4,491
RAJASTHAN,DHOLPUR,2021-01-05,25,599,13,637
RAJASTHAN,DUNGARPUR,2021-01-01,15,179,0,194
RAJASTHAN,DUNGARPUR,2021-01-02,30,354,0,384
RAJASTHAN,DUNGARPUR,2021-01-03,16,238,0,254
RAJASTHAN,DUNGARPUR,2021-01-04,13,240,0,253
RAJASTHAN,DUNGARPUR,2021-01-05,15,374,0,389
RAJASTHAN,GANGANAGAR,2021-01-01,2,25,0,27
RAJASTHAN,GANGANAGAR,2021-01-02,2,34,1,37
RAJASTHAN,GANGANAGAR,2021-01-03,1,18,0,19
RAJASTHAN,GANGANAGAR,2021-01-04,2,24,0,26
RAJASTHAN,GANGANAGAR,2021-01-05,2,26,0,28
RAJASTHAN,HANUMANGARH,2021-01-01,8,587,1,596
RAJASTHAN,HANUMANGARH,2021-01-02,5,656,3,664
RAJASTHAN,HANUMANGARH,2021-01-03,4,608,2,614
RAJASTHAN,HANUMANGARH,2021-01-04,1,206,4,211
RAJASTHAN,HANUMANGARH,2021-01-05,5,695,2,702
RAJASTHAN,JAIPUR,2021-01-01,141,2543,364,3048
RAJASTHAN,JAIPUR,2021-01-02,211,2999,359,3569
RAJASTHAN,JAIPUR,2021-01-03,133,2782,276,3191
RAJASTHAN,JAIPUR,2021-01-04,211,2685,355,3251
RAJASTHAN,JAIPUR,2021-01-05,207,2476,302,2985
RAJASTHAN,JAISALMER,2021-01-01,0,4,0,4
RAJASTHAN,JAISALMER,2021-01-02,0,108,0,108
RAJASTHAN,JAISALMER,2021-01-03,2,156,0,158
RAJASTHAN,JAISALMER,2021-01-04,30,131,0,161
RAJASTHAN,JAISALMER,2021-01-05,0,210,0,210
RAJASTHAN,JALORE,2021-01-01,0,6,0,6
RAJASTHAN,JALORE,2021-01-02,1,8,0,9
RAJASTHAN,JALORE,2021-01-03,0,1,0,1
RAJASTHAN,JALORE,2021-01-04,0,16,1,17
RAJASTHAN,JALORE,2021-01-05,1,6,0,7
RAJASTHAN,JHALAWAR,2021-01-01,17,393,2,412
RAJASTHAN,JHALAWAR,2021-01-02,1,536,0,537
RAJASTHAN,JHALAWAR,2021-01-03,34,294,12,340
RAJASTHAN,JHALAWAR,2021-01-04,19,481,9,509
RAJASTHAN,JHALAWAR,2021-01-05,1,824,0,825
RAJASTHAN,JHUNJHUNU,2021-01-01,2,92,3,97
RAJASTHAN,JHUNJHUNU,2021-01-02,2,72,6,80
RAJASTHAN,JHUNJHUNU,2021-01-03,2,98,11,111
RAJASTHAN,JHUNJHUNU,2021-01-04,4,94,7,105
RAJASTHAN,JHUNJHUNU,2021-01-05,5,68,7,80
RAJASTHAN,JODHPUR,2021-01-01,39,1065,3,1107
RAJASTHAN,JODHPUR,2021-01-02,55,1066,7,1128
RAJASTHAN,JODHPUR,2021-01-03,42,857,5,904
RAJASTHAN,JODHPUR,2021-01-04,65,662,3,730
RAJASTHAN,JODHPUR,2021-01-05,49,984,8,1041
RAJASTHAN,KARAULI,2021-01-01,1,29,5,35
RAJASTHAN,KARAULI,2021-01-02,6,289,7,302
RAJASTHAN,KARAULI,2021-01-03,1,275,9,285
RAJASTHAN,KARAULI,2021-01-04,8,500,9,517
RAJASTHAN,KARAULI,2021-01-05,8,263,7,278
RAJASTHAN,KOTA,2021-01-01,4,958,1,963
RAJASTHAN,KOTA,2021-01-02,39,944,1,984
RAJASTHAN,KOTA,2021-01-03,1,1059,4,1064
RAJASTHAN,KOTA,2021-01-04,138,1153,2,1293
RAJASTHAN,KOTA,2021-01-05,200,1244,2,1446
RAJASTHAN,NAGAUR,2021-01-01,3,333,402,738
RAJASTHAN,NAGAUR,2021-01-02,2,287,416,705
RAJASTHAN,NAGAUR,2021-01-03,25,111,73,209
RAJASTHAN,NAGAUR,2021-01-04,119,327,207,653
RAJASTHAN,NAGAUR,2021-01-05,9,471,445,925
RAJASTHAN,PALI,2021-01-01,37,572,5,614
RAJASTHAN,PALI,2021-01-02,31,312,2,345
RAJASTHAN,PALI,2021-01-03,41,875,46,962
RAJASTHAN,PALI,2021-01-04,91,1220,12,1323
RAJASTHAN,PALI,2021-01-05,4,116,2,122
RAJASTHAN,PRATAPGARH,2021-01-01,1,4,0,5
RAJASTHAN,PRATAPGARH,2021-01-02,0,10,0,10
RAJASTHAN,PRATAPGARH,2021-01-03,1,4,0,5
RAJASTHAN,PRATAPGARH,2021-01-04,0,5,0,5
RAJASTHAN,PRATAPGARH,2021-01-05,0,13,0,13
RAJASTHAN,RAJSAMAND,2021-01-01,34,430,4,468
RAJASTHAN,RAJSAMAND,2021-01-02,27,370,3,400
RAJASTHAN,RAJSAMAND,2021-01-03,31,399,4,434
RAJASTHAN,RAJSAMAND,2021-01-04,37,478,5,520
RAJASTHAN,RAJSAMAND,2021-01-05,20,629,2,651
RAJASTHAN,SAWAI MADHOPUR,2021-01-01,69,661,11,741
RAJASTHAN,SAWAI MADHOPUR,2021-01-02,12,662,20,694
RAJASTHAN,SAWAI MADHOPUR,2021-01-03,6,446,13,465
RAJASTHAN,SAWAI MADHOPUR,2021-01-04,8,345,18,371
RAJASTHAN,SAWAI MADHOPUR,2021-01-05,7,358,4,369
RAJASTHAN,SIKAR,2021-01-01,1,109,6,116
RAJASTHAN,SIKAR,2021-01-02,2,84,13,99
RAJASTHAN,SIKAR,2021-01-03,10,154,22,186
RAJASTHAN,SIKAR,2021-01-04,2,123,12,137
RAJASTHAN,SIKAR,2021-01-05,5,75,11,91
RAJASTHAN,SIROHI,2021-01-01,1,263,0,264
RAJASTHAN,SIROHI,2021-01-02,12,439,1,452
RAJASTHAN,SIROHI,2021-01-03,1,4,1,6
RAJASTHAN,SIROHI,2021-01-04,30,391,0,421
RAJASTHAN,SIROHI,2021-01-05,0,302,0,302
RAJASTHAN,TONK,2021-01-01,2,79,7,88
RAJASTHAN,TONK,2021-01-02,0,38,5,43
RAJASTHAN,TONK,2021-01-03,1,55,7,63
RAJASTHAN,TONK,2021-01-04,0,159,7,166
RAJASTHAN,TONK,2021-01-05,1,63,9,73
RAJASTHAN,UDAIPUR,2021-01-01,179,615,0,794
RAJASTHAN,UDAIPUR,2021-01-02,127,914,1,1042
RAJASTHAN,UDAIPUR,2021-01-03,117,572,1,690
RAJASTHAN,UDAIPUR,2021-01-04,135,759,2,896
RAJASTHAN,UDAIPUR,2021-01-05,201,839,1,1041
SIKKIM,EAST DISTRICT,2021-01-01,9,66,0,75
SIKKIM,EAST DISTRICT,2021-01-02,1,73,0,74
SIKKIM,EAST DISTRICT,2021-01-03,3,11,0,14
SIKKIM,EAST DISTRICT,2021-01-04,14,167,0,181
SIKKIM,EAST DISTRICT,2021-01-05,16,229,0,245
SIKKIM,NORTH DISTRICT,2021-01-01,0,2,0,2
SIKKIM,NORTH DISTRICT,2021-01-02,0,2,0,2
SIKKIM,NORTH DISTRICT,2021-01-03,0,2,0,2
SIKKIM,NORTH DISTRICT,2021-01-04,0,7,0,7
SIKKIM,NORTH DISTRICT,2021-01-05,0,7,0,7
SIKKIM,SOUTH DISTRICT,2021-01-01,0,9,0,9
SIKKIM,SOUTH DISTRICT,2021-01-02,0,7,0,7
SIKKIM,SOUTH DISTRICT,2021-01-03,0,2,0,2
SIKKIM,SOUTH DISTRICT,2021-01-04,10,59,0,69
SIKKIM,SOUTH DISTRICT,2021-01-05,2,20,0,22
SIKKIM,WEST DISTRICT,2021-01-01,3,3,0,6
SIKKIM,WEST DISTRICT,2021-01-02,0,1,0,1
SIKKIM,WEST DISTRICT,2021-01-04,0,5,0,5
SIKKIM,WEST DISTRICT,2021-01-05,0,16,0,16
TAMIL NADU,ARIYALUR,2021-01-01,0,184,0,184
TAMIL NADU,ARIYALUR,2021-01-02,0,392,0,392
TAMIL NADU,ARIYALUR,2021-01-03,2,77,0,79
TAMIL NADU,ARIYALUR,2021-01-04,2,121,1,124
TAMIL NADU,ARIYALUR,2021-01-05,2,441,0,443
TAMIL NADU,CHENGALPATTU,2021-01-01,31,3285,0,3316
TAMIL NADU,CHENGALPATTU,2021-01-02,35,2541,0,2576
TAMIL NADU,CHENGALPATTU,2021-01-03,23,1898,0,1921
TAMIL NADU,CHENGALPATTU,2021-01-04,35,1925,0,1960
TAMIL NADU,CHENGALPATTU,2021-01-05,29,4079,2,4110
TAMIL NADU,CHENNAI,2021-01-01,241,8801,11,9053
TAMIL NADU,CHENNAI,2021-01-02,215,7343,8,7566
TAMIL NADU,CHENNAI,2021-01-03,236,9489,19,9744
TAMIL NADU,CHENNAI,2021-01-04,239,8550,8,8797
TAMIL NADU,CHENNAI,2021-01-05,247,12167,43,12457
TAMIL NADU,COIMBATORE,2021-01-01,82,3510,1,3593
TAMIL NADU,COIMBATORE,2021-01-02,64,2513,1,2578
TAMIL NADU,COIMBATORE,2021-01-03,99,2523,0,2622
TAMIL NADU,COIMBATORE,2021-01-04,76,1932,0,2008
TAMIL NADU,COIMBATORE,2021-01-05,101,2111,0,2212
TAMIL NADU,CUDDALORE,2021-01-01,9,841,2,852
TAMIL NADU,CUDDALORE,2021-01-02,20,1677,1,1698
TAMIL NADU,CUDDALORE,2021-01-03,6,843,0,849
TAMIL NADU,CUDDALORE,2021-01-04,9,1858,0,1867
TAMIL NADU,CUDDALORE,2021-01-05,9,1517,1,1527
TAMIL NADU,DHARMAPURI,2021-01-01,10,908,0,918
TAMIL NADU,DHARMAPURI,2021-01-02,7,735,2,744
TAMIL NADU,DHARMAPURI,2021-01-03,3,908,0,911
TAMIL NADU,DHARMAPURI,2021-01-04,6,744,0,750
TAMIL NADU,DHARMAPURI,2021-01-05,10,896,0,906
TAMIL NADU,DINDIGUL,2021-01-01,15,958,0,973
TAMIL NADU,DINDIGUL,2021-01-02,7,1378,0,1385
TAMIL NADU,DINDIGUL,2021-01-03,7,694,0,701
TAMIL NADU,DINDIGUL,2021-01-04,5,1529,3,1537
TAMIL NADU,DINDIGUL,2021-01-05,9,1249,3,1261
TAMIL NADU,ERODE,2021-01-01,33,1631,0,1664
TAMIL NADU,ERODE,2021-01-02,27,1267,0,1294
TAMIL NADU,ERODE,2021-01-03,31,1006,0,1037
TAMIL NADU,ERODE,2021-01-04,14,1264,1,1279
TAMIL NADU,ERODE,2021-01-05,34,1841,0,1875
TAMIL NADU,KALLAKURICHI,2021-01-01,0,737,1,738
TAMIL NADU,KALLAKURICHI,2021-01-02,2,604,1,607
TAMIL NADU,KALLAKURICHI,2021-01-03,0,622,0,622
TAMIL NADU,KALLAKURICHI,2021-01-04,0,900,0,900
TAMIL NADU,KALLAKURICHI,2021-01-05,0,419,0,419
TAMIL NADU,KANCHIPURAM,2021-01-01,14,1394,0,1408
TAMIL NADU,KANCHIPURAM,2021-01-02,23,3469,0,3492
TAMIL NADU,KANCHIPURAM,2021-01-03,8,2374,0,2382
TAMIL NADU,KANCHIPURAM,2021-01-04,17,3298,0,3315
TAMIL NADU,KANCHIPURAM,2021-01-05,25,3618,0,3643
TAMIL NADU,KANNIYAKUMARI,2021-01-01,18,1697,3,1718
TAMIL NADU,KANNIYAKUMARI,2021-01-02,13,1561,0,1574
TAMIL NADU,KANNIYAKUMARI,2021-01-03,20,1800,1,1821
TAMIL NADU,KANNIYAKUMARI,2021-01-04,20,1837,2,1859
TAMIL NADU,KANNIYAKUMARI,2021-01-05,10,2303,2,2315
TAMIL NADU,KARUR,2021-01-01,4,1043,0,1047
TAMIL NADU,KARUR,2021-01-02,14,993,1,1008
TAMIL NADU,KARUR,2021-01-03,11,1174,2,1187
TAMIL NADU,KARUR,2021-01-04,10,871,1,882
TAMIL NADU,KARUR,2021-01-05,9,1213,20,1242
TAMIL NADU,KRISHNAGIRI,2021-01-01,3,316,0,319
TAMIL NADU,KRISHNAGIRI,2021-01-02,2,804,1,807
TAMIL NADU,KRISHNAGIRI,2021-01-03,3,563,0,566
TAMIL NADU,KRISHNAGIRI,2021-01-04,5,1121,0,1126
TAMIL NADU,KRISHNAGIRI,2021-01-05,10,1393,1,1404
TAMIL NADU,MADURAI,2021-01-01,19,2287,0,2306
TAMIL NADU,MADURAI,2021-01-02,13,2347,1,2361
TAMIL NADU,MADURAI,2021-01-03,19,2306,0,2325
TAMIL NADU,MADURAI,2021-01-04,6,4578,1,4585
TAMIL NADU,MADURAI,2021-01-05,18,4443,3,4464
TAMIL NADU,NAGAPATTINAM,2021-01-01,3,424,0,427
TAMIL NADU,NAGAPATTINAM,2021-01-02,14,686,0,700
TAMIL NADU,NAGAPATTINAM,2021-01-03,16,624,0,640
TAMIL NADU,NAGAPATTINAM,2021-01-04,5,240,0,245
TAMIL NADU,NAGAPATTINAM,2021-01-05,9,763,0,772
TAMIL NADU,NAMAKKAL,2021-01-01,15,431,0,446
TAMIL NADU,NAMAKKAL,2021-01-02,18,1507,0,1525
TAMIL NADU,NAMAKKAL,2021-01-03,10,893,0,903
TAMIL NADU,NAMAKKAL,2021-01-04,18,4729,8,4755
TAMIL NADU,NAMAKKAL,2021-01-05,14,1502,1,1517
TAMIL NADU,PERAMBALUR,2021-01-01,1,53,0,54
TAMIL NADU,PERAMBALUR,2021-01-02,0,293,0,293
TAMIL NADU,PERAMBALUR,2021-01-03,0,337,0,337
TAMIL NADU,PERAMBALUR,2021-01-04,0,492,1,493
TAMIL NADU,PERAMBALUR,2021-01-05,0,376,1,377
TAMIL NADU,PUDUKKOTTAI,2021-01-01,6,852,0,858
TAMIL NADU,PUDUKKOTTAI,2021-01-02,2,467,0,469
TAMIL NADU,PUDUKKOTTAI,2021-01-03,2,693,0,695
TAMIL NADU,PUDUKKOTTAI,2021-01-04,4,709,0,713
TAMIL NADU,PUDUKKOTTAI,2021-01-05,3,968,0,971
TAMIL NADU,RAMANATHAPURAM,2021-01-01,0,340,0,340
TAMIL NADU,RAMANATHAPURAM,2021-01-02,3,364,0,367
TAMIL NADU,RAMANATHAPURAM,2021-01-03,3,132,0,135
TAMIL NADU,RAMANATHAPURAM,2021-01-04,2,587,0,589
TAMIL NADU,RAMANATHAPURAM,2021-01-05,3,664,0,667
TAMIL NADU,RANIPET,2021-01-01,4,231,0,235
TAMIL NADU,RANIPET,2021-01-02,6,358,0,364
TAMIL NADU,RANIPET,2021-01-03,5,153,0,158
TAMIL NADU,RANIPET,2021-01-04,5,1517,0,1522
TAMIL NADU,RANIPET,2021-01-05,21,1747,1,1769
TAMIL NADU,SALEM,2021-01-01,27,567,1,595
TAMIL NADU,SALEM,2021-01-02,24,1809,24,1857
TAMIL NADU,SALEM,2021-01-03,30,1188,36,1254
TAMIL NADU,SALEM,2021-01-04,35,1239,56,1330
TAMIL NADU,SALEM,2021-01-05,28,1180,32,1240
TAMIL NADU,SIVAGANGA,2021-01-01,1,867,0,868
TAMIL NADU,SIVAGANGA,2021-01-02,1,492,0,493
TAMIL NADU,SIVAGANGA,2021-01-03,2,404,0,406
TAMIL NADU,SIVAGANGA,2021-01-04,4,269,0,273
TAMIL NADU,SIVAGANGA,2021-01-05,3,877,0,880
TAMIL NADU,TENKASI,2021-01-01,2,655,0,657
TAMIL NADU,TENKASI,2021-01-02,0,826,0,826
TAMIL NADU,TENKASI,2021-01-03,7,938,0,945
TAMIL NADU,TENKASI,2021-01-04,0,540,0,540
TAMIL NADU,TENKASI,2021-01-05,2,873,0,875
TAMIL NADU,THANJAVUR,2021-01-01,27,489,0,516
TAMIL NADU,THANJAVUR,2021-01-02,21,1101,0,1122
TAMIL NADU,THANJAVUR,2021-01-03,12,313,1,326
TAMIL NADU,THANJAVUR,2021-01-04,17,1353,1,1371
TAMIL NADU,THANJAVUR,2021-01-05,13,1057,0,1070
TAMIL NADU,THE NILGIRIS,2021-01-01,14,1785,11,1810
TAMIL NADU,THE NILGIRIS,2021-01-02,17,1673,0,1690
TAMIL NADU,THE NILGIRIS,2021-01-03,9,978,0,987
TAMIL NADU,THE NILGIRIS,2021-01-04,13,2016,0,2029
TAMIL NADU,THE NILGIRIS,2021-01-05,9,1387,0,1396
TAMIL NADU,THENI,2021-01-01,8,261,0,269
TAMIL NADU,THENI,2021-01-02,4,540,0,544
TAMIL NADU,THENI,2021-01-03,4,155,0,159
TAMIL NADU,THENI,2021-01-04,5,314,0,319
TAMIL NADU,THENI,2021-01-05,3,219,0,222
TAMIL NADU,THIRUVALLUR,2021-01-01,20,1603,0,1623
TAMIL NADU,THIRUVALLUR,2021-01-02,16,4138,1,4155
TAMIL NADU,THIRUVALLUR,2021-01-03,31,2099,0,2130
TAMIL NADU,THIRUVALLUR,2021-01-04,27,3201,2,3230
TAMIL NADU,THIRUVALLUR,2021-01-05,26,2001,4,2031
TAMIL NADU,THIRUVARUR,2021-01-01,4,269,0,273
TAMIL NADU,THIRUVARUR,2021-01-02,6,724,0,730
TAMIL NADU,THIRUVARUR,2021-01-03,6,245,0,251
TAMIL NADU,THIRUVARUR,2021-01-04,8,1514,0,1522
TAMIL NADU,THIRUVARUR,2021-01-05,7,2036,0,2043
TAMIL NADU,TIRUCHIRAPPALLI,2021-01-01,12,1848,1,1861
TAMIL NADU,TIRUCHIRAPPALLI,2021-01-02,28,1043,1,1072
TAMIL NADU,TIRUCHIRAPPALLI,2021-01-03,16,1257,0,1273
TAMIL NADU,TIRUCHIRAPPALLI,2021-01-04,18,1222,1,1241
TAMIL NADU,TIRUCHIRAPPALLI,2021-01-05,25,1620,0,1645
TAMIL NADU,TIRUNELVELI,2021-01-01,9,724,0,733
TAMIL NADU,TIRUNELVELI,2021-01-02,10,1287,0,1297
TAMIL NADU,TIRUNELVELI,2021-01-03,8,652,0,660
TAMIL NADU,TIRUNELVELI,2021-01-04,6,1567,0,1573
TAMIL NADU,TIRUNELVELI,2021-01-05,23,1469,0,1492
TAMIL NADU,TIRUPATHUR,2021-01-01,2,1339,0,1341
TAMIL NADU,TIRUPATHUR,2021-01-02,7,3416,8,3431
TAMIL NADU,TIRUPATHUR,2021-01-03,4,2187,2,2193
TAMIL NADU,TIRUPATHUR,2021-01-04,0,1960,0,1960
TAMIL NADU,TIRUPATHUR,2021-01-05,4,2319,0,2323
TAMIL NADU,TIRUPPUR,2021-01-01,27,1799,0,1826
TAMIL NADU,TIRUPPUR,2021-01-02,21,1743,1,1765
TAMIL NADU,TIRUPPUR,2021-01-03,31,1238,0,1269
TAMIL NADU,TIRUPPUR,2021-01-04,21,1919,0,1940
TAMIL NADU,TIRUPPUR,2021-01-05,25,1562,0,1587
TAMIL NADU,TIRUVANNAMALAI,2021-01-01,6,390,0,396
TAMIL NADU,TIRUVANNAMALAI,2021-01-02,8,946,3,957
TAMIL NADU,TIRUVANNAMALAI,2021-01-03,12,362,0,374
TAMIL NADU,TIRUVANNAMALAI,2021-01-04,15,851,2,868
TAMIL NADU,TIRUVANNAMALAI,2021-01-05,10,1267,1,1278
TAMIL NADU,TUTICORIN,2021-01-01,3,1297,0,1300
TAMIL NADU,TUTICORIN,2021-01-02,6,542,0,548
TAMIL NADU,TUTICORIN,2021-01-03,3,1300,0,1303
TAMIL NADU,TUTICORIN,2021-01-04,5,669,0,674
TAMIL NADU,TUTICORIN,2021-01-05,14,1328,0,1342
TAMIL NADU,VELLORE,2021-01-01,12,738,0,750
TAMIL NADU,VELLORE,2021-01-02,12,1700,0,1712
TAMIL NADU,VELLORE,2021-01-03,8,678,0,686
TAMIL NADU,VELLORE,2021-01-04,7,2051,0,2058
TAMIL NADU,VELLORE,2021-01-05,33,1616,0,1649
TAMIL NADU,VILLUPURAM,2021-01-01,10,443,0,453
TAMIL NADU,VILLUPURAM,2021-01-02,6,1496,1,1503
TAMIL NADU,VILLUPURAM,2021-01-03,10,321,0,331
TAMIL NADU,VILLUPURAM,2021-01-04,4,1317,1,1322
TAMIL NADU,VILLUPURAM,2021-01-05,0,190,2,192
TAMIL NADU,VIRUDHUNAGAR,2021-01-01,6,642,0,648
TAMIL NADU,VIRUDHUNAGAR,2021-01-02,13,1564,0,1577
TAMIL NADU,VIRUDHUNAGAR,2021-01-03,6,1390,1,1397
TAMIL NADU,VIRUDHUNAGAR,2021-01-04,11,1740,0,1751
TAMIL NADU,VIRUDHUNAGAR,2021-01-05,4,1952,1,1957
TELANGANA,ADILABAD,2021-01-01,1,561,0,562
TELANGANA,ADILABAD,2021-01-02,1,528,0,529
TELANGANA,ADILABAD,2021-01-03,2,311,0,313
TELANGANA,ADILABAD,2021-01-04,0,581,0,581
TELANGANA,ADILABAD,2021-01-05,0,546,0,546
TELANGANA,BHADRADRI KOTHAGUDEM,2021-01-01,0,572,0,572
TELANGANA,BHADRADRI KOTHAGUDEM,2021-01-02,0,1108,0,1108
TELANGANA,BHADRADRI KOTHAGUDEM,2021-01-03,0,709,0,709
TELANGANA,BHADRADRI KOTHAGUDEM,2021-01-04,0,1713,0,1713
TELANGANA,BHADRADRI KOTHAGUDEM,2021-01-05,0,1187,0,1187
TELANGANA,HYDERABAD,2021-01-01,35,5719,1,5755
TELANGANA,HYDERABAD,2021-01-02,53,7263,4,7320
TELANGANA,HYDERABAD,2021-01-03,53,4977,2,5032
TELANGANA,HYDERABAD,2021-01-04,41,7777,6,7824
TELANGANA,HYDERABAD,2021-01-05,68,8004,1,8073
TELANGANA,JAGITIAL,2021-01-01,0,299,0,299
TELANGANA,JAGITIAL,2021-01-02,0,476,0,476
TELANGANA,JAGITIAL,2021-01-03,0,208,0,208
TELANGANA,JAGITIAL,2021-01-04,0,500,0,500
TELANGANA,JAGITIAL,2021-01-05,0,432,0,432
TELANGANA,JANGOAN,2021-01-01,0,491,0,491
TELANGANA,JANGOAN,2021-01-02,0,862,0,862
TELANGANA,JANGOAN,2021-01-03,0,487,0,487
TELANGANA,JANGOAN,2021-01-04,0,816,0,816
TELANGANA,JANGOAN,2021-01-05,0,805,0,805
TELANGANA,JAYASHANKAR BHUPALAPALLY,2021-01-01,0,58,0,58
TELANGANA,JAYASHANKAR BHUPALAPALLY,2021-01-02,0,231,0,231
TELANGANA,JAYASHANKAR BHUPALAPALLY,2021-01-03,0,64,0,64
TELANGANA,JAYASHANKAR BHUPALAPALLY,2021-01-04,0,286,0,286
TELANGANA,JAYASHANKAR BHUPALAPALLY,2021-01-05,0,148,0,148
TELANGANA,JOGULAMBA GADWAL,2021-01-01,0,475,0,475
TELANGANA,JOGULAMBA GADWAL,2021-01-02,0,601,0,601
TELANGANA,JOGULAMBA GADWAL,2021-01-03,0,272,0,272
TELANGANA,JOGULAMBA GADWAL,2021-01-04,0,796,0,796
TELANGANA,JOGULAMBA GADWAL,2021-01-05,0,445,0,445
TELANGANA,KAMAREDDY,2021-01-01,0,262,0,262
TELANGANA,KAMAREDDY,2021-01-02,1,705,0,706
TELANGANA,KAMAREDDY,2021-01-03,0,123,0,123
TELANGANA,KAMAREDDY,2021-01-04,0,924,0,924
TELANGANA,KAMAREDDY,2021-01-05,0,786,0,786
TELANGANA,KARIMNAGAR,2021-01-01,4,704,0,708
TELANGANA,KARIMNAGAR,2021-01-02,2,1162,0,1164
TELANGANA,KARIMNAGAR,2021-01-03,4,661,0,665
TELANGANA,KARIMNAGAR,2021-01-04,6,1376,0,1382
TELANGANA,KARIMNAGAR,2021-01-05,11,1267,0,1278
TELANGANA,KHAMMAM,2021-01-01,0,455,0,455
TELANGANA,KHAMMAM,2021-01-02,0,1282,0,1282
TELANGANA,KHAMMAM,2021-01-03,2,293,0,295
TELANGANA,KHAMMAM,2021-01-04,2,1568,0,1570
TELANGANA,KHAMMAM,2021-01-05,5,1044,0,1049
TELANGANA,KUMURAM BHEEM ASIFABAD,2021-01-01,0,486,0,486
TELANGANA,KUMURAM BHEEM ASIFABAD,2021-01-02,0,749,0,749
TELANGANA,KUMURAM BHEEM ASIFABAD,2021-01-03,0,387,0,387
TELANGANA,KUMURAM BHEEM ASIFABAD,2021-01-04,0,1022,0,1022
TELANGANA,KUMURAM BHEEM ASIFABAD,2021-01-05,0,888,0,888
TELANGANA,MAHABUBABAD,2021-01-01,0,517,0,517
TELANGANA,MAHABUBABAD,2021-01-02,0,570,0,570
TELANGANA,MAHABUBABAD,2021-01-03,0,628,0,628
TELANGANA,MAHABUBABAD,2021-01-04,0,1205,0,1205
TELANGANA,MAHABUBABAD,2021-01-05,0,814,0,814
TELANGANA,MAHABUBNAGAR,2021-01-01,0,478,0,478
TELANGANA,MAHABUBNAGAR,2021-01-02,0,812,0,812
TELANGANA,MAHABUBNAGAR,2021-01-03,0,312,0,312
TELANGANA,MAHABUBNAGAR,2021-01-04,0,726,0,726
TELANGANA,MAHABUBNAGAR,2021-01-05,0,844,0,844
TELANGANA,MANCHERIAL,2021-01-01,0,362,0,362
TELANGANA,MANCHERIAL,2021-01-02,0,770,0,770
TELANGANA,MANCHERIAL,2021-01-03,0,331,0,331
TELANGANA,MANCHERIAL,2021-01-04,0,736,0,736
TELANGANA,MANCHERIAL,2021-01-05,0,732,0,732
TELANGANA,MEDAK,2021-01-01,0,147,0,147
TELANGANA,MEDAK,2021-01-02,1,257,0,258
TELANGANA,MEDAK,2021-01-03,0,106,0,106
TELANGANA,MEDAK,2021-01-04,1,411,0,412
TELANGANA,MEDAK,2021-01-05,0,306,0,306
TELANGANA,MEDCHAL MALKAJGIRI,2021-01-01,6,775,0,781
TELANGANA,MEDCHAL MALKAJGIRI,2021-01-02,4,1593,0,1597
TELANGANA,MEDCHAL MALKAJGIRI,2021-01-03,0,463,0,463
TELANGANA,MEDCHAL MALKAJGIRI,2021-01-04,1,1917,0,1918
TELANGANA,MEDCHAL MALKAJGIRI,2021-01-05,2,1737,0,1739
TELANGANA,MULUGU,2021-01-01,0,136,0,136
TELANGANA,MULUGU,2021-01-02,0,184,0,184
TELANGANA,MULUGU,2021-01-03,0,62,0,62
TELANGANA,MULUGU,2021-01-04,0,211,0,211
TELANGANA,MULUGU,2021-01-05,0,168,0,168
TELANGANA,NAGARKURNOOL,2021-01-01,0,918,0,918
TELANGANA,NAGARKURNOOL,2021-01-02,0,909,0,909
TELANGANA,NAGARKURNOOL,2021-01-03,0,806,0,806
TELANGANA,NAGARKURNOOL,2021-01-04,0,1128,0,1128
TELANGANA,NAGARKURNOOL,2021-01-05,0,1189,0,1189
TELANGANA,NALGONDA,2021-01-01,0,144,0,144
TELANGANA,NALGONDA,2021-01-02,0,449,0,449
TELANGANA,NALGONDA,2021-01-03,1,90,0,91
TELANGANA,NALGONDA,2021-01-04,1,628,0,629
TELANGANA,NALGONDA,2021-01-05,1,660,0,661
TELANGANA,NARAYANPET,2021-01-01,0,275,0,275
TELANGANA,NARAYANPET,2021-01-02,0,386,0,386
TELANGANA,NARAYANPET,2021-01-03,0,98,0,98
TELANGANA,NARAYANPET,2021-01-04,0,274,0,274
TELANGANA,NARAYANPET,2021-01-05,0,527,0,527
TELANGANA,NIRMAL,2021-01-01,0,618,0,618
TELANGANA,NIRMAL,2021-01-02,0,1021,0,1021
TELANGANA,NIRMAL,2021-01-03,0,443,0,443
TELANGANA,NIRMAL,2021-01-04,0,1283,0,1283
TELANGANA,NIRMAL,2021-01-05,0,846,0,846
TELANGANA,NIZAMABAD,2021-01-01,3,186,0,189
TELANGANA,NIZAMABAD,2021-01-02,0,442,0,442
TELANGANA,NIZAMABAD,2021-01-03,0,119,0,119
TELANGANA,NIZAMABAD,2021-01-04,0,687,0,687
TELANGANA,NIZAMABAD,2021-01-05,1,460,0,461
TELANGANA,PEDDAPALLI,2021-01-01,0,474,0,474
TELANGANA,PEDDAPALLI,2021-01-02,0,1117,0,1117
TELANGANA,PEDDAPALLI,2021-01-03,0,344,0,344
TELANGANA,PEDDAPALLI,2021-01-04,0,1337,0,1337
TELANGANA,PEDDAPALLI,2021-01-05,0,1072,0,1072
TELANGANA,RAJANNA SIRCILLA,2021-01-01,0,241,0,241
TELANGANA,RAJANNA SIRCILLA,2021-01-02,0,629,0,629
TELANGANA,RAJANNA SIRCILLA,2021-01-03,0,184,0,184
TELANGANA,RAJANNA SIRCILLA,2021-01-04,0,312,0,312
TELANGANA,RAJANNA SIRCILLA,2021-01-05,1,377,0,378
TELANGANA,RANGA REDDY,2021-01-01,16,1500,0,1516
TELANGANA,RANGA REDDY,2021-01-02,8,2054,1,2063
TELANGANA,RANGA REDDY,2021-01-03,7,1103,1,1111
TELANGANA,RANGA REDDY,2021-01-04,6,2237,0,2243
TELANGANA,RANGA REDDY,2021-01-05,9,2214,0,2223
TELANGANA,SANGAREDDY,2021-01-01,0,849,0,849
TELANGANA,SANGAREDDY,2021-01-02,0,970,0,970
TELANGANA,SANGAREDDY,2021-01-03,0,502,0,502
TELANGANA,SANGAREDDY,2021-01-04,0,1390,0,1390
TELANGANA,SANGAREDDY,2021-01-05,0,1578,0,1578
TELANGANA,SIDDIPET,2021-01-01,0,1385,0,1385
TELANGANA,SIDDIPET,2021-01-02,0,1475,0,1475
TELANGANA,SIDDIPET,2021-01-03,0,1734,0,1734
TELANGANA,SIDDIPET,2021-01-04,0,2167,0,2167
TELANGANA,SIDDIPET,2021-01-05,0,2298,0,2298
TELANGANA,SURYAPET,2021-01-01,0,632,0,632
TELANGANA,SURYAPET,2021-01-02,0,1299,0,1299
TELANGANA,SURYAPET,2021-01-03,0,1011,0,1011
TELANGANA,SURYAPET,2021-01-04,1,1175,0,1176
TELANGANA,SURYAPET,2021-01-05,1,1162,0,1163
TELANGANA,VIKARABAD,2021-01-01,0,387,0,387
TELANGANA,VIKARABAD,2021-01-02,0,680,0,680
TELANGANA,VIKARABAD,2021-01-03,0,405,0,405
TELANGANA,VIKARABAD,2021-01-04,0,476,0,476
TELANGANA,VIKARABAD,2021-01-05,1,750,0,751
TELANGANA,WANAPARTHY,2021-01-01,0,209,0,209
TELANGANA,WANAPARTHY,2021-01-02,0,379,0,379
TELANGANA,WANAPARTHY,2021-01-03,0,150,0,150
TELANGANA,WANAPARTHY,2021-01-04,0,362,0,362
TELANGANA,WANAPARTHY,2021-01-05,0,335,0,335
TELANGANA,WARANGAL RURAL,2021-01-01,0,383,0,383
TELANGANA,WARANGAL RURAL,2021-01-02,0,722,0,722
TELANGANA,WARANGAL RURAL,2021-01-03,0,456,0,456
TELANGANA,WARANGAL RURAL,2021-01-04,0,901,0,901
TELANGANA,WARANGAL RURAL,2021-01-05,0,570,0,570
TELANGANA,WARANGAL URBAN,2021-01-01,1,1432,0,1433
TELANGANA,WARANGAL URBAN,2021-01-02,0,2263,0,2263
TELANGANA,WARANGAL URBAN,2021-01-03,0,1678,0,1678
TELANGANA,WARANGAL URBAN,2021-01-04,1,2627,0,2628
TELANGANA,WARANGAL URBAN,2021-01-05,0,2777,0,2777
TELANGANA,YADADRI BHUVANAGIRI,2021-01-01,0,82,0,82
TELANGANA,YADADRI BHUVANAGIRI,2021-01-02,0,229,0,229
TELANGANA,YADADRI BHUVANAGIRI,2021-01-03,0,107,0,107
TELANGANA,YADADRI BHUVANAGIRI,2021-01-04,0,399,0,399
TELANGANA,YADADRI BHUVANAGIRI,2021-01-05,0,382,0,382
TRIPURA,DHALAI,2021-01-01,0,73,0,73
TRIPURA,DHALAI,2021-01-02,0,51,0,51
TRIPURA,DHALAI,2021-01-03,0,7,0,7
TRIPURA,DHALAI,2021-01-04,1,88,0,89
TRIPURA,DHALAI,2021-01-05,0,108,0,108
TRIPURA,GOMATI,2021-01-01,0,68,0,68
TRIPURA,GOMATI,2021-01-02,0,92,0,92
TRIPURA,GOMATI,2021-01-03,0,33,0,33
TRIPURA,GOMATI,2021-01-04,0,40,0,40
TRIPURA,GOMATI,2021-01-05,0,83,0,83
TRIPURA,KHOWAI,2021-01-01,0,71,0,71
TRIPURA,KHOWAI,2021-01-02,0,93,0,93
TRIPURA,KHOWAI,2021-01-03,0,9,0,9
TRIPURA,KHOWAI,2021-01-04,0,50,0,50
TRIPURA,KHOWAI,2021-01-05,0,80,0,80
TRIPURA,NORTH TRIPURA,2021-01-01,0,102,0,102
TRIPURA,NORTH TRIPURA,2021-01-02,1,143,0,144
TRIPURA,NORTH TRIPURA,2021-01-03,0,94,0,94
TRIPURA,NORTH TRIPURA,2021-01-04,0,144,0,144
TRIPURA,NORTH TRIPURA,2021-01-05,0,107,0,107
TRIPURA,SEPAHIJALA,2021-01-01,0,157,0,157
TRIPURA,SEPAHIJALA,2021-01-02,0,132,0,132
TRIPURA,SEPAHIJALA,2021-01-03,0,41,0,41
TRIPURA,SEPAHIJALA,2021-01-04,0,123,0,123
TRIPURA,SEPAHIJALA,2021-01-05,0,123,0,123
TRIPURA,SOUTH TRIPURA,2021-01-01,1,235,0,236
TRIPURA,SOUTH TRIPURA,2021-01-02,0,253,0,253
TRIPURA,SOUTH TRIPURA,2021-01-03,0,181,0,181
TRIPURA,SOUTH TRIPURA,2021-01-04,0,127,0,127
TRIPURA,SOUTH TRIPURA,2021-01-05,4,151,0,155
TRIPURA,UNAKOTI,2021-01-01,0,4,0,4
TRIPURA,UNAKOTI,2021-01-02,0,8,0,8
TRIPURA,UNAKOTI,2021-01-03,0,3,0,3
TRIPURA,UNAKOTI,2021-01-04,0,8,0,8
TRIPURA,UNAKOTI,2021-01-05,0,7,0,7
TRIPURA,WEST TRIPURA,2021-01-01,5,419,0,424
TRIPURA,WEST TRIPURA,2021-01-02,2,450,0,452
TRIPURA,WEST TRIPURA,2021-01-03,2,166,0,168
TRIPURA,WEST TRIPURA,2021-01-04,2,444,0,446
TRIPURA,WEST TRIPURA,2021-01-05,4,245,0,249
UTTAR PRADESH,AGRA,2021-01-01,18,2903,15,2936
UTTAR PRADESH,AGRA,2021-01-02,23,1383,7,1413
UTTAR PRADESH,AGRA,2021-01-03,12,2612,9,2633
UTTAR PRADESH,AGRA,2021-01-04,14,1469,9,1492
UTTAR PRADESH,AGRA,2021-01-05,27,2287,14,2328
UTTAR PRADESH,ALIGARH,2021-01-01,16,2763,4,2783
UTTAR PRADESH,ALIGARH,2021-01-02,11,1348,3,1362
UTTAR PRADESH,ALIGARH,2021-01-03,8,2296,6,2310
UTTAR PRADESH,ALIGARH,2021-01-04,11,2823,1,2835
UTTAR PRADESH,ALIGARH,2021-01-05,8,2668,0,2676
UTTAR PRADESH,AMBEDKAR NAGAR,2021-01-01,2,1079,0,1081
UTTAR PRADESH,AMBEDKAR NAGAR,2021-01-02,3,1379,2,1384
UTTAR PRADESH,AMBEDKAR NAGAR,2021-01-03,2,1498,1,1501
UTTAR PRADESH,AMBEDKAR NAGAR,2021-01-04,5,1233,1,1239
UTTAR PRADESH,AMBEDKAR NAGAR,2021-01-05,4,1335,0,1339
UTTAR PRADESH,AMETHI,2021-01-01,7,1622,0,1629
UTTAR PRADESH,AMETHI,2021-01-02,8,1150,1,1159
UTTAR PRADESH,AMETHI,2021-01-03,3,1181,20,1204
UTTAR PRADESH,AMETHI,2021-01-04,6,1493,0,1499
UTTAR PRADESH,AMETHI,2021-01-05,3,1181,31,1215
UTTAR PRADESH,AMROHA,2021-01-01,4,1284,8,1296
UTTAR PRADESH,AMROHA,2021-01-02,11,1716,3,1730
UTTAR PRADESH,AMROHA,2021-01-03,1,1134,0,1135
UTTAR PRADESH,AMROHA,2021-01-04,3,778,0,781
UTTAR PRADESH,AMROHA,2021-01-05,14,1223,0,1237
UTTAR PRADESH,AURAIYA,2021-01-01,7,1089,53,1149
UTTAR PRADESH,AURAIYA,2021-01-02,3,395,24,422
UTTAR PRADESH,AURAIYA,2021-01-03,4,935,0,939
UTTAR PRADESH,AURAIYA,2021-01-04,3,1194,7,1204
UTTAR PRADESH,AURAIYA,2021-01-05,7,641,9,657
UTTAR PRADESH,AYODHYA,2021-01-01,7,1853,2,1862
UTTAR PRADESH,AYODHYA,2021-01-02,3,1798,0,1801
UTTAR PRADESH,AYODHYA,2021-01-03,17,1755,6,1778
UTTAR PRADESH,AYODHYA,2021-01-04,13,1494,1,1508
UTTAR PRADESH,AYODHYA,2021-01-05,12,1892,0,1904
UTTAR PRADESH,AZAMGARH,2021-01-01,7,745,41,793
UTTAR PRADESH,AZAMGARH,2021-01-02,0,984,5,989
UTTAR PRADESH,AZAMGARH,2021-01-03,1,1070,59,1130
UTTAR PRADESH,AZAMGARH,2021-01-04,4,340,7,351
UTTAR PRADESH,AZAMGARH,2021-01-05,5,1543,9,1557
UTTAR PRADESH,BAGHPAT,2021-01-01,2,1721,4,1727
UTTAR PRADESH,BAGHPAT,2021-01-02,11,1299,96,1406
UTTAR PRADESH,BAGHPAT,2021-01-03,5,2074,46,2125
UTTAR PRADESH,BAGHPAT,2021-01-04,2,1524,25,1551
UTTAR PRADESH,BAGHPAT,2021-01-05,0,179,9,188
UTTAR PRADESH,BAHRAICH,2021-01-01,2,1505,11,1518
UTTAR PRADESH,BAHRAICH,2021-01-02,3,1543,16,1562
UTTAR PRADESH,BAHRAICH,2021-01-03,7,1765,38,1810
UTTAR PRADESH,BAHRAICH,2021-01-04,2,1789,32,1823
UTTAR PRADESH,BAHRAICH,2021-01-05,5,2035,2,2042
UTTAR PRADESH,BALLIA,2021-01-01,10,889,4,903
UTTAR PRADESH,BALLIA,2021-01-02,9,992,2,1003
UTTAR PRADESH,BALLIA,2021-01-03,10,513,1,524
UTTAR PRADESH,BALLIA,2021-01-04,5,982,16,1003
UTTAR PRADESH,BALLIA,2021-01-05,3,626,31,660
UTTAR PRADESH,BALRAMPUR,2021-01-01,3,791,1,795
UTTAR PRADESH,BALRAMPUR,2021-01-02,3,1040,71,1114
UTTAR PRADESH,BALRAMPUR,2021-01-03,3,662,20,685
UTTAR PRADESH,BALRAMPUR,2021-01-04,4,1280,0,1284
UTTAR PRADESH,BALRAMPUR,2021-01-05,3,1324,0,1327
UTTAR PRADESH,BANDA,2021-01-01,18,1711,9,1738
UTTAR PRADESH,BANDA,2021-01-02,9,2403,8,2420
UTTAR PRADESH,BANDA,2021-01-03,8,2067,11,2086
UTTAR PRADESH,BANDA,2021-01-04,7,2142,3,2152
UTTAR PRADESH,BANDA,2021-01-05,6,1810,4,1820
UTTAR PRADESH,BARABANKI,2021-01-01,2,1343,5,1350
UTTAR PRADESH,BARABANKI,2021-01-02,5,1231,15,1251
UTTAR PRADESH,BARABANKI,2021-01-03,10,1468,2,1480
UTTAR PRADESH,BARABANKI,2021-01-04,4,1523,15,1542
UTTAR PRADESH,BARABANKI,2021-01-05,5,1481,10,1496
UTTAR PRADESH,BAREILLY,2021-01-01,26,2288,104,2418
UTTAR PRADESH,BAREILLY,2021-01-02,21,3045,23,3089
UTTAR PRADESH,BAREILLY,2021-01-03,34,1471,9,1514
UTTAR PRADESH,BAREILLY,2021-01-04,24,2453,20,2497
UTTAR PRADESH,BAREILLY,2021-01-05,41,2664,11,2716
UTTAR PRADESH,BASTI,2021-01-01,5,1771,1,1777
UTTAR PRADESH,BASTI,2021-01-02,4,1397,11,1412
UTTAR PRADESH,BASTI,2021-01-03,2,1142,7,1151
UTTAR PRADESH,BASTI,2021-01-04,5,1150,22,1177
UTTAR PRADESH,BASTI,2021-01-05,2,1695,36,1733
UTTAR PRADESH,BHADOHI,2021-01-01,3,1506,0,1509
UTTAR PRADESH,BHADOHI,2021-01-02,1,1470,0,1471
UTTAR PRADESH,BHADOHI,2021-01-03,1,1433,79,1513
UTTAR PRADESH,BHADOHI,2021-01-04,1,1499,0,1500
UTTAR PRADESH,BHADOHI,2021-01-05,0,1497,3,1500
UTTAR PRADESH,BIJNOR,2021-01-01,13,1495,0,1508
UTTAR PRADESH,BIJNOR,2021-01-02,7,839,3,849
UTTAR PRADESH,BIJNOR,2021-01-03,4,2258,5,2267
UTTAR PRADESH,BIJNOR,2021-01-04,17,1008,9,1034
UTTAR PRADESH,BIJNOR,2021-01-05,9,1412,2,1423
UTTAR PRADESH,BUDAUN,2021-01-01,7,1447,10,1464
UTTAR PRADESH,BUDAUN,2021-01-02,6,523,10,539
UTTAR PRADESH,BUDAUN,2021-01-03,5,1441,21,1467
UTTAR PRADESH,BUDAUN,2021-01-04,1,2343,33,2377
UTTAR PRADESH,BUDAUN,2021-01-05,31,2438,32,2501
UTTAR PRADESH,BULANDSHAHR,2021-01-01,3,775,0,778
UTTAR PRADESH,BULANDSHAHR,2021-01-02,4,3252,1,3257
UTTAR PRADESH,BULANDSHAHR,2021-01-03,7,623,3,633
UTTAR PRADESH,BULANDSHAHR,2021-01-04,17,2238,10,2265
UTTAR PRADESH,BULANDSHAHR,2021-01-05,11,1368,2,1381
UTTAR PRADESH,CHANDAULI,2021-01-01,5,605,2,612
UTTAR PRADESH,CHANDAULI,2021-01-02,11,1014,16,1041
UTTAR PRADESH,CHANDAULI,2021-01-03,0,738,20,758
UTTAR PRADESH,CHANDAULI,2021-01-04,8,1021,10,1039
UTTAR PRADESH,CHANDAULI,2021-01-05,7,1348,7,1362
UTTAR PRADESH,CHITRAKOOT,2021-01-01,6,813,1,820
UTTAR PRADESH,CHITRAKOOT,2021-01-02,0,908,60,968
UTTAR PRADESH,CHITRAKOOT,2021-01-03,2,890,5,897
UTTAR PRADESH,CHITRAKOOT,2021-01-04,4,1241,27,1272
UTTAR PRADESH,CHITRAKOOT,2021-01-05,3,1286,1,1290
UTTAR PRADESH,DEORIA,2021-01-01,2,1161,134,1297
UTTAR PRADESH,DEORIA,2021-01-02,9,1212,33,1254
UTTAR PRADESH,DEORIA,2021-01-03,2,851,5,858
UTTAR PRADESH,DEORIA,2021-01-04,3,1751,30,1784
UTTAR PRADESH,DEORIA,2021-01-05,4,2239,1,2244
UTTAR PRADESH,ETAH,2021-01-01,0,2630,18,2648
UTTAR PRADESH,ETAH,2021-01-02,1,6312,0,6313
UTTAR PRADESH,ETAH,2021-01-03,3,836,2,841
UTTAR PRADESH,ETAH,2021-01-04,3,1702,18,1723
UTTAR PRADESH,ETAH,2021-01-05,1,814,5,820
UTTAR PRADESH,ETAWAH,2021-01-01,2,688,121,811
UTTAR PRADESH,ETAWAH,2021-01-02,5,4919,56,4980
UTTAR PRADESH,ETAWAH,2021-01-03,5,1716,156,1877
UTTAR PRADESH,ETAWAH,2021-01-04,2,1277,81,1360
UTTAR PRADESH,ETAWAH,2021-01-05,3,1620,144,1767
UTTAR PRADESH,FARRUKHABAD,2021-01-01,2,755,0,757
UTTAR PRADESH,FARRUKHABAD,2021-01-02,6,1041,80,1127
UTTAR PRADESH,FARRUKHABAD,2021-01-03,3,573,49,625
UTTAR PRADESH,FARRUKHABAD,2021-01-04,10,1212,20,1242
UTTAR PRADESH,FARRUKHABAD,2021-01-05,22,1534,62,1618
UTTAR PRADESH,FATEHPUR,2021-01-01,4,1448,2,1454
UTTAR PRADESH,FATEHPUR,2021-01-02,5,1524,2,1531
UTTAR PRADESH,FATEHPUR,2021-01-03,2,1073,48,1123
UTTAR PRADESH,FATEHPUR,2021-01-04,8,1197,3,1208
UTTAR PRADESH,FATEHPUR,2021-01-05,3,780,1,784
UTTAR PRADESH,FIROZABAD,2021-01-01,0,1570,5,1575
UTTAR PRADESH,FIROZABAD,2021-01-02,4,1713,18,1735
UTTAR PRADESH,FIROZABAD,2021-01-03,1,1274,0,1275
UTTAR PRADESH,FIROZABAD,2021-01-04,13,1589,14,1616
UTTAR PRADESH,FIROZABAD,2021-01-05,6,1347,10,1363
UTTAR PRADESH,GAUTAM BUDDHA NAGAR,2021-01-01,71,2464,3,2538
UTTAR PRADESH,GAUTAM BUDDHA NAGAR,2021-01-02,81,2190,6,2277
UTTAR PRADESH,GAUTAM BUDDHA NAGAR,2021-01-03,70,2699,8,2777
UTTAR PRADESH,GAUTAM BUDDHA NAGAR,2021-01-04,73,2694,6,2773
UTTAR PRADESH,GAUTAM BUDDHA NAGAR,2021-01-05,130,3549,44,3723
UTTAR PRADESH,GHAZIABAD,2021-01-01,100,4301,8,4409
UTTAR PRADESH,GHAZIABAD,2021-01-02,72,2036,11,2119
UTTAR PRADESH,GHAZIABAD,2021-01-03,81,2841,26,2948
UTTAR PRADESH,GHAZIABAD,2021-01-04,107,2439,23,2569
UTTAR PRADESH,GHAZIABAD,2021-01-05,87,3723,14,3824
UTTAR PRADESH,GHAZIPUR,2021-01-01,7,671,12,690
UTTAR PRADESH,GHAZIPUR,2021-01-02,9,848,18,875
UTTAR PRADESH,GHAZIPUR,2021-01-03,9,676,32,717
UTTAR PRADESH,GHAZIPUR,2021-01-04,5,1299,6,1310
UTTAR PRADESH,GHAZIPUR,2021-01-05,4,654,5,663
UTTAR PRADESH,GONDA,2021-01-01,4,1402,91,1497
UTTAR PRADESH,GONDA,2021-01-02,0,1671,45,1716
UTTAR PRADESH,GONDA,2021-01-03,2,1376,0,1378
UTTAR PRADESH,GONDA,2021-01-04,3,1553,3,1559
UTTAR PRADESH,GONDA,2021-01-05,3,1189,72,1264
UTTAR PRADESH,GORAKHPUR,2021-01-01,18,2807,79,2904
UTTAR PRADESH,GORAKHPUR,2021-01-02,25,1748,31,1804
UTTAR PRADESH,GORAKHPUR,2021-01-03,37,3487,73,3597
UTTAR PRADESH,GORAKHPUR,2021-01-04,18,1561,57,1636
UTTAR PRADESH,GORAKHPUR,2021-01-05,15,3525,26,3566
UTTAR PRADESH,HAMIRPUR,2021-01-01,0,1091,6,1097
UTTAR PRADESH,HAMIRPUR,2021-01-02,2,836,1,839
UTTAR PRADESH,HAMIRPUR,2021-01-03,0,1237,1,1238
UTTAR PRADESH,HAMIRPUR,2021-01-04,0,1275,2,1277
UTTAR PRADESH,HAMIRPUR,2021-01-05,1,1196,13,1210
UTTAR PRADESH,HAPUR,2021-01-01,4,1135,20,1159
UTTAR PRADESH,HAPUR,2021-01-02,3,669,22,694
UTTAR PRADESH,HAPUR,2021-01-03,5,2626,2,2633
UTTAR PRADESH,HAPUR,2021-01-04,6,294,0,300
UTTAR PRADESH,HAPUR,2021-01-05,4,2070,128,2202
UTTAR PRADESH,HARDOI,2021-01-01,2,1321,14,1337
UTTAR PRADESH,HARDOI,2021-01-02,6,1801,49,1856
UTTAR PRADESH,HARDOI,2021-01-03,3,974,3,980
UTTAR PRADESH,HARDOI,2021-01-04,13,1815,11,1839
UTTAR PRADESH,HARDOI,2021-01-05,2,1514,56,1572
UTTAR PRADESH,HATHRAS,2021-01-01,0,1040,41,1081
UTTAR PRADESH,HATHRAS,2021-01-02,2,914,2,918
UTTAR PRADESH,HATHRAS,2021-01-03,2,1169,1,1172
UTTAR PRADESH,HATHRAS,2021-01-04,0,464,1,465
UTTAR PRADESH,HATHRAS,2021-01-05,1,1805,0,1806
UTTAR PRADESH,JALAUN,2021-01-01,4,997,2,1003
UTTAR PRADESH,JALAUN,2021-01-02,4,1066,3,1073
UTTAR PRADESH,JALAUN,2021-01-03,9,787,1,797
UTTAR PRADESH,JALAUN,2021-01-04,1,1430,1,1432
UTTAR PRADESH,JALAUN,2021-01-05,1,1739,6,1746
UTTAR PRADESH,JAUNPUR,2021-01-01,4,1635,5,1644
UTTAR PRADESH,JAUNPUR,2021-01-02,5,1257,0,1262
UTTAR PRADESH,JAUNPUR,2021-01-03,5,1144,0,1149
UTTAR PRADESH,JAUNPUR,2021-01-04,9,1473,0,1482
UTTAR PRADESH,JAUNPUR,2021-01-05,3,1476,7,1486
UTTAR PRADESH,JHANSI,2021-01-01,10,2220,4,2234
UTTAR PRADESH,JHANSI,2021-01-02,20,3562,1,3583
UTTAR PRADESH,JHANSI,2021-01-03,17,2000,4,2021
UTTAR PRADESH,JHANSI,2021-01-04,17,2869,4,2890
UTTAR PRADESH,JHANSI,2021-01-05,13,4035,4,4052
UTTAR PRADESH,KANNAUJ,2021-01-01,1,1357,5,1363
UTTAR PRADESH,KANNAUJ,2021-01-02,1,1564,6,1571
UTTAR PRADESH,KANNAUJ,2021-01-03,3,1483,1,1487
UTTAR PRADESH,KANNAUJ,2021-01-04,6,2468,1,2475
UTTAR PRADESH,KANNAUJ,2021-01-05,4,1488,1,1493
UTTAR PRADESH,KANPUR DEHAT,2021-01-01,1,1050,4,1055
UTTAR PRADESH,KANPUR DEHAT,2021-01-02,1,1265,3,1269
UTTAR PRADESH,KANPUR DEHAT,2021-01-03,2,866,12,880
UTTAR PRADESH,KANPUR DEHAT,2021-01-04,2,1083,6,1091
UTTAR PRADESH,KANPUR DEHAT,2021-01-05,2,1464,8,1474
UTTAR PRADESH,KANPUR NAGAR,2021-01-01,35,3157,19,3211
UTTAR PRADESH,KANPUR NAGAR,2021-01-02,19,3510,30,3559
UTTAR PRADESH,KANPUR NAGAR,2021-01-03,39,3060,43,3142
UTTAR PRADESH,KANPUR NAGAR,2021-01-04,65,3303,17,3385
UTTAR PRADESH,KANPUR NAGAR,2021-01-05,40,3951,74,4065
UTTAR PRADESH,KASGANJ,2021-01-01,0,583,0,583
UTTAR PRADESH,KASGANJ,2021-01-02,2,1840,10,1852
UTTAR PRADESH,KASGANJ,2021-01-03,0,97,9,106
UTTAR PRADESH,KASGANJ,2021-01-04,1,2041,12,2054
UTTAR PRADESH,KASGANJ,2021-01-05,3,1266,6,1275
UTTAR PRADESH,KAUSHAMBI,2021-01-01,0,1119,0,1119
UTTAR PRADESH,KAUSHAMBI,2021-01-02,0,1384,1,1385
UTTAR PRADESH,KAUSHAMBI,2021-01-03,0,2318,0,2318
UTTAR PRADESH,KAUSHAMBI,2021-01-04,3,1199,0,1202
UTTAR PRADESH,KAUSHAMBI,2021-01-05,1,1836,0,1837
UTTAR PRADESH,KHERI,2021-01-01,9,1584,13,1606
UTTAR PRADESH,KHERI,2021-01-02,4,1708,10,1722
UTTAR PRADESH,KHERI,2021-01-03,4,1492,65,1561
UTTAR PRADESH,KHERI,2021-01-04,7,1620,15,1642
UTTAR PRADESH,KHERI,2021-01-05,6,1682,16,1704
UTTAR PRADESH,KUSHI NAGAR,2021-01-01,0,2396,19,2415
UTTAR PRADESH,KUSHI NAGAR,2021-01-02,14,1173,21,1208
UTTAR PRADESH,KUSHI NAGAR,2021-01-03,2,734,112,848
UTTAR PRADESH,KUSHI NAGAR,2021-01-04,2,838,129,969
UTTAR PRADESH,KUSHI NAGAR,2021-01-05,3,1432,31,1466
UTTAR PRADESH,LALITPUR,2021-01-01,3,1701,1,1705
UTTAR PRADESH,LALITPUR,2021-01-02,6,1386,0,1392
UTTAR PRADESH,LALITPUR,2021-01-03,7,1191,1,1199
UTTAR PRADESH,LALITPUR,2021-01-04,16,1120,0,1136
UTTAR PRADESH,LALITPUR,2021-01-05,12,1054,1,1067
UTTAR PRADESH,LUCKNOW,2021-01-01,169,7550,265,7984
UTTAR PRADESH,LUCKNOW,2021-01-02,149,6466,261,6876
UTTAR PRADESH,LUCKNOW,2021-01-03,191,6829,196,7216
UTTAR PRADESH,LUCKNOW,2021-01-04,173,7275,368,7816
UTTAR PRADESH,LUCKNOW,2021-01-05,167,8273,260,8700
UTTAR PRADESH,MAHARAJGANJ,2021-01-01,1,1424,7,1432
UTTAR PRADESH,MAHARAJGANJ,2021-01-02,8,1100,33,1141
UTTAR PRADESH,MAHARAJGANJ,2021-01-03,0,593,61,654
UTTAR PRADESH,MAHARAJGANJ,2021-01-04,1,1144,52,1197
UTTAR PRADESH,MAHARAJGANJ,2021-01-05,2,1929,52,1983
UTTAR PRADESH,MAHOBA,2021-01-01,0,2170,0,2170
UTTAR PRADESH,MAHOBA,2021-01-02,0,851,0,851
UTTAR PRADESH,MAHOBA,2021-01-03,2,631,7,640
UTTAR PRADESH,MAHOBA,2021-01-04,6,849,0,855
UTTAR PRADESH,MAHOBA,2021-01-05,0,961,0,961
UTTAR PRADESH,MAINPURI,2021-01-01,1,1505,2,1508
UTTAR PRADESH,MAINPURI,2021-01-02,3,1602,0,1605
UTTAR PRADESH,MAINPURI,2021-01-03,3,1565,2,1570
UTTAR PRADESH,MAINPURI,2021-01-04,2,1503,60,1565
UTTAR PRADESH,MAINPURI,2021-01-05,3,1708,2,1713
UTTAR PRADESH,MATHURA,2021-01-01,7,1270,5,1282
UTTAR PRADESH,MATHURA,2021-01-02,10,1556,2,1568
UTTAR PRADESH,MATHURA,2021-01-03,10,1001,3,1014
UTTAR PRADESH,MATHURA,2021-01-04,12,1437,0,1449
UTTAR PRADESH,MATHURA,2021-01-05,9,2203,7,2219
UTTAR PRADESH,MAU,2021-01-01,1,870,13,884
UTTAR PRADESH,MAU,2021-01-02,2,1230,30,1262
UTTAR PRADESH,MAU,2021-01-03,1,500,0,501
UTTAR PRADESH,MAU,2021-01-04,2,2053,31,2086
UTTAR PRADESH,MAU,2021-01-05,0,1200,26,1226
UTTAR PRADESH,MEERUT,2021-01-01,67,4272,15,4354
UTTAR PRADESH,MEERUT,2021-01-02,46,4563,74,4683
UTTAR PRADESH,MEERUT,2021-01-03,54,2689,22,2765
UTTAR PRADESH,MEERUT,2021-01-04,34,2948,8,2990
UTTAR PRADESH,MEERUT,2021-01-05,38,3896,15,3949
UTTAR PRADESH,MIRZAPUR,2021-01-01,0,1540,5,1545
UTTAR PRADESH,MIRZAPUR,2021-01-02,0,1761,1,1762
UTTAR PRADESH,MIRZAPUR,2021-01-03,4,2056,0,2060
UTTAR PRADESH,MIRZAPUR,2021-01-04,3,1710,0,1713
UTTAR PRADESH,MIRZAPUR,2021-01-05,5,2335,3,2343
UTTAR PRADESH,MORADABAD,2021-01-01,24,3587,36,3647
UTTAR PRADESH,MORADABAD,2021-01-02,18,1831,0,1849
UTTAR PRADESH,MORADABAD,2021-01-03,12,4816,92,4920
UTTAR PRADESH,MORADABAD,2021-01-04,8,2516,49,2573
UTTAR PRADESH,MORADABAD,2021-01-05,12,2817,3,2832
UTTAR PRADESH,MUZAFFARNAGAR,2021-01-01,16,1586,2,1604
UTTAR PRADESH,MUZAFFARNAGAR,2021-01-02,45,1407,9,1461
UTTAR PRADESH,MUZAFFARNAGAR,2021-01-03,19,1115,1,1135
UTTAR PRADESH,MUZAFFARNAGAR,2021-01-04,35,837,14,886
UTTAR PRADESH,MUZAFFARNAGAR,2021-01-05,25,2007,9,2041
UTTAR PRADESH,PILIBHIT,2021-01-01,7,1553,0,1560
UTTAR PRADESH,PILIBHIT,2021-01-02,1,1295,0,1296
UTTAR PRADESH,PILIBHIT,2021-01-03,4,1269,0,1273
UTTAR PRADESH,PILIBHIT,2021-01-04,1,1516,7,1524
UTTAR PRADESH,PILIBHIT,2021-01-05,7,1478,1,1486
UTTAR PRADESH,PRATAPGARH,2021-01-01,9,2509,62,2580
UTTAR PRADESH,PRATAPGARH,2021-01-02,8,1781,37,1826
UTTAR PRADESH,PRATAPGARH,2021-01-03,1,1243,123,1367
UTTAR PRADESH,PRATAPGARH,2021-01-04,6,2199,173,2378
UTTAR PRADESH,PRATAPGARH,2021-01-05,3,1388,61,1452
UTTAR PRADESH,PRAYAGRAJ,2021-01-01,52,3909,5,3966
UTTAR PRADESH,PRAYAGRAJ,2021-01-02,41,4240,2,4283
UTTAR PRADESH,PRAYAGRAJ,2021-01-03,43,3551,2,3596
UTTAR PRADESH,PRAYAGRAJ,2021-01-04,40,3621,3,3664
UTTAR PRADESH,PRAYAGRAJ,2021-01-05,49,4497,1,4547
UTTAR PRADESH,RAE BARELI,2021-01-01,12,2277,3,2292
UTTAR PRADESH,RAE BARELI,2021-01-02,19,2516,9,2544
UTTAR PRADESH,RAE BARELI,2021-01-03,10,2336,2,2348
UTTAR PRADESH,RAE BARELI,2021-01-04,24,2910,25,2959
UTTAR PRADESH,RAE BARELI,2021-01-05,9,4073,3,4085
UTTAR PRADESH,RAMPUR,2021-01-01,2,1065,6,1073
UTTAR PRADESH,RAMPUR,2021-01-02,4,1237,31,1272
UTTAR PRADESH,RAMPUR,2021-01-03,4,1119,12,1135
UTTAR PRADESH,RAMPUR,2021-01-04,12,1385,24,1421
UTTAR PRADESH,RAMPUR,2021-01-05,8,1527,15,1550
UTTAR PRADESH,SAHARANPUR,2021-01-01,42,2033,8,2083
UTTAR PRADESH,SAHARANPUR,2021-01-02,19,3422,20,3461
UTTAR PRADESH,SAHARANPUR,2021-01-03,17,2384,60,2461
UTTAR PRADESH,SAHARANPUR,2021-01-04,23,2191,16,2230
UTTAR PRADESH,SAHARANPUR,2021-01-05,13,4008,4,4025
UTTAR PRADESH,SAMBHAL,2021-01-01,2,837,12,851
UTTAR PRADESH,SAMBHAL,2021-01-02,5,1526,36,1567
UTTAR PRADESH,SAMBHAL,2021-01-03,3,965,45,1013
UTTAR PRADESH,SAMBHAL,2021-01-04,6,1076,32,1114
UTTAR PRADESH,SAMBHAL,2021-01-05,1,799,1,801
UTTAR PRADESH,SANT KABEER NAGAR,2021-01-01,5,2041,70,2116
UTTAR PRADESH,SANT KABEER NAGAR,2021-01-02,4,725,0,729
UTTAR PRADESH,SANT KABEER NAGAR,2021-01-03,4,1685,40,1729
UTTAR PRADESH,SANT KABEER NAGAR,2021-01-04,4,1317,67,1388
UTTAR PRADESH,SANT KABEER NAGAR,2021-01-05,2,1369,0,1371
UTTAR PRADESH,SHAHJAHANPUR,2021-01-01,3,3171,17,3191
UTTAR PRADESH,SHAHJAHANPUR,2021-01-02,4,1056,40,1100
UTTAR PRADESH,SHAHJAHANPUR,2021-01-03,6,1495,7,1508
UTTAR PRADESH,SHAHJAHANPUR,2021-01-04,6,1966,3,1975
UTTAR PRADESH,SHAHJAHANPUR,2021-01-05,7,1982,29,2018
UTTAR PRADESH,SHAMLI,2021-01-01,10,1277,5,1292
UTTAR PRADESH,SHAMLI,2021-01-02,4,1406,0,1410
UTTAR PRADESH,SHAMLI,2021-01-03,7,1396,1,1404
UTTAR PRADESH,SHAMLI,2021-01-04,10,1191,4,1205
UTTAR PRADESH,SHAMLI,2021-01-05,5,1939,9,1953
UTTAR PRADESH,SHRAVASTI,2021-01-01,2,1192,0,1194
UTTAR PRADESH,SHRAVASTI,2021-01-02,5,1160,31,1196
UTTAR PRADESH,SHRAVASTI,2021-01-03,2,1025,17,1044
UTTAR PRADESH,SHRAVASTI,2021-01-04,4,1038,31,1073
UTTAR PRADESH,SHRAVASTI,2021-01-05,2,1070,0,1072
UTTAR PRADESH,SIDDHARTH NAGAR,2021-01-01,6,1072,3,1081
UTTAR PRADESH,SIDDHARTH NAGAR,2021-01-02,8,1646,2,1656
UTTAR PRADESH,SIDDHARTH NAGAR,2021-01-03,4,1060,34,1098
UTTAR PRADESH,SIDDHARTH NAGAR,2021-01-04,3,1047,15,1065
UTTAR PRADESH,SIDDHARTH NAGAR,2021-01-05,8,1101,0,1109
UTTAR PRADESH,SITAPUR,2021-01-01,3,1763,97,1863
UTTAR PRADESH,SITAPUR,2021-01-02,3,1979,11,1993
UTTAR PRADESH,SITAPUR,2021-01-03,4,1785,6,1795
UTTAR PRADESH,SITAPUR,2021-01-04,7,1771,25,1803
UTTAR PRADESH,SITAPUR,2021-01-05,6,2131,30,2167
UTTAR PRADESH,SONBHADRA,2021-01-01,4,1204,9,1217
UTTAR PRADESH,SONBHADRA,2021-01-02,3,1408,16,1427
UTTAR PRADESH,SONBHADRA,2021-01-03,3,493,17,513
UTTAR PRADESH,SONBHADRA,2021-01-04,2,1573,25,1600
UTTAR PRADESH,SONBHADRA,2021-01-05,4,1515,40,1559
UTTAR PRADESH,SULTANPUR,2021-01-01,20,1800,43,1863
UTTAR PRADESH,SULTANPUR,2021-01-02,12,1184,19,1215
UTTAR PRADESH,SULTANPUR,2021-01-03,7,768,8,783
UTTAR PRADESH,SULTANPUR,2021-01-04,16,763,17,796
UTTAR PRADESH,SULTANPUR,2021-01-05,11,1555,22,1588
UTTAR PRADESH,UNNAO,2021-01-01,5,649,7,661
UTTAR PRADESH,UNNAO,2021-01-02,10,1770,59,1839
UTTAR PRADESH,UNNAO,2021-01-03,5,1367,152,1524
UTTAR PRADESH,UNNAO,2021-01-04,3,2232,24,2259
UTTAR PRADESH,UNNAO,2021-01-05,5,1903,24,1932
UTTAR PRADESH,VARANASI,2021-01-01,55,2701,253,3009
UTTAR PRADESH,VARANASI,2021-01-02,85,2509,109,2703
UTTAR PRADESH,VARANASI,2021-01-03,47,2823,196,3066
UTTAR PRADESH,VARANASI,2021-01-04,39,2361,51,2451
UTTAR PRADESH,VARANASI,2021-01-05,64,3076,223,3363
UTTARAKHAND,ALMORA,2021-01-01,12,241,0,253
UTTARAKHAND,ALMORA,2021-01-02,3,85,0,88
UTTARAKHAND,ALMORA,2021-01-03,1,23,0,24
UTTARAKHAND,ALMORA,2021-01-04,6,40,0,46
UTTARAKHAND,ALMORA,2021-01-05,12,132,1,145
UTTARAKHAND,BAGESHWAR,2021-01-01,5,373,0,378
UTTARAKHAND,BAGESHWAR,2021-01-02,4,276,16,296
UTTARAKHAND,BAGESHWAR,2021-01-03,1,23,0,24
UTTARAKHAND,BAGESHWAR,2021-01-04,1,237,0,238
UTTARAKHAND,BAGESHWAR,2021-01-05,2,195,7,204
UTTARAKHAND,CHAMOLI,2021-01-01,8,484,17,509
UTTARAKHAND,CHAMOLI,2021-01-02,6,352,18,376
UTTARAKHAND,CHAMOLI,2021-01-03,1,87,0,88
UTTARAKHAND,CHAMOLI,2021-01-04,6,110,0,116
UTTARAKHAND,CHAMOLI,2021-01-05,3,280,3,286
UTTARAKHAND,CHAMPAWAT,2021-01-01,19,607,3,629
UTTARAKHAND,CHAMPAWAT,2021-01-02,3,219,0,222
UTTARAKHAND,CHAMPAWAT,2021-01-03,6,306,0,312
UTTARAKHAND,CHAMPAWAT,2021-01-04,17,659,2,678
UTTARAKHAND,CHAMPAWAT,2021-01-05,9,632,0,641
UTTARAKHAND,DEHRADUN,2021-01-01,131,2863,19,3013
UTTARAKHAND,DEHRADUN,2021-01-02,134,2741,7,2882
UTTARAKHAND,DEHRADUN,2021-01-03,80,2559,17,2656
UTTARAKHAND,DEHRADUN,2021-01-04,136,3927,8,4071
UTTARAKHAND,DEHRADUN,2021-01-05,113,2931,7,3051
UTTARAKHAND,HARIDWAR,2021-01-01,35,2318,5,2358
UTTARAKHAND,HARIDWAR,2021-01-02,29,3060,40,3129
UTTARAKHAND,HARIDWAR,2021-01-03,14,1860,109,1983
UTTARAKHAND,HARIDWAR,2021-01-04,30,1002,1,1033
UTTARAKHAND,HARIDWAR,2021-01-05,15,1680,28,1723
UTTARAKHAND,NAINITAL,2021-01-01,94,1665,13,1772
UTTARAKHAND,NAINITAL,2021-01-02,61,1216,13,1290
UTTARAKHAND,NAINITAL,2021-01-03,52,601,0,653
UTTARAKHAND,NAINITAL,2021-01-04,73,1661,7,1741
UTTARAKHAND,NAINITAL,2021-01-05,72,1608,13,1693
UTTARAKHAND,PAURI GARHWAL,2021-01-01,10,496,303,809
UTTARAKHAND,PAURI GARHWAL,2021-01-02,19,702,89,810
UTTARAKHAND,PAURI GARHWAL,2021-01-03,7,758,59,824
UTTARAKHAND,PAURI GARHWAL,2021-01-04,3,543,5,551
UTTARAKHAND,PAURI GARHWAL,2021-01-05,5,787,21,813
UTTARAKHAND,PITHORAGARH,2021-01-01,33,679,1,713
UTTARAKHAND,PITHORAGARH,2021-01-02,7,199,0,206
UTTARAKHAND,PITHORAGARH,2021-01-03,2,55,3,60
UTTARAKHAND,PITHORAGARH,2021-01-04,17,281,7,305
UTTARAKHAND,PITHORAGARH,2021-01-05,2,38,0,40
UTTARAKHAND,RUDRA PRAYAG,2021-01-01,4,137,0,141
UTTARAKHAND,RUDRA PRAYAG,2021-01-02,6,187,0,193
UTTARAKHAND,RUDRA PRAYAG,2021-01-03,2,109,1,112
UTTARAKHAND,RUDRA PRAYAG,2021-01-04,4,61,0,65
UTTARAKHAND,RUDRA PRAYAG,2021-01-05,4,151,5,160
UTTARAKHAND,TEHRI GARHWAL,2021-01-01,7,709,5,721
UTTARAKHAND,TEHRI GARHWAL,2021-01-02,15,709,4,728
UTTARAKHAND,TEHRI GARHWAL,2021-01-03,6,392,3,401
UTTARAKHAND,TEHRI GARHWAL,2021-01-04,3,709,1,713
UTTARAKHAND,TEHRI GARHWAL,2021-01-05,9,413,4,426
UTTARAKHAND,UDAM SINGH NAGAR,2021-01-01,29,1784,107,1920
UTTARAKHAND,UDAM SINGH NAGAR,2021-01-02,23,2569,64,2656
UTTARAKHAND,UDAM SINGH NAGAR,2021-01-03,11,2209,38,2258
UTTARAKHAND,UDAM SINGH NAGAR,2021-01-04,28,3436,27,3491
UTTARAKHAND,UDAM SINGH NAGAR,2021-01-05,18,2640,37,2695
UTTARAKHAND,UTTAR KASHI,2021-01-01,14,343,7,364
UTTARAKHAND,UTTAR KASHI,2021-01-02,16,811,7,834
UTTARAKHAND,UTTAR KASHI,2021-01-03,10,544,2,556
UTTARAKHAND,UTTAR KASHI,2021-01-04,13,1226,11,1250
UTTARAKHAND,UTTAR KASHI,2021-01-05,10,811,3,824
WEST BENGAL,24 PARAGANAS NORTH,2021-01-01,184,4470,24,4678
WEST BENGAL,24 PARAGANAS NORTH,2021-01-02,209,3337,31,3577
WEST BENGAL,24 PARAGANAS NORTH,2021-01-03,191,3485,30,3706
WEST BENGAL,24 PARAGANAS NORTH,2021-01-04,180,3984,22,4186
WEST BENGAL,24 PARAGANAS NORTH,2021-01-05,219,4887,18,5124
WEST BENGAL,24 PARAGANAS SOUTH,2021-01-01,43,3897,11,3951
WEST BENGAL,24 PARAGANAS SOUTH,2021-01-02,28,3197,8,3233
WEST BENGAL,24 PARAGANAS SOUTH,2021-01-03,21,3129,20,3170
WEST BENGAL,24 PARAGANAS SOUTH,2021-01-04,36,2896,10,2942
WEST BENGAL,24 PARAGANAS SOUTH,2021-01-05,46,3327,9,3382
WEST BENGAL,ALIPURDUAR,2021-01-01,0,265,0,265
WEST BENGAL,ALIPURDUAR,2021-01-02,0,858,0,858
WEST BENGAL,ALIPURDUAR,2021-01-03,4,645,0,649
WEST BENGAL,ALIPURDUAR,2021-01-04,2,570,0,572
WEST BENGAL,ALIPURDUAR,2021-01-05,0,773,0,773
WEST BENGAL,BANKURA,2021-01-01,8,863,0,871
WEST BENGAL,BANKURA,2021-01-02,18,625,0,643
WEST BENGAL,BANKURA,2021-01-03,9,780,12,801
WEST BENGAL,BANKURA,2021-01-04,16,855,1,872
WEST BENGAL,BANKURA,2021-01-05,10,602,2,614
WEST BENGAL,BIRBHUM,2021-01-01,23,1200,22,1245
WEST BENGAL,BIRBHUM,2021-01-02,22,1133,10,1165
WEST BENGAL,BIRBHUM,2021-01-03,8,558,3,569
WEST BENGAL,BIRBHUM,2021-01-04,16,1053,9,1078
WEST BENGAL,BIRBHUM,2021-01-05,22,1591,13,1626
WEST BENGAL,COOCHBEHAR,2021-01-01,8,2737,0,2745
WEST BENGAL,COOCHBEHAR,2021-01-02,3,2765,59,2827
WEST BENGAL,COOCHBEHAR,2021-01-03,2,2934,0,2936
WEST BENGAL,COOCHBEHAR,2021-01-04,10,2844,1,2855
WEST BENGAL,COOCHBEHAR,2021-01-05,8,2959,20,2987
WEST BENGAL,DARJEELING,2021-01-01,27,489,1,517
WEST BENGAL,DARJEELING,2021-01-02,17,725,0,742
WEST BENGAL,DARJEELING,2021-01-03,25,449,2,476
WEST BENGAL,DARJEELING,2021-01-04,30,898,0,928
WEST BENGAL,DARJEELING,2021-01-05,23,592,2,617
WEST BENGAL,DINAJPUR DAKSHIN,2021-01-01,0,716,5,721
WEST BENGAL,DINAJPUR DAKSHIN,2021-01-02,8,892,1,901
WEST BENGAL,DINAJPUR DAKSHIN,2021-01-03,3,757,5,765
WEST BENGAL,DINAJPUR DAKSHIN,2021-01-04,1,865,0,866
WEST BENGAL,DINAJPUR DAKSHIN,2021-01-05,7,927,2,936
WEST BENGAL,DINAJPUR UTTAR,2021-01-01,4,465,0,469
WEST BENGAL,DINAJPUR UTTAR,2021-01-02,2,592,0,594
WEST BENGAL,DINAJPUR UTTAR,2021-01-03,0,473,0,473
WEST BENGAL,DINAJPUR UTTAR,2021-01-04,3,514,0,517
WEST BENGAL,DINAJPUR UTTAR,2021-01-05,2,299,0,301
WEST BENGAL,HOOGHLY,2021-01-01,38,614,11,663
WEST BENGAL,HOOGHLY,2021-01-02,34,1602,35,1671
WEST BENGAL,HOOGHLY,2021-01-03,25,776,20,821
WEST BENGAL,HOOGHLY,2021-01-04,43,1681,108,1832
WEST BENGAL,HOOGHLY,2021-01-05,38,1782,6,1826
WEST BENGAL,HOWRAH,2021-01-01,30,1548,4,1582
WEST BENGAL,HOWRAH,2021-01-02,35,2075,12,2122
WEST BENGAL,HOWRAH,2021-01-03,19,1423,1,1443
WEST BENGAL,HOWRAH,2021-01-04,30,2022,3,2055
WEST BENGAL,HOWRAH,2021-01-05,41,2139,7,2187
WEST BENGAL,JALPAIGURI,2021-01-01,25,238,0,263
WEST BENGAL,JALPAIGURI,2021-01-02,7,560,0,567
WEST BENGAL,JALPAIGURI,2021-01-03,9,969,2,980
WEST BENGAL,JALPAIGURI,2021-01-04,7,580,0,587
WEST BENGAL,JALPAIGURI,2021-01-05,16,513,1,530
WEST BENGAL,JHARGRAM,2021-01-01,1,33,0,34
WEST BENGAL,JHARGRAM,2021-01-02,5,173,0,178
WEST BENGAL,JHARGRAM,2021-01-03,1,77,0,78
WEST BENGAL,JHARGRAM,2021-01-04,5,195,1,201
WEST BENGAL,JHARGRAM,2021-01-05,1,172,0,173
WEST BENGAL,KALIMPONG,2021-01-01,3,44,0,47
WEST BENGAL,KALIMPONG,2021-01-02,1,96,0,97
WEST BENGAL,KALIMPONG,2021-01-03,2,282,0,284
WEST BENGAL,KALIMPONG,2021-01-04,3,169,0,172
WEST BENGAL,KALIMPONG,2021-01-05,2,79,0,81
WEST BENGAL,KOLKATA,2021-01-01,314,2368,19,2701
WEST BENGAL,KOLKATA,2021-01-02,278,3245,13,3536
WEST BENGAL,KOLKATA,2021-01-03,205,1473,13,1691
WEST BENGAL,KOLKATA,2021-01-04,267,3156,17,3440
WEST BENGAL,KOLKATA,2021-01-05,347,3600,24,3971
WEST BENGAL,MALDAH,2021-01-01,11,515,11,537
WEST BENGAL,MALDAH,2021-01-02,6,986,9,1001
WEST BENGAL,MALDAH,2021-01-03,6,165,8,179
WEST BENGAL,MALDAH,2021-01-04,8,746,5,759
WEST BENGAL,MALDAH,2021-01-05,12,1035,15,1062
WEST BENGAL,MEDINIPUR EAST,2021-01-01,28,1157,24,1209
WEST BENGAL,MEDINIPUR EAST,2021-01-02,34,1434,5,1473
WEST BENGAL,MEDINIPUR EAST,2021-01-03,27,1185,3,1215
WEST BENGAL,MEDINIPUR EAST,2021-01-04,12,754,1,767
WEST BENGAL,MEDINIPUR EAST,2021-01-05,13,1159,2,1174
WEST BENGAL,MEDINIPUR WEST,2021-01-01,26,478,5,509
WEST BENGAL,MEDINIPUR WEST,2021-01-02,12,555,2,569
WEST BENGAL,MEDINIPUR WEST,2021-01-03,9,260,5,274
WEST BENGAL,MEDINIPUR WEST,2021-01-04,12,645,6,663
WEST BENGAL,MEDINIPUR WEST,2021-01-05,15,727,20,762
WEST BENGAL,MURSHIDABAD,2021-01-01,8,1310,8,1326
WEST BENGAL,MURSHIDABAD,2021-01-02,22,1749,5,1776
WEST BENGAL,MURSHIDABAD,2021-01-03,11,1554,13,1578
WEST BENGAL,MURSHIDABAD,2021-01-04,24,1192,11,1227
WEST BENGAL,MURSHIDABAD,2021-01-05,23,1602,6,1631
WEST BENGAL,NADIA,2021-01-01,31,1104,5,1140
WEST BENGAL,NADIA,2021-01-02,61,1136,16,1213
WEST BENGAL,NADIA,2021-01-03,29,823,12,864
WEST BENGAL,NADIA,2021-01-04,39,1025,6,1070
WEST BENGAL,NADIA,2021-01-05,40,1047,11,1098
WEST BENGAL,PASCHIM BARDHAMAN,2021-01-01,47,1255,11,1313
WEST BENGAL,PASCHIM BARDHAMAN,2021-01-02,47,1342,3,1392
WEST BENGAL,PASCHIM BARDHAMAN,2021-01-03,16,1126,6,1148
WEST BENGAL,PASCHIM BARDHAMAN,2021-01-04,26,952,14,992
WEST BENGAL,PASCHIM BARDHAMAN,2021-01-05,31,1049,7,1087
WEST BENGAL,PURBA BARDHAMAN,2021-01-01,17,1072,1,1090
WEST BENGAL,PURBA BARDHAMAN,2021-01-02,26,1588,6,1620
WEST BENGAL,PURBA BARDHAMAN,2021-01-03,25,998,0,1023
WEST BENGAL,PURBA BARDHAMAN,2021-01-04,8,1339,2,1349
WEST BENGAL,PURBA BARDHAMAN,2021-01-05,21,1272,0,1293
WEST BENGAL,PURULIA,2021-01-01,8,492,0,500
WEST BENGAL,PURULIA,2021-01-02,14,581,0,595
WEST BENGAL,PURULIA,2021-01-03,4,81,0,85
WEST BENGAL,PURULIA,2021-01-04,10,781,0,791
WEST BENGAL,PURULIA,2021-01-05,17,851,0,868
ANDAMAN AND NICOBAR ISLANDS,NICOBARS,2021-01-16,0,12,0,12
ANDAMAN AND NICOBAR ISLANDS,NICOBARS,2021-01-17,0,10,0,10
ANDAMAN AND NICOBAR ISLANDS,NICOBARS,2021-01-18,0,19,0,19
ANDAMAN AND NICOBAR ISLANDS,NICOBARS,2021-01-19,0,16,0,16
ANDAMAN AND NICOBAR ISLANDS,NICOBARS,2021-01-20,0,11,0,11
ANDAMAN AND NICOBAR ISLANDS,NORTH AND MIDDLE ANDAMAN,2021-01-16,0,11,0,11
ANDAMAN AND NICOBAR ISLANDS,NORTH AND MIDDLE ANDAMAN,2021-01-17,0,8,0,8
ANDAMAN AND NICOBAR ISLANDS,NORTH AND MIDDLE ANDAMAN,2021-01-18,0,9,0,9
ANDAMAN AND NICOBAR ISLANDS,NORTH AND MIDDLE ANDAMAN,2021-01-19,0,14,0,14
ANDAMAN AND NICOBAR ISLANDS,NORTH AND MIDDLE ANDAMAN,2021-01-20,0,11,0,11
ANDAMAN AND NICOBAR ISLANDS,SOUTH ANDAMANS,2021-01-16,1,537,0,538
ANDAMAN AND NICOBAR ISLANDS,SOUTH ANDAMANS,2021-01-17,0,298,0,298
ANDAMAN AND NICOBAR ISLANDS,SOUTH ANDAMANS,2021-01-18,1,645,1,647
ANDAMAN AND NICOBAR ISLANDS,SOUTH ANDAMANS,2021-01-19,4,726,1,731
ANDAMAN AND NICOBAR ISLANDS,SOUTH ANDAMANS,2021-01-20,4,880,1,885
ANDHRA PRADESH,ANANTAPUR,2021-01-16,4,1334,0,1338
ANDHRA PRADESH,ANANTAPUR,2021-01-17,0,28,1,29
ANDHRA PRADESH,ANANTAPUR,2021-01-18,0,32,0,32
ANDHRA PRADESH,ANANTAPUR,2021-01-19,1,70,0,71
ANDHRA PRADESH,ANANTAPUR,2021-01-20,0,47,0,47
ANDHRA PRADESH,CHITTOOR,2021-01-16,27,1147,0,1174
ANDHRA PRADESH,CHITTOOR,2021-01-17,2,137,1,140
ANDHRA PRADESH,CHITTOOR,2021-01-18,2,101,0,103
ANDHRA PRADESH,CHITTOOR,2021-01-19,6,192,0,198
ANDHRA PRADESH,CHITTOOR,2021-01-20,2,142,0,144
ANDHRA PRADESH,EAST GODAVARI,2021-01-16,3,351,0,354
ANDHRA PRADESH,EAST GODAVARI,2021-01-17,1,4,0,5
ANDHRA PRADESH,EAST GODAVARI,2021-01-18,1,12,0,13
ANDHRA PRADESH,EAST GODAVARI,2021-01-19,0,21,0,21
ANDHRA PRADESH,EAST GODAVARI,2021-01-20,0,16,0,16
ANDHRA PRADESH,GUNTUR,2021-01-16,4,544,0,548
ANDHRA PRADESH,GUNTUR,2021-01-17,1,17,0,18
ANDHRA PRADESH,GUNTUR,2021-01-18,1,12,0,13
ANDHRA PRADESH,GUNTUR,2021-01-19,0,18,0,18
ANDHRA PRADESH,GUNTUR,2021-01-20,0,18,0,18
ANDHRA PRADESH,KRISHNA,2021-01-16,8,771,0,779
ANDHRA PRADESH,KRISHNA,2021-01-17,0,11,0,11
ANDHRA PRADESH,KRISHNA,2021-01-18,1,12,0,13
ANDHRA PRADESH,KRISHNA,2021-01-19,0,19,0,19
ANDHRA PRADESH,KRISHNA,2021-01-20,5,12,0,17
ANDHRA PRADESH,KURNOOL,2021-01-16,2,893,0,895
ANDHRA PRADESH,KURNOOL,2021-01-17,0,7,0,7
ANDHRA PRADESH,KURNOOL,2021-01-18,1,10,0,11
ANDHRA PRADESH,KURNOOL,2021-01-19,0,13,0,13
ANDHRA PRADESH,KURNOOL,2021-01-20,0,16,0,16
ANDHRA PRADESH,PRAKASAM,2021-01-16,2,1429,0,1431
ANDHRA PRADESH,PRAKASAM,2021-01-17,0,4,0,4
ANDHRA PRADESH,PRAKASAM,2021-01-18,0,6,0,6
ANDHRA PRADESH,PRAKASAM,2021-01-19,0,7,0,7
ANDHRA PRADESH,PRAKASAM,2021-01-20,0,9,0,9
ANDHRA PRADESH,SPSR NELLORE,2021-01-16,2,1977,0,1979
ANDHRA PRADESH,SPSR NELLORE,2021-01-17,1,8,0,9
ANDHRA PRADESH,SPSR NELLORE,2021-01-18,1,17,0,18
ANDHRA PRADESH,SPSR NELLORE,2021-01-19,1,49,0,50
ANDHRA PRADESH,SPSR NELLORE,2021-01-20,2,20,0,22
ANDHRA PRADESH,SRIKAKULAM,2021-01-16,5,329,0,334
ANDHRA PRADESH,SRIKAKULAM,2021-01-17,0,5,0,5
ANDHRA PRADESH,SRIKAKULAM,2021-01-18,0,13,0,13
ANDHRA PRADESH,SRIKAKULAM,2021-01-19,0,19,1,20
ANDHRA PRADESH,SRIKAKULAM,2021-01-20,0,16,0,16
ANDHRA PRADESH,VISAKHAPATANAM,2021-01-16,6,526,0,532
ANDHRA PRADESH,VISAKHAPATANAM,2021-01-17,1,16,0,17
ANDHRA PRADESH,VISAKHAPATANAM,2021-01-18,2,97,0,99
ANDHRA PRADESH,VISAKHAPATANAM,2021-01-19,5,129,0,134
ANDHRA PRADESH,VISAKHAPATANAM,2021-01-20,3,133,0,136
ANDHRA PRADESH,VIZIANAGARAM,2021-01-16,0,986,0,986
ANDHRA PRADESH,VIZIANAGARAM,2021-01-17,1,3,0,4
ANDHRA PRADESH,VIZIANAGARAM,2021-01-18,0,11,0,11
ANDHRA PRADESH,VIZIANAGARAM,2021-01-19,0,19,0,19
ANDHRA PRADESH,VIZIANAGARAM,2021-01-20,1,22,0,23
ANDHRA PRADESH,WEST GODAVARI,2021-01-16,3,482,0,485
ANDHRA PRADESH,WEST GODAVARI,2021-01-17,1,9,0,10
ANDHRA PRADESH,WEST GODAVARI,2021-01-18,1,6,0,7
ANDHRA PRADESH,WEST GODAVARI,2021-01-19,1,16,0,17
ANDHRA PRADESH,WEST GODAVARI,2021-01-20,0,13,0,13
ANDHRA PRADESH,Y.S.R.,2021-01-16,2,577,0,579
ANDHRA PRADESH,Y.S.R.,2021-01-17,2,12,0,14
ANDHRA PRADESH,Y.S.R.,2021-01-18,0,27,0,27
ANDHRA PRADESH,Y.S.R.,2021-01-19,1,31,0,32
ANDHRA PRADESH,Y.S.R.,2021-01-20,1,23,0,24
ARUNACHAL PRADESH,ANJAW,2021-01-19,0,5,0,5
ARUNACHAL PRADESH,ANJAW,2021-01-20,0,1,0,1
ARUNACHAL PRADESH,CHANGLANG,2021-01-16,0,3,0,3
ARUNACHAL PRADESH,CHANGLANG,2021-01-17,0,1,0,1
ARUNACHAL PRADESH,CHANGLANG,2021-01-18,0,1,0,1
ARUNACHAL PRADESH,CHANGLANG,2021-01-20,2,1,0,3
ARUNACHAL PRADESH,DIBANG VALLEY,2021-01-16,0,2,0,2
ARUNACHAL PRADESH,DIBANG VALLEY,2021-01-19,0,1,0,1
ARUNACHAL PRADESH,DIBANG VALLEY,2021-01-20,1,0,0,1
ARUNACHAL PRADESH,EAST KAMENG,2021-01-19,0,4,0,4
ARUNACHAL PRADESH,EAST SIANG,2021-01-16,0,30,0,30
ARUNACHAL PRADESH,EAST SIANG,2021-01-17,0,1,0,1
ARUNACHAL PRADESH,EAST SIANG,2021-01-18,1,30,0,31
ARUNACHAL PRADESH,EAST SIANG,2021-01-19,0,26,0,26
ARUNACHAL PRADESH,EAST SIANG,2021-01-20,0,32,0,32
ARUNACHAL PRADESH,KRA  DAADI,2021-01-20,0,1,0,1
ARUNACHAL PRADESH,LEPARADA,2021-01-20,0,2,0,2
ARUNACHAL PRADESH,LOHIT,2021-01-18,0,3,0,3
ARUNACHAL PRADESH,LOHIT,2021-01-19,0,2,0,2
ARUNACHAL PRADESH,LOHIT,2021-01-20,0,10,0,10
ARUNACHAL PRADESH,LONGDING,2021-01-16,0,1,0,1
ARUNACHAL PRADESH,LOWER DIBANG VALLEY,2021-01-16,0,3,0,3
ARUNACHAL PRADESH,LOWER DIBANG VALLEY,2021-01-18,0,27,0,27
ARUNACHAL PRADESH,LOWER SIANG,2021-01-16,0,5,0,5
ARUNACHAL PRADESH,LOWER SIANG,2021-01-18,0,6,0,6
ARUNACHAL PRADESH,LOWER SIANG,2021-01-19,0,21,0,21
ARUNACHAL PRADESH,LOWER SIANG,2021-01-20,0,10,0,10
ARUNACHAL PRADESH,LOWER SUBANSIRI,2021-01-16,0,2,0,2
ARUNACHAL PRADESH,LOWER SUBANSIRI,2021-01-17,0,16,0,16
ARUNACHAL PRADESH,LOWER SUBANSIRI,2021-01-19,0,3,0,3
ARUNACHAL PRADESH,LOWER SUBANSIRI,2021-01-20,0,1,0,1
ARUNACHAL PRADESH,NAMSAI,2021-01-16,0,3,0,3
ARUNACHAL PRADESH,NAMSAI,2021-01-17,0,1,0,1
ARUNACHAL PRADESH,NAMSAI,2021-01-18,0,2,0,2
ARUNACHAL PRADESH,NAMSAI,2021-01-20,0,3,0,3
ARUNACHAL PRADESH,PAPUM PARE,2021-01-16,14,13,0,27
ARUNACHAL PRADESH,PAPUM PARE,2021-01-18,0,13,0,13
ARUNACHAL PRADESH,PAPUM PARE,2021-01-19,5,30,0,35
ARUNACHAL PRADESH,PAPUM PARE,2021-01-20,0,25,0,25
ARUNACHAL PRADESH,SHI YOMI,2021-01-18,0,1,0,1
ARUNACHAL PRADESH,SIANG,2021-01-17,0,1,0,1
ARUNACHAL PRADESH,TAWANG,2021-01-16,0,76,0,76
ARUNACHAL PRADESH,TAWANG,2021-01-17,0,38,0,38
ARUNACHAL PRADESH,TAWANG,2021-01-18,0,45,0,45
ARUNACHAL PRADESH,TAWANG,2021-01-19,2,40,0,42
ARUNACHAL PRADESH,TAWANG,2021-01-20,1,0,0,1
ARUNACHAL PRADESH,TIRAP,2021-01-16,0,1,0,1
ARUNACHAL PRADESH,TIRAP,2021-01-19,0,1,0,1
ARUNACHAL PRADESH,TIRAP,2021-01-20,0,1,0,1
ARUNACHAL PRADESH,UPPER SIANG,2021-01-17,0,1,0,1
ARUNACHAL PRADESH,UPPER SIANG,2021-01-19,0,1,0,1
ARUNACHAL PRADESH,UPPER SUBANSIRI,2021-01-18,0,3,0,3
ARUNACHAL PRADESH,UPPER SUBANSIRI,2021-01-19,0,1,0,1
ARUNACHAL PRADESH,WEST KAMENG,2021-01-16,0,176,0,176
ARUNACHAL PRADESH,WEST KAMENG,2021-01-17,13,1,0,14
ARUNACHAL PRADESH,WEST KAMENG,2021-01-18,12,8,0,20
ARUNACHAL PRADESH,WEST KAMENG,2021-01-19,9,33,0,42
ARUNACHAL PRADESH,WEST KAMENG,2021-01-20,0,153,0,153
ARUNACHAL PRADESH,WEST SIANG,2021-01-19,1,0,0,1
ASSAM,BAKSA,2021-01-16,0,60,0,60
ASSAM,BAKSA,2021-01-17,0,17,0,17
ASSAM,BAKSA,2021-01-18,0,83,0,83
ASSAM,BAKSA,2021-01-19,0,64,0,64
ASSAM,BAKSA,2021-01-20,0,113,0,113
ASSAM,BARPETA,2021-01-16,0,210,0,210
ASSAM,BARPETA,2021-01-17,0,66,0,66
ASSAM,BARPETA,2021-01-18,0,207,0,207
ASSAM,BARPETA,2021-01-19,0,198,0,198
ASSAM,BARPETA,2021-01-20,0,203,0,203
ASSAM,BISWANATH,2021-01-16,0,43,0,43
ASSAM,BISWANATH,2021-01-17,0,30,0,30
ASSAM,BISWANATH,2021-01-18,0,76,0,76
ASSAM,BISWANATH,2021-01-19,0,50,0,50
ASSAM,BISWANATH,2021-01-20,1,51,0,52
ASSAM,BONGAIGAON,2021-01-16,0,164,0,164
ASSAM,BONGAIGAON,2021-01-17,0,118,0,118
ASSAM,BONGAIGAON,2021-01-18,1,357,0,358
ASSAM,BONGAIGAON,2021-01-19,0,403,0,403
ASSAM,BONGAIGAON,2021-01-20,0,362,0,362
ASSAM,CACHAR,2021-01-16,4,254,7,265
ASSAM,CACHAR,2021-01-17,1,43,0,44
ASSAM,CACHAR,2021-01-18,1,3090,28,3119
ASSAM,CACHAR,2021-01-19,25,1558,53,1636
ASSAM,CACHAR,2021-01-20,3,195,14,212
ASSAM,CHARAIDEO,2021-01-16,0,169,0,169
ASSAM,CHARAIDEO,2021-01-17,0,35,1,36
ASSAM,CHARAIDEO,2021-01-18,1,193,0,194
ASSAM,CHARAIDEO,2021-01-19,0,154,0,154
ASSAM,CHARAIDEO,2021-01-20,0,160,0,160
ASSAM,CHIRANG,2021-01-16,0,61,0,61
ASSAM,CHIRANG,2021-01-17,0,6,0,6
ASSAM,CHIRANG,2021-01-18,0,31,0,31
ASSAM,CHIRANG,2021-01-19,0,72,0,72
ASSAM,CHIRANG,2021-01-20,0,36,0,36
ASSAM,DARRANG,2021-01-16,0,373,0,373
ASSAM,DARRANG,2021-01-17,0,170,0,170
ASSAM,DARRANG,2021-01-18,2,504,0,506
ASSAM,DARRANG,2021-01-19,0,668,0,668
ASSAM,DARRANG,2021-01-20,1,600,0,601
ASSAM,DHEMAJI,2021-01-16,0,50,0,50
ASSAM,DHEMAJI,2021-01-17,0,18,0,18
ASSAM,DHEMAJI,2021-01-18,0,120,0,120
ASSAM,DHEMAJI,2021-01-19,0,98,0,98
ASSAM,DHEMAJI,2021-01-20,0,96,0,96
ASSAM,DHUBRI,2021-01-16,1,252,0,253
ASSAM,DHUBRI,2021-01-17,0,44,0,44
ASSAM,DHUBRI,2021-01-18,0,359,0,359
ASSAM,DHUBRI,2021-01-19,2,264,0,266
ASSAM,DHUBRI,2021-01-20,0,235,0,235
ASSAM,DIBRUGARH,2021-01-16,7,420,0,427
ASSAM,DIBRUGARH,2021-01-17,0,174,1,175
ASSAM,DIBRUGARH,2021-01-18,18,541,0,559
ASSAM,DIBRUGARH,2021-01-19,7,726,0,733
ASSAM,DIBRUGARH,2021-01-20,5,571,0,576
ASSAM,DIMA HASAO,2021-01-16,6,40,0,46
ASSAM,DIMA HASAO,2021-01-17,0,5,0,5
ASSAM,DIMA HASAO,2021-01-18,1,88,0,89
ASSAM,DIMA HASAO,2021-01-19,1,80,0,81
ASSAM,DIMA HASAO,2021-01-20,0,37,0,37
ASSAM,GOALPARA,2021-01-16,0,543,0,543
ASSAM,GOALPARA,2021-01-17,0,142,1,143
ASSAM,GOALPARA,2021-01-18,0,717,0,717
ASSAM,GOALPARA,2021-01-19,0,450,0,450
ASSAM,GOALPARA,2021-01-20,0,411,0,411
ASSAM,GOLAGHAT,2021-01-16,2,270,0,272
ASSAM,GOLAGHAT,2021-01-17,0,58,0,58
ASSAM,GOLAGHAT,2021-01-18,47,388,0,435
ASSAM,GOLAGHAT,2021-01-19,40,443,1,484
ASSAM,GOLAGHAT,2021-01-20,8,260,0,268
ASSAM,HAILAKANDI,2021-01-16,1,346,0,347
ASSAM,HAILAKANDI,2021-01-17,0,38,0,38
ASSAM,HAILAKANDI,2021-01-18,1,499,1,501
ASSAM,HAILAKANDI,2021-01-19,0,416,121,537
ASSAM,HAILAKANDI,2021-01-20,0,303,1,304
ASSAM,HOJAI,2021-01-16,0,140,0,140
ASSAM,HOJAI,2021-01-17,0,22,0,22
ASSAM,HOJAI,2021-01-18,0,180,0,180
ASSAM,HOJAI,2021-01-19,0,125,0,125
ASSAM,HOJAI,2021-01-20,0,124,0,124
ASSAM,JORHAT,2021-01-16,4,594,0,598
ASSAM,JORHAT,2021-01-17,1,258,0,259
ASSAM,JORHAT,2021-01-18,3,669,0,672
ASSAM,JORHAT,2021-01-19,2,451,0,453
ASSAM,JORHAT,2021-01-20,1,551,0,552
ASSAM,KAMRUP,2021-01-16,0,571,0,571
ASSAM,KAMRUP,2021-01-17,1,165,0,166
ASSAM,KAMRUP,2021-01-18,3,882,0,885
ASSAM,KAMRUP,2021-01-19,1,639,0,640
ASSAM,KAMRUP,2021-01-20,3,632,0,635
ASSAM,KAMRUP METRO,2021-01-16,10,3255,0,3265
ASSAM,KAMRUP METRO,2021-01-17,11,2347,0,2358
ASSAM,KAMRUP METRO,2021-01-18,14,3398,2,3414
ASSAM,KAMRUP METRO,2021-01-19,11,3058,0,3069
ASSAM,KAMRUP METRO,2021-01-20,9,3310,2,3321
ASSAM,KARBI ANGLONG,2021-01-16,0,15,0,15
ASSAM,KARBI ANGLONG,2021-01-17,0,9,0,9
ASSAM,KARBI ANGLONG,2021-01-18,0,35,0,35
ASSAM,KARBI ANGLONG,2021-01-19,0,99,0,99
ASSAM,KARBI ANGLONG,2021-01-20,0,43,0,43
ASSAM,KARIMGANJ,2021-01-16,1,168,0,169
ASSAM,KARIMGANJ,2021-01-17,1,108,0,109
ASSAM,KARIMGANJ,2021-01-18,0,538,1,539
ASSAM,KARIMGANJ,2021-01-19,1,611,21,633
ASSAM,KARIMGANJ,2021-01-20,4,350,1,355
ASSAM,KOKRAJHAR,2021-01-16,1,31,0,32
ASSAM,KOKRAJHAR,2021-01-17,2,50,0,52
ASSAM,KOKRAJHAR,2021-01-18,1,104,0,105
ASSAM,KOKRAJHAR,2021-01-19,2,50,0,52
ASSAM,KOKRAJHAR,2021-01-20,1,65,0,66
ASSAM,LAKHIMPUR,2021-01-16,0,252,0,252
ASSAM,LAKHIMPUR,2021-01-17,0,154,0,154
ASSAM,LAKHIMPUR,2021-01-18,0,277,0,277
ASSAM,LAKHIMPUR,2021-01-19,0,204,0,204
ASSAM,LAKHIMPUR,2021-01-20,2,166,0,168
ASSAM,MAJULI,2021-01-16,0,11,0,11
ASSAM,MAJULI,2021-01-17,0,7,0,7
ASSAM,MAJULI,2021-01-18,0,13,0,13
ASSAM,MAJULI,2021-01-19,0,15,0,15
ASSAM,MAJULI,2021-01-20,0,36,0,36
ASSAM,MARIGAON,2021-01-16,0,52,0,52
ASSAM,MARIGAON,2021-01-17,0,65,0,65
ASSAM,MARIGAON,2021-01-18,0,64,0,64
ASSAM,MARIGAON,2021-01-19,0,82,0,82
ASSAM,MARIGAON,2021-01-20,0,85,0,85
ASSAM,NAGAON,2021-01-16,0,338,0,338
ASSAM,NAGAON,2021-01-17,2,128,4,134
ASSAM,NAGAON,2021-01-18,3,597,0,600
ASSAM,NAGAON,2021-01-19,1,330,0,331
ASSAM,NAGAON,2021-01-20,7,342,0,349
ASSAM,NALBARI,2021-01-16,0,55,0,55
ASSAM,NALBARI,2021-01-17,0,18,0,18
ASSAM,NALBARI,2021-01-18,0,105,0,105
ASSAM,NALBARI,2021-01-19,3,112,0,115
ASSAM,NALBARI,2021-01-20,0,114,0,114
ASSAM,SIVASAGAR,2021-01-16,0,228,0,228
ASSAM,SIVASAGAR,2021-01-17,1,51,0,52
ASSAM,SIVASAGAR,2021-01-18,1,326,0,327
ASSAM,SIVASAGAR,2021-01-19,0,293,0,293
ASSAM,SIVASAGAR,2021-01-20,0,327,0,327
ASSAM,SONITPUR,2021-01-16,1,248,0,249
ASSAM,SONITPUR,2021-01-17,8,309,0,317
ASSAM,SONITPUR,2021-01-18,0,264,0,264
ASSAM,SONITPUR,2021-01-19,1,362,0,363
ASSAM,SONITPUR,2021-01-20,1,266,0,267
ASSAM,SOUTH SALMARA MANCACHAR,2021-01-16,0,33,0,33
ASSAM,SOUTH SALMARA MANCACHAR,2021-01-17,0,9,0,9
ASSAM,SOUTH SALMARA MANCACHAR,2021-01-18,0,86,0,86
ASSAM,SOUTH SALMARA MANCACHAR,2021-01-19,0,123,0,123
ASSAM,SOUTH SALMARA MANCACHAR,2021-01-20,0,34,0,34
ASSAM,TINSUKIA,2021-01-16,7,146,0,153
ASSAM,TINSUKIA,2021-01-17,10,252,0,262
ASSAM,TINSUKIA,2021-01-18,0,332,0,332
ASSAM,TINSUKIA,2021-01-19,1,218,0,219
ASSAM,TINSUKIA,2021-01-20,2,530,0,532
ASSAM,UDALGURI,2021-01-16,0,49,0,49
ASSAM,UDALGURI,2021-01-17,0,18,0,18
ASSAM,UDALGURI,2021-01-18,0,88,0,88
ASSAM,UDALGURI,2021-01-19,0,40,0,40
ASSAM,UDALGURI,2021-01-20,0,46,0,46
ASSAM,WEST KARBI ANGLONG,2021-01-16,0,4,0,4
ASSAM,WEST KARBI ANGLONG,2021-01-18,0,10,0,10
ASSAM,WEST KARBI ANGLONG,2021-01-19,0,3,0,3
ASSAM,WEST KARBI ANGLONG,2021-01-20,0,1,0,1
BIHAR,ARARIA,2021-01-16,0,574,0,574
BIHAR,ARARIA,2021-01-17,5,483,0,488
BIHAR,ARARIA,2021-01-18,0,131,0,131
BIHAR,ARARIA,2021-01-19,0,443,0,443
BIHAR,ARARIA,2021-01-20,8,143,0,151
BIHAR,ARWAL,2021-01-16,0,1652,4,1656
BIHAR,ARWAL,2021-01-17,11,760,0,771
BIHAR,ARWAL,2021-01-18,0,1065,1,1066
BIHAR,ARWAL,2021-01-19,3,741,0,744
BIHAR,ARWAL,2021-01-20,1,912,9,922
BIHAR,AURANGABAD,2021-01-16,7,939,0,946
BIHAR,AURANGABAD,2021-01-17,0,1066,0,1066
BIHAR,AURANGABAD,2021-01-18,8,2886,0,2894
BIHAR,AURANGABAD,2021-01-19,8,1602,3,1613
BIHAR,AURANGABAD,2021-01-20,2,521,0,523
BIHAR,BANKA,2021-01-16,0,2155,0,2155
BIHAR,BANKA,2021-01-17,3,1761,158,1922
BIHAR,BANKA,2021-01-18,2,2145,39,2186
BIHAR,BANKA,2021-01-19,6,2573,49,2628
BIHAR,BANKA,2021-01-20,3,2277,46,2326
BIHAR,BEGUSARAI,2021-01-16,5,4271,0,4276
BIHAR,BEGUSARAI,2021-01-17,0,1802,1,1803
BIHAR,BEGUSARAI,2021-01-18,5,2906,1,2912
BIHAR,BEGUSARAI,2021-01-19,6,3640,0,3646
BIHAR,BEGUSARAI,2021-01-20,0,2462,0,2462
BIHAR,BHAGALPUR,2021-01-16,3,2831,166,3000
BIHAR,BHAGALPUR,2021-01-17,1,1387,382,1770
BIHAR,BHAGALPUR,2021-01-18,3,3049,92,3144
BIHAR,BHAGALPUR,2021-01-19,5,4032,217,4254
BIHAR,BHAGALPUR,2021-01-20,3,3653,258,3914
BIHAR,BHOJPUR,2021-01-16,10,1404,57,1471
BIHAR,BHOJPUR,2021-01-17,1,1240,436,1677
BIHAR,BHOJPUR,2021-01-18,0,1282,215,1497
BIHAR,BHOJPUR,2021-01-19,0,2178,36,2214
BIHAR,BHOJPUR,2021-01-20,4,1591,47,1642
BIHAR,BUXAR,2021-01-16,1,1308,128,1437
BIHAR,BUXAR,2021-01-17,1,1253,63,1317
BIHAR,BUXAR,2021-01-18,1,1157,86,1244
BIHAR,BUXAR,2021-01-19,0,1039,3,1042
BIHAR,BUXAR,2021-01-20,0,1053,71,1124
BIHAR,DARBHANGA,2021-01-16,16,1918,2,1936
BIHAR,DARBHANGA,2021-01-17,2,1722,0,1724
BIHAR,DARBHANGA,2021-01-18,7,2142,0,2149
BIHAR,DARBHANGA,2021-01-19,9,1665,0,1674
BIHAR,DARBHANGA,2021-01-20,10,1976,0,1986
BIHAR,GAYA,2021-01-16,2,3184,14,3200
BIHAR,GAYA,2021-01-17,8,2883,26,2917
BIHAR,GAYA,2021-01-18,7,3635,15,3657
BIHAR,GAYA,2021-01-19,2,2133,9,2144
BIHAR,GAYA,2021-01-20,4,3192,12,3208
BIHAR,GOPALGANJ,2021-01-16,3,1146,17,1166
BIHAR,GOPALGANJ,2021-01-17,0,470,0,470
BIHAR,GOPALGANJ,2021-01-18,3,742,25,770
BIHAR,GOPALGANJ,2021-01-19,1,417,0,418
BIHAR,GOPALGANJ,2021-01-20,2,921,19,942
BIHAR,JAMUI,2021-01-16,0,1283,0,1283
BIHAR,JAMUI,2021-01-17,0,698,0,698
BIHAR,JAMUI,2021-01-18,1,1058,0,1059
BIHAR,JAMUI,2021-01-19,0,971,0,971
BIHAR,JAMUI,2021-01-20,0,1156,0,1156
BIHAR,JEHANABAD,2021-01-16,4,599,0,603
BIHAR,JEHANABAD,2021-01-17,1,740,0,741
BIHAR,JEHANABAD,2021-01-18,2,1186,70,1258
BIHAR,JEHANABAD,2021-01-19,1,1466,37,1504
BIHAR,JEHANABAD,2021-01-20,3,693,39,735
BIHAR,KAIMUR (BHABUA),2021-01-16,2,1418,0,1420
BIHAR,KAIMUR (BHABUA),2021-01-17,3,1071,0,1074
BIHAR,KAIMUR (BHABUA),2021-01-18,0,2240,1,2241
BIHAR,KAIMUR (BHABUA),2021-01-19,6,2159,0,2165
BIHAR,KAIMUR (BHABUA),2021-01-20,2,1437,0,1439
BIHAR,KATIHAR,2021-01-16,15,1268,6,1289
BIHAR,KATIHAR,2021-01-17,1,975,0,976
BIHAR,KATIHAR,2021-01-18,0,1270,0,1270
BIHAR,KATIHAR,2021-01-19,4,1616,0,1620
BIHAR,KATIHAR,2021-01-20,0,1786,0,1786
BIHAR,KHAGARIA,2021-01-16,0,1198,0,1198
BIHAR,KHAGARIA,2021-01-17,0,1656,0,1656
BIHAR,KHAGARIA,2021-01-18,1,837,0,838
BIHAR,KHAGARIA,2021-01-19,0,1616,0,1616
BIHAR,KHAGARIA,2021-01-20,0,1712,0,1712
BIHAR,KISHANGANJ,2021-01-16,0,647,1,648
BIHAR,KISHANGANJ,2021-01-17,2,305,0,307
BIHAR,KISHANGANJ,2021-01-18,2,1131,0,1133
BIHAR,KISHANGANJ,2021-01-19,0,988,2,990
BIHAR,KISHANGANJ,2021-01-20,0,1160,27,1187
BIHAR,LAKHISARAI,2021-01-16,1,567,0,568
BIHAR,LAKHISARAI,2021-01-17,0,502,0,502
BIHAR,LAKHISARAI,2021-01-18,3,534,0,537
BIHAR,LAKHISARAI,2021-01-19,2,529,0,531
BIHAR,LAKHISARAI,2021-01-20,3,1916,0,1919
BIHAR,MADHEPURA,2021-01-16,2,1981,0,1983
BIHAR,MADHEPURA,2021-01-17,0,863,0,863
BIHAR,MADHEPURA,2021-01-18,0,1435,0,1435
BIHAR,MADHEPURA,2021-01-19,0,1814,0,1814
BIHAR,MADHEPURA,2021-01-20,2,1829,0,1831
BIHAR,MADHUBANI,2021-01-16,2,1477,16,1495
BIHAR,MADHUBANI,2021-01-17,1,382,0,383
BIHAR,MADHUBANI,2021-01-18,3,1815,30,1848
BIHAR,MADHUBANI,2021-01-19,0,1703,3,1706
BIHAR,MADHUBANI,2021-01-20,2,921,4,927
BIHAR,MUNGER,2021-01-16,2,1053,21,1076
BIHAR,MUNGER,2021-01-17,1,497,0,498
BIHAR,MUNGER,2021-01-18,3,1504,26,1533
BIHAR,MUNGER,2021-01-19,1,1418,7,1426
BIHAR,MUNGER,2021-01-20,3,1526,0,1529
BIHAR,MUZAFFARPUR,2021-01-16,10,1300,0,1310
BIHAR,MUZAFFARPUR,2021-01-17,2,950,0,952
BIHAR,MUZAFFARPUR,2021-01-18,6,1782,1,1789
BIHAR,MUZAFFARPUR,2021-01-19,11,1144,0,1155
BIHAR,MUZAFFARPUR,2021-01-20,2,2204,2,2208
BIHAR,NALANDA,2021-01-16,6,3650,117,3773
BIHAR,NALANDA,2021-01-17,3,3094,19,3116
BIHAR,NALANDA,2021-01-18,7,3420,0,3427
BIHAR,NALANDA,2021-01-19,1,3577,1,3579
BIHAR,NALANDA,2021-01-20,3,2929,1,2933
BIHAR,NAWADA,2021-01-16,2,1014,0,1016
BIHAR,NAWADA,2021-01-17,0,918,0,918
BIHAR,NAWADA,2021-01-18,1,1419,0,1420
BIHAR,NAWADA,2021-01-19,0,1139,0,1139
BIHAR,NAWADA,2021-01-20,0,870,0,870
BIHAR,PASHCHIM CHAMPARAN,2021-01-16,3,2657,0,2660
BIHAR,PASHCHIM CHAMPARAN,2021-01-17,2,2209,41,2252
BIHAR,PASHCHIM CHAMPARAN,2021-01-18,0,1405,0,1405
BIHAR,PASHCHIM CHAMPARAN,2021-01-19,1,2407,1,2409
BIHAR,PASHCHIM CHAMPARAN,2021-01-20,1,1509,1,1511
BIHAR,PATNA,2021-01-16,137,4869,27,5033
BIHAR,PATNA,2021-01-17,78,3554,54,3686
BIHAR,PATNA,2021-01-18,76,4274,5,4355
BIHAR,PATNA,2021-01-19,115,4351,5,4471
BIHAR,PATNA,2021-01-20,112,5084,5,5201
BIHAR,PURBI CHAMPARAN,2021-01-16,10,3533,1,3544
BIHAR,PURBI CHAMPARAN,2021-01-17,4,2719,4,2727
BIHAR,PURBI CHAMPARAN,2021-01-18,4,2839,2,2845
BIHAR,PURBI CHAMPARAN,2021-01-19,2,3168,12,3182
BIHAR,PURBI CHAMPARAN,2021-01-20,2,3065,7,3074
BIHAR,PURNIA,2021-01-16,4,1094,0,1098
BIHAR,PURNIA,2021-01-17,2,849,0,851
BIHAR,PURNIA,2021-01-18,0,1304,2,1306
BIHAR,PURNIA,2021-01-19,4,1425,0,1429
BIHAR,PURNIA,2021-01-20,2,1473,1,1476
BIHAR,ROHTAS,2021-01-16,3,1629,0,1632
BIHAR,ROHTAS,2021-01-17,3,1211,0,1214
BIHAR,ROHTAS,2021-01-18,7,1630,0,1637
BIHAR,ROHTAS,2021-01-19,7,1565,4,1576
BIHAR,ROHTAS,2021-01-20,3,2440,0,2443
BIHAR,SAHARSA,2021-01-16,3,984,0,987
BIHAR,SAHARSA,2021-01-17,0,244,0,244
BIHAR,SAHARSA,2021-01-18,5,1082,0,1087
BIHAR,SAHARSA,2021-01-19,2,373,0,375
BIHAR,SAHARSA,2021-01-20,2,830,0,832
BIHAR,SAMASTIPUR,2021-01-16,2,3331,67,3400
BIHAR,SAMASTIPUR,2021-01-17,3,3184,57,3244
BIHAR,SAMASTIPUR,2021-01-18,3,2633,74,2710
BIHAR,SAMASTIPUR,2021-01-19,1,3638,27,3666
BIHAR,SAMASTIPUR,2021-01-20,2,3847,31,3880
BIHAR,SARAN,2021-01-16,0,1574,2,1576
BIHAR,SARAN,2021-01-17,5,1613,0,1618
BIHAR,SARAN,2021-01-18,19,2313,0,2332
BIHAR,SARAN,2021-01-19,6,1903,0,1909
BIHAR,SARAN,2021-01-20,5,2125,2,2132
BIHAR,SHEIKHPURA,2021-01-16,0,728,17,745
BIHAR,SHEIKHPURA,2021-01-17,0,1,0,1
BIHAR,SHEIKHPURA,2021-01-18,0,827,13,840
BIHAR,SHEIKHPURA,2021-01-19,1,161,5,167
BIHAR,SHEIKHPURA,2021-01-20,0,271,0,271
BIHAR,SHEOHAR,2021-01-16,5,436,0,441
BIHAR,SHEOHAR,2021-01-17,0,800,0,800
BIHAR,SHEOHAR,2021-01-18,6,532,0,538
BIHAR,SHEOHAR,2021-01-19,0,834,0,834
BIHAR,SHEOHAR,2021-01-20,6,606,0,612
BIHAR,SITAMARHI,2021-01-16,1,1025,0,1026
BIHAR,SITAMARHI,2021-01-17,0,1326,0,1326
BIHAR,SITAMARHI,2021-01-18,3,836,0,839
BIHAR,SITAMARHI,2021-01-19,3,847,0,850
BIHAR,SITAMARHI,2021-01-20,0,1119,0,1119
BIHAR,SIWAN,2021-01-16,2,2144,1,2147
BIHAR,SIWAN,2021-01-17,0,853,0,853
BIHAR,SIWAN,2021-01-18,2,1864,0,1866
BIHAR,SIWAN,2021-01-19,4,2172,0,2176
BIHAR,SIWAN,2021-01-20,0,1299,0,1299
BIHAR,SUPAUL,2021-01-16,0,1251,2,1253
BIHAR,SUPAUL,2021-01-17,2,666,9,677
BIHAR,SUPAUL,2021-01-18,2,1812,53,1867
BIHAR,SUPAUL,2021-01-19,1,1300,0,1301
BIHAR,SUPAUL,2021-01-20,1,1412,7,1420
BIHAR,VAISHALI,2021-01-16,3,3620,1,3624
BIHAR,VAISHALI,2021-01-17,4,2197,11,2212
BIHAR,VAISHALI,2021-01-18,10,3868,54,3932
BIHAR,VAISHALI,2021-01-19,11,3979,19,4009
BIHAR,VAISHALI,2021-01-20,1,3000,0,3001
CHANDIGARH,CHANDIGARH,2021-01-16,29,1095,5,1129
CHANDIGARH,CHANDIGARH,2021-01-17,37,431,3,471
CHANDIGARH,CHANDIGARH,2021-01-18,35,1243,81,1359
CHANDIGARH,CHANDIGARH,2021-01-19,44,1375,7,1426
CHANDIGARH,CHANDIGARH,2021-01-20,29,523,0,552
CHHATTISGARH,BALOD,2021-01-16,10,539,2,551
CHHATTISGARH,BALOD,2021-01-17,18,487,0,505
CHHATTISGARH,BALOD,2021-01-18,17,1088,1,1106
CHHATTISGARH,BALOD,2021-01-19,23,823,1,847
CHHATTISGARH,BALOD,2021-01-20,14,973,0,987
CHHATTISGARH,BALODA BAZAR,2021-01-16,20,461,30,511
CHHATTISGARH,BALODA BAZAR,2021-01-17,32,204,3,239
CHHATTISGARH,BALODA BAZAR,2021-01-18,28,570,23,621
CHHATTISGARH,BALODA BAZAR,2021-01-19,7,280,0,287
CHHATTISGARH,BALODA BAZAR,2021-01-20,13,446,1,460
CHHATTISGARH,BALRAMPUR,2021-01-16,3,450,1,454
CHHATTISGARH,BALRAMPUR,2021-01-17,9,44,0,53
CHHATTISGARH,BALRAMPUR,2021-01-18,3,645,8,656
CHHATTISGARH,BALRAMPUR,2021-01-19,7,450,1,458
CHHATTISGARH,BALRAMPUR,2021-01-20,3,686,1,690
CHHATTISGARH,BASTAR,2021-01-16,3,930,0,933
CHHATTISGARH,BASTAR,2021-01-17,1,909,0,910
CHHATTISGARH,BASTAR,2021-01-18,6,1697,0,1703
CHHATTISGARH,BASTAR,2021-01-19,6,1290,0,1296
CHHATTISGARH,BASTAR,2021-01-20,7,495,0,502
CHHATTISGARH,BEMETARA,2021-01-16,5,295,0,300
CHHATTISGARH,BEMETARA,2021-01-17,15,421,1,437
CHHATTISGARH,BEMETARA,2021-01-18,4,231,0,235
CHHATTISGARH,BEMETARA,2021-01-19,14,427,0,441
CHHATTISGARH,BEMETARA,2021-01-20,5,421,0,426
CHHATTISGARH,BIJAPUR,2021-01-16,1,147,0,148
CHHATTISGARH,BIJAPUR,2021-01-17,1,68,0,69
CHHATTISGARH,BIJAPUR,2021-01-18,2,191,0,193
CHHATTISGARH,BIJAPUR,2021-01-19,0,93,0,93
CHHATTISGARH,BIJAPUR,2021-01-20,0,132,0,132
CHHATTISGARH,BILASPUR,2021-01-16,52,852,5,909
CHHATTISGARH,BILASPUR,2021-01-17,20,939,10,969
CHHATTISGARH,BILASPUR,2021-01-18,36,567,17,620
CHHATTISGARH,BILASPUR,2021-01-19,44,892,27,963
CHHATTISGARH,BILASPUR,2021-01-20,54,940,4,998
CHHATTISGARH,DANTEWADA,2021-01-16,3,218,0,221
CHHATTISGARH,DANTEWADA,2021-01-17,2,262,0,264
CHHATTISGARH,DANTEWADA,2021-01-18,0,263,0,263
CHHATTISGARH,DANTEWADA,2021-01-19,3,212,0,215
CHHATTISGARH,DANTEWADA,2021-01-20,4,258,0,262
CHHATTISGARH,DHAMTARI,2021-01-16,24,614,11,649
CHHATTISGARH,DHAMTARI,2021-01-17,13,252,18,283
CHHATTISGARH,DHAMTARI,2021-01-18,12,550,15,577
CHHATTISGARH,DHAMTARI,2021-01-19,19,619,10,648
CHHATTISGARH,DHAMTARI,2021-01-20,25,739,1,765
CHHATTISGARH,DURG,2021-01-16,61,915,1,977
CHHATTISGARH,DURG,2021-01-17,45,903,2,950
CHHATTISGARH,DURG,2021-01-18,63,1233,2,1298
CHHATTISGARH,DURG,2021-01-19,66,887,3,956
CHHATTISGARH,DURG,2021-01-20,68,1049,4,1121
CHHATTISGARH,GARIYABAND,2021-01-16,4,391,2,397
CHHATTISGARH,GARIYABAND,2021-01-17,4,54,0,58
CHHATTISGARH,GARIYABAND,2021-01-18,7,336,1,344
CHHATTISGARH,GARIYABAND,2021-01-19,5,463,12,480
CHHATTISGARH,GARIYABAND,2021-01-20,2,563,8,573
CHHATTISGARH,GAURELLA PENDRA MARWAHI,2021-01-16,7,258,2,267
CHHATTISGARH,GAURELLA PENDRA MARWAHI,2021-01-17,3,393,2,398
CHHATTISGARH,GAURELLA PENDRA MARWAHI,2021-01-18,1,302,0,303
CHHATTISGARH,GAURELLA PENDRA MARWAHI,2021-01-19,7,360,5,372
CHHATTISGARH,GAURELLA PENDRA MARWAHI,2021-01-20,1,168,5,174
CHHATTISGARH,JANJGIR CHAMPA,2021-01-16,34,1275,0,1309
CHHATTISGARH,JANJGIR CHAMPA,2021-01-17,11,833,1,845
CHHATTISGARH,JANJGIR CHAMPA,2021-01-18,26,2203,2,2231
CHHATTISGARH,JANJGIR CHAMPA,2021-01-19,23,1469,1,1493
CHHATTISGARH,JANJGIR CHAMPA,2021-01-20,40,1258,4,1302
CHHATTISGARH,JASHPUR,2021-01-16,6,449,0,455
CHHATTISGARH,JASHPUR,2021-01-17,4,192,0,196
CHHATTISGARH,JASHPUR,2021-01-18,10,409,0,419
CHHATTISGARH,JASHPUR,2021-01-19,14,292,0,306
CHHATTISGARH,JASHPUR,2021-01-20,20,392,0,412
CHHATTISGARH,KABIRDHAM,2021-01-16,2,362,1,365
CHHATTISGARH,KABIRDHAM,2021-01-17,10,341,0,351
CHHATTISGARH,KABIRDHAM,2021-01-18,5,455,0,460
CHHATTISGARH,KABIRDHAM,2021-01-19,8,683,0,691
CHHATTISGARH,KABIRDHAM,2021-01-20,2,457,0,459
CHHATTISGARH,KANKER,2021-01-16,15,660,0,675
CHHATTISGARH,KANKER,2021-01-17,4,366,1,371
CHHATTISGARH,KANKER,2021-01-18,2,295,0,297
CHHATTISGARH,KANKER,2021-01-19,15,818,0,833
CHHATTISGARH,KANKER,2021-01-20,8,357,0,365
CHHATTISGARH,KONDAGAON,2021-01-16,8,304,2,314
CHHATTISGARH,KONDAGAON,2021-01-17,4,156,2,162
CHHATTISGARH,KONDAGAON,2021-01-18,61,236,0,297
CHHATTISGARH,KONDAGAON,2021-01-19,14,469,0,483
CHHATTISGARH,KONDAGAON,2021-01-20,14,457,3,474
CHHATTISGARH,KORBA,2021-01-16,8,489,0,497
CHHATTISGARH,KORBA,2021-01-17,11,805,1,817
CHHATTISGARH,KORBA,2021-01-18,27,977,0,1004
CHHATTISGARH,KORBA,2021-01-19,16,1094,0,1110
CHHATTISGARH,KORBA,2021-01-20,20,1299,0,1319
CHHATTISGARH,KOREA,2021-01-16,7,578,0,585
CHHATTISGARH,KOREA,2021-01-17,13,190,0,203
CHHATTISGARH,KOREA,2021-01-18,14,768,0,782
CHHATTISGARH,KOREA,2021-01-19,14,1083,4,1101
CHHATTISGARH,KOREA,2021-01-20,14,804,0,818
CHHATTISGARH,MAHASAMUND,2021-01-16,29,777,8,814
CHHATTISGARH,MAHASAMUND,2021-01-17,27,1041,1,1069
CHHATTISGARH,MAHASAMUND,2021-01-18,21,1762,0,1783
CHHATTISGARH,MAHASAMUND,2021-01-19,25,1823,11,1859
CHHATTISGARH,MAHASAMUND,2021-01-20,19,1872,3,1894
CHHATTISGARH,MUNGELI,2021-01-16,4,322,3,329
CHHATTISGARH,MUNGELI,2021-01-17,2,425,0,427
CHHATTISGARH,MUNGELI,2021-01-18,14,500,1,515
CHHATTISGARH,MUNGELI,2021-01-19,5,598,1,604
CHHATTISGARH,MUNGELI,2021-01-20,9,499,5,513
CHHATTISGARH,NARAYANPUR,2021-01-16,2,184,0,186
CHHATTISGARH,NARAYANPUR,2021-01-17,0,203,0,203
CHHATTISGARH,NARAYANPUR,2021-01-18,1,183,0,184
CHHATTISGARH,NARAYANPUR,2021-01-19,0,130,0,130
CHHATTISGARH,NARAYANPUR,2021-01-20,1,199,0,200
CHHATTISGARH,RAIGARH,2021-01-16,35,1623,16,1674
CHHATTISGARH,RAIGARH,2021-01-17,24,853,17,894
CHHATTISGARH,RAIGARH,2021-01-18,44,1683,0,1727
CHHATTISGARH,RAIGARH,2021-01-19,25,1345,0,1370
CHHATTISGARH,RAIGARH,2021-01-20,34,1252,3,1289
CHHATTISGARH,RAIPUR,2021-01-16,155,1788,20,1963
CHHATTISGARH,RAIPUR,2021-01-17,73,734,19,826
CHHATTISGARH,RAIPUR,2021-01-18,107,1559,11,1677
CHHATTISGARH,RAIPUR,2021-01-19,96,2013,30,2139
CHHATTISGARH,RAIPUR,2021-01-20,138,1825,21,1984
CHHATTISGARH,RAJNANDGAON,2021-01-16,26,1072,0,1098
CHHATTISGARH,RAJNANDGAON,2021-01-17,34,1176,0,1210
CHHATTISGARH,RAJNANDGAON,2021-01-18,31,1362,13,1406
CHHATTISGARH,RAJNANDGAON,2021-01-19,36,1140,1,1177
CHHATTISGARH,RAJNANDGAON,2021-01-20,39,1537,0,1576
CHHATTISGARH,SUKMA,2021-01-16,3,240,0,243
CHHATTISGARH,SUKMA,2021-01-17,5,310,0,315
CHHATTISGARH,SUKMA,2021-01-18,3,126,0,129
CHHATTISGARH,SUKMA,2021-01-19,3,181,0,184
CHHATTISGARH,SUKMA,2021-01-20,3,173,0,176
CHHATTISGARH,SURAJPUR,2021-01-16,18,1102,0,1120
CHHATTISGARH,SURAJPUR,2021-01-17,7,909,0,916
CHHATTISGARH,SURAJPUR,2021-01-18,21,1170,0,1191
CHHATTISGARH,SURAJPUR,2021-01-19,21,1357,3,1381
CHHATTISGARH,SURAJPUR,2021-01-20,13,946,0,959
CHHATTISGARH,SURGUJA,2021-01-16,19,584,2,605
CHHATTISGARH,SURGUJA,2021-01-17,17,268,3,288
CHHATTISGARH,SURGUJA,2021-01-18,30,839,1,870
CHHATTISGARH,SURGUJA,2021-01-19,22,773,5,800
CHHATTISGARH,SURGUJA,2021-01-20,22,588,0,610
DADRA AND NAGAR HAVELI,DADRA AND NAGAR HAVELI,2021-01-16,0,543,0,543
DADRA AND NAGAR HAVELI,DADRA AND NAGAR HAVELI,2021-01-17,0,92,0,92
DADRA AND NAGAR HAVELI,DADRA AND NAGAR HAVELI,2021-01-18,0,471,0,471
DADRA AND NAGAR HAVELI,DADRA AND NAGAR HAVELI,2021-01-19,2,519,3,524
DADRA AND NAGAR HAVELI,DADRA AND NAGAR HAVELI,2021-01-20,0,210,0,210
DAMAN AND DIU,DAMAN,2021-01-16,0,68,0,68
DAMAN AND DIU,DAMAN,2021-01-17,1,241,0,242
DAMAN AND DIU,DAMAN,2021-01-18,0,163,0,163
DAMAN AND DIU,DAMAN,2021-01-19,0,229,0,229
DAMAN AND DIU,DAMAN,2021-01-20,1,93,0,94
DAMAN AND DIU,DIU,2021-01-17,0,25,0,25
DAMAN AND DIU,DIU,2021-01-18,0,136,0,136
DAMAN AND DIU,DIU,2021-01-19,0,20,1,21
DAMAN AND DIU,DIU,2021-01-20,0,42,0,42
DELHI,CENTRAL,2021-01-16,19,6132,9,6160
DELHI,CENTRAL,2021-01-17,12,3846,75,3933
DELHI,CENTRAL,2021-01-18,9,6134,3,6146
DELHI,CENTRAL,2021-01-19,26,4352,9,4387
DELHI,CENTRAL,2021-01-20,12,3992,11,4015
DELHI,EAST,2021-01-16,15,4277,1,4293
DELHI,EAST,2021-01-17,13,2268,2,2283
DELHI,EAST,2021-01-18,19,5097,3,5119
DELHI,EAST,2021-01-19,19,3750,2,3771
DELHI,EAST,2021-01-20,11,4961,4,4976
DELHI,NEW DELHI,2021-01-16,29,5698,17,5744
DELHI,NEW DELHI,2021-01-17,23,4626,3,4652
DELHI,NEW DELHI,2021-01-18,50,5636,17,5703
DELHI,NEW DELHI,2021-01-19,40,5465,10,5515
DELHI,NEW DELHI,2021-01-20,28,7162,27,7217
DELHI,NORTH,2021-01-16,14,6432,67,6513
DELHI,NORTH,2021-01-17,9,5590,23,5622
DELHI,NORTH,2021-01-18,10,7252,40,7302
DELHI,NORTH,2021-01-19,18,7194,5,7217
DELHI,NORTH,2021-01-20,16,9003,24,9043
DELHI,NORTH EAST,2021-01-16,9,5147,6,5162
DELHI,NORTH EAST,2021-01-17,3,3167,26,3196
DELHI,NORTH EAST,2021-01-18,6,5149,46,5201
DELHI,NORTH EAST,2021-01-19,3,3541,22,3566
DELHI,NORTH EAST,2021-01-20,17,7228,36,7281
DELHI,NORTH WEST,2021-01-16,55,6339,108,6502
DELHI,NORTH WEST,2021-01-17,26,4261,19,4306
DELHI,NORTH WEST,2021-01-18,37,7865,3,7905
DELHI,NORTH WEST,2021-01-19,41,6694,127,6862
DELHI,NORTH WEST,2021-01-20,49,8076,24,8149
DELHI,SHAHDARA,2021-01-16,10,6304,7,6321
DELHI,SHAHDARA,2021-01-17,11,3657,1,3669
DELHI,SHAHDARA,2021-01-18,12,6023,2,6037
DELHI,SHAHDARA,2021-01-19,7,5460,2,5469
DELHI,SHAHDARA,2021-01-20,7,8151,2,8160
DELHI,SOUTH,2021-01-16,42,5417,9,5468
DELHI,SOUTH,2021-01-17,32,4224,13,4269
DELHI,SOUTH,2021-01-18,43,6369,13,6425
DELHI,SOUTH,2021-01-19,54,4465,11,4530
DELHI,SOUTH,2021-01-20,28,7929,25,7982
DELHI,SOUTH EAST,2021-01-16,37,6285,11,6333
DELHI,SOUTH EAST,2021-01-17,24,4482,2,4508
DELHI,SOUTH EAST,2021-01-18,27,6141,0,6168
DELHI,SOUTH EAST,2021-01-19,29,5751,3,5783
DELHI,SOUTH EAST,2021-01-20,29,7138,0,7167
DELHI,SOUTH WEST,2021-01-16,41,6133,3,6177
DELHI,SOUTH WEST,2021-01-17,14,5468,59,5541
DELHI,SOUTH WEST,2021-01-18,25,6523,3,6551
DELHI,SOUTH WEST,2021-01-19,26,5987,2,6015
DELHI,SOUTH WEST,2021-01-20,27,7307,1,7335
DELHI,WEST,2021-01-16,43,8776,9,8828
DELHI,WEST,2021-01-17,30,8483,7,8520
DELHI,WEST,2021-01-18,51,9882,5,9938
DELHI,WEST,2021-01-19,24,10091,6,10121
DELHI,WEST,2021-01-20,32,10251,25,10308
GOA,NORTH GOA,2021-01-16,45,860,1,906
GOA,NORTH GOA,2021-01-17,32,476,0,508
GOA,NORTH GOA,2021-01-18,36,803,2,841
GOA,NORTH GOA,2021-01-19,54,936,3,993
GOA,NORTH GOA,2021-01-20,46,923,1,970
GOA,SOUTH GOA,2021-01-16,35,838,2,875
GOA,SOUTH GOA,2021-01-17,28,501,1,530
GOA,SOUTH GOA,2021-01-18,34,836,1,871
GOA,SOUTH GOA,2021-01-19,39,1105,11,1155
GOA,SOUTH GOA,2021-01-20,42,904,0,946
GUJARAT,AHMADABAD,2021-01-16,66,3354,79,3499
GUJARAT,AHMADABAD,2021-01-17,63,3512,2,3577
GUJARAT,AHMADABAD,2021-01-18,129,4601,118,4848
GUJARAT,AHMADABAD,2021-01-19,60,5685,56,5801
GUJARAT,AHMADABAD,2021-01-20,88,6265,85,6438
GUJARAT,AMRELI,2021-01-16,1,301,0,302
GUJARAT,AMRELI,2021-01-17,3,297,0,300
GUJARAT,AMRELI,2021-01-18,23,527,8,558
GUJARAT,AMRELI,2021-01-19,18,683,26,727
GUJARAT,AMRELI,2021-01-20,49,876,24,949
GUJARAT,ANAND,2021-01-16,8,252,8,268
GUJARAT,ANAND,2021-01-17,4,67,0,71
GUJARAT,ANAND,2021-01-18,10,398,0,408
GUJARAT,ANAND,2021-01-19,9,499,10,518
GUJARAT,ANAND,2021-01-20,5,437,2,444
GUJARAT,ARVALLI,2021-01-16,0,312,0,312
GUJARAT,ARVALLI,2021-01-17,0,166,0,166
GUJARAT,ARVALLI,2021-01-18,0,284,5,289
GUJARAT,ARVALLI,2021-01-19,0,156,0,156
GUJARAT,ARVALLI,2021-01-20,23,262,2,287
GUJARAT,BANAS KANTHA,2021-01-16,2,195,0,197
GUJARAT,BANAS KANTHA,2021-01-17,4,70,0,74
GUJARAT,BANAS KANTHA,2021-01-18,4,335,1,340
GUJARAT,BANAS KANTHA,2021-01-19,3,714,0,717
GUJARAT,BANAS KANTHA,2021-01-20,4,456,2,462
GUJARAT,BHARUCH,2021-01-16,17,313,3,333
GUJARAT,BHARUCH,2021-01-17,12,118,0,130
GUJARAT,BHARUCH,2021-01-18,10,350,5,365
GUJARAT,BHARUCH,2021-01-19,11,418,3,432
GUJARAT,BHARUCH,2021-01-20,9,367,0,376
GUJARAT,BHAVNAGAR,2021-01-16,4,761,0,765
GUJARAT,BHAVNAGAR,2021-01-17,9,416,0,425
GUJARAT,BHAVNAGAR,2021-01-18,7,771,0,778
GUJARAT,BHAVNAGAR,2021-01-19,4,793,4,801
GUJARAT,BHAVNAGAR,2021-01-20,4,1166,6,1176
GUJARAT,BOTAD,2021-01-16,0,380,0,380
GUJARAT,BOTAD,2021-01-17,0,19,0,19
GUJARAT,BOTAD,2021-01-18,0,288,0,288
GUJARAT,BOTAD,2021-01-19,0,153,0,153
GUJARAT,BOTAD,2021-01-20,1,274,0,275
GUJARAT,CHHOTAUDEPUR,2021-01-16,0,58,0,58
GUJARAT,CHHOTAUDEPUR,2021-01-17,0,12,0,12
GUJARAT,CHHOTAUDEPUR,2021-01-18,1,119,0,120
GUJARAT,CHHOTAUDEPUR,2021-01-19,0,117,0,117
GUJARAT,CHHOTAUDEPUR,2021-01-20,0,106,0,106
GUJARAT,DANG,2021-01-16,2,26,0,28
GUJARAT,DANG,2021-01-17,0,9,0,9
GUJARAT,DANG,2021-01-18,2,62,0,64
GUJARAT,DANG,2021-01-19,0,65,0,65
GUJARAT,DANG,2021-01-20,0,58,0,58
GUJARAT,DEVBHUMI DWARKA,2021-01-16,5,111,0,116
GUJARAT,DEVBHUMI DWARKA,2021-01-17,6,4,0,10
GUJARAT,DEVBHUMI DWARKA,2021-01-18,5,151,0,156
GUJARAT,DEVBHUMI DWARKA,2021-01-19,3,118,0,121
GUJARAT,DEVBHUMI DWARKA,2021-01-20,5,139,0,144
GUJARAT,DOHAD,2021-01-16,26,686,0,712
GUJARAT,DOHAD,2021-01-17,14,401,0,415
GUJARAT,DOHAD,2021-01-18,31,840,0,871
GUJARAT,DOHAD,2021-01-19,29,600,0,629
GUJARAT,DOHAD,2021-01-20,11,606,2,619
GUJARAT,GANDHINAGAR,2021-01-16,13,1185,5,1203
GUJARAT,GANDHINAGAR,2021-01-17,14,446,4,464
GUJARAT,GANDHINAGAR,2021-01-18,7,1175,3,1185
GUJARAT,GANDHINAGAR,2021-01-19,6,1185,7,1198
GUJARAT,GANDHINAGAR,2021-01-20,12,1165,0,1177
GUJARAT,GIR SOMNATH,2021-01-16,1,129,0,130
GUJARAT,GIR SOMNATH,2021-01-17,8,161,0,169
GUJARAT,GIR SOMNATH,2021-01-18,4,227,0,231
GUJARAT,GIR SOMNATH,2021-01-19,2,203,0,205
GUJARAT,GIR SOMNATH,2021-01-20,6,216,0,222
GUJARAT,JAMNAGAR,2021-01-16,28,1326,6,1360
GUJARAT,JAMNAGAR,2021-01-17,17,630,1,648
GUJARAT,JAMNAGAR,2021-01-18,27,1190,4,1221
GUJARAT,JAMNAGAR,2021-01-19,12,1454,7,1473
GUJARAT,JAMNAGAR,2021-01-20,10,1299,9,1318
GUJARAT,JUNAGADH,2021-01-16,5,491,0,496
GUJARAT,JUNAGADH,2021-01-17,14,128,0,142
GUJARAT,JUNAGADH,2021-01-18,12,596,0,608
GUJARAT,JUNAGADH,2021-01-19,12,739,0,751
GUJARAT,JUNAGADH,2021-01-20,7,759,0,766
GUJARAT,KACHCHH,2021-01-16,11,373,5,389
GUJARAT,KACHCHH,2021-01-17,34,200,18,252
GUJARAT,KACHCHH,2021-01-18,23,449,40,512
GUJARAT,KACHCHH,2021-01-19,14,426,35,475
GUJARAT,KACHCHH,2021-01-20,26,619,6,651
GUJARAT,KHEDA,2021-01-16,10,534,3,547
GUJARAT,KHEDA,2021-01-17,6,387,3,396
GUJARAT,KHEDA,2021-01-18,10,618,2,630
GUJARAT,KHEDA,2021-01-19,3,853,3,859
GUJARAT,KHEDA,2021-01-20,6,765,1,772
GUJARAT,MAHESANA,2021-01-16,7,534,0,541
GUJARAT,MAHESANA,2021-01-17,11,191,0,202
GUJARAT,MAHESANA,2021-01-18,1,602,1,604
GUJARAT,MAHESANA,2021-01-19,11,224,4,239
GUJARAT,MAHESANA,2021-01-20,9,416,4,429
GUJARAT,MAHISAGAR,2021-01-16,4,219,0,223
GUJARAT,MAHISAGAR,2021-01-17,2,256,0,258
GUJARAT,MAHISAGAR,2021-01-18,0,244,0,244
GUJARAT,MAHISAGAR,2021-01-19,4,334,1,339
GUJARAT,MAHISAGAR,2021-01-20,2,406,0,408
GUJARAT,MORBI,2021-01-16,5,323,65,393
GUJARAT,MORBI,2021-01-17,6,344,24,374
GUJARAT,MORBI,2021-01-18,6,575,20,601
GUJARAT,MORBI,2021-01-19,3,391,33,427
GUJARAT,MORBI,2021-01-20,7,406,19,432
GUJARAT,NARMADA,2021-01-16,9,82,1,92
GUJARAT,NARMADA,2021-01-17,1,58,0,59
GUJARAT,NARMADA,2021-01-18,4,30,0,34
GUJARAT,NARMADA,2021-01-19,4,85,0,89
GUJARAT,NARMADA,2021-01-20,3,51,0,54
GUJARAT,NAVSARI,2021-01-16,1,233,0,234
GUJARAT,NAVSARI,2021-01-17,2,140,0,142
GUJARAT,NAVSARI,2021-01-18,2,257,1,260
GUJARAT,NAVSARI,2021-01-19,2,311,0,313
GUJARAT,NAVSARI,2021-01-20,7,302,0,309
GUJARAT,PANCH MAHALS,2021-01-16,2,298,1,301
GUJARAT,PANCH MAHALS,2021-01-17,2,247,0,249
GUJARAT,PANCH MAHALS,2021-01-18,8,429,0,437
GUJARAT,PANCH MAHALS,2021-01-19,6,600,1,607
GUJARAT,PANCH MAHALS,2021-01-20,4,626,0,630
GUJARAT,PATAN,2021-01-16,4,383,0,387
GUJARAT,PATAN,2021-01-17,1,107,0,108
GUJARAT,PATAN,2021-01-18,7,571,0,578
GUJARAT,PATAN,2021-01-19,2,349,1,352
GUJARAT,PATAN,2021-01-20,2,502,2,506
GUJARAT,PORBANDAR,2021-01-16,2,202,0,204
GUJARAT,PORBANDAR,2021-01-17,1,109,0,110
GUJARAT,PORBANDAR,2021-01-18,0,220,0,220
GUJARAT,PORBANDAR,2021-01-19,2,140,0,142
GUJARAT,PORBANDAR,2021-01-20,2,246,0,248
GUJARAT,RAJKOT,2021-01-16,71,1367,105,1543
GUJARAT,RAJKOT,2021-01-17,89,824,58,971
GUJARAT,RAJKOT,2021-01-18,70,1834,56,1960
GUJARAT,RAJKOT,2021-01-19,48,1774,109,1931
GUJARAT,RAJKOT,2021-01-20,45,1792,112,1949
GUJARAT,SABAR KANTHA,2021-01-16,6,105,1,112
GUJARAT,SABAR KANTHA,2021-01-17,5,93,0,98
GUJARAT,SABAR KANTHA,2021-01-18,0,143,5,148
GUJARAT,SABAR KANTHA,2021-01-19,4,173,8,185
GUJARAT,SABAR KANTHA,2021-01-20,5,199,7,211
GUJARAT,SURAT,2021-01-16,52,1586,7,1645
GUJARAT,SURAT,2021-01-17,29,791,3,823
GUJARAT,SURAT,2021-01-18,53,1956,25,2034
GUJARAT,SURAT,2021-01-19,64,1619,2,1685
GUJARAT,SURAT,2021-01-20,56,1618,34,1708
GUJARAT,SURENDRANAGAR,2021-01-16,1,153,0,154
GUJARAT,SURENDRANAGAR,2021-01-17,2,34,0,36
GUJARAT,SURENDRANAGAR,2021-01-18,3,273,0,276
GUJARAT,SURENDRANAGAR,2021-01-19,2,207,0,209
GUJARAT,SURENDRANAGAR,2021-01-20,1,344,2,347
GUJARAT,TAPI,2021-01-16,4,363,0,367
GUJARAT,TAPI,2021-01-17,5,94,1,100
GUJARAT,TAPI,2021-01-18,3,295,12,310
GUJARAT,TAPI,2021-01-19,2,262,3,267
GUJARAT,TAPI,2021-01-20,1,184,2,187
GUJARAT,VADODARA,2021-01-16,67,1216,27,1310
GUJARAT,VADODARA,2021-01-17,76,602,16,694
GUJARAT,VADODARA,2021-01-18,67,2150,26,2243
GUJARAT,VADODARA,2021-01-19,82,2168,26,2276
GUJARAT,VADODARA,2021-01-20,95,2121,73,2289
GUJARAT,VALSAD,2021-01-16,2,297,0,299
GUJARAT,VALSAD,2021-01-17,4,283,0,287
GUJARAT,VALSAD,2021-01-18,2,361,1,364
GUJARAT,VALSAD,2021-01-19,11,390,0,401
GUJARAT,VALSAD,2021-01-20,5,420,0,425
HARYANA,AMBALA,2021-01-16,20,595,24,639
HARYANA,AMBALA,2021-01-17,10,170,4,184
HARYANA,AMBALA,2021-01-18,32,801,11,844
HARYANA,AMBALA,2021-01-19,22,1099,19,1140
HARYANA,AMBALA,2021-01-20,25,352,3,380
HARYANA,BHIWANI,2021-01-16,3,768,0,771
HARYANA,BHIWANI,2021-01-17,1,366,0,367
HARYANA,BHIWANI,2021-01-18,2,1715,0,1717
HARYANA,BHIWANI,2021-01-19,4,1672,0,1676
HARYANA,BHIWANI,2021-01-20,0,1372,0,1372
HARYANA,CHARKI DADRI,2021-01-16,1,587,0,588
HARYANA,CHARKI DADRI,2021-01-17,0,121,0,121
HARYANA,CHARKI DADRI,2021-01-18,3,780,0,783
HARYANA,CHARKI DADRI,2021-01-19,0,240,0,240
HARYANA,CHARKI DADRI,2021-01-20,0,384,0,384
HARYANA,FARIDABAD,2021-01-16,27,1341,2,1370
HARYANA,FARIDABAD,2021-01-17,17,666,3,686
HARYANA,FARIDABAD,2021-01-18,17,1141,1,1159
HARYANA,FARIDABAD,2021-01-19,15,1039,1,1055
HARYANA,FARIDABAD,2021-01-20,13,954,2,969
HARYANA,FATEHABAD,2021-01-16,0,384,0,384
HARYANA,FATEHABAD,2021-01-17,2,306,0,308
HARYANA,FATEHABAD,2021-01-18,3,820,1,824
HARYANA,FATEHABAD,2021-01-19,4,213,0,217
HARYANA,FATEHABAD,2021-01-20,4,190,0,194
HARYANA,GURUGRAM,2021-01-16,72,2586,8,2666
HARYANA,GURUGRAM,2021-01-17,47,2732,25,2804
HARYANA,GURUGRAM,2021-01-18,46,2770,35,2851
HARYANA,GURUGRAM,2021-01-19,33,3050,12,3095
HARYANA,GURUGRAM,2021-01-20,52,2623,27,2702
HARYANA,HISAR,2021-01-16,5,1500,0,1505
HARYANA,HISAR,2021-01-17,7,851,0,858
HARYANA,HISAR,2021-01-18,5,2108,8,2121
HARYANA,HISAR,2021-01-19,8,1479,0,1487
HARYANA,HISAR,2021-01-20,7,1231,0,1238
HARYANA,JHAJJAR,2021-01-16,2,1806,1,1809
HARYANA,JHAJJAR,2021-01-17,0,1713,0,1713
HARYANA,JHAJJAR,2021-01-18,3,1570,1,1574
HARYANA,JHAJJAR,2021-01-19,4,2023,0,2027
HARYANA,JHAJJAR,2021-01-20,0,1516,1,1517
HARYANA,JIND,2021-01-16,20,800,0,820
HARYANA,JIND,2021-01-17,0,536,0,536
HARYANA,JIND,2021-01-18,6,596,0,602
HARYANA,JIND,2021-01-19,0,375,4,379
HARYANA,JIND,2021-01-20,0,617,2,619
HARYANA,KAITHAL,2021-01-16,5,195,0,200
HARYANA,KAITHAL,2021-01-17,4,50,0,54
HARYANA,KAITHAL,2021-01-18,6,213,1,220
HARYANA,KAITHAL,2021-01-19,5,245,1,251
HARYANA,KAITHAL,2021-01-20,4,224,0,228
HARYANA,KARNAL,2021-01-16,15,1459,0,1474
HARYANA,KARNAL,2021-01-17,4,179,1,184
HARYANA,KARNAL,2021-01-18,12,1098,4,1114
HARYANA,KARNAL,2021-01-19,3,1221,3,1227
HARYANA,KARNAL,2021-01-20,3,132,0,135
HARYANA,KURUKSHETRA,2021-01-16,10,504,1,515
HARYANA,KURUKSHETRA,2021-01-17,8,77,0,85
HARYANA,KURUKSHETRA,2021-01-18,7,852,6,865
HARYANA,KURUKSHETRA,2021-01-19,6,758,1,765
HARYANA,KURUKSHETRA,2021-01-20,3,292,0,295
HARYANA,MAHENDRAGARH,2021-01-16,1,276,1,278
HARYANA,MAHENDRAGARH,2021-01-17,0,210,5,215
HARYANA,MAHENDRAGARH,2021-01-18,2,306,0,308
HARYANA,MAHENDRAGARH,2021-01-19,3,333,0,336
HARYANA,MAHENDRAGARH,2021-01-20,3,423,5,431
HARYANA,NUH,2021-01-16,0,486,0,486
HARYANA,NUH,2021-01-17,0,145,0,145
HARYANA,NUH,2021-01-18,0,579,2,581
HARYANA,NUH,2021-01-19,2,527,0,529
HARYANA,NUH,2021-01-20,2,246,0,248
HARYANA,PALWAL,2021-01-16,1,580,3,584
HARYANA,PALWAL,2021-01-17,0,30,0,30
HARYANA,PALWAL,2021-01-18,1,369,0,370
HARYANA,PALWAL,2021-01-19,2,243,0,245
HARYANA,PALWAL,2021-01-20,0,63,1,64
HARYANA,PANCHKULA,2021-01-16,39,884,3,926
HARYANA,PANCHKULA,2021-01-17,14,194,5,213
HARYANA,PANCHKULA,2021-01-18,13,251,5,269
HARYANA,PANCHKULA,2021-01-19,35,617,5,657
HARYANA,PANCHKULA,2021-01-20,24,1256,13,1293
HARYANA,PANIPAT,2021-01-16,20,837,0,857
HARYANA,PANIPAT,2021-01-17,7,798,0,805
HARYANA,PANIPAT,2021-01-18,6,650,2,658
HARYANA,PANIPAT,2021-01-19,9,727,2,738
HARYANA,PANIPAT,2021-01-20,11,771,1,783
HARYANA,REWARI,2021-01-16,3,916,1,920
HARYANA,REWARI,2021-01-17,1,315,8,324
HARYANA,REWARI,2021-01-18,2,123,2,127
HARYANA,REWARI,2021-01-19,2,369,1,372
HARYANA,REWARI,2021-01-20,1,355,1,357
HARYANA,ROHTAK,2021-01-16,38,900,3,941
HARYANA,ROHTAK,2021-01-17,26,920,0,946
HARYANA,ROHTAK,2021-01-18,65,836,0,901
HARYANA,ROHTAK,2021-01-19,8,1295,2,1305
HARYANA,ROHTAK,2021-01-20,9,438,0,447
HARYANA,SIRSA,2021-01-16,0,615,8,623
HARYANA,SIRSA,2021-01-17,12,1082,6,1100
HARYANA,SIRSA,2021-01-18,13,973,12,998
HARYANA,SIRSA,2021-01-19,9,761,5,775
HARYANA,SIRSA,2021-01-20,4,1637,52,1693
HARYANA,SONIPAT,2021-01-16,19,1305,0,1324
HARYANA,SONIPAT,2021-01-17,8,1213,0,1221
HARYANA,SONIPAT,2021-01-18,12,1122,2,1136
HARYANA,SONIPAT,2021-01-19,6,1356,0,1362
HARYANA,SONIPAT,2021-01-20,5,1814,0,1819
HARYANA,YAMUNANAGAR,2021-01-16,3,1255,0,1258
HARYANA,YAMUNANAGAR,2021-01-17,14,1000,0,1014
HARYANA,YAMUNANAGAR,2021-01-18,16,1626,5,1647
HARYANA,YAMUNANAGAR,2021-01-19,14,1012,1,1027
HARYANA,YAMUNANAGAR,2021-01-20,11,415,0,426
HIMACHAL PRADESH,BILASPUR,2021-01-16,3,354,0,357
HIMACHAL PRADESH,BILASPUR,2021-01-17,1,87,0,88
HIMACHAL PRADESH,BILASPUR,2021-01-18,1,124,0,125
HIMACHAL PRADESH,BILASPUR,2021-01-19,1,216,3,220
HIMACHAL PRADESH,BILASPUR,2021-01-20,0,153,1,154
HIMACHAL PRADESH,CHAMBA,2021-01-16,2,159,2,163
HIMACHAL PRADESH,CHAMBA,2021-01-17,0,239,7,246
HIMACHAL PRADESH,CHAMBA,2021-01-18,3,153,1,157
HIMACHAL PRADESH,CHAMBA,2021-01-19,5,602,14,621
HIMACHAL PRADESH,CHAMBA,2021-01-20,3,364,4,371
HIMACHAL PRADESH,HAMIRPUR,2021-01-16,8,261,0,269
HIMACHAL PRADESH,HAMIRPUR,2021-01-17,0,190,0,190
HIMACHAL PRADESH,HAMIRPUR,2021-01-18,2,111,5,118
HIMACHAL PRADESH,HAMIRPUR,2021-01-19,5,188,1,194
HIMACHAL PRADESH,HAMIRPUR,2021-01-20,4,190,1,195
HIMACHAL PRADESH,KANGRA,2021-01-16,7,1947,1,1955
HIMACHAL PRADESH,KANGRA,2021-01-17,5,539,1,545
HIMACHAL PRADESH,KANGRA,2021-01-18,13,1703,4,1720
HIMACHAL PRADESH,KANGRA,2021-01-19,3,887,1,891
HIMACHAL PRADESH,KANGRA,2021-01-20,6,1349,2,1357
HIMACHAL PRADESH,KINNAUR,2021-01-16,0,4,0,4
HIMACHAL PRADESH,KINNAUR,2021-01-17,1,6,0,7
HIMACHAL PRADESH,KINNAUR,2021-01-18,0,24,0,24
HIMACHAL PRADESH,KINNAUR,2021-01-19,0,8,0,8
HIMACHAL PRADESH,KINNAUR,2021-01-20,0,22,0,22
HIMACHAL PRADESH,KULLU,2021-01-16,0,222,1,223
HIMACHAL PRADESH,KULLU,2021-01-17,2,108,3,113
HIMACHAL PRADESH,KULLU,2021-01-18,1,171,3,175
HIMACHAL PRADESH,KULLU,2021-01-19,2,224,3,229
HIMACHAL PRADESH,KULLU,2021-01-20,3,237,3,243
HIMACHAL PRADESH,LAHUL AND SPITI,2021-01-16,0,1,0,1
HIMACHAL PRADESH,LAHUL AND SPITI,2021-01-18,3,3,0,6
HIMACHAL PRADESH,LAHUL AND SPITI,2021-01-20,3,2,0,5
HIMACHAL PRADESH,MANDI,2021-01-16,22,370,11,403
HIMACHAL PRADESH,MANDI,2021-01-17,5,61,6,72
HIMACHAL PRADESH,MANDI,2021-01-18,9,234,7,250
HIMACHAL PRADESH,MANDI,2021-01-19,4,162,3,169
HIMACHAL PRADESH,MANDI,2021-01-20,4,273,3,280
HIMACHAL PRADESH,SHIMLA,2021-01-16,15,549,6,570
HIMACHAL PRADESH,SHIMLA,2021-01-17,7,120,7,134
HIMACHAL PRADESH,SHIMLA,2021-01-18,2,499,17,518
HIMACHAL PRADESH,SHIMLA,2021-01-19,5,392,7,404
HIMACHAL PRADESH,SHIMLA,2021-01-20,8,498,2,508
HIMACHAL PRADESH,SIRMAUR,2021-01-16,19,839,1,859
HIMACHAL PRADESH,SIRMAUR,2021-01-17,8,144,1,153
HIMACHAL PRADESH,SIRMAUR,2021-01-18,6,156,2,164
HIMACHAL PRADESH,SIRMAUR,2021-01-19,12,293,8,313
HIMACHAL PRADESH,SIRMAUR,2021-01-20,16,212,29,257
HIMACHAL PRADESH,SOLAN,2021-01-16,16,348,0,364
HIMACHAL PRADESH,SOLAN,2021-01-17,4,312,0,316
HIMACHAL PRADESH,SOLAN,2021-01-18,7,335,4,346
HIMACHAL PRADESH,SOLAN,2021-01-19,15,600,1,616
HIMACHAL PRADESH,SOLAN,2021-01-20,5,518,0,523
HIMACHAL PRADESH,UNA,2021-01-16,2,690,0,692
HIMACHAL PRADESH,UNA,2021-01-17,3,333,0,336
HIMACHAL PRADESH,UNA,2021-01-18,7,435,2,444
HIMACHAL PRADESH,UNA,2021-01-19,3,883,3,889
HIMACHAL PRADESH,UNA,2021-01-20,6,658,1,665
INDIA,INDIA,2021-01-16,5,3,0,8
INDIA,INDIA,2021-01-17,3,0,0,3
INDIA,INDIA,2021-01-18,6,2,0,8
INDIA,INDIA,2021-01-19,8,4,0,12
INDIA,INDIA,2021-01-20,9,2,0,11
JAMMU AND KASHMIR,ANANTNAG,2021-01-16,6,370,1,377
JAMMU AND KASHMIR,ANANTNAG,2021-01-17,0,160,0,160
JAMMU AND KASHMIR,ANANTNAG,2021-01-18,10,428,0,438
JAMMU AND KASHMIR,ANANTNAG,2021-01-19,11,513,0,524
JAMMU AND KASHMIR,ANANTNAG,2021-01-20,4,201,0,205
JAMMU AND KASHMIR,BANDIPORA,2021-01-16,0,22,0,22
JAMMU AND KASHMIR,BANDIPORA,2021-01-17,0,12,0,12
JAMMU AND KASHMIR,BANDIPORA,2021-01-18,1,71,0,72
JAMMU AND KASHMIR,BANDIPORA,2021-01-19,0,93,0,93
JAMMU AND KASHMIR,BANDIPORA,2021-01-20,1,13,0,14
JAMMU AND KASHMIR,BARAMULLA,2021-01-16,21,655,0,676
JAMMU AND KASHMIR,BARAMULLA,2021-01-17,63,367,5,435
JAMMU AND KASHMIR,BARAMULLA,2021-01-18,16,579,0,595
JAMMU AND KASHMIR,BARAMULLA,2021-01-19,6,558,0,564
JAMMU AND KASHMIR,BARAMULLA,2021-01-20,7,684,0,691
JAMMU AND KASHMIR,BUDGAM,2021-01-16,9,645,1,655
JAMMU AND KASHMIR,BUDGAM,2021-01-17,1,257,0,258
JAMMU AND KASHMIR,BUDGAM,2021-01-18,6,798,0,804
JAMMU AND KASHMIR,BUDGAM,2021-01-19,21,581,0,602
JAMMU AND KASHMIR,BUDGAM,2021-01-20,21,389,0,410
JAMMU AND KASHMIR,DODA,2021-01-16,1,23,0,24
JAMMU AND KASHMIR,DODA,2021-01-17,0,19,0,19
JAMMU AND KASHMIR,DODA,2021-01-18,1,54,0,55
JAMMU AND KASHMIR,DODA,2021-01-19,5,106,0,111
JAMMU AND KASHMIR,DODA,2021-01-20,0,21,0,21
JAMMU AND KASHMIR,GANDERBAL,2021-01-16,2,228,0,230
JAMMU AND KASHMIR,GANDERBAL,2021-01-17,0,126,0,126
JAMMU AND KASHMIR,GANDERBAL,2021-01-18,1,347,0,348
JAMMU AND KASHMIR,GANDERBAL,2021-01-19,18,367,0,385
JAMMU AND KASHMIR,GANDERBAL,2021-01-20,2,228,0,230
JAMMU AND KASHMIR,JAMMU,2021-01-16,40,1323,0,1363
JAMMU AND KASHMIR,JAMMU,2021-01-17,39,1485,2,1526
JAMMU AND KASHMIR,JAMMU,2021-01-18,64,1013,1,1078
JAMMU AND KASHMIR,JAMMU,2021-01-19,55,1096,0,1151
JAMMU AND KASHMIR,JAMMU,2021-01-20,34,1287,0,1321
JAMMU AND KASHMIR,KATHUA,2021-01-16,2,178,0,180
JAMMU AND KASHMIR,KATHUA,2021-01-17,0,21,0,21
JAMMU AND KASHMIR,KATHUA,2021-01-18,0,84,0,84
JAMMU AND KASHMIR,KATHUA,2021-01-19,2,152,0,154
JAMMU AND KASHMIR,KATHUA,2021-01-20,2,50,0,52
JAMMU AND KASHMIR,KISHTWAR,2021-01-16,4,147,0,151
JAMMU AND KASHMIR,KISHTWAR,2021-01-17,0,68,0,68
JAMMU AND KASHMIR,KISHTWAR,2021-01-18,22,206,0,228
JAMMU AND KASHMIR,KISHTWAR,2021-01-19,12,189,0,201
JAMMU AND KASHMIR,KISHTWAR,2021-01-20,3,160,0,163
JAMMU AND KASHMIR,KULGAM,2021-01-16,4,623,0,627
JAMMU AND KASHMIR,KULGAM,2021-01-17,1,447,0,448
JAMMU AND KASHMIR,KULGAM,2021-01-18,2,535,0,537
JAMMU AND KASHMIR,KULGAM,2021-01-19,3,202,0,205
JAMMU AND KASHMIR,KULGAM,2021-01-20,0,226,0,226
JAMMU AND KASHMIR,KUPWARA,2021-01-16,0,63,0,63
JAMMU AND KASHMIR,KUPWARA,2021-01-17,0,9,0,9
JAMMU AND KASHMIR,KUPWARA,2021-01-18,1,351,0,352
JAMMU AND KASHMIR,KUPWARA,2021-01-19,19,33,0,52
JAMMU AND KASHMIR,KUPWARA,2021-01-20,1,78,1,80
JAMMU AND KASHMIR,POONCH,2021-01-16,1,271,0,272
JAMMU AND KASHMIR,POONCH,2021-01-17,0,323,1,324
JAMMU AND KASHMIR,POONCH,2021-01-18,7,402,0,409
JAMMU AND KASHMIR,POONCH,2021-01-19,7,320,0,327
JAMMU AND KASHMIR,POONCH,2021-01-20,0,172,0,172
JAMMU AND KASHMIR,PULWAMA,2021-01-16,7,541,4,552
JAMMU AND KASHMIR,PULWAMA,2021-01-17,0,165,0,165
JAMMU AND KASHMIR,PULWAMA,2021-01-18,10,491,2,503
JAMMU AND KASHMIR,PULWAMA,2021-01-19,5,365,0,370
JAMMU AND KASHMIR,PULWAMA,2021-01-20,11,535,10,556
JAMMU AND KASHMIR,RAJOURI,2021-01-16,0,290,0,290
JAMMU AND KASHMIR,RAJOURI,2021-01-17,0,220,0,220
JAMMU AND KASHMIR,RAJOURI,2021-01-18,0,146,0,146
JAMMU AND KASHMIR,RAJOURI,2021-01-19,2,275,0,277
JAMMU AND KASHMIR,RAJOURI,2021-01-20,0,171,0,171
JAMMU AND KASHMIR,RAMBAN,2021-01-16,11,363,0,374
JAMMU AND KASHMIR,RAMBAN,2021-01-17,0,121,0,121
JAMMU AND KASHMIR,RAMBAN,2021-01-18,1,269,0,270
JAMMU AND KASHMIR,RAMBAN,2021-01-19,11,446,0,457
JAMMU AND KASHMIR,RAMBAN,2021-01-20,1,332,0,333
JAMMU AND KASHMIR,REASI,2021-01-16,23,216,0,239
JAMMU AND KASHMIR,REASI,2021-01-17,11,73,0,84
JAMMU AND KASHMIR,REASI,2021-01-18,7,154,1,162
JAMMU AND KASHMIR,REASI,2021-01-19,8,116,0,124
JAMMU AND KASHMIR,REASI,2021-01-20,7,92,0,99
JAMMU AND KASHMIR,SAMBA,2021-01-16,1,48,0,49
JAMMU AND KASHMIR,SAMBA,2021-01-17,0,258,0,258
JAMMU AND KASHMIR,SAMBA,2021-01-18,4,240,0,244
JAMMU AND KASHMIR,SAMBA,2021-01-19,3,122,0,125
JAMMU AND KASHMIR,SAMBA,2021-01-20,0,108,0,108
JAMMU AND KASHMIR,SHOPIAN,2021-01-16,4,45,1,50
JAMMU AND KASHMIR,SHOPIAN,2021-01-17,0,11,0,11
JAMMU AND KASHMIR,SHOPIAN,2021-01-18,3,124,0,127
JAMMU AND KASHMIR,SHOPIAN,2021-01-19,6,122,0,128
JAMMU AND KASHMIR,SHOPIAN,2021-01-20,1,31,0,32
JAMMU AND KASHMIR,SRINAGAR,2021-01-16,64,2648,7,2719
JAMMU AND KASHMIR,SRINAGAR,2021-01-17,5,1192,0,1197
JAMMU AND KASHMIR,SRINAGAR,2021-01-18,18,2358,2,2378
JAMMU AND KASHMIR,SRINAGAR,2021-01-19,51,1812,1,1864
JAMMU AND KASHMIR,SRINAGAR,2021-01-20,42,2278,4,2324
JAMMU AND KASHMIR,UDHAMPUR,2021-01-16,6,625,0,631
JAMMU AND KASHMIR,UDHAMPUR,2021-01-17,1,115,0,116
JAMMU AND KASHMIR,UDHAMPUR,2021-01-18,1,579,0,580
JAMMU AND KASHMIR,UDHAMPUR,2021-01-19,3,317,0,320
JAMMU AND KASHMIR,UDHAMPUR,2021-01-20,0,355,0,355
JHARKHAND,BOKARO,2021-01-16,2,431,0,433
JHARKHAND,BOKARO,2021-01-17,2,174,6,182
JHARKHAND,BOKARO,2021-01-18,10,1089,1,1100
JHARKHAND,BOKARO,2021-01-19,11,861,0,872
JHARKHAND,BOKARO,2021-01-20,8,760,2,770
JHARKHAND,CHATRA,2021-01-16,0,309,0,309
JHARKHAND,CHATRA,2021-01-17,1,367,0,368
JHARKHAND,CHATRA,2021-01-18,4,369,0,373
JHARKHAND,CHATRA,2021-01-19,0,261,0,261
JHARKHAND,CHATRA,2021-01-20,2,194,0,196
JHARKHAND,DEOGHAR,2021-01-16,3,655,1,659
JHARKHAND,DEOGHAR,2021-01-17,1,370,0,371
JHARKHAND,DEOGHAR,2021-01-18,0,1681,14,1695
JHARKHAND,DEOGHAR,2021-01-19,6,1035,6,1047
JHARKHAND,DEOGHAR,2021-01-20,2,1424,5,1431
JHARKHAND,DHANBAD,2021-01-16,24,761,2,787
JHARKHAND,DHANBAD,2021-01-17,5,67,0,72
JHARKHAND,DHANBAD,2021-01-18,18,657,1,676
JHARKHAND,DHANBAD,2021-01-19,19,747,2,768
JHARKHAND,DHANBAD,2021-01-20,11,724,1,736
JHARKHAND,DUMKA,2021-01-16,0,445,1,446
JHARKHAND,DUMKA,2021-01-17,1,583,0,584
JHARKHAND,DUMKA,2021-01-18,0,515,1,516
JHARKHAND,DUMKA,2021-01-19,0,285,1,286
JHARKHAND,DUMKA,2021-01-20,2,727,0,729
JHARKHAND,EAST SINGHBUM,2021-01-16,12,948,0,960
JHARKHAND,EAST SINGHBUM,2021-01-17,10,491,0,501
JHARKHAND,EAST SINGHBUM,2021-01-18,11,1191,0,1202
JHARKHAND,EAST SINGHBUM,2021-01-19,10,1705,10,1725
JHARKHAND,EAST SINGHBUM,2021-01-20,9,1251,1,1261
JHARKHAND,GARHWA,2021-01-16,1,355,0,356
JHARKHAND,GARHWA,2021-01-17,1,95,0,96
JHARKHAND,GARHWA,2021-01-18,1,171,0,172
JHARKHAND,GARHWA,2021-01-19,2,477,0,479
JHARKHAND,GARHWA,2021-01-20,0,1131,0,1131
JHARKHAND,GIRIDIH,2021-01-16,2,942,0,944
JHARKHAND,GIRIDIH,2021-01-17,3,17,0,20
JHARKHAND,GIRIDIH,2021-01-18,0,588,0,588
JHARKHAND,GIRIDIH,2021-01-19,2,939,0,941
JHARKHAND,GIRIDIH,2021-01-20,0,458,0,458
JHARKHAND,GODDA,2021-01-16,0,693,0,693
JHARKHAND,GODDA,2021-01-17,3,206,0,209
JHARKHAND,GODDA,2021-01-18,2,525,0,527
JHARKHAND,GODDA,2021-01-19,1,688,1,690
JHARKHAND,GODDA,2021-01-20,6,829,0,835
JHARKHAND,GUMLA,2021-01-16,3,246,0,249
JHARKHAND,GUMLA,2021-01-17,0,13,0,13
JHARKHAND,GUMLA,2021-01-18,3,457,0,460
JHARKHAND,GUMLA,2021-01-19,4,454,0,458
JHARKHAND,GUMLA,2021-01-20,1,716,0,717
JHARKHAND,HAZARIBAGH,2021-01-16,4,464,0,468
JHARKHAND,HAZARIBAGH,2021-01-17,1,492,0,493
JHARKHAND,HAZARIBAGH,2021-01-18,3,538,0,541
JHARKHAND,HAZARIBAGH,2021-01-19,6,527,0,533
JHARKHAND,HAZARIBAGH,2021-01-20,6,611,0,617
JHARKHAND,JAMTARA,2021-01-16,0,291,43,334
JHARKHAND,JAMTARA,2021-01-17,0,88,1,89
JHARKHAND,JAMTARA,2021-01-18,0,300,0,300
JHARKHAND,JAMTARA,2021-01-19,0,187,2,189
JHARKHAND,JAMTARA,2021-01-20,0,195,8,203
JHARKHAND,KHUNTI,2021-01-16,0,370,0,370
JHARKHAND,KHUNTI,2021-01-17,0,164,0,164
JHARKHAND,KHUNTI,2021-01-18,1,394,0,395
JHARKHAND,KHUNTI,2021-01-19,1,172,0,173
JHARKHAND,KHUNTI,2021-01-20,2,242,0,244
JHARKHAND,KODERMA,2021-01-16,0,116,0,116
JHARKHAND,KODERMA,2021-01-17,0,18,0,18
JHARKHAND,KODERMA,2021-01-18,2,167,0,169
JHARKHAND,KODERMA,2021-01-19,4,145,6,155
JHARKHAND,KODERMA,2021-01-20,1,392,0,393
JHARKHAND,LATEHAR,2021-01-16,1,369,1,371
JHARKHAND,LATEHAR,2021-01-17,0,5,0,5
JHARKHAND,LATEHAR,2021-01-18,9,351,11,371
JHARKHAND,LATEHAR,2021-01-19,2,386,0,388
JHARKHAND,LATEHAR,2021-01-20,0,367,15,382
JHARKHAND,LOHARDAGA,2021-01-16,4,137,0,141
JHARKHAND,LOHARDAGA,2021-01-17,7,52,0,59
JHARKHAND,LOHARDAGA,2021-01-18,1,210,0,211
JHARKHAND,LOHARDAGA,2021-01-19,1,265,0,266
JHARKHAND,LOHARDAGA,2021-01-20,0,310,0,310
JHARKHAND,PAKUR,2021-01-16,0,1131,0,1131
JHARKHAND,PAKUR,2021-01-17,0,403,0,403
JHARKHAND,PAKUR,2021-01-18,0,708,0,708
JHARKHAND,PAKUR,2021-01-19,0,1652,1,1653
JHARKHAND,PAKUR,2021-01-20,0,735,0,735
JHARKHAND,PALAMU,2021-01-16,31,972,17,1020
JHARKHAND,PALAMU,2021-01-17,0,815,0,815
JHARKHAND,PALAMU,2021-01-18,4,1099,1,1104
JHARKHAND,PALAMU,2021-01-19,11,953,1,965
JHARKHAND,PALAMU,2021-01-20,4,822,1,827
JHARKHAND,RAMGARH,2021-01-16,2,388,0,390
JHARKHAND,RAMGARH,2021-01-17,0,49,0,49
JHARKHAND,RAMGARH,2021-01-18,4,154,0,158
JHARKHAND,RAMGARH,2021-01-19,1,191,4,196
JHARKHAND,RAMGARH,2021-01-20,1,230,0,231
JHARKHAND,RANCHI,2021-01-16,74,757,1,832
JHARKHAND,RANCHI,2021-01-17,80,359,3,442
JHARKHAND,RANCHI,2021-01-18,50,651,3,704
JHARKHAND,RANCHI,2021-01-19,71,862,1,934
JHARKHAND,RANCHI,2021-01-20,78,1070,0,1148
JHARKHAND,SAHEBGANJ,2021-01-16,0,396,0,396
JHARKHAND,SAHEBGANJ,2021-01-17,0,98,0,98
JHARKHAND,SAHEBGANJ,2021-01-18,0,342,0,342
JHARKHAND,SAHEBGANJ,2021-01-19,0,302,0,302
JHARKHAND,SAHEBGANJ,2021-01-20,1,577,1,579
JHARKHAND,SARAIKELA KHARSAWAN,2021-01-16,0,162,0,162
JHARKHAND,SARAIKELA KHARSAWAN,2021-01-17,0,20,0,20
JHARKHAND,SARAIKELA KHARSAWAN,2021-01-18,1,275,0,276
JHARKHAND,SARAIKELA KHARSAWAN,2021-01-19,5,327,0,332
JHARKHAND,SARAIKELA KHARSAWAN,2021-01-20,0,217,0,217
JHARKHAND,SIMDEGA,2021-01-16,2,130,0,132
JHARKHAND,SIMDEGA,2021-01-17,1,110,0,111
JHARKHAND,SIMDEGA,2021-01-18,2,202,0,204
JHARKHAND,SIMDEGA,2021-01-19,2,433,0,435
JHARKHAND,SIMDEGA,2021-01-20,5,396,0,401
JHARKHAND,WEST SINGHBHUM,2021-01-16,2,1096,0,1098
JHARKHAND,WEST SINGHBHUM,2021-01-17,0,656,0,656
JHARKHAND,WEST SINGHBHUM,2021-01-18,3,358,0,361
JHARKHAND,WEST SINGHBHUM,2021-01-19,0,160,0,160
JHARKHAND,WEST SINGHBHUM,2021-01-20,1,347,0,348
KARNATAKA,BAGALKOTE,2021-01-16,9,3460,11,3480
KARNATAKA,BAGALKOTE,2021-01-17,3,3814,6,3823
KARNATAKA,BAGALKOTE,2021-01-18,4,3572,3,3579
KARNATAKA,BAGALKOTE,2021-01-19,4,3255,13,3272
KARNATAKA,BAGALKOTE,2021-01-20,0,1832,0,1832
KARNATAKA,BALLARI,2021-01-16,10,2624,6,2640
KARNATAKA,BALLARI,2021-01-17,8,2412,8,2428
KARNATAKA,BALLARI,2021-01-18,4,2764,1,2769
KARNATAKA,BALLARI,2021-01-19,11,1875,13,1899
KARNATAKA,BALLARI,2021-01-20,10,2487,27,2524
KARNATAKA,BELAGAVI,2021-01-16,26,3882,1,3909
KARNATAKA,BELAGAVI,2021-01-17,5,2010,2,2017
KARNATAKA,BELAGAVI,2021-01-18,18,2946,5,2969
KARNATAKA,BELAGAVI,2021-01-19,26,3968,2,3996
KARNATAKA,BELAGAVI,2021-01-20,10,3589,3,3602
KARNATAKA,BENGALURU RURAL,2021-01-16,24,2677,1,2702
KARNATAKA,BENGALURU RURAL,2021-01-17,4,947,0,951
KARNATAKA,BENGALURU RURAL,2021-01-18,18,1266,1,1285
KARNATAKA,BENGALURU RURAL,2021-01-19,14,1711,0,1725
KARNATAKA,BENGALURU RURAL,2021-01-20,15,2112,2,2129
KARNATAKA,BENGALURU URBAN,2021-01-16,390,35646,17,36053
KARNATAKA,BENGALURU URBAN,2021-01-17,274,21538,90,21902
KARNATAKA,BENGALURU URBAN,2021-01-18,359,34011,67,34437
KARNATAKA,BENGALURU URBAN,2021-01-19,398,29551,44,29993
KARNATAKA,BENGALURU URBAN,2021-01-20,364,33557,78,33999
KARNATAKA,BIDAR,2021-01-16,7,1136,0,1143
KARNATAKA,BIDAR,2021-01-17,4,1670,0,1674
KARNATAKA,BIDAR,2021-01-18,6,1230,2,1238
KARNATAKA,BIDAR,2021-01-19,8,1692,0,1700
KARNATAKA,BIDAR,2021-01-20,2,1682,0,1684
KARNATAKA,CHAMARAJANAGARA,2021-01-16,3,1380,0,1383
KARNATAKA,CHAMARAJANAGARA,2021-01-17,1,853,1,855
KARNATAKA,CHAMARAJANAGARA,2021-01-18,7,568,0,575
KARNATAKA,CHAMARAJANAGARA,2021-01-19,4,1127,0,1131
KARNATAKA,CHAMARAJANAGARA,2021-01-20,5,1089,2,1096
KARNATAKA,CHIKKABALLAPURA,2021-01-16,10,2257,5,2272
KARNATAKA,CHIKKABALLAPURA,2021-01-17,23,2100,8,2131
KARNATAKA,CHIKKABALLAPURA,2021-01-18,24,1435,3,1462
KARNATAKA,CHIKKABALLAPURA,2021-01-19,11,1648,0,1659
KARNATAKA,CHIKKABALLAPURA,2021-01-20,23,2209,13,2245
KARNATAKA,CHIKKAMAGALURU,2021-01-16,9,1883,20,1912
KARNATAKA,CHIKKAMAGALURU,2021-01-17,7,1020,6,1033
KARNATAKA,CHIKKAMAGALURU,2021-01-18,4,589,1,594
KARNATAKA,CHIKKAMAGALURU,2021-01-19,2,1511,7,1520
KARNATAKA,CHIKKAMAGALURU,2021-01-20,11,1078,2,1091
KARNATAKA,CHITRADURGA,2021-01-16,9,2461,1,2471
KARNATAKA,CHITRADURGA,2021-01-17,17,1302,0,1319
KARNATAKA,CHITRADURGA,2021-01-18,18,1648,1,1667
KARNATAKA,CHITRADURGA,2021-01-19,20,1355,0,1375
KARNATAKA,CHITRADURGA,2021-01-20,6,1237,1,1244
KARNATAKA,DAKSHINA KANNADA,2021-01-16,27,3276,1,3304
KARNATAKA,DAKSHINA KANNADA,2021-01-17,12,1338,0,1350
KARNATAKA,DAKSHINA KANNADA,2021-01-18,23,2992,23,3038
KARNATAKA,DAKSHINA KANNADA,2021-01-19,22,3091,2,3115
KARNATAKA,DAKSHINA KANNADA,2021-01-20,37,2634,8,2679
KARNATAKA,DAVANGERE,2021-01-16,16,1905,10,1931
KARNATAKA,DAVANGERE,2021-01-17,8,1619,15,1642
KARNATAKA,DAVANGERE,2021-01-18,9,1312,12,1333
KARNATAKA,DAVANGERE,2021-01-19,16,2779,1,2796
KARNATAKA,DAVANGERE,2021-01-20,10,2873,111,2994
KARNATAKA,DHARWAD,2021-01-16,16,2912,5,2933
KARNATAKA,DHARWAD,2021-01-17,8,2272,1,2281
KARNATAKA,DHARWAD,2021-01-18,7,2274,18,2299
KARNATAKA,DHARWAD,2021-01-19,15,3654,4,3673
KARNATAKA,DHARWAD,2021-01-20,9,2393,5,2407
KARNATAKA,GADAG,2021-01-16,1,2562,82,2645
KARNATAKA,GADAG,2021-01-17,6,448,44,498
KARNATAKA,GADAG,2021-01-18,4,1276,75,1355
KARNATAKA,GADAG,2021-01-19,1,574,10,585
KARNATAKA,GADAG,2021-01-20,0,1300,74,1374
KARNATAKA,HASSAN,2021-01-16,10,1571,6,1587
KARNATAKA,HASSAN,2021-01-17,7,4680,2,4689
KARNATAKA,HASSAN,2021-01-18,11,2465,86,2562
KARNATAKA,HASSAN,2021-01-19,13,1811,17,1841
KARNATAKA,HASSAN,2021-01-20,17,1425,37,1479
KARNATAKA,HAVERI,2021-01-16,1,1271,0,1272
KARNATAKA,HAVERI,2021-01-17,0,928,0,928
KARNATAKA,HAVERI,2021-01-18,0,1199,1,1200
KARNATAKA,HAVERI,2021-01-19,0,626,1,627
KARNATAKA,HAVERI,2021-01-20,3,1008,1,1012
KARNATAKA,KALABURAGI,2021-01-16,24,2207,0,2231
KARNATAKA,KALABURAGI,2021-01-17,14,1549,0,1563
KARNATAKA,KALABURAGI,2021-01-18,11,780,3,794
KARNATAKA,KALABURAGI,2021-01-19,16,1559,4,1579
KARNATAKA,KALABURAGI,2021-01-20,62,2472,9,2543
KARNATAKA,KODAGU,2021-01-16,11,871,8,890
KARNATAKA,KODAGU,2021-01-17,14,665,20,699
KARNATAKA,KODAGU,2021-01-18,6,497,11,514
KARNATAKA,KODAGU,2021-01-19,4,593,17,614
KARNATAKA,KODAGU,2021-01-20,12,413,8,433
KARNATAKA,KOLAR,2021-01-16,9,2395,11,2415
KARNATAKA,KOLAR,2021-01-17,13,2238,0,2251
KARNATAKA,KOLAR,2021-01-18,8,1336,16,1360
KARNATAKA,KOLAR,2021-01-19,15,1940,46,2001
KARNATAKA,KOLAR,2021-01-20,9,2613,1,2623
KARNATAKA,KOPPAL,2021-01-16,1,1266,3,1270
KARNATAKA,KOPPAL,2021-01-17,0,1285,0,1285
KARNATAKA,KOPPAL,2021-01-18,3,1115,3,1121
KARNATAKA,KOPPAL,2021-01-19,1,1293,6,1300
KARNATAKA,KOPPAL,2021-01-20,1,1157,9,1167
KARNATAKA,MANDYA,2021-01-16,4,2322,4,2330
KARNATAKA,MANDYA,2021-01-17,15,831,1,847
KARNATAKA,MANDYA,2021-01-18,7,1214,0,1221
KARNATAKA,MANDYA,2021-01-19,10,2147,1,2158
KARNATAKA,MANDYA,2021-01-20,9,2507,3,2519
KARNATAKA,MYSURU,2021-01-16,44,7069,8,7121
KARNATAKA,MYSURU,2021-01-17,21,4283,4,4308
KARNATAKA,MYSURU,2021-01-18,26,1964,1,1991
KARNATAKA,MYSURU,2021-01-19,34,4608,4,4646
KARNATAKA,MYSURU,2021-01-20,33,6008,5,6046
KARNATAKA,RAICHUR,2021-01-16,5,255,2,262
KARNATAKA,RAICHUR,2021-01-17,5,1203,11,1219
KARNATAKA,RAICHUR,2021-01-18,7,1298,1,1306
KARNATAKA,RAICHUR,2021-01-19,2,582,4,588
KARNATAKA,RAICHUR,2021-01-20,1,1617,2,1620
KARNATAKA,RAMANAGARA,2021-01-16,0,965,0,965
KARNATAKA,RAMANAGARA,2021-01-17,1,52,0,53
KARNATAKA,RAMANAGARA,2021-01-18,1,952,1,954
KARNATAKA,RAMANAGARA,2021-01-19,2,599,0,601
KARNATAKA,RAMANAGARA,2021-01-20,2,817,0,819
KARNATAKA,SHIVAMOGGA,2021-01-16,7,2562,90,2659
KARNATAKA,SHIVAMOGGA,2021-01-17,7,1503,1,1511
KARNATAKA,SHIVAMOGGA,2021-01-18,16,2489,1,2506
KARNATAKA,SHIVAMOGGA,2021-01-19,7,1882,0,1889
KARNATAKA,SHIVAMOGGA,2021-01-20,17,2222,0,2239
KARNATAKA,TUMAKURU,2021-01-16,28,3313,0,3341
KARNATAKA,TUMAKURU,2021-01-17,27,2411,7,2445
KARNATAKA,TUMAKURU,2021-01-18,10,3823,165,3998
KARNATAKA,TUMAKURU,2021-01-19,62,3579,2,3643
KARNATAKA,TUMAKURU,2021-01-20,30,2507,188,2725
KARNATAKA,UDUPI,2021-01-16,5,1165,1,1171
KARNATAKA,UDUPI,2021-01-17,2,744,0,746
KARNATAKA,UDUPI,2021-01-18,3,1240,2,1245
KARNATAKA,UDUPI,2021-01-19,10,765,0,775
KARNATAKA,UDUPI,2021-01-20,7,1186,2,1195
KARNATAKA,UTTARA KANNADA,2021-01-16,16,1532,38,1586
KARNATAKA,UTTARA KANNADA,2021-01-17,14,1519,53,1586
KARNATAKA,UTTARA KANNADA,2021-01-18,8,748,19,775
KARNATAKA,UTTARA KANNADA,2021-01-19,12,2220,105,2337
KARNATAKA,UTTARA KANNADA,2021-01-20,5,789,1,795
KARNATAKA,VIJAYAPURA,2021-01-16,4,1338,1,1343
KARNATAKA,VIJAYAPURA,2021-01-17,5,652,0,657
KARNATAKA,VIJAYAPURA,2021-01-18,9,1413,0,1422
KARNATAKA,VIJAYAPURA,2021-01-19,3,1362,1,1366
KARNATAKA,VIJAYAPURA,2021-01-20,2,1017,0,1019
KARNATAKA,YADGIR,2021-01-16,7,1310,0,1317
KARNATAKA,YADGIR,2021-01-17,4,911,0,915
KARNATAKA,YADGIR,2021-01-18,2,882,0,884
KARNATAKA,YADGIR,2021-01-19,1,1243,0,1244
KARNATAKA,YADGIR,2021-01-20,3,1432,0,1435
KERALA,ALAPPUZHA,2021-01-16,330,3625,2,3957
KERALA,ALAPPUZHA,2021-01-17,228,1437,3,1668
KERALA,ALAPPUZHA,2021-01-18,444,3493,5,3942
KERALA,ALAPPUZHA,2021-01-19,463,3264,2,3729
KERALA,ALAPPUZHA,2021-01-20,318,2075,4,2397
KERALA,ERNAKULAM,2021-01-16,998,6814,21,7833
KERALA,ERNAKULAM,2021-01-17,509,1545,6,2060
KERALA,ERNAKULAM,2021-01-18,1089,7288,27,8404
KERALA,ERNAKULAM,2021-01-19,1197,5971,10,7178
KERALA,ERNAKULAM,2021-01-20,850,4196,17,5063
KERALA,IDUKKI,2021-01-16,295,1891,7,2193
KERALA,IDUKKI,2021-01-17,198,1256,7,1461
KERALA,IDUKKI,2021-01-18,192,2508,0,2700
KERALA,IDUKKI,2021-01-19,394,2107,8,2509
KERALA,IDUKKI,2021-01-20,276,1329,13,1618
KERALA,KANNUR,2021-01-16,252,2830,1,3083
KERALA,KANNUR,2021-01-17,224,1157,3,1384
KERALA,KANNUR,2021-01-18,307,3167,8,3482
KERALA,KANNUR,2021-01-19,301,2586,2,2889
KERALA,KANNUR,2021-01-20,350,1972,3,2325
KERALA,KASARAGOD,2021-01-16,106,1851,4,1961
KERALA,KASARAGOD,2021-01-17,37,643,6,686
KERALA,KASARAGOD,2021-01-18,92,1337,6,1435
KERALA,KASARAGOD,2021-01-19,98,1488,6,1592
KERALA,KASARAGOD,2021-01-20,106,1308,3,1417
KERALA,KOLLAM,2021-01-16,586,5348,0,5934
KERALA,KOLLAM,2021-01-17,284,1675,0,1959
KERALA,KOLLAM,2021-01-18,608,5782,0,6390
KERALA,KOLLAM,2021-01-19,854,4960,0,5814
KERALA,KOLLAM,2021-01-20,432,2328,0,2760
KERALA,KOTTAYAM,2021-01-16,527,3489,11,4027
KERALA,KOTTAYAM,2021-01-17,295,1622,8,1925
KERALA,KOTTAYAM,2021-01-18,758,4747,6,5511
KERALA,KOTTAYAM,2021-01-19,831,4203,5,5039
KERALA,KOTTAYAM,2021-01-20,583,2390,14,2987
KERALA,KOZHIKODE,2021-01-16,774,4725,29,5528
KERALA,KOZHIKODE,2021-01-17,490,2113,12,2615
KERALA,KOZHIKODE,2021-01-18,558,5106,10,5674
KERALA,KOZHIKODE,2021-01-19,850,4700,26,5576
KERALA,KOZHIKODE,2021-01-20,666,3268,21,3955
KERALA,MALAPPURAM,2021-01-16,467,3368,3,3838
KERALA,MALAPPURAM,2021-01-17,330,1462,2,1794
KERALA,MALAPPURAM,2021-01-18,482,4298,6,4786
KERALA,MALAPPURAM,2021-01-19,508,3234,8,3750
KERALA,MALAPPURAM,2021-01-20,612,2817,1,3430
KERALA,PALAKKAD,2021-01-16,388,2460,1,2849
KERALA,PALAKKAD,2021-01-17,153,1252,0,1405
KERALA,PALAKKAD,2021-01-18,259,3125,0,3384
KERALA,PALAKKAD,2021-01-19,268,2216,0,2484
KERALA,PALAKKAD,2021-01-20,262,1997,0,2259
KERALA,PATHANAMTHITTA,2021-01-16,530,3585,3,4118
KERALA,PATHANAMTHITTA,2021-01-17,92,858,0,950
KERALA,PATHANAMTHITTA,2021-01-18,586,3438,3,4027
KERALA,PATHANAMTHITTA,2021-01-19,668,3322,8,3998
KERALA,PATHANAMTHITTA,2021-01-20,541,2405,5,2951
KERALA,THIRUVANANTHAPURAM,2021-01-16,448,4990,1,5439
KERALA,THIRUVANANTHAPURAM,2021-01-17,343,2498,1,2842
KERALA,THIRUVANANTHAPURAM,2021-01-18,472,5174,1,5647
KERALA,THIRUVANANTHAPURAM,2021-01-19,451,4122,1,4574
KERALA,THIRUVANANTHAPURAM,2021-01-20,517,4599,0,5116
KERALA,THRISSUR,2021-01-16,400,3719,0,4119
KERALA,THRISSUR,2021-01-17,183,1491,0,1674
KERALA,THRISSUR,2021-01-18,517,4695,0,5212
KERALA,THRISSUR,2021-01-19,618,3897,0,4515
KERALA,THRISSUR,2021-01-20,412,2416,0,2828
KERALA,WAYANAD,2021-01-16,242,1744,3,1989
KERALA,WAYANAD,2021-01-17,79,900,0,979
KERALA,WAYANAD,2021-01-18,266,1294,7,1567
KERALA,WAYANAD,2021-01-19,398,1337,10,1745
KERALA,WAYANAD,2021-01-20,243,547,8,798
LADAKH,KARGIL,2021-01-16,0,34,0,34
LADAKH,KARGIL,2021-01-17,0,86,0,86
LADAKH,KARGIL,2021-01-18,0,62,0,62
LADAKH,KARGIL,2021-01-19,1,104,0,105
LADAKH,KARGIL,2021-01-20,0,34,0,34
LADAKH,LEH LADAKH,2021-01-16,6,175,0,181
LADAKH,LEH LADAKH,2021-01-17,0,112,0,112
LADAKH,LEH LADAKH,2021-01-18,2,178,0,180
LADAKH,LEH LADAKH,2021-01-19,6,161,3,170
LADAKH,LEH LADAKH,2021-01-20,6,242,0,248
LAKSHADWEEP,LAKSHADWEEP DISTRICT,2021-01-16,0,49,0,49
LAKSHADWEEP,LAKSHADWEEP DISTRICT,2021-01-17,0,49,0,49
LAKSHADWEEP,LAKSHADWEEP DISTRICT,2021-01-18,0,90,0,90
LAKSHADWEEP,LAKSHADWEEP DISTRICT,2021-01-19,0,70,0,70
LAKSHADWEEP,LAKSHADWEEP DISTRICT,2021-01-20,0,85,0,85
MADHYA PRADESH,AGAR MALWA,2021-01-16,0,318,0,318
MADHYA PRADESH,AGAR MALWA,2021-01-17,0,179,0,179
MADHYA PRADESH,AGAR MALWA,2021-01-18,0,189,0,189
MADHYA PRADESH,AGAR MALWA,2021-01-19,0,287,0,287
MADHYA PRADESH,AGAR MALWA,2021-01-20,1,170,0,171
MADHYA PRADESH,ALIRAJPUR,2021-01-16,3,81,0,84
MADHYA PRADESH,ALIRAJPUR,2021-01-17,1,32,0,33
MADHYA PRADESH,ALIRAJPUR,2021-01-18,2,211,0,213
MADHYA PRADESH,ALIRAJPUR,2021-01-19,1,95,0,96
MADHYA PRADESH,ALIRAJPUR,2021-01-20,0,224,0,224
MADHYA PRADESH,ANUPPUR,2021-01-16,3,96,0,99
MADHYA PRADESH,ANUPPUR,2021-01-17,4,72,0,76
MADHYA PRADESH,ANUPPUR,2021-01-18,2,53,0,55
MADHYA PRADESH,ANUPPUR,2021-01-19,2,48,0,50
MADHYA PRADESH,ANUPPUR,2021-01-20,6,44,0,50
MADHYA PRADESH,ASHOKNAGAR,2021-01-16,1,59,0,60
MADHYA PRADESH,ASHOKNAGAR,2021-01-17,2,102,0,104
MADHYA PRADESH,ASHOKNAGAR,2021-01-18,1,92,0,93
MADHYA PRADESH,ASHOKNAGAR,2021-01-19,1,187,0,188
MADHYA PRADESH,ASHOKNAGAR,2021-01-20,3,135,0,138
MADHYA PRADESH,BALAGHAT,2021-01-16,8,261,1,270
MADHYA PRADESH,BALAGHAT,2021-01-17,3,257,4,264
MADHYA PRADESH,BALAGHAT,2021-01-18,6,527,2,535
MADHYA PRADESH,BALAGHAT,2021-01-19,5,524,1,530
MADHYA PRADESH,BALAGHAT,2021-01-20,11,342,5,358
MADHYA PRADESH,BARWANI,2021-01-16,7,209,0,216
MADHYA PRADESH,BARWANI,2021-01-17,12,108,0,120
MADHYA PRADESH,BARWANI,2021-01-18,5,375,0,380
MADHYA PRADESH,BARWANI,2021-01-19,1,252,0,253
MADHYA PRADESH,BARWANI,2021-01-20,3,316,0,319
MADHYA PRADESH,BETUL,2021-01-16,10,402,1,413
MADHYA PRADESH,BETUL,2021-01-17,39,258,0,297
MADHYA PRADESH,BETUL,2021-01-18,7,477,2,486
MADHYA PRADESH,BETUL,2021-01-19,9,432,0,441
MADHYA PRADESH,BETUL,2021-01-20,10,505,0,515
MADHYA PRADESH,BHIND,2021-01-16,1,507,0,508
MADHYA PRADESH,BHIND,2021-01-17,0,332,0,332
MADHYA PRADESH,BHIND,2021-01-18,1,534,0,535
MADHYA PRADESH,BHIND,2021-01-19,1,341,1,343
MADHYA PRADESH,BHIND,2021-01-20,1,371,0,372
MADHYA PRADESH,BHOPAL,2021-01-16,102,1753,12,1867
MADHYA PRADESH,BHOPAL,2021-01-17,95,1687,19,1801
MADHYA PRADESH,BHOPAL,2021-01-18,69,1736,13,1818
MADHYA PRADESH,BHOPAL,2021-01-19,106,1999,30,2135
MADHYA PRADESH,BHOPAL,2021-01-20,108,2299,23,2430
MADHYA PRADESH,BURHANPUR,2021-01-16,0,265,0,265
MADHYA PRADESH,BURHANPUR,2021-01-17,2,176,0,178
MADHYA PRADESH,BURHANPUR,2021-01-18,0,99,0,99
MADHYA PRADESH,BURHANPUR,2021-01-19,0,93,0,93
MADHYA PRADESH,BURHANPUR,2021-01-20,2,315,0,317
MADHYA PRADESH,CHHATARPUR,2021-01-16,4,264,2,270
MADHYA PRADESH,CHHATARPUR,2021-01-17,3,210,0,213
MADHYA PRADESH,CHHATARPUR,2021-01-18,1,478,1,480
MADHYA PRADESH,CHHATARPUR,2021-01-19,1,308,0,309
MADHYA PRADESH,CHHATARPUR,2021-01-20,1,359,1,361
MADHYA PRADESH,CHHINDWARA,2021-01-16,17,457,3,477
MADHYA PRADESH,CHHINDWARA,2021-01-17,8,237,15,260
MADHYA PRADESH,CHHINDWARA,2021-01-18,4,152,301,457
MADHYA PRADESH,CHHINDWARA,2021-01-19,15,466,18,499
MADHYA PRADESH,CHHINDWARA,2021-01-20,11,493,9,513
MADHYA PRADESH,DAMOH,2021-01-16,3,260,0,263
MADHYA PRADESH,DAMOH,2021-01-17,0,120,1,121
MADHYA PRADESH,DAMOH,2021-01-18,5,383,0,388
MADHYA PRADESH,DAMOH,2021-01-19,2,147,0,149
MADHYA PRADESH,DAMOH,2021-01-20,5,273,0,278
MADHYA PRADESH,DATIA,2021-01-16,1,313,1,315
MADHYA PRADESH,DATIA,2021-01-17,2,205,9,216
MADHYA PRADESH,DATIA,2021-01-18,1,204,2,207
MADHYA PRADESH,DATIA,2021-01-19,0,388,5,393
MADHYA PRADESH,DATIA,2021-01-20,5,419,3,427
MADHYA PRADESH,DEWAS,2021-01-16,11,165,0,176
MADHYA PRADESH,DEWAS,2021-01-17,13,414,0,427
MADHYA PRADESH,DEWAS,2021-01-18,16,157,2,175
MADHYA PRADESH,DEWAS,2021-01-19,12,135,0,147
MADHYA PRADESH,DEWAS,2021-01-20,13,269,0,282
MADHYA PRADESH,DHAR,2021-01-16,4,256,0,260
MADHYA PRADESH,DHAR,2021-01-17,11,137,0,148
MADHYA PRADESH,DHAR,2021-01-18,17,500,0,517
MADHYA PRADESH,DHAR,2021-01-19,2,326,0,328
MADHYA PRADESH,DHAR,2021-01-20,7,482,0,489
MADHYA PRADESH,DINDORI,2021-01-16,1,137,0,138
MADHYA PRADESH,DINDORI,2021-01-17,1,168,0,169
MADHYA PRADESH,DINDORI,2021-01-18,1,290,0,291
MADHYA PRADESH,DINDORI,2021-01-19,3,86,0,89
MADHYA PRADESH,DINDORI,2021-01-20,1,102,0,103
MADHYA PRADESH,EAST NIMAR,2021-01-16,3,458,2,463
MADHYA PRADESH,EAST NIMAR,2021-01-17,2,344,3,349
MADHYA PRADESH,EAST NIMAR,2021-01-18,2,485,1,488
MADHYA PRADESH,EAST NIMAR,2021-01-19,1,236,2,239
MADHYA PRADESH,EAST NIMAR,2021-01-20,11,216,0,227
MADHYA PRADESH,GUNA,2021-01-16,12,142,0,154
MADHYA PRADESH,GUNA,2021-01-17,1,151,0,152
MADHYA PRADESH,GUNA,2021-01-18,3,410,0,413
MADHYA PRADESH,GUNA,2021-01-19,2,397,0,399
MADHYA PRADESH,GUNA,2021-01-20,3,229,0,232
MADHYA PRADESH,GWALIOR,2021-01-16,19,1443,4,1466
MADHYA PRADESH,GWALIOR,2021-01-17,14,1058,0,1072
MADHYA PRADESH,GWALIOR,2021-01-18,15,1820,3,1838
MADHYA PRADESH,GWALIOR,2021-01-19,14,1818,5,1837
MADHYA PRADESH,GWALIOR,2021-01-20,12,1577,2,1591
MADHYA PRADESH,HARDA,2021-01-16,2,260,0,262
MADHYA PRADESH,HARDA,2021-01-17,2,277,4,283
MADHYA PRADESH,HARDA,2021-01-18,3,257,4,264
MADHYA PRADESH,HARDA,2021-01-19,1,240,0,241
MADHYA PRADESH,HARDA,2021-01-20,3,262,0,265
MADHYA PRADESH,HOSHANGABAD,2021-01-16,7,247,0,254
MADHYA PRADESH,HOSHANGABAD,2021-01-17,6,243,0,249
MADHYA PRADESH,HOSHANGABAD,2021-01-18,6,277,2,285
MADHYA PRADESH,HOSHANGABAD,2021-01-19,5,203,0,208
MADHYA PRADESH,HOSHANGABAD,2021-01-20,7,401,0,408
MADHYA PRADESH,INDORE,2021-01-16,94,3144,1,3239
MADHYA PRADESH,INDORE,2021-01-17,53,2482,2,2537
MADHYA PRADESH,INDORE,2021-01-18,76,3232,3,3311
MADHYA PRADESH,INDORE,2021-01-19,51,3204,1,3256
MADHYA PRADESH,INDORE,2021-01-20,85,3751,0,3836
MADHYA PRADESH,JABALPUR,2021-01-16,19,577,0,596
MADHYA PRADESH,JABALPUR,2021-01-17,19,153,0,172
MADHYA PRADESH,JABALPUR,2021-01-18,33,249,1,283
MADHYA PRADESH,JABALPUR,2021-01-19,20,247,3,270
MADHYA PRADESH,JABALPUR,2021-01-20,8,402,1,411
MADHYA PRADESH,JHABUA,2021-01-16,2,475,0,477
MADHYA PRADESH,JHABUA,2021-01-17,9,465,1,475
MADHYA PRADESH,JHABUA,2021-01-18,2,475,0,477
MADHYA PRADESH,JHABUA,2021-01-19,3,438,0,441
MADHYA PRADESH,JHABUA,2021-01-20,2,295,0,297
MADHYA PRADESH,KATNI,2021-01-16,2,170,3,175
MADHYA PRADESH,KATNI,2021-01-17,0,169,1,170
MADHYA PRADESH,KATNI,2021-01-18,1,106,0,107
MADHYA PRADESH,KATNI,2021-01-19,8,212,3,223
MADHYA PRADESH,KATNI,2021-01-20,2,168,2,172
MADHYA PRADESH,KHARGONE,2021-01-16,10,392,0,402
MADHYA PRADESH,KHARGONE,2021-01-17,3,113,5,121
MADHYA PRADESH,KHARGONE,2021-01-18,11,453,0,464
MADHYA PRADESH,KHARGONE,2021-01-19,10,327,0,337
MADHYA PRADESH,KHARGONE,2021-01-20,4,309,0,313
MADHYA PRADESH,MANDLA,2021-01-16,0,382,0,382
MADHYA PRADESH,MANDLA,2021-01-17,0,147,0,147
MADHYA PRADESH,MANDLA,2021-01-18,4,138,0,142
MADHYA PRADESH,MANDLA,2021-01-19,2,189,1,192
MADHYA PRADESH,MANDLA,2021-01-20,2,302,0,304
MADHYA PRADESH,MANDSAUR,2021-01-16,2,224,2,228
MADHYA PRADESH,MANDSAUR,2021-01-17,6,84,1,91
MADHYA PRADESH,MANDSAUR,2021-01-18,4,269,5,278
MADHYA PRADESH,MANDSAUR,2021-01-19,2,209,3,214
MADHYA PRADESH,MANDSAUR,2021-01-20,2,275,0,277
MADHYA PRADESH,MORENA,2021-01-16,0,357,0,357
MADHYA PRADESH,MORENA,2021-01-17,1,148,0,149
MADHYA PRADESH,MORENA,2021-01-18,1,482,0,483
MADHYA PRADESH,MORENA,2021-01-19,0,397,0,397
MADHYA PRADESH,MORENA,2021-01-20,4,354,1,359
MADHYA PRADESH,NARSINGHPUR,2021-01-16,0,562,0,562
MADHYA PRADESH,NARSINGHPUR,2021-01-17,0,253,0,253
MADHYA PRADESH,NARSINGHPUR,2021-01-18,4,198,0,202
MADHYA PRADESH,NARSINGHPUR,2021-01-19,4,292,1,297
MADHYA PRADESH,NARSINGHPUR,2021-01-20,2,380,0,382
MADHYA PRADESH,NEEMUCH,2021-01-16,1,146,0,147
MADHYA PRADESH,NEEMUCH,2021-01-17,2,87,1,90
MADHYA PRADESH,NEEMUCH,2021-01-18,5,206,3,214
MADHYA PRADESH,NEEMUCH,2021-01-19,2,222,3,227
MADHYA PRADESH,NEEMUCH,2021-01-20,4,145,0,149
MADHYA PRADESH,NIWARI,2021-01-16,1,184,0,185
MADHYA PRADESH,NIWARI,2021-01-17,1,291,0,292
MADHYA PRADESH,NIWARI,2021-01-18,0,182,1,183
MADHYA PRADESH,NIWARI,2021-01-19,0,65,0,65
MADHYA PRADESH,NIWARI,2021-01-20,2,276,0,278
MADHYA PRADESH,PANNA,2021-01-16,1,70,0,71
MADHYA PRADESH,PANNA,2021-01-17,4,117,0,121
MADHYA PRADESH,PANNA,2021-01-18,1,82,3,86
MADHYA PRADESH,PANNA,2021-01-19,3,96,0,99
MADHYA PRADESH,PANNA,2021-01-20,0,115,0,115
MADHYA PRADESH,RAISEN,2021-01-16,3,152,0,155
MADHYA PRADESH,RAISEN,2021-01-17,2,85,0,87
MADHYA PRADESH,RAISEN,2021-01-18,5,162,0,167
MADHYA PRADESH,RAISEN,2021-01-19,0,262,0,262
MADHYA PRADESH,RAISEN,2021-01-20,4,229,0,233
MADHYA PRADESH,RAJGARH,2021-01-16,5,139,2,146
MADHYA PRADESH,RAJGARH,2021-01-17,3,158,0,161
MADHYA PRADESH,RAJGARH,2021-01-18,5,298,1,304
MADHYA PRADESH,RAJGARH,2021-01-19,2,248,0,250
MADHYA PRADESH,RAJGARH,2021-01-20,2,355,0,357
MADHYA PRADESH,RATLAM,2021-01-16,4,353,1,358
MADHYA PRADESH,RATLAM,2021-01-17,8,86,0,94
MADHYA PRADESH,RATLAM,2021-01-18,9,360,1,370
MADHYA PRADESH,RATLAM,2021-01-19,9,374,0,383
MADHYA PRADESH,RATLAM,2021-01-20,8,384,1,393
MADHYA PRADESH,REWA,2021-01-16,15,519,0,534
MADHYA PRADESH,REWA,2021-01-17,2,422,5,429
MADHYA PRADESH,REWA,2021-01-18,1,200,0,201
MADHYA PRADESH,REWA,2021-01-19,3,766,0,769
MADHYA PRADESH,REWA,2021-01-20,1,751,0,752
MADHYA PRADESH,SAGAR,2021-01-16,6,819,4,829
MADHYA PRADESH,SAGAR,2021-01-17,9,1301,0,1310
MADHYA PRADESH,SAGAR,2021-01-18,7,884,2,893
MADHYA PRADESH,SAGAR,2021-01-19,5,1212,1,1218
MADHYA PRADESH,SAGAR,2021-01-20,9,851,4,864
MADHYA PRADESH,SATNA,2021-01-16,1,132,0,133
MADHYA PRADESH,SATNA,2021-01-17,2,148,1,151
MADHYA PRADESH,SATNA,2021-01-18,5,432,0,437
MADHYA PRADESH,SATNA,2021-01-19,3,248,0,251
MADHYA PRADESH,SATNA,2021-01-20,5,554,2,561
MADHYA PRADESH,SEHORE,2021-01-16,3,382,1,386
MADHYA PRADESH,SEHORE,2021-01-17,1,525,0,526
MADHYA PRADESH,SEHORE,2021-01-18,3,396,0,399
MADHYA PRADESH,SEHORE,2021-01-19,3,424,0,427
MADHYA PRADESH,SEHORE,2021-01-20,1,436,0,437
MADHYA PRADESH,SEONI,2021-01-16,2,337,2,341
MADHYA PRADESH,SEONI,2021-01-17,1,256,0,257
MADHYA PRADESH,SEONI,2021-01-18,6,278,1,285
MADHYA PRADESH,SEONI,2021-01-19,4,343,3,350
MADHYA PRADESH,SEONI,2021-01-20,1,410,0,411
MADHYA PRADESH,SHAHDOL,2021-01-16,3,54,0,57
MADHYA PRADESH,SHAHDOL,2021-01-17,4,192,0,196
MADHYA PRADESH,SHAHDOL,2021-01-18,1,16,0,17
MADHYA PRADESH,SHAHDOL,2021-01-19,6,9,0,15
MADHYA PRADESH,SHAHDOL,2021-01-20,0,96,0,96
MADHYA PRADESH,SHAJAPUR,2021-01-16,0,293,0,293
MADHYA PRADESH,SHAJAPUR,2021-01-17,1,235,0,236
MADHYA PRADESH,SHAJAPUR,2021-01-18,3,438,0,441
MADHYA PRADESH,SHAJAPUR,2021-01-19,2,289,0,291
MADHYA PRADESH,SHAJAPUR,2021-01-20,1,365,0,366
MADHYA PRADESH,SHEOPUR,2021-01-16,3,370,0,373
MADHYA PRADESH,SHEOPUR,2021-01-17,3,200,1,204
MADHYA PRADESH,SHEOPUR,2021-01-18,3,319,0,322
MADHYA PRADESH,SHEOPUR,2021-01-19,0,145,0,145
MADHYA PRADESH,SHEOPUR,2021-01-20,0,154,0,154
MADHYA PRADESH,SHIVPURI,2021-01-16,2,242,6,250
MADHYA PRADESH,SHIVPURI,2021-01-17,1,68,0,69
MADHYA PRADESH,SHIVPURI,2021-01-18,2,152,2,156
MADHYA PRADESH,SHIVPURI,2021-01-19,4,375,8,387
MADHYA PRADESH,SHIVPURI,2021-01-20,2,293,6,301
MADHYA PRADESH,SIDHI,2021-01-16,0,19,0,19
MADHYA PRADESH,SIDHI,2021-01-17,0,180,0,180
MADHYA PRADESH,SIDHI,2021-01-18,8,200,0,208
MADHYA PRADESH,SIDHI,2021-01-19,6,217,0,223
MADHYA PRADESH,SIDHI,2021-01-20,0,253,0,253
MADHYA PRADESH,SINGRAULI,2021-01-16,1,171,1,173
MADHYA PRADESH,SINGRAULI,2021-01-17,0,118,0,118
MADHYA PRADESH,SINGRAULI,2021-01-18,2,80,0,82
MADHYA PRADESH,SINGRAULI,2021-01-19,5,349,0,354
MADHYA PRADESH,SINGRAULI,2021-01-20,2,55,0,57
MADHYA PRADESH,TIKAMGARH,2021-01-16,2,205,0,207
MADHYA PRADESH,TIKAMGARH,2021-01-17,0,149,0,149
MADHYA PRADESH,TIKAMGARH,2021-01-18,2,177,1,180
MADHYA PRADESH,TIKAMGARH,2021-01-19,3,110,0,113
MADHYA PRADESH,TIKAMGARH,2021-01-20,2,251,0,253
MADHYA PRADESH,UJJAIN,2021-01-16,10,443,1,454
MADHYA PRADESH,UJJAIN,2021-01-17,9,96,0,105
MADHYA PRADESH,UJJAIN,2021-01-18,17,631,2,650
MADHYA PRADESH,UJJAIN,2021-01-19,13,477,1,491
MADHYA PRADESH,UJJAIN,2021-01-20,10,584,0,594
MADHYA PRADESH,UMARIA,2021-01-16,0,82,0,82
MADHYA PRADESH,UMARIA,2021-01-17,2,89,0,91
MADHYA PRADESH,UMARIA,2021-01-18,0,38,0,38
MADHYA PRADESH,UMARIA,2021-01-19,0,39,0,39
MADHYA PRADESH,UMARIA,2021-01-20,12,38,1,51
MADHYA PRADESH,VIDISHA,2021-01-16,2,228,1,231
MADHYA PRADESH,VIDISHA,2021-01-17,3,28,0,31
MADHYA PRADESH,VIDISHA,2021-01-18,4,268,3,275
MADHYA PRADESH,VIDISHA,2021-01-19,3,100,0,103
MADHYA PRADESH,VIDISHA,2021-01-20,4,179,2,185
MAHARASHTRA,AHMEDNAGAR,2021-01-16,103,1086,44,1233
MAHARASHTRA,AHMEDNAGAR,2021-01-17,88,605,1,694
MAHARASHTRA,AHMEDNAGAR,2021-01-18,51,551,0,602
MAHARASHTRA,AHMEDNAGAR,2021-01-19,81,764,28,873
MAHARASHTRA,AHMEDNAGAR,2021-01-20,104,1065,1,1170
MAHARASHTRA,AKOLA,2021-01-16,27,355,0,382
MAHARASHTRA,AKOLA,2021-01-17,23,220,0,243
MAHARASHTRA,AKOLA,2021-01-18,30,141,1,172
MAHARASHTRA,AKOLA,2021-01-19,46,432,2,480
MAHARASHTRA,AKOLA,2021-01-20,45,495,0,540
MAHARASHTRA,AMRAVATI,2021-01-16,66,460,0,526
MAHARASHTRA,AMRAVATI,2021-01-17,18,129,0,147
MAHARASHTRA,AMRAVATI,2021-01-18,35,420,0,455
MAHARASHTRA,AMRAVATI,2021-01-19,76,608,1,685
MAHARASHTRA,AMRAVATI,2021-01-20,60,650,0,710
MAHARASHTRA,AURANGABAD,2021-01-16,55,440,0,495
MAHARASHTRA,AURANGABAD,2021-01-17,21,684,5,710
MAHARASHTRA,AURANGABAD,2021-01-18,56,1612,9,1677
MAHARASHTRA,AURANGABAD,2021-01-19,32,2086,1,2119
MAHARASHTRA,AURANGABAD,2021-01-20,49,1922,8,1979
MAHARASHTRA,BEED,2021-01-16,31,465,0,496
MAHARASHTRA,BEED,2021-01-17,31,350,0,381
MAHARASHTRA,BEED,2021-01-18,20,494,0,514
MAHARASHTRA,BEED,2021-01-19,46,583,0,629
MAHARASHTRA,BEED,2021-01-20,31,529,1,561
MAHARASHTRA,BHANDARA,2021-01-16,16,417,0,433
MAHARASHTRA,BHANDARA,2021-01-17,22,232,0,254
MAHARASHTRA,BHANDARA,2021-01-18,15,351,0,366
MAHARASHTRA,BHANDARA,2021-01-19,16,155,3,174
MAHARASHTRA,BHANDARA,2021-01-20,28,636,0,664
MAHARASHTRA,BULDHANA,2021-01-16,26,364,1,391
MAHARASHTRA,BULDHANA,2021-01-17,58,212,7,277
MAHARASHTRA,BULDHANA,2021-01-18,41,215,0,256
MAHARASHTRA,BULDHANA,2021-01-19,36,163,1,200
MAHARASHTRA,BULDHANA,2021-01-20,61,614,13,688
MAHARASHTRA,CHANDRAPUR,2021-01-16,22,339,2,363
MAHARASHTRA,CHANDRAPUR,2021-01-17,4,125,1,130
MAHARASHTRA,CHANDRAPUR,2021-01-18,22,374,2,398
MAHARASHTRA,CHANDRAPUR,2021-01-19,27,380,1,408
MAHARASHTRA,CHANDRAPUR,2021-01-20,18,337,0,355
MAHARASHTRA,DHULE,2021-01-16,17,402,2,421
MAHARASHTRA,DHULE,2021-01-17,10,260,0,270
MAHARASHTRA,DHULE,2021-01-18,19,584,2,605
MAHARASHTRA,DHULE,2021-01-19,32,714,5,751
MAHARASHTRA,DHULE,2021-01-20,22,653,4,679
MAHARASHTRA,GADCHIROLI,2021-01-16,11,259,0,270
MAHARASHTRA,GADCHIROLI,2021-01-17,1,135,1,137
MAHARASHTRA,GADCHIROLI,2021-01-18,16,835,4,855
MAHARASHTRA,GADCHIROLI,2021-01-19,2,548,0,550
MAHARASHTRA,GADCHIROLI,2021-01-20,7,622,0,629
MAHARASHTRA,GONDIA,2021-01-16,12,141,0,153
MAHARASHTRA,GONDIA,2021-01-17,14,120,1,135
MAHARASHTRA,GONDIA,2021-01-18,16,357,0,373
MAHARASHTRA,GONDIA,2021-01-19,14,239,1,254
MAHARASHTRA,GONDIA,2021-01-20,8,233,0,241
MAHARASHTRA,HINGOLI,2021-01-16,7,153,0,160
MAHARASHTRA,HINGOLI,2021-01-17,13,264,0,277
MAHARASHTRA,HINGOLI,2021-01-18,8,184,0,192
MAHARASHTRA,HINGOLI,2021-01-19,8,192,0,200
MAHARASHTRA,HINGOLI,2021-01-20,27,300,0,327
MAHARASHTRA,JALGAON,2021-01-16,36,820,0,856
MAHARASHTRA,JALGAON,2021-01-17,28,855,1,884
MAHARASHTRA,JALGAON,2021-01-18,25,560,0,585
MAHARASHTRA,JALGAON,2021-01-19,57,1110,0,1167
MAHARASHTRA,JALGAON,2021-01-20,25,1239,0,1264
MAHARASHTRA,JALNA,2021-01-16,16,113,0,129
MAHARASHTRA,JALNA,2021-01-17,8,116,0,124
MAHARASHTRA,JALNA,2021-01-18,11,249,0,260
MAHARASHTRA,JALNA,2021-01-19,10,309,0,319
MAHARASHTRA,JALNA,2021-01-20,25,373,0,398
MAHARASHTRA,KOLHAPUR,2021-01-16,12,826,5,843
MAHARASHTRA,KOLHAPUR,2021-01-17,10,848,2,860
MAHARASHTRA,KOLHAPUR,2021-01-18,8,394,11,413
MAHARASHTRA,KOLHAPUR,2021-01-19,17,923,69,1009
MAHARASHTRA,KOLHAPUR,2021-01-20,26,1315,114,1455
MAHARASHTRA,LATUR,2021-01-16,26,974,7,1007
MAHARASHTRA,LATUR,2021-01-17,62,1086,6,1154
MAHARASHTRA,LATUR,2021-01-18,47,706,2,755
MAHARASHTRA,LATUR,2021-01-19,70,1598,3,1671
MAHARASHTRA,LATUR,2021-01-20,48,1193,0,1241
MAHARASHTRA,MUMBAI,2021-01-16,495,14320,18,14833
MAHARASHTRA,MUMBAI,2021-01-17,387,9590,7,9984
MAHARASHTRA,MUMBAI,2021-01-18,460,11619,46,12125
MAHARASHTRA,MUMBAI,2021-01-19,505,15267,7,15779
MAHARASHTRA,MUMBAI,2021-01-20,489,12049,16,12554
MAHARASHTRA,MUMBAI SUBURBAN,2021-01-16,126,3119,2,3247
MAHARASHTRA,MUMBAI SUBURBAN,2021-01-17,77,2247,0,2324
MAHARASHTRA,MUMBAI SUBURBAN,2021-01-18,105,2158,0,2263
MAHARASHTRA,MUMBAI SUBURBAN,2021-01-19,82,3090,0,3172
MAHARASHTRA,MUMBAI SUBURBAN,2021-01-20,144,3093,9,3246
MAHARASHTRA,NAGPUR,2021-01-16,344,3110,28,3482
MAHARASHTRA,NAGPUR,2021-01-17,264,1968,11,2243
MAHARASHTRA,NAGPUR,2021-01-18,210,2510,27,2747
MAHARASHTRA,NAGPUR,2021-01-19,279,2851,33,3163
MAHARASHTRA,NAGPUR,2021-01-20,378,2734,33,3145
MAHARASHTRA,NANDED,2021-01-16,52,446,5,503
MAHARASHTRA,NANDED,2021-01-17,21,454,3,478
MAHARASHTRA,NANDED,2021-01-18,29,576,9,614
MAHARASHTRA,NANDED,2021-01-19,22,555,6,583
MAHARASHTRA,NANDED,2021-01-20,23,854,14,891
MAHARASHTRA,NANDURBAR,2021-01-16,67,126,0,193
MAHARASHTRA,NANDURBAR,2021-01-17,19,124,0,143
MAHARASHTRA,NANDURBAR,2021-01-18,80,216,0,296
MAHARASHTRA,NANDURBAR,2021-01-19,47,305,0,352
MAHARASHTRA,NANDURBAR,2021-01-20,60,183,0,243
MAHARASHTRA,NASHIK,2021-01-16,270,2119,3,2392
MAHARASHTRA,NASHIK,2021-01-17,92,969,0,1061
MAHARASHTRA,NASHIK,2021-01-18,65,950,2,1017
MAHARASHTRA,NASHIK,2021-01-19,317,1850,6,2173
MAHARASHTRA,NASHIK,2021-01-20,229,1217,1,1447
MAHARASHTRA,OSMANABAD,2021-01-16,23,291,0,314
MAHARASHTRA,OSMANABAD,2021-01-17,10,213,1,224
MAHARASHTRA,OSMANABAD,2021-01-18,22,301,2,325
MAHARASHTRA,OSMANABAD,2021-01-19,12,233,2,247
MAHARASHTRA,OSMANABAD,2021-01-20,14,398,5,417
MAHARASHTRA,PALGHAR,2021-01-16,35,1334,0,1369
MAHARASHTRA,PALGHAR,2021-01-17,20,331,0,351
MAHARASHTRA,PALGHAR,2021-01-18,33,838,0,871
MAHARASHTRA,PALGHAR,2021-01-19,36,881,1,918
MAHARASHTRA,PALGHAR,2021-01-20,49,779,1,829
MAHARASHTRA,PARBHANI,2021-01-16,16,778,0,794
MAHARASHTRA,PARBHANI,2021-01-17,14,807,0,821
MAHARASHTRA,PARBHANI,2021-01-18,10,139,2,151
MAHARASHTRA,PARBHANI,2021-01-19,17,441,0,458
MAHARASHTRA,PARBHANI,2021-01-20,15,496,0,511
MAHARASHTRA,PUNE,2021-01-16,521,5717,94,6332
MAHARASHTRA,PUNE,2021-01-17,317,3617,15,3949
MAHARASHTRA,PUNE,2021-01-18,437,5618,104,6159
MAHARASHTRA,PUNE,2021-01-19,600,6275,59,6934
MAHARASHTRA,PUNE,2021-01-20,490,6301,65,6856
MAHARASHTRA,RAIGAD,2021-01-16,85,936,3,1024
MAHARASHTRA,RAIGAD,2021-01-17,65,767,1,833
MAHARASHTRA,RAIGAD,2021-01-18,56,1085,4,1145
MAHARASHTRA,RAIGAD,2021-01-19,107,1310,3,1420
MAHARASHTRA,RAIGAD,2021-01-20,75,1212,1,1288
MAHARASHTRA,RATNAGIRI,2021-01-16,32,127,0,159
MAHARASHTRA,RATNAGIRI,2021-01-17,3,90,1,94
MAHARASHTRA,RATNAGIRI,2021-01-18,15,168,0,183
MAHARASHTRA,RATNAGIRI,2021-01-19,4,211,0,215
MAHARASHTRA,RATNAGIRI,2021-01-20,13,173,0,186
MAHARASHTRA,SANGLI,2021-01-16,27,951,0,978
MAHARASHTRA,SANGLI,2021-01-17,13,322,2,337
MAHARASHTRA,SANGLI,2021-01-18,20,716,3,739
MAHARASHTRA,SANGLI,2021-01-19,16,711,0,727
MAHARASHTRA,SANGLI,2021-01-20,18,627,0,645
MAHARASHTRA,SATARA,2021-01-16,73,1038,5,1116
MAHARASHTRA,SATARA,2021-01-17,66,735,23,824
MAHARASHTRA,SATARA,2021-01-18,44,1241,8,1293
MAHARASHTRA,SATARA,2021-01-19,91,796,1,888
MAHARASHTRA,SATARA,2021-01-20,72,941,8,1021
MAHARASHTRA,SINDHUDURG,2021-01-16,22,153,0,175
MAHARASHTRA,SINDHUDURG,2021-01-17,5,49,0,54
MAHARASHTRA,SINDHUDURG,2021-01-18,20,239,0,259
MAHARASHTRA,SINDHUDURG,2021-01-19,11,161,2,174
MAHARASHTRA,SINDHUDURG,2021-01-20,14,163,0,177
MAHARASHTRA,SOLAPUR,2021-01-16,76,1940,0,2016
MAHARASHTRA,SOLAPUR,2021-01-17,73,1497,0,1570
MAHARASHTRA,SOLAPUR,2021-01-18,81,2079,3,2163
MAHARASHTRA,SOLAPUR,2021-01-19,73,2159,5,2237
MAHARASHTRA,SOLAPUR,2021-01-20,69,2208,4,2281
MAHARASHTRA,THANE,2021-01-16,414,11718,38,12170
MAHARASHTRA,THANE,2021-01-17,244,5033,7,5284
MAHARASHTRA,THANE,2021-01-18,363,6124,26,6513
MAHARASHTRA,THANE,2021-01-19,432,7748,13,8193
MAHARASHTRA,THANE,2021-01-20,361,9976,23,10360
MAHARASHTRA,WARDHA,2021-01-16,26,401,8,435
MAHARASHTRA,WARDHA,2021-01-17,12,182,1,195
MAHARASHTRA,WARDHA,2021-01-18,34,572,5,611
MAHARASHTRA,WARDHA,2021-01-19,28,567,6,601
MAHARASHTRA,WARDHA,2021-01-20,37,518,2,557
MAHARASHTRA,WASHIM,2021-01-16,25,1560,3,1588
MAHARASHTRA,WASHIM,2021-01-17,19,422,3,444
MAHARASHTRA,WASHIM,2021-01-18,3,236,0,239
MAHARASHTRA,WASHIM,2021-01-19,11,396,0,407
MAHARASHTRA,WASHIM,2021-01-20,26,458,4,488
MAHARASHTRA,YAVATMAL,2021-01-16,68,235,0,303
MAHARASHTRA,YAVATMAL,2021-01-17,30,246,0,276
MAHARASHTRA,YAVATMAL,2021-01-18,25,279,0,304
MAHARASHTRA,YAVATMAL,2021-01-19,29,391,0,420
MAHARASHTRA,YAVATMAL,2021-01-20,48,373,1,422
MANIPUR,BISHNUPUR,2021-01-16,2,130,0,132
MANIPUR,BISHNUPUR,2021-01-17,2,47,0,49
MANIPUR,BISHNUPUR,2021-01-18,2,104,0,106
MANIPUR,BISHNUPUR,2021-01-19,0,66,0,66
MANIPUR,BISHNUPUR,2021-01-20,0,73,0,73
MANIPUR,CHANDEL,2021-01-16,0,25,0,25
MANIPUR,CHANDEL,2021-01-17,0,32,0,32
MANIPUR,CHANDEL,2021-01-18,1,32,0,33
MANIPUR,CHANDEL,2021-01-19,9,65,0,74
MANIPUR,CHANDEL,2021-01-20,2,29,0,31
MANIPUR,CHURACHANDPUR,2021-01-16,8,58,0,66
MANIPUR,CHURACHANDPUR,2021-01-17,1,45,0,46
MANIPUR,CHURACHANDPUR,2021-01-18,2,141,0,143
MANIPUR,CHURACHANDPUR,2021-01-19,4,95,0,99
MANIPUR,CHURACHANDPUR,2021-01-20,4,173,0,177
MANIPUR,IMPHAL EAST,2021-01-16,3,211,1,215
MANIPUR,IMPHAL EAST,2021-01-17,3,165,0,168
MANIPUR,IMPHAL EAST,2021-01-18,3,196,0,199
MANIPUR,IMPHAL EAST,2021-01-19,10,325,0,335
MANIPUR,IMPHAL EAST,2021-01-20,3,207,0,210
MANIPUR,IMPHAL WEST,2021-01-16,22,1091,0,1113
MANIPUR,IMPHAL WEST,2021-01-17,22,865,0,887
MANIPUR,IMPHAL WEST,2021-01-18,37,723,0,760
MANIPUR,IMPHAL WEST,2021-01-19,35,1083,0,1118
MANIPUR,IMPHAL WEST,2021-01-20,28,892,0,920
MANIPUR,JIRIBAM,2021-01-16,0,7,0,7
MANIPUR,JIRIBAM,2021-01-17,0,10,0,10
MANIPUR,JIRIBAM,2021-01-18,0,26,0,26
MANIPUR,JIRIBAM,2021-01-19,0,17,0,17
MANIPUR,JIRIBAM,2021-01-20,0,1,0,1
MANIPUR,KAKCHING,2021-01-16,10,125,0,135
MANIPUR,KAKCHING,2021-01-17,0,32,0,32
MANIPUR,KAKCHING,2021-01-18,2,84,0,86
MANIPUR,KAKCHING,2021-01-19,3,41,0,44
MANIPUR,KAKCHING,2021-01-20,5,115,0,120
MANIPUR,KAMJONG,2021-01-16,0,5,0,5
MANIPUR,KAMJONG,2021-01-17,0,2,0,2
MANIPUR,KAMJONG,2021-01-18,0,8,0,8
MANIPUR,KAMJONG,2021-01-19,0,1,0,1
MANIPUR,KAMJONG,2021-01-20,0,6,0,6
MANIPUR,KANGPOKPI,2021-01-16,1,31,0,32
MANIPUR,KANGPOKPI,2021-01-17,0,40,0,40
MANIPUR,KANGPOKPI,2021-01-18,0,99,0,99
MANIPUR,KANGPOKPI,2021-01-19,0,90,0,90
MANIPUR,KANGPOKPI,2021-01-20,5,53,0,58
MANIPUR,NONEY,2021-01-16,0,2,0,2
MANIPUR,NONEY,2021-01-18,0,1,0,1
MANIPUR,NONEY,2021-01-19,0,1,0,1
MANIPUR,NONEY,2021-01-20,0,2,0,2
MANIPUR,SENAPATI,2021-01-16,1,45,0,46
MANIPUR,SENAPATI,2021-01-17,0,27,0,27
MANIPUR,SENAPATI,2021-01-18,0,35,0,35
MANIPUR,SENAPATI,2021-01-19,1,35,0,36
MANIPUR,SENAPATI,2021-01-20,0,28,0,28
MANIPUR,TAMENGLONG,2021-01-16,3,53,0,56
MANIPUR,TAMENGLONG,2021-01-17,1,27,0,28
MANIPUR,TAMENGLONG,2021-01-18,0,39,0,39
MANIPUR,TAMENGLONG,2021-01-19,0,58,0,58
MANIPUR,TAMENGLONG,2021-01-20,0,104,0,104
MANIPUR,TENGNOUPAL,2021-01-16,6,5,0,11
MANIPUR,TENGNOUPAL,2021-01-17,0,41,0,41
MANIPUR,TENGNOUPAL,2021-01-18,0,7,0,7
MANIPUR,TENGNOUPAL,2021-01-19,0,5,0,5
MANIPUR,TENGNOUPAL,2021-01-20,0,5,0,5
MANIPUR,THOUBAL,2021-01-16,17,196,0,213
MANIPUR,THOUBAL,2021-01-17,5,122,0,127
MANIPUR,THOUBAL,2021-01-18,5,178,0,183
MANIPUR,THOUBAL,2021-01-19,2,154,0,156
MANIPUR,THOUBAL,2021-01-20,2,175,0,177
MANIPUR,UKHRUL,2021-01-16,5,183,0,188
MANIPUR,UKHRUL,2021-01-17,5,187,0,192
MANIPUR,UKHRUL,2021-01-18,8,234,0,242
MANIPUR,UKHRUL,2021-01-19,5,143,0,148
MANIPUR,UKHRUL,2021-01-20,1,58,0,59
MEGHALAYA,EAST GARO HILLS,2021-01-16,0,17,0,17
MEGHALAYA,EAST GARO HILLS,2021-01-17,0,2,0,2
MEGHALAYA,EAST GARO HILLS,2021-01-18,0,38,0,38
MEGHALAYA,EAST GARO HILLS,2021-01-19,0,16,0,16
MEGHALAYA,EAST GARO HILLS,2021-01-20,0,22,0,22
MEGHALAYA,EAST JAINTIA HILLS,2021-01-16,0,21,0,21
MEGHALAYA,EAST JAINTIA HILLS,2021-01-17,0,37,0,37
MEGHALAYA,EAST JAINTIA HILLS,2021-01-18,0,273,0,273
MEGHALAYA,EAST JAINTIA HILLS,2021-01-19,0,248,0,248
MEGHALAYA,EAST JAINTIA HILLS,2021-01-20,2,84,0,86
MEGHALAYA,EAST KHASI HILLS,2021-01-16,22,472,1,495
MEGHALAYA,EAST KHASI HILLS,2021-01-17,1,251,0,252
MEGHALAYA,EAST KHASI HILLS,2021-01-18,9,673,0,682
MEGHALAYA,EAST KHASI HILLS,2021-01-19,6,695,0,701
MEGHALAYA,EAST KHASI HILLS,2021-01-20,5,443,0,448
MEGHALAYA,NORTH GARO HILLS,2021-01-16,0,7,0,7
MEGHALAYA,NORTH GARO HILLS,2021-01-18,0,4,0,4
MEGHALAYA,NORTH GARO HILLS,2021-01-19,0,12,0,12
MEGHALAYA,NORTH GARO HILLS,2021-01-20,0,9,0,9
MEGHALAYA,RI BHOI,2021-01-16,0,87,0,87
MEGHALAYA,RI BHOI,2021-01-17,0,37,0,37
MEGHALAYA,RI BHOI,2021-01-18,1,85,0,86
MEGHALAYA,RI BHOI,2021-01-19,0,69,0,69
MEGHALAYA,RI BHOI,2021-01-20,0,56,0,56
MEGHALAYA,SOUTH GARO HILLS,2021-01-16,0,7,0,7
MEGHALAYA,SOUTH GARO HILLS,2021-01-17,0,14,0,14
MEGHALAYA,SOUTH GARO HILLS,2021-01-18,0,17,0,17
MEGHALAYA,SOUTH GARO HILLS,2021-01-19,0,16,0,16
MEGHALAYA,SOUTH GARO HILLS,2021-01-20,0,4,0,4
MEGHALAYA,SOUTH WEST GARO HILLS,2021-01-16,0,21,0,21
MEGHALAYA,SOUTH WEST GARO HILLS,2021-01-17,0,4,0,4
MEGHALAYA,SOUTH WEST GARO HILLS,2021-01-18,0,18,0,18
MEGHALAYA,SOUTH WEST GARO HILLS,2021-01-19,0,22,0,22
MEGHALAYA,SOUTH WEST GARO HILLS,2021-01-20,0,33,0,33
MEGHALAYA,SOUTH WEST KHASI HILLS,2021-01-16,0,4,0,4
MEGHALAYA,SOUTH WEST KHASI HILLS,2021-01-17,0,2,0,2
MEGHALAYA,SOUTH WEST KHASI HILLS,2021-01-18,0,30,0,30
MEGHALAYA,SOUTH WEST KHASI HILLS,2021-01-19,0,16,0,16
MEGHALAYA,SOUTH WEST KHASI HILLS,2021-01-20,0,5,0,5
MEGHALAYA,WEST GARO HILLS,2021-01-16,0,111,0,111
MEGHALAYA,WEST GARO HILLS,2021-01-17,0,16,0,16
MEGHALAYA,WEST GARO HILLS,2021-01-18,0,150,1,151
MEGHALAYA,WEST GARO HILLS,2021-01-19,0,203,0,203
MEGHALAYA,WEST GARO HILLS,2021-01-20,0,188,0,188
MEGHALAYA,WEST JAINTIA HILLS,2021-01-16,0,51,1,52
MEGHALAYA,WEST JAINTIA HILLS,2021-01-17,0,46,0,46
MEGHALAYA,WEST JAINTIA HILLS,2021-01-18,1,82,0,83
MEGHALAYA,WEST JAINTIA HILLS,2021-01-19,0,67,2,69
MEGHALAYA,WEST JAINTIA HILLS,2021-01-20,0,42,0,42
MEGHALAYA,WEST KHASI HILLS,2021-01-16,0,60,0,60
MEGHALAYA,WEST KHASI HILLS,2021-01-17,0,36,0,36
MEGHALAYA,WEST KHASI HILLS,2021-01-18,0,80,0,80
MEGHALAYA,WEST KHASI HILLS,2021-01-19,0,45,0,45
MEGHALAYA,WEST KHASI HILLS,2021-01-20,0,75,0,75
MIZORAM,AIZAWL,2021-01-16,7,557,0,564
MIZORAM,AIZAWL,2021-01-17,1,89,0,90
MIZORAM,AIZAWL,2021-01-18,5,817,0,822
MIZORAM,AIZAWL,2021-01-19,4,743,0,747
MIZORAM,AIZAWL,2021-01-20,9,1137,0,1146
MIZORAM,CHAMPHAI,2021-01-16,0,12,0,12
MIZORAM,CHAMPHAI,2021-01-18,0,26,0,26
MIZORAM,CHAMPHAI,2021-01-19,0,54,0,54
MIZORAM,CHAMPHAI,2021-01-20,0,44,0,44
MIZORAM,HNAHTHIAL,2021-01-18,0,3,0,3
MIZORAM,HNAHTHIAL,2021-01-19,0,13,0,13
MIZORAM,HNAHTHIAL,2021-01-20,0,21,0,21
MIZORAM,KHAWZAWL,2021-01-16,0,4,0,4
MIZORAM,KHAWZAWL,2021-01-18,0,12,0,12
MIZORAM,KHAWZAWL,2021-01-19,0,15,0,15
MIZORAM,KHAWZAWL,2021-01-20,0,22,0,22
MIZORAM,KOLASIB,2021-01-16,1,86,0,87
MIZORAM,KOLASIB,2021-01-17,0,132,0,132
MIZORAM,KOLASIB,2021-01-18,0,202,0,202
MIZORAM,KOLASIB,2021-01-19,0,139,0,139
MIZORAM,KOLASIB,2021-01-20,1,118,0,119
MIZORAM,LAWNGTLAI,2021-01-16,0,31,0,31
MIZORAM,LAWNGTLAI,2021-01-18,1,140,0,141
MIZORAM,LAWNGTLAI,2021-01-19,0,20,0,20
MIZORAM,LAWNGTLAI,2021-01-20,1,183,0,184
MIZORAM,LUNGLEI,2021-01-16,0,20,0,20
MIZORAM,LUNGLEI,2021-01-17,0,5,0,5
MIZORAM,LUNGLEI,2021-01-18,0,52,0,52
MIZORAM,LUNGLEI,2021-01-19,1,61,0,62
MIZORAM,LUNGLEI,2021-01-20,0,79,0,79
MIZORAM,MAMIT,2021-01-16,0,57,0,57
MIZORAM,MAMIT,2021-01-17,0,24,0,24
MIZORAM,MAMIT,2021-01-18,0,42,0,42
MIZORAM,MAMIT,2021-01-19,0,95,0,95
MIZORAM,MAMIT,2021-01-20,0,83,0,83
MIZORAM,SAIHA,2021-01-16,0,25,0,25
MIZORAM,SAIHA,2021-01-17,0,11,0,11
MIZORAM,SAIHA,2021-01-18,0,20,0,20
MIZORAM,SAIHA,2021-01-19,1,39,0,40
MIZORAM,SAIHA,2021-01-20,0,76,0,76
MIZORAM,SAITUAL,2021-01-16,0,4,0,4
MIZORAM,SAITUAL,2021-01-17,1,8,0,9
MIZORAM,SAITUAL,2021-01-18,0,26,0,26
MIZORAM,SAITUAL,2021-01-19,0,178,0,178
MIZORAM,SAITUAL,2021-01-20,0,84,0,84
MIZORAM,SERCHHIP,2021-01-16,0,20,0,20
MIZORAM,SERCHHIP,2021-01-18,0,25,0,25
MIZORAM,SERCHHIP,2021-01-19,0,52,0,52
MIZORAM,SERCHHIP,2021-01-20,1,85,0,86
NAGALAND,DIMAPUR,2021-01-16,4,41,0,45
NAGALAND,DIMAPUR,2021-01-17,0,89,0,89
NAGALAND,DIMAPUR,2021-01-18,0,118,0,118
NAGALAND,DIMAPUR,2021-01-19,0,69,0,69
NAGALAND,DIMAPUR,2021-01-20,0,84,0,84
NAGALAND,KIPHIRE,2021-01-16,0,1,0,1
NAGALAND,KIPHIRE,2021-01-17,0,8,0,8
NAGALAND,KIPHIRE,2021-01-18,0,1,0,1
NAGALAND,KIPHIRE,2021-01-19,0,3,0,3
NAGALAND,KIPHIRE,2021-01-20,0,1,0,1
NAGALAND,KOHIMA,2021-01-16,5,41,0,46
NAGALAND,KOHIMA,2021-01-17,0,2,0,2
NAGALAND,KOHIMA,2021-01-18,0,10,0,10
NAGALAND,KOHIMA,2021-01-19,1,16,0,17
NAGALAND,KOHIMA,2021-01-20,0,1,0,1
NAGALAND,LONGLENG,2021-01-16,0,1,0,1
NAGALAND,LONGLENG,2021-01-19,0,1,0,1
NAGALAND,MOKOKCHUNG,2021-01-16,6,7,0,13
NAGALAND,MOKOKCHUNG,2021-01-17,0,11,0,11
NAGALAND,MOKOKCHUNG,2021-01-18,0,18,0,18
NAGALAND,MOKOKCHUNG,2021-01-19,0,15,0,15
NAGALAND,MOKOKCHUNG,2021-01-20,0,29,0,29
NAGALAND,MON,2021-01-16,0,1,0,1
NAGALAND,MON,2021-01-20,0,1,0,1
NAGALAND,PEREN,2021-01-16,0,1,0,1
NAGALAND,PEREN,2021-01-18,0,1,0,1
NAGALAND,PEREN,2021-01-20,0,2,0,2
NAGALAND,PHEK,2021-01-18,0,7,0,7
NAGALAND,PHEK,2021-01-19,0,1,0,1
NAGALAND,PHEK,2021-01-20,0,1,0,1
NAGALAND,TUENSANG,2021-01-17,1,0,0,1
NAGALAND,TUENSANG,2021-01-18,1,3,0,4
NAGALAND,TUENSANG,2021-01-19,0,2,0,2
NAGALAND,TUENSANG,2021-01-20,0,1,0,1
NAGALAND,WOKHA,2021-01-16,0,2,0,2
NAGALAND,WOKHA,2021-01-18,0,1,0,1
NAGALAND,WOKHA,2021-01-19,0,4,0,4
NAGALAND,ZUNHEBOTO,2021-01-19,0,1,0,1
ODISHA,ANUGUL,2021-01-16,9,662,0,671
ODISHA,ANUGUL,2021-01-17,5,304,0,309
ODISHA,ANUGUL,2021-01-18,11,807,0,818
ODISHA,ANUGUL,2021-01-19,5,573,0,578
ODISHA,ANUGUL,2021-01-20,13,560,0,573
ODISHA,BALANGIR,2021-01-16,0,1160,0,1160
ODISHA,BALANGIR,2021-01-17,3,1148,0,1151
ODISHA,BALANGIR,2021-01-18,1,1245,0,1246
ODISHA,BALANGIR,2021-01-19,1,1036,0,1037
ODISHA,BALANGIR,2021-01-20,2,1152,0,1154
ODISHA,BALESHWAR,2021-01-16,9,1953,17,1979
ODISHA,BALESHWAR,2021-01-17,5,1200,7,1212
ODISHA,BALESHWAR,2021-01-18,29,2033,6,2068
ODISHA,BALESHWAR,2021-01-19,17,2077,5,2099
ODISHA,BALESHWAR,2021-01-20,10,1794,0,1804
ODISHA,BARGARH,2021-01-16,3,659,2,664
ODISHA,BARGARH,2021-01-17,5,379,3,387
ODISHA,BARGARH,2021-01-18,4,554,0,558
ODISHA,BARGARH,2021-01-19,0,459,0,459
ODISHA,BARGARH,2021-01-20,1,490,0,491
ODISHA,BHADRAK,2021-01-16,1,1092,10,1103
ODISHA,BHADRAK,2021-01-17,0,716,1,717
ODISHA,BHADRAK,2021-01-18,5,777,0,782
ODISHA,BHADRAK,2021-01-19,2,1410,0,1412
ODISHA,BHADRAK,2021-01-20,1,766,0,767
ODISHA,BOUDH,2021-01-16,2,428,0,430
ODISHA,BOUDH,2021-01-17,0,250,0,250
ODISHA,BOUDH,2021-01-18,0,287,0,287
ODISHA,BOUDH,2021-01-19,0,335,0,335
ODISHA,BOUDH,2021-01-20,0,340,0,340
ODISHA,CUTTACK,2021-01-16,9,1562,0,1571
ODISHA,CUTTACK,2021-01-17,2,462,0,464
ODISHA,CUTTACK,2021-01-18,6,1249,2,1257
ODISHA,CUTTACK,2021-01-19,11,1774,1,1786
ODISHA,CUTTACK,2021-01-20,6,1342,2,1350
ODISHA,DEOGARH,2021-01-16,3,241,0,244
ODISHA,DEOGARH,2021-01-17,1,207,0,208
ODISHA,DEOGARH,2021-01-18,1,444,0,445
ODISHA,DEOGARH,2021-01-19,1,224,0,225
ODISHA,DEOGARH,2021-01-20,0,137,0,137
ODISHA,DHENKANAL,2021-01-16,1,970,0,971
ODISHA,DHENKANAL,2021-01-17,0,470,0,470
ODISHA,DHENKANAL,2021-01-18,0,656,0,656
ODISHA,DHENKANAL,2021-01-19,1,638,1,640
ODISHA,DHENKANAL,2021-01-20,0,499,0,499
ODISHA,GAJAPATI,2021-01-16,0,282,2,284
ODISHA,GAJAPATI,2021-01-17,0,181,0,181
ODISHA,GAJAPATI,2021-01-18,2,188,0,190
ODISHA,GAJAPATI,2021-01-19,0,313,0,313
ODISHA,GAJAPATI,2021-01-20,2,244,0,246
ODISHA,GANJAM,2021-01-16,2,834,0,836
ODISHA,GANJAM,2021-01-17,1,735,0,736
ODISHA,GANJAM,2021-01-18,1,1435,14,1450
ODISHA,GANJAM,2021-01-19,2,1234,41,1277
ODISHA,GANJAM,2021-01-20,2,1040,0,1042
ODISHA,JAGATSINGHAPUR,2021-01-16,1,629,0,630
ODISHA,JAGATSINGHAPUR,2021-01-17,0,469,0,469
ODISHA,JAGATSINGHAPUR,2021-01-18,4,698,2,704
ODISHA,JAGATSINGHAPUR,2021-01-19,4,817,0,821
ODISHA,JAGATSINGHAPUR,2021-01-20,5,526,0,531
ODISHA,JAJAPUR,2021-01-16,5,854,0,859
ODISHA,JAJAPUR,2021-01-17,1,202,0,203
ODISHA,JAJAPUR,2021-01-18,7,623,0,630
ODISHA,JAJAPUR,2021-01-19,5,488,0,493
ODISHA,JAJAPUR,2021-01-20,2,487,0,489
ODISHA,JHARSUGUDA,2021-01-16,4,560,0,564
ODISHA,JHARSUGUDA,2021-01-17,0,402,0,402
ODISHA,JHARSUGUDA,2021-01-18,2,497,4,503
ODISHA,JHARSUGUDA,2021-01-19,5,423,1,429
ODISHA,JHARSUGUDA,2021-01-20,3,422,0,425
ODISHA,KALAHANDI,2021-01-16,4,99,0,103
ODISHA,KALAHANDI,2021-01-17,1,420,0,421
ODISHA,KALAHANDI,2021-01-18,0,379,0,379
ODISHA,KALAHANDI,2021-01-19,0,368,0,368
ODISHA,KALAHANDI,2021-01-20,1,521,0,522
ODISHA,KANDHAMAL,2021-01-16,0,786,0,786
ODISHA,KANDHAMAL,2021-01-17,0,857,0,857
ODISHA,KANDHAMAL,2021-01-18,1,723,0,724
ODISHA,KANDHAMAL,2021-01-19,0,925,0,925
ODISHA,KANDHAMAL,2021-01-20,0,789,0,789
ODISHA,KENDRAPARA,2021-01-16,1,1141,1,1143
ODISHA,KENDRAPARA,2021-01-17,0,935,0,935
ODISHA,KENDRAPARA,2021-01-18,0,1218,1,1219
ODISHA,KENDRAPARA,2021-01-19,0,839,0,839
ODISHA,KENDRAPARA,2021-01-20,2,1161,0,1163
ODISHA,KENDUJHAR,2021-01-16,4,790,0,794
ODISHA,KENDUJHAR,2021-01-17,1,390,0,391
ODISHA,KENDUJHAR,2021-01-18,0,841,0,841
ODISHA,KENDUJHAR,2021-01-19,1,769,0,770
ODISHA,KENDUJHAR,2021-01-20,2,920,0,922
ODISHA,KHORDHA,2021-01-16,27,2058,1,2086
ODISHA,KHORDHA,2021-01-17,6,1274,2,1282
ODISHA,KHORDHA,2021-01-18,21,1850,4,1875
ODISHA,KHORDHA,2021-01-19,18,1792,6,1816
ODISHA,KHORDHA,2021-01-20,8,1748,3,1759
ODISHA,KORAPUT,2021-01-16,0,1102,0,1102
ODISHA,KORAPUT,2021-01-17,0,899,0,899
ODISHA,KORAPUT,2021-01-18,1,989,0,990
ODISHA,KORAPUT,2021-01-19,2,1035,1,1038
ODISHA,KORAPUT,2021-01-20,1,1081,0,1082
ODISHA,MALKANGIRI,2021-01-16,0,823,1,824
ODISHA,MALKANGIRI,2021-01-17,0,577,0,577
ODISHA,MALKANGIRI,2021-01-18,1,614,0,615
ODISHA,MALKANGIRI,2021-01-19,0,698,0,698
ODISHA,MALKANGIRI,2021-01-20,0,413,0,413
ODISHA,MAYURBHANJ,2021-01-16,8,1002,0,1010
ODISHA,MAYURBHANJ,2021-01-17,4,838,0,842
ODISHA,MAYURBHANJ,2021-01-18,3,1050,0,1053
ODISHA,MAYURBHANJ,2021-01-19,4,1070,0,1074
ODISHA,MAYURBHANJ,2021-01-20,2,1051,0,1053
ODISHA,NABARANGPUR,2021-01-16,0,634,0,634
ODISHA,NABARANGPUR,2021-01-17,0,504,0,504
ODISHA,NABARANGPUR,2021-01-18,0,769,0,769
ODISHA,NABARANGPUR,2021-01-19,1,629,0,630
ODISHA,NABARANGPUR,2021-01-20,0,627,0,627
ODISHA,NAYAGARH,2021-01-16,0,582,0,582
ODISHA,NAYAGARH,2021-01-17,0,653,1,654
ODISHA,NAYAGARH,2021-01-18,0,678,0,678
ODISHA,NAYAGARH,2021-01-19,0,588,0,588
ODISHA,NAYAGARH,2021-01-20,0,786,0,786
ODISHA,NUAPADA,2021-01-16,15,404,0,419
ODISHA,NUAPADA,2021-01-17,13,398,0,411
ODISHA,NUAPADA,2021-01-18,6,290,0,296
ODISHA,NUAPADA,2021-01-19,9,231,0,240
ODISHA,NUAPADA,2021-01-20,3,235,0,238
ODISHA,PURI,2021-01-16,26,1793,0,1819
ODISHA,PURI,2021-01-17,29,1488,1,1518
ODISHA,PURI,2021-01-18,7,1324,0,1331
ODISHA,PURI,2021-01-19,25,1272,0,1297
ODISHA,PURI,2021-01-20,10,877,1,888
ODISHA,RAYAGADA,2021-01-16,0,615,0,615
ODISHA,RAYAGADA,2021-01-17,0,317,0,317
ODISHA,RAYAGADA,2021-01-18,1,851,0,852
ODISHA,RAYAGADA,2021-01-19,2,492,0,494
ODISHA,RAYAGADA,2021-01-20,0,880,0,880
ODISHA,SAMBALPUR,2021-01-16,26,637,0,663
ODISHA,SAMBALPUR,2021-01-17,24,422,0,446
ODISHA,SAMBALPUR,2021-01-18,36,439,2,477
ODISHA,SAMBALPUR,2021-01-19,36,852,0,888
ODISHA,SAMBALPUR,2021-01-20,25,750,0,775
ODISHA,SONEPUR,2021-01-16,0,507,0,507
ODISHA,SONEPUR,2021-01-17,0,373,0,373
ODISHA,SONEPUR,2021-01-18,1,524,0,525
ODISHA,SONEPUR,2021-01-19,0,449,0,449
ODISHA,SONEPUR,2021-01-20,0,352,0,352
ODISHA,SUNDARGARH,2021-01-16,35,926,0,961
ODISHA,SUNDARGARH,2021-01-17,5,320,0,325
ODISHA,SUNDARGARH,2021-01-18,24,1081,2,1107
ODISHA,SUNDARGARH,2021-01-19,25,939,1,965
ODISHA,SUNDARGARH,2021-01-20,33,841,1,875
PUDUCHERRY,KARAIKAL,2021-01-16,3,539,0,542
PUDUCHERRY,KARAIKAL,2021-01-17,4,509,0,513
PUDUCHERRY,KARAIKAL,2021-01-18,3,697,0,700
PUDUCHERRY,KARAIKAL,2021-01-19,2,769,0,771
PUDUCHERRY,KARAIKAL,2021-01-20,9,740,0,749
PUDUCHERRY,MAHE,2021-01-16,1,126,0,127
PUDUCHERRY,MAHE,2021-01-17,20,72,0,92
PUDUCHERRY,MAHE,2021-01-18,4,385,0,389
PUDUCHERRY,MAHE,2021-01-19,6,158,0,164
PUDUCHERRY,MAHE,2021-01-20,11,344,0,355
PUDUCHERRY,PONDICHERRY,2021-01-16,31,626,2,659
PUDUCHERRY,PONDICHERRY,2021-01-17,13,433,0,446
PUDUCHERRY,PONDICHERRY,2021-01-18,28,1026,1,1055
PUDUCHERRY,PONDICHERRY,2021-01-19,25,902,0,927
PUDUCHERRY,PONDICHERRY,2021-01-20,12,768,2,782
PUDUCHERRY,YANAM,2021-01-16,0,73,0,73
PUDUCHERRY,YANAM,2021-01-17,0,3,0,3
PUDUCHERRY,YANAM,2021-01-18,0,59,0,59
PUDUCHERRY,YANAM,2021-01-19,0,160,0,160
PUDUCHERRY,YANAM,2021-01-20,0,75,0,75
PUNJAB,AMRITSAR,2021-01-16,32,1436,6,1474
PUNJAB,AMRITSAR,2021-01-17,11,1297,1,1309
PUNJAB,AMRITSAR,2021-01-18,29,1622,10,1661
PUNJAB,AMRITSAR,2021-01-19,11,1704,2,1717
PUNJAB,AMRITSAR,2021-01-20,19,868,2,889
PUNJAB,BARNALA,2021-01-16,5,159,2,166
PUNJAB,BARNALA,2021-01-17,0,202,4,206
PUNJAB,BARNALA,2021-01-18,2,350,3,355
PUNJAB,BARNALA,2021-01-19,0,41,3,44
PUNJAB,BARNALA,2021-01-20,0,139,23,162
PUNJAB,BATHINDA,2021-01-16,19,769,1,789
PUNJAB,BATHINDA,2021-01-17,6,712,7,725
PUNJAB,BATHINDA,2021-01-18,9,1067,3,1079
PUNJAB,BATHINDA,2021-01-19,14,1305,33,1352
PUNJAB,BATHINDA,2021-01-20,12,1125,0,1137
PUNJAB,FARIDKOT,2021-01-16,8,203,1,212
PUNJAB,FARIDKOT,2021-01-17,3,113,0,116
PUNJAB,FARIDKOT,2021-01-18,12,229,1,242
PUNJAB,FARIDKOT,2021-01-19,6,194,1,201
PUNJAB,FARIDKOT,2021-01-20,8,173,0,181
PUNJAB,FATEHGARH SAHIB,2021-01-16,13,308,0,321
PUNJAB,FATEHGARH SAHIB,2021-01-17,2,112,0,114
PUNJAB,FATEHGARH SAHIB,2021-01-18,3,322,2,327
PUNJAB,FATEHGARH SAHIB,2021-01-19,6,337,1,344
PUNJAB,FATEHGARH SAHIB,2021-01-20,3,108,0,111
PUNJAB,FAZILKA,2021-01-16,5,303,0,308
PUNJAB,FAZILKA,2021-01-17,0,351,0,351
PUNJAB,FAZILKA,2021-01-18,2,71,0,73
PUNJAB,FAZILKA,2021-01-19,0,164,0,164
PUNJAB,FAZILKA,2021-01-20,3,201,0,204
PUNJAB,FIROZEPUR,2021-01-16,5,354,0,359
PUNJAB,FIROZEPUR,2021-01-17,0,198,0,198
PUNJAB,FIROZEPUR,2021-01-18,0,106,0,106
PUNJAB,FIROZEPUR,2021-01-19,7,263,0,270
PUNJAB,FIROZEPUR,2021-01-20,0,332,0,332
PUNJAB,GURDASPUR,2021-01-16,20,1683,19,1722
PUNJAB,GURDASPUR,2021-01-17,4,1304,73,1381
PUNJAB,GURDASPUR,2021-01-18,6,1388,0,1394
PUNJAB,GURDASPUR,2021-01-19,5,919,0,924
PUNJAB,GURDASPUR,2021-01-20,10,1655,5,1670
PUNJAB,HOSHIARPUR,2021-01-16,4,1519,1,1524
PUNJAB,HOSHIARPUR,2021-01-17,3,778,3,784
PUNJAB,HOSHIARPUR,2021-01-18,16,1491,0,1507
PUNJAB,HOSHIARPUR,2021-01-19,14,1163,2,1179
PUNJAB,HOSHIARPUR,2021-01-20,23,1057,3,1083
PUNJAB,JALANDHAR,2021-01-16,31,2371,155,2557
PUNJAB,JALANDHAR,2021-01-17,22,2106,49,2177
PUNJAB,JALANDHAR,2021-01-18,30,1496,56,1582
PUNJAB,JALANDHAR,2021-01-19,25,3106,55,3186
PUNJAB,JALANDHAR,2021-01-20,26,2806,109,2941
PUNJAB,KAPURTHALA,2021-01-16,7,314,1,322
PUNJAB,KAPURTHALA,2021-01-17,1,788,1,790
PUNJAB,KAPURTHALA,2021-01-18,6,717,2,725
PUNJAB,KAPURTHALA,2021-01-19,4,758,1,763
PUNJAB,KAPURTHALA,2021-01-20,10,1091,20,1121
PUNJAB,LUDHIANA,2021-01-16,46,2039,7,2092
PUNJAB,LUDHIANA,2021-01-17,39,2411,9,2459
PUNJAB,LUDHIANA,2021-01-18,52,2431,25,2508
PUNJAB,LUDHIANA,2021-01-19,50,1531,8,1589
PUNJAB,LUDHIANA,2021-01-20,41,2561,4,2606
PUNJAB,MANSA,2021-01-16,3,293,0,296
PUNJAB,MANSA,2021-01-17,0,474,0,474
PUNJAB,MANSA,2021-01-18,0,45,1,46
PUNJAB,MANSA,2021-01-19,2,331,1,334
PUNJAB,MANSA,2021-01-20,1,398,0,399
PUNJAB,MOGA,2021-01-16,0,190,0,190
PUNJAB,MOGA,2021-01-17,1,155,0,156
PUNJAB,MOGA,2021-01-18,0,142,3,145
PUNJAB,MOGA,2021-01-19,8,227,1,236
PUNJAB,MOGA,2021-01-20,4,250,3,257
PUNJAB,PATHANKOT,2021-01-16,8,1096,1,1105
PUNJAB,PATHANKOT,2021-01-17,1,52,1,54
PUNJAB,PATHANKOT,2021-01-18,3,250,1,254
PUNJAB,PATHANKOT,2021-01-19,2,193,1,196
PUNJAB,PATHANKOT,2021-01-20,5,548,0,553
PUNJAB,PATIALA,2021-01-16,27,1332,1,1360
PUNJAB,PATIALA,2021-01-17,27,927,3,957
PUNJAB,PATIALA,2021-01-18,23,755,6,784
PUNJAB,PATIALA,2021-01-19,17,1130,2,1149
PUNJAB,PATIALA,2021-01-20,21,1274,1,1296
PUNJAB,RUPNAGAR,2021-01-16,22,592,2,616
PUNJAB,RUPNAGAR,2021-01-17,4,401,1,406
PUNJAB,RUPNAGAR,2021-01-18,6,364,4,374
PUNJAB,RUPNAGAR,2021-01-19,3,491,1,495
PUNJAB,RUPNAGAR,2021-01-20,4,513,0,517
PUNJAB,S.A.S NAGAR,2021-01-16,66,779,2,847
PUNJAB,S.A.S NAGAR,2021-01-17,32,443,0,475
PUNJAB,S.A.S NAGAR,2021-01-18,51,700,23,774
PUNJAB,S.A.S NAGAR,2021-01-19,65,1115,7,1187
PUNJAB,S.A.S NAGAR,2021-01-20,33,872,4,909
PUNJAB,SANGRUR,2021-01-16,4,1055,0,1059
PUNJAB,SANGRUR,2021-01-17,1,1054,3,1058
PUNJAB,SANGRUR,2021-01-18,0,837,2,839
PUNJAB,SANGRUR,2021-01-19,5,1124,1,1130
PUNJAB,SANGRUR,2021-01-20,4,1097,1,1102
PUNJAB,SHAHID BHAGAT SINGH NAGAR,2021-01-16,3,530,0,533
PUNJAB,SHAHID BHAGAT SINGH NAGAR,2021-01-17,8,811,0,819
PUNJAB,SHAHID BHAGAT SINGH NAGAR,2021-01-18,6,223,1,230
PUNJAB,SHAHID BHAGAT SINGH NAGAR,2021-01-19,10,488,1,499
PUNJAB,SHAHID BHAGAT SINGH NAGAR,2021-01-20,9,1061,0,1070
PUNJAB,SRI MUKTSAR SAHIB,2021-01-16,7,272,2,281
PUNJAB,SRI MUKTSAR SAHIB,2021-01-17,2,183,5,190
PUNJAB,SRI MUKTSAR SAHIB,2021-01-18,0,348,1,349
PUNJAB,SRI MUKTSAR SAHIB,2021-01-19,5,61,0,66
PUNJAB,SRI MUKTSAR SAHIB,2021-01-20,1,306,6,313
PUNJAB,TARN TARAN,2021-01-16,2,278,0,280
PUNJAB,TARN TARAN,2021-01-17,1,2542,0,2543
PUNJAB,TARN TARAN,2021-01-18,0,1047,1,1048
PUNJAB,TARN TARAN,2021-01-19,3,1372,77,1452
PUNJAB,TARN TARAN,2021-01-20,2,164,0,166
RAJASTHAN,AJMER,2021-01-16,1,75,637,713
RAJASTHAN,AJMER,2021-01-17,4,140,388,532
RAJASTHAN,AJMER,2021-01-18,3,64,737,804
RAJASTHAN,AJMER,2021-01-19,6,163,780,949
RAJASTHAN,AJMER,2021-01-20,6,118,474,598
RAJASTHAN,ALWAR,2021-01-16,3,1149,14,1166
RAJASTHAN,ALWAR,2021-01-17,240,2107,16,2363
RAJASTHAN,ALWAR,2021-01-18,216,2194,16,2426
RAJASTHAN,ALWAR,2021-01-19,200,1723,16,1939
RAJASTHAN,ALWAR,2021-01-20,1,2024,22,2047
RAJASTHAN,BANSWARA,2021-01-16,2,84,0,86
RAJASTHAN,BANSWARA,2021-01-17,2,36,0,38
RAJASTHAN,BANSWARA,2021-01-18,9,49,2,60
RAJASTHAN,BANSWARA,2021-01-19,5,129,1,135
RAJASTHAN,BANSWARA,2021-01-20,3,157,0,160
RAJASTHAN,BARAN,2021-01-16,12,186,0,198
RAJASTHAN,BARAN,2021-01-17,6,183,0,189
RAJASTHAN,BARAN,2021-01-18,16,267,0,283
RAJASTHAN,BARAN,2021-01-19,8,283,0,291
RAJASTHAN,BARAN,2021-01-20,9,69,0,78
RAJASTHAN,BARMER,2021-01-16,15,431,0,446
RAJASTHAN,BARMER,2021-01-17,14,184,0,198
RAJASTHAN,BARMER,2021-01-18,28,414,0,442
RAJASTHAN,BARMER,2021-01-19,18,190,3,211
RAJASTHAN,BARMER,2021-01-20,13,211,2,226
RAJASTHAN,BHARATPUR,2021-01-16,5,459,3,467
RAJASTHAN,BHARATPUR,2021-01-17,6,626,4,636
RAJASTHAN,BHARATPUR,2021-01-18,5,907,29,941
RAJASTHAN,BHARATPUR,2021-01-19,2,437,4,443
RAJASTHAN,BHARATPUR,2021-01-20,0,206,6,212
RAJASTHAN,BHILWARA,2021-01-16,12,266,5,283
RAJASTHAN,BHILWARA,2021-01-17,19,388,2,409
RAJASTHAN,BHILWARA,2021-01-18,14,214,6,234
RAJASTHAN,BHILWARA,2021-01-19,23,214,2,239
RAJASTHAN,BHILWARA,2021-01-20,26,602,3,631
RAJASTHAN,BIKANER,2021-01-16,0,391,3,394
RAJASTHAN,BIKANER,2021-01-17,0,10,4,14
RAJASTHAN,BIKANER,2021-01-18,1,184,2,187
RAJASTHAN,BIKANER,2021-01-19,0,293,0,293
RAJASTHAN,BIKANER,2021-01-20,7,30,0,37
RAJASTHAN,BUNDI,2021-01-16,0,408,1,409
RAJASTHAN,BUNDI,2021-01-17,0,354,1,355
RAJASTHAN,BUNDI,2021-01-18,0,328,0,328
RAJASTHAN,BUNDI,2021-01-19,0,197,5,202
RAJASTHAN,BUNDI,2021-01-20,0,187,0,187
RAJASTHAN,CHITTORGARH,2021-01-16,21,986,12,1019
RAJASTHAN,CHITTORGARH,2021-01-17,0,308,2,310
RAJASTHAN,CHITTORGARH,2021-01-18,1,791,4,796
RAJASTHAN,CHITTORGARH,2021-01-19,17,645,4,666
RAJASTHAN,CHITTORGARH,2021-01-20,0,814,6,820
RAJASTHAN,CHURU,2021-01-16,1,641,1,643
RAJASTHAN,CHURU,2021-01-17,0,535,6,541
RAJASTHAN,CHURU,2021-01-18,0,85,6,91
RAJASTHAN,CHURU,2021-01-19,1,463,4,468
RAJASTHAN,CHURU,2021-01-20,0,482,2,484
RAJASTHAN,DAUSA,2021-01-16,0,284,15,299
RAJASTHAN,DAUSA,2021-01-17,3,380,7,390
RAJASTHAN,DAUSA,2021-01-18,3,117,10,130
RAJASTHAN,DAUSA,2021-01-19,1,372,15,388
RAJASTHAN,DAUSA,2021-01-20,1,320,14,335
RAJASTHAN,DHOLPUR,2021-01-16,1,259,4,264
RAJASTHAN,DHOLPUR,2021-01-17,0,4,0,4
RAJASTHAN,DHOLPUR,2021-01-18,4,256,3,263
RAJASTHAN,DHOLPUR,2021-01-19,1,482,9,492
RAJASTHAN,DHOLPUR,2021-01-20,1,114,1,116
RAJASTHAN,DUNGARPUR,2021-01-16,3,362,1,366
RAJASTHAN,DUNGARPUR,2021-01-17,17,261,0,278
RAJASTHAN,DUNGARPUR,2021-01-18,11,265,0,276
RAJASTHAN,DUNGARPUR,2021-01-19,8,307,0,315
RAJASTHAN,DUNGARPUR,2021-01-20,10,351,0,361
RAJASTHAN,GANGANAGAR,2021-01-16,2,42,3,47
RAJASTHAN,GANGANAGAR,2021-01-17,2,19,0,21
RAJASTHAN,GANGANAGAR,2021-01-18,0,22,1,23
RAJASTHAN,GANGANAGAR,2021-01-19,0,29,0,29
RAJASTHAN,GANGANAGAR,2021-01-20,0,37,1,38
RAJASTHAN,HANUMANGARH,2021-01-16,2,728,2,732
RAJASTHAN,HANUMANGARH,2021-01-17,3,497,1,501
RAJASTHAN,HANUMANGARH,2021-01-18,2,399,2,403
RAJASTHAN,HANUMANGARH,2021-01-19,1,836,0,837
RAJASTHAN,HANUMANGARH,2021-01-20,1,845,6,852
RAJASTHAN,JAIPUR,2021-01-16,122,2750,387,3259
RAJASTHAN,JAIPUR,2021-01-17,85,2947,329,3361
RAJASTHAN,JAIPUR,2021-01-18,123,2367,256,2746
RAJASTHAN,JAIPUR,2021-01-19,89,2937,286,3312
RAJASTHAN,JAIPUR,2021-01-20,54,2588,306,2948
RAJASTHAN,JAISALMER,2021-01-16,228,565,0,793
RAJASTHAN,JAISALMER,2021-01-17,143,574,0,717
RAJASTHAN,JAISALMER,2021-01-18,74,674,4,752
RAJASTHAN,JAISALMER,2021-01-19,4,649,1,654
RAJASTHAN,JAISALMER,2021-01-20,7,457,0,464
RAJASTHAN,JALORE,2021-01-16,31,1832,2,1865
RAJASTHAN,JALORE,2021-01-17,14,1829,1,1844
RAJASTHAN,JALORE,2021-01-18,27,1521,2,1550
RAJASTHAN,JALORE,2021-01-19,7,1508,0,1515
RAJASTHAN,JALORE,2021-01-20,7,980,1,988
RAJASTHAN,JHALAWAR,2021-01-16,31,270,18,319
RAJASTHAN,JHALAWAR,2021-01-17,20,207,8,235
RAJASTHAN,JHALAWAR,2021-01-18,13,184,11,208
RAJASTHAN,JHALAWAR,2021-01-19,0,370,0,370
RAJASTHAN,JHALAWAR,2021-01-20,0,325,0,325
RAJASTHAN,JHUNJHUNU,2021-01-16,3,102,6,111
RAJASTHAN,JHUNJHUNU,2021-01-17,1,99,2,102
RAJASTHAN,JHUNJHUNU,2021-01-18,1,85,3,89
RAJASTHAN,JHUNJHUNU,2021-01-19,2,95,5,102
RAJASTHAN,JHUNJHUNU,2021-01-20,1,95,5,101
RAJASTHAN,JODHPUR,2021-01-16,32,942,3,977
RAJASTHAN,JODHPUR,2021-01-17,16,793,8,817
RAJASTHAN,JODHPUR,2021-01-18,27,775,2,804
RAJASTHAN,JODHPUR,2021-01-19,35,1011,6,1052
RAJASTHAN,JODHPUR,2021-01-20,24,998,4,1026
RAJASTHAN,KARAULI,2021-01-16,0,197,5,202
RAJASTHAN,KARAULI,2021-01-17,6,455,19,480
RAJASTHAN,KARAULI,2021-01-18,1,345,8,354
RAJASTHAN,KARAULI,2021-01-19,0,180,7,187
RAJASTHAN,KARAULI,2021-01-20,1,350,30,381
RAJASTHAN,KOTA,2021-01-16,2,2184,3,2189
RAJASTHAN,KOTA,2021-01-17,40,1593,0,1633
RAJASTHAN,KOTA,2021-01-18,97,1941,1,2039
RAJASTHAN,KOTA,2021-01-19,95,1928,5,2028
RAJASTHAN,KOTA,2021-01-20,45,1631,4,1680
RAJASTHAN,NAGAUR,2021-01-16,160,363,515,1038
RAJASTHAN,NAGAUR,2021-01-17,2,533,162,697
RAJASTHAN,NAGAUR,2021-01-18,4,139,319,462
RAJASTHAN,NAGAUR,2021-01-19,133,281,443,857
RAJASTHAN,NAGAUR,2021-01-20,1,377,561,939
RAJASTHAN,PALI,2021-01-16,15,653,7,675
RAJASTHAN,PALI,2021-01-17,9,443,3,455
RAJASTHAN,PALI,2021-01-18,11,352,2,365
RAJASTHAN,PALI,2021-01-19,2,159,1,162
RAJASTHAN,PALI,2021-01-20,3,385,0,388
RAJASTHAN,PRATAPGARH,2021-01-16,2,5,2,9
RAJASTHAN,PRATAPGARH,2021-01-17,0,2,0,2
RAJASTHAN,PRATAPGARH,2021-01-18,1,13,0,14
RAJASTHAN,PRATAPGARH,2021-01-19,1,8,0,9
RAJASTHAN,PRATAPGARH,2021-01-20,0,10,0,10
RAJASTHAN,RAJSAMAND,2021-01-16,6,173,2,181
RAJASTHAN,RAJSAMAND,2021-01-17,5,217,0,222
RAJASTHAN,RAJSAMAND,2021-01-18,8,480,1,489
RAJASTHAN,RAJSAMAND,2021-01-19,12,433,1,446
RAJASTHAN,RAJSAMAND,2021-01-20,6,314,0,320
RAJASTHAN,SAWAI MADHOPUR,2021-01-16,8,487,10,505
RAJASTHAN,SAWAI MADHOPUR,2021-01-17,1,199,13,213
RAJASTHAN,SAWAI MADHOPUR,2021-01-18,21,362,6,389
RAJASTHAN,SAWAI MADHOPUR,2021-01-19,12,471,8,491
RAJASTHAN,SAWAI MADHOPUR,2021-01-20,2,295,5,302
RAJASTHAN,SIKAR,2021-01-16,0,172,17,189
RAJASTHAN,SIKAR,2021-01-17,1,536,4,541
RAJASTHAN,SIKAR,2021-01-18,3,349,9,361
RAJASTHAN,SIKAR,2021-01-19,0,351,12,363
RAJASTHAN,SIKAR,2021-01-20,1,425,9,435
RAJASTHAN,SIROHI,2021-01-16,4,284,1,289
RAJASTHAN,SIROHI,2021-01-17,0,165,1,166
RAJASTHAN,SIROHI,2021-01-18,18,216,0,234
RAJASTHAN,SIROHI,2021-01-19,0,312,0,312
RAJASTHAN,SIROHI,2021-01-20,16,465,0,481
RAJASTHAN,TONK,2021-01-16,1,124,17,142
RAJASTHAN,TONK,2021-01-17,1,158,11,170
RAJASTHAN,TONK,2021-01-18,2,209,23,234
RAJASTHAN,TONK,2021-01-19,0,227,34,261
RAJASTHAN,TONK,2021-01-20,1,156,10,167
RAJASTHAN,UDAIPUR,2021-01-16,92,879,2,973
RAJASTHAN,UDAIPUR,2021-01-17,39,257,10,306
RAJASTHAN,UDAIPUR,2021-01-18,45,1147,0,1192
RAJASTHAN,UDAIPUR,2021-01-19,49,999,5,1053
RAJASTHAN,UDAIPUR,2021-01-20,58,785,2,845
SIKKIM,EAST DISTRICT,2021-01-16,13,194,0,207
SIKKIM,EAST DISTRICT,2021-01-17,0,13,0,13
SIKKIM,EAST DISTRICT,2021-01-18,14,172,0,186
SIKKIM,EAST DISTRICT,2021-01-19,11,232,0,243
SIKKIM,EAST DISTRICT,2021-01-20,7,256,0,263
SIKKIM,NORTH DISTRICT,2021-01-16,1,3,0,4
SIKKIM,NORTH DISTRICT,2021-01-17,0,1,0,1
SIKKIM,NORTH DISTRICT,2021-01-18,0,3,0,3
SIKKIM,NORTH DISTRICT,2021-01-19,0,1,0,1
SIKKIM,NORTH DISTRICT,2021-01-20,0,17,0,17
SIKKIM,SOUTH DISTRICT,2021-01-16,0,12,0,12
SIKKIM,SOUTH DISTRICT,2021-01-17,0,3,0,3
SIKKIM,SOUTH DISTRICT,2021-01-18,2,21,0,23
SIKKIM,SOUTH DISTRICT,2021-01-19,0,5,0,5
SIKKIM,SOUTH DISTRICT,2021-01-20,4,34,0,38
SIKKIM,WEST DISTRICT,2021-01-16,0,7,0,7
SIKKIM,WEST DISTRICT,2021-01-17,0,2,0,2
SIKKIM,WEST DISTRICT,2021-01-18,0,7,0,7
SIKKIM,WEST DISTRICT,2021-01-19,0,7,0,7
SIKKIM,WEST DISTRICT,2021-01-20,0,12,0,12
TAMIL NADU,ARIYALUR,2021-01-16,3,80,0,83
TAMIL NADU,ARIYALUR,2021-01-17,1,287,0,288
TAMIL NADU,ARIYALUR,2021-01-18,2,129,0,131
TAMIL NADU,ARIYALUR,2021-01-19,0,87,0,87
TAMIL NADU,ARIYALUR,2021-01-20,1,279,0,280
TAMIL NADU,CHENGALPATTU,2021-01-16,28,2152,0,2180
TAMIL NADU,CHENGALPATTU,2021-01-17,20,1958,1,1979
TAMIL NADU,CHENGALPATTU,2021-01-18,22,2924,1,2947
TAMIL NADU,CHENGALPATTU,2021-01-19,47,3053,0,3100
TAMIL NADU,CHENGALPATTU,2021-01-20,51,3371,0,3422
TAMIL NADU,CHENNAI,2021-01-16,186,7549,29,7764
TAMIL NADU,CHENNAI,2021-01-17,187,7814,46,8047
TAMIL NADU,CHENNAI,2021-01-18,179,7843,10,8032
TAMIL NADU,CHENNAI,2021-01-19,202,10094,22,10318
TAMIL NADU,CHENNAI,2021-01-20,231,11248,20,11499
TAMIL NADU,COIMBATORE,2021-01-16,52,2156,1,2209
TAMIL NADU,COIMBATORE,2021-01-17,61,1341,1,1403
TAMIL NADU,COIMBATORE,2021-01-18,72,1747,2,1821
TAMIL NADU,COIMBATORE,2021-01-19,56,2597,1,2654
TAMIL NADU,COIMBATORE,2021-01-20,73,2430,1,2504
TAMIL NADU,CUDDALORE,2021-01-16,5,867,1,873
TAMIL NADU,CUDDALORE,2021-01-17,2,1019,0,1021
TAMIL NADU,CUDDALORE,2021-01-18,3,1528,0,1531
TAMIL NADU,CUDDALORE,2021-01-19,3,1474,0,1477
TAMIL NADU,CUDDALORE,2021-01-20,1,1694,2,1697
TAMIL NADU,DHARMAPURI,2021-01-16,1,837,0,838
TAMIL NADU,DHARMAPURI,2021-01-17,4,596,1,601
TAMIL NADU,DHARMAPURI,2021-01-18,1,827,0,828
TAMIL NADU,DHARMAPURI,2021-01-19,4,955,0,959
TAMIL NADU,DHARMAPURI,2021-01-20,6,690,0,696
TAMIL NADU,DINDIGUL,2021-01-16,10,827,0,837
TAMIL NADU,DINDIGUL,2021-01-17,5,736,0,741
TAMIL NADU,DINDIGUL,2021-01-18,3,668,24,695
TAMIL NADU,DINDIGUL,2021-01-19,5,212,1,218
TAMIL NADU,DINDIGUL,2021-01-20,8,273,0,281
TAMIL NADU,ERODE,2021-01-16,14,662,0,676
TAMIL NADU,ERODE,2021-01-17,13,844,0,857
TAMIL NADU,ERODE,2021-01-18,12,777,0,789
TAMIL NADU,ERODE,2021-01-19,22,1190,0,1212
TAMIL NADU,ERODE,2021-01-20,25,1641,0,1666
TAMIL NADU,KALLAKURICHI,2021-01-16,3,841,1,845
TAMIL NADU,KALLAKURICHI,2021-01-17,0,131,0,131
TAMIL NADU,KALLAKURICHI,2021-01-18,0,398,0,398
TAMIL NADU,KALLAKURICHI,2021-01-19,0,389,0,389
TAMIL NADU,KALLAKURICHI,2021-01-20,0,583,2,585
TAMIL NADU,KANCHIPURAM,2021-01-16,11,2605,0,2616
TAMIL NADU,KANCHIPURAM,2021-01-17,8,1936,1,1945
TAMIL NADU,KANCHIPURAM,2021-01-18,12,2209,2,2223
TAMIL NADU,KANCHIPURAM,2021-01-19,18,2217,2,2237
TAMIL NADU,KANCHIPURAM,2021-01-20,24,2695,0,2719
TAMIL NADU,KANNIYAKUMARI,2021-01-16,9,1000,2,1011
TAMIL NADU,KANNIYAKUMARI,2021-01-17,9,1466,2,1477
TAMIL NADU,KANNIYAKUMARI,2021-01-18,7,2243,2,2252
TAMIL NADU,KANNIYAKUMARI,2021-01-19,10,2452,6,2468
TAMIL NADU,KANNIYAKUMARI,2021-01-20,16,2701,4,2721
TAMIL NADU,KARUR,2021-01-16,2,566,0,568
TAMIL NADU,KARUR,2021-01-17,5,1390,0,1395
TAMIL NADU,KARUR,2021-01-18,4,1092,0,1096
TAMIL NADU,KARUR,2021-01-19,8,1069,1,1078
TAMIL NADU,KARUR,2021-01-20,4,1140,4,1148
TAMIL NADU,KRISHNAGIRI,2021-01-16,1,417,0,418
TAMIL NADU,KRISHNAGIRI,2021-01-17,0,896,0,896
TAMIL NADU,KRISHNAGIRI,2021-01-18,3,728,1,732
TAMIL NADU,KRISHNAGIRI,2021-01-19,5,1227,0,1232
TAMIL NADU,KRISHNAGIRI,2021-01-20,2,1406,1,1409
TAMIL NADU,MADURAI,2021-01-16,13,4085,2,4100
TAMIL NADU,MADURAI,2021-01-17,11,2195,1,2207
TAMIL NADU,MADURAI,2021-01-18,11,3668,1,3680
TAMIL NADU,MADURAI,2021-01-19,12,3676,1,3689
TAMIL NADU,MADURAI,2021-01-20,24,3137,2,3163
TAMIL NADU,NAGAPATTINAM,2021-01-16,3,526,0,529
TAMIL NADU,NAGAPATTINAM,2021-01-17,7,530,0,537
TAMIL NADU,NAGAPATTINAM,2021-01-18,9,153,0,162
TAMIL NADU,NAGAPATTINAM,2021-01-19,3,1235,0,1238
TAMIL NADU,NAGAPATTINAM,2021-01-20,10,1012,1,1023
TAMIL NADU,NAMAKKAL,2021-01-16,6,611,0,617
TAMIL NADU,NAMAKKAL,2021-01-17,6,341,0,347
TAMIL NADU,NAMAKKAL,2021-01-18,2,386,0,388
TAMIL NADU,NAMAKKAL,2021-01-19,7,731,0,738
TAMIL NADU,NAMAKKAL,2021-01-20,6,1326,2,1334
TAMIL NADU,PERAMBALUR,2021-01-16,0,179,0,179
TAMIL NADU,PERAMBALUR,2021-01-17,0,80,0,80
TAMIL NADU,PERAMBALUR,2021-01-18,0,283,0,283
TAMIL NADU,PERAMBALUR,2021-01-19,0,144,0,144
TAMIL NADU,PERAMBALUR,2021-01-20,0,401,0,401
TAMIL NADU,PUDUKKOTTAI,2021-01-16,4,303,0,307
TAMIL NADU,PUDUKKOTTAI,2021-01-17,6,525,0,531
TAMIL NADU,PUDUKKOTTAI,2021-01-18,4,323,0,327
TAMIL NADU,PUDUKKOTTAI,2021-01-19,5,1199,5,1209
TAMIL NADU,PUDUKKOTTAI,2021-01-20,3,1177,0,1180
TAMIL NADU,RAMANATHAPURAM,2021-01-16,1,1104,0,1105
TAMIL NADU,RAMANATHAPURAM,2021-01-17,6,631,0,637
TAMIL NADU,RAMANATHAPURAM,2021-01-18,2,985,0,987
TAMIL NADU,RAMANATHAPURAM,2021-01-19,0,1130,5,1135
TAMIL NADU,RAMANATHAPURAM,2021-01-20,6,1201,6,1213
TAMIL NADU,RANIPET,2021-01-16,1,242,0,243
TAMIL NADU,RANIPET,2021-01-17,3,193,0,196
TAMIL NADU,RANIPET,2021-01-18,1,1320,0,1321
TAMIL NADU,RANIPET,2021-01-19,2,1528,3,1533
TAMIL NADU,RANIPET,2021-01-20,8,2550,0,2558
TAMIL NADU,SALEM,2021-01-16,12,998,1,1011
TAMIL NADU,SALEM,2021-01-17,17,1077,1,1095
TAMIL NADU,SALEM,2021-01-18,10,821,0,831
TAMIL NADU,SALEM,2021-01-19,26,804,0,830
TAMIL NADU,SALEM,2021-01-20,36,751,0,787
TAMIL NADU,SIVAGANGA,2021-01-16,3,498,1,502
TAMIL NADU,SIVAGANGA,2021-01-17,0,255,0,255
TAMIL NADU,SIVAGANGA,2021-01-18,2,521,1,524
TAMIL NADU,SIVAGANGA,2021-01-19,4,580,0,584
TAMIL NADU,SIVAGANGA,2021-01-20,3,1022,0,1025
TAMIL NADU,TENKASI,2021-01-16,0,574,0,574
TAMIL NADU,TENKASI,2021-01-17,5,687,0,692
TAMIL NADU,TENKASI,2021-01-18,3,404,1,408
TAMIL NADU,TENKASI,2021-01-19,17,826,0,843
TAMIL NADU,TENKASI,2021-01-20,6,661,1,668
TAMIL NADU,THANJAVUR,2021-01-16,15,531,1,547
TAMIL NADU,THANJAVUR,2021-01-17,15,170,0,185
TAMIL NADU,THANJAVUR,2021-01-18,14,407,1,422
TAMIL NADU,THANJAVUR,2021-01-19,16,1638,0,1654
TAMIL NADU,THANJAVUR,2021-01-20,7,948,0,955
TAMIL NADU,THE NILGIRIS,2021-01-16,6,1103,0,1109
TAMIL NADU,THE NILGIRIS,2021-01-17,5,1094,0,1099
TAMIL NADU,THE NILGIRIS,2021-01-18,5,1035,0,1040
TAMIL NADU,THE NILGIRIS,2021-01-19,10,1046,0,1056
TAMIL NADU,THE NILGIRIS,2021-01-20,6,1073,0,1079
TAMIL NADU,THENI,2021-01-16,1,609,0,610
TAMIL NADU,THENI,2021-01-17,8,474,1,483
TAMIL NADU,THENI,2021-01-18,6,714,0,720
TAMIL NADU,THENI,2021-01-19,8,610,0,618
TAMIL NADU,THENI,2021-01-20,2,673,0,675
TAMIL NADU,THIRUVALLUR,2021-01-16,22,2212,0,2234
TAMIL NADU,THIRUVALLUR,2021-01-17,13,1960,0,1973
TAMIL NADU,THIRUVALLUR,2021-01-18,20,2563,6,2589
TAMIL NADU,THIRUVALLUR,2021-01-19,26,3276,1,3303
TAMIL NADU,THIRUVALLUR,2021-01-20,26,3437,2,3465
TAMIL NADU,THIRUVARUR,2021-01-16,4,256,0,260
TAMIL NADU,THIRUVARUR,2021-01-17,13,114,0,127
TAMIL NADU,THIRUVARUR,2021-01-18,4,1404,1,1409
TAMIL NADU,THIRUVARUR,2021-01-19,11,1172,0,1183
TAMIL NADU,THIRUVARUR,2021-01-20,7,497,0,504
TAMIL NADU,TIRUCHIRAPPALLI,2021-01-16,13,878,4,895
TAMIL NADU,TIRUCHIRAPPALLI,2021-01-17,12,1068,2,1082
TAMIL NADU,TIRUCHIRAPPALLI,2021-01-18,17,998,0,1015
TAMIL NADU,TIRUCHIRAPPALLI,2021-01-19,10,1639,2,1651
TAMIL NADU,TIRUCHIRAPPALLI,2021-01-20,13,1984,1,1998
TAMIL NADU,TIRUNELVELI,2021-01-16,5,1090,0,1095
TAMIL NADU,TIRUNELVELI,2021-01-17,12,559,0,571
TAMIL NADU,TIRUNELVELI,2021-01-18,12,1551,1,1564
TAMIL NADU,TIRUNELVELI,2021-01-19,10,1457,1,1468
TAMIL NADU,TIRUNELVELI,2021-01-20,0,1588,2,1590
TAMIL NADU,TIRUPATHUR,2021-01-16,0,1282,0,1282
TAMIL NADU,TIRUPATHUR,2021-01-17,3,2021,1,2025
TAMIL NADU,TIRUPATHUR,2021-01-18,2,2789,1,2792
TAMIL NADU,TIRUPATHUR,2021-01-19,0,2410,1,2411
TAMIL NADU,TIRUPATHUR,2021-01-20,3,2235,0,2238
TAMIL NADU,TIRUPPUR,2021-01-16,13,1125,0,1138
TAMIL NADU,TIRUPPUR,2021-01-17,20,1194,4,1218
TAMIL NADU,TIRUPPUR,2021-01-18,15,1162,3,1180
TAMIL NADU,TIRUPPUR,2021-01-19,27,1757,1,1785
TAMIL NADU,TIRUPPUR,2021-01-20,38,2111,0,2149
TAMIL NADU,TIRUVANNAMALAI,2021-01-16,2,352,0,354
TAMIL NADU,TIRUVANNAMALAI,2021-01-17,2,302,0,304
TAMIL NADU,TIRUVANNAMALAI,2021-01-18,3,317,0,320
TAMIL NADU,TIRUVANNAMALAI,2021-01-19,4,945,0,949
TAMIL NADU,TIRUVANNAMALAI,2021-01-20,2,1057,0,1059
TAMIL NADU,TUTICORIN,2021-01-16,2,443,0,445
TAMIL NADU,TUTICORIN,2021-01-17,4,812,0,816
TAMIL NADU,TUTICORIN,2021-01-18,1,560,2,563
TAMIL NADU,TUTICORIN,2021-01-19,9,1278,1,1288
TAMIL NADU,TUTICORIN,2021-01-20,9,1084,0,1093
TAMIL NADU,VELLORE,2021-01-16,10,1072,0,1082
TAMIL NADU,VELLORE,2021-01-17,13,1176,1,1190
TAMIL NADU,VELLORE,2021-01-18,10,1992,0,2002
TAMIL NADU,VELLORE,2021-01-19,17,1898,0,1915
TAMIL NADU,VELLORE,2021-01-20,15,2054,0,2069
TAMIL NADU,VILLUPURAM,2021-01-16,1,385,0,386
TAMIL NADU,VILLUPURAM,2021-01-17,0,412,1,413
TAMIL NADU,VILLUPURAM,2021-01-18,2,565,1,568
TAMIL NADU,VILLUPURAM,2021-01-19,9,1076,1,1086
TAMIL NADU,VILLUPURAM,2021-01-20,7,1182,3,1192
TAMIL NADU,VIRUDHUNAGAR,2021-01-16,5,684,0,689
TAMIL NADU,VIRUDHUNAGAR,2021-01-17,8,709,1,718
TAMIL NADU,VIRUDHUNAGAR,2021-01-18,2,882,0,884
TAMIL NADU,VIRUDHUNAGAR,2021-01-19,2,1504,0,1506
TAMIL NADU,VIRUDHUNAGAR,2021-01-20,15,1754,0,1769
TELANGANA,ADILABAD,2021-01-16,0,496,0,496
TELANGANA,ADILABAD,2021-01-17,1,354,0,355
TELANGANA,ADILABAD,2021-01-18,0,355,0,355
TELANGANA,ADILABAD,2021-01-19,1,260,0,261
TELANGANA,ADILABAD,2021-01-20,0,322,0,322
TELANGANA,BHADRADRI KOTHAGUDEM,2021-01-16,0,861,0,861
TELANGANA,BHADRADRI KOTHAGUDEM,2021-01-17,0,493,0,493
TELANGANA,BHADRADRI KOTHAGUDEM,2021-01-18,0,730,0,730
TELANGANA,BHADRADRI KOTHAGUDEM,2021-01-19,0,680,0,680
TELANGANA,BHADRADRI KOTHAGUDEM,2021-01-20,0,747,0,747
TELANGANA,HYDERABAD,2021-01-16,58,7567,2,7627
TELANGANA,HYDERABAD,2021-01-17,24,4130,9,4163
TELANGANA,HYDERABAD,2021-01-18,34,7330,9,7373
TELANGANA,HYDERABAD,2021-01-19,39,6306,2,6347
TELANGANA,HYDERABAD,2021-01-20,13,6044,0,6057
TELANGANA,JAGITIAL,2021-01-16,0,576,0,576
TELANGANA,JAGITIAL,2021-01-17,0,242,0,242
TELANGANA,JAGITIAL,2021-01-18,0,402,0,402
TELANGANA,JAGITIAL,2021-01-19,0,345,0,345
TELANGANA,JAGITIAL,2021-01-20,0,319,0,319
TELANGANA,JANGOAN,2021-01-16,0,718,0,718
TELANGANA,JANGOAN,2021-01-17,0,418,0,418
TELANGANA,JANGOAN,2021-01-18,0,634,0,634
TELANGANA,JANGOAN,2021-01-19,0,455,0,455
TELANGANA,JANGOAN,2021-01-20,0,534,0,534
TELANGANA,JAYASHANKAR BHUPALAPALLY,2021-01-16,0,154,0,154
TELANGANA,JAYASHANKAR BHUPALAPALLY,2021-01-17,0,53,0,53
TELANGANA,JAYASHANKAR BHUPALAPALLY,2021-01-18,0,158,0,158
TELANGANA,JAYASHANKAR BHUPALAPALLY,2021-01-19,0,241,0,241
TELANGANA,JAYASHANKAR BHUPALAPALLY,2021-01-20,0,86,0,86
TELANGANA,JOGULAMBA GADWAL,2021-01-16,0,273,0,273
TELANGANA,JOGULAMBA GADWAL,2021-01-17,0,342,0,342
TELANGANA,JOGULAMBA GADWAL,2021-01-18,0,470,0,470
TELANGANA,JOGULAMBA GADWAL,2021-01-19,0,162,0,162
TELANGANA,JOGULAMBA GADWAL,2021-01-20,0,283,0,283
TELANGANA,KAMAREDDY,2021-01-16,0,593,0,593
TELANGANA,KAMAREDDY,2021-01-17,0,81,0,81
TELANGANA,KAMAREDDY,2021-01-18,0,576,0,576
TELANGANA,KAMAREDDY,2021-01-19,0,172,0,172
TELANGANA,KAMAREDDY,2021-01-20,0,327,0,327
TELANGANA,KARIMNAGAR,2021-01-16,0,1082,0,1082
TELANGANA,KARIMNAGAR,2021-01-17,0,564,0,564
TELANGANA,KARIMNAGAR,2021-01-18,0,793,0,793
TELANGANA,KARIMNAGAR,2021-01-19,0,731,0,731
TELANGANA,KARIMNAGAR,2021-01-20,1,825,0,826
TELANGANA,KHAMMAM,2021-01-16,0,598,0,598
TELANGANA,KHAMMAM,2021-01-17,1,175,0,176
TELANGANA,KHAMMAM,2021-01-18,0,676,0,676
TELANGANA,KHAMMAM,2021-01-19,4,525,0,529
TELANGANA,KHAMMAM,2021-01-20,1,493,0,494
TELANGANA,KUMURAM BHEEM ASIFABAD,2021-01-16,0,444,0,444
TELANGANA,KUMURAM BHEEM ASIFABAD,2021-01-17,0,567,0,567
TELANGANA,KUMURAM BHEEM ASIFABAD,2021-01-18,0,621,0,621
TELANGANA,KUMURAM BHEEM ASIFABAD,2021-01-19,0,391,0,391
TELANGANA,KUMURAM BHEEM ASIFABAD,2021-01-20,0,440,0,440
TELANGANA,MAHABUBABAD,2021-01-16,0,732,0,732
TELANGANA,MAHABUBABAD,2021-01-17,0,319,0,319
TELANGANA,MAHABUBABAD,2021-01-18,0,270,0,270
TELANGANA,MAHABUBABAD,2021-01-19,0,338,0,338
TELANGANA,MAHABUBABAD,2021-01-20,0,375,0,375
TELANGANA,MAHABUBNAGAR,2021-01-16,0,705,0,705
TELANGANA,MAHABUBNAGAR,2021-01-17,1,275,0,276
TELANGANA,MAHABUBNAGAR,2021-01-18,0,693,0,693
TELANGANA,MAHABUBNAGAR,2021-01-19,2,334,0,336
TELANGANA,MAHABUBNAGAR,2021-01-20,1,559,0,560
TELANGANA,MANCHERIAL,2021-01-16,0,577,0,577
TELANGANA,MANCHERIAL,2021-01-17,0,331,0,331
TELANGANA,MANCHERIAL,2021-01-18,0,599,0,599
TELANGANA,MANCHERIAL,2021-01-19,0,480,0,480
TELANGANA,MANCHERIAL,2021-01-20,0,498,0,498
TELANGANA,MEDAK,2021-01-16,1,280,0,281
TELANGANA,MEDAK,2021-01-17,0,100,0,100
TELANGANA,MEDAK,2021-01-18,1,340,0,341
TELANGANA,MEDAK,2021-01-19,1,190,0,191
TELANGANA,MEDAK,2021-01-20,0,261,0,261
TELANGANA,MEDCHAL MALKAJGIRI,2021-01-16,0,1422,0,1422
TELANGANA,MEDCHAL MALKAJGIRI,2021-01-17,0,399,0,399
TELANGANA,MEDCHAL MALKAJGIRI,2021-01-18,1,1613,0,1614
TELANGANA,MEDCHAL MALKAJGIRI,2021-01-19,0,1617,0,1617
TELANGANA,MEDCHAL MALKAJGIRI,2021-01-20,0,1237,0,1237
TELANGANA,MULUGU,2021-01-16,0,165,0,165
TELANGANA,MULUGU,2021-01-17,0,58,0,58
TELANGANA,MULUGU,2021-01-18,0,107,0,107
TELANGANA,MULUGU,2021-01-19,0,87,0,87
TELANGANA,MULUGU,2021-01-20,0,95,0,95
TELANGANA,NAGARKURNOOL,2021-01-16,0,848,0,848
TELANGANA,NAGARKURNOOL,2021-01-17,0,726,0,726
TELANGANA,NAGARKURNOOL,2021-01-18,0,690,0,690
TELANGANA,NAGARKURNOOL,2021-01-19,3,662,0,665
TELANGANA,NAGARKURNOOL,2021-01-20,0,786,0,786
TELANGANA,NALGONDA,2021-01-16,0,526,0,526
TELANGANA,NALGONDA,2021-01-17,0,168,0,168
TELANGANA,NALGONDA,2021-01-18,0,531,0,531
TELANGANA,NALGONDA,2021-01-19,0,478,0,478
TELANGANA,NALGONDA,2021-01-20,0,384,0,384
TELANGANA,NARAYANPET,2021-01-16,0,108,0,108
TELANGANA,NARAYANPET,2021-01-17,0,140,0,140
TELANGANA,NARAYANPET,2021-01-18,0,301,0,301
TELANGANA,NARAYANPET,2021-01-19,0,189,0,189
TELANGANA,NARAYANPET,2021-01-20,0,101,0,101
TELANGANA,NIRMAL,2021-01-16,0,819,0,819
TELANGANA,NIRMAL,2021-01-17,0,263,0,263
TELANGANA,NIRMAL,2021-01-18,0,613,0,613
TELANGANA,NIRMAL,2021-01-19,0,368,0,368
TELANGANA,NIRMAL,2021-01-20,0,745,0,745
TELANGANA,NIZAMABAD,2021-01-16,0,261,0,261
TELANGANA,NIZAMABAD,2021-01-17,0,102,0,102
TELANGANA,NIZAMABAD,2021-01-18,0,318,0,318
TELANGANA,NIZAMABAD,2021-01-19,1,302,0,303
TELANGANA,NIZAMABAD,2021-01-20,1,274,0,275
TELANGANA,PEDDAPALLI,2021-01-16,0,830,0,830
TELANGANA,PEDDAPALLI,2021-01-17,0,326,0,326
TELANGANA,PEDDAPALLI,2021-01-18,0,976,0,976
TELANGANA,PEDDAPALLI,2021-01-19,0,628,0,628
TELANGANA,PEDDAPALLI,2021-01-20,0,593,0,593
TELANGANA,RAJANNA SIRCILLA,2021-01-16,0,356,0,356
TELANGANA,RAJANNA SIRCILLA,2021-01-17,0,140,0,140
TELANGANA,RAJANNA SIRCILLA,2021-01-18,0,329,0,329
TELANGANA,RAJANNA SIRCILLA,2021-01-19,0,229,0,229
TELANGANA,RAJANNA SIRCILLA,2021-01-20,0,155,0,155
TELANGANA,RANGA REDDY,2021-01-16,3,1912,0,1915
TELANGANA,RANGA REDDY,2021-01-17,2,789,1,792
TELANGANA,RANGA REDDY,2021-01-18,11,1974,0,1985
TELANGANA,RANGA REDDY,2021-01-19,3,1765,0,1768
TELANGANA,RANGA REDDY,2021-01-20,7,1487,0,1494
TELANGANA,SANGAREDDY,2021-01-16,0,910,0,910
TELANGANA,SANGAREDDY,2021-01-17,1,281,0,282
TELANGANA,SANGAREDDY,2021-01-18,8,1150,4,1162
TELANGANA,SANGAREDDY,2021-01-19,0,1044,3,1047
TELANGANA,SANGAREDDY,2021-01-20,4,898,1,903
TELANGANA,SIDDIPET,2021-01-16,0,2171,0,2171
TELANGANA,SIDDIPET,2021-01-17,0,1750,0,1750
TELANGANA,SIDDIPET,2021-01-18,0,1572,0,1572
TELANGANA,SIDDIPET,2021-01-19,0,791,0,791
TELANGANA,SIDDIPET,2021-01-20,0,1364,0,1364
TELANGANA,SURYAPET,2021-01-16,0,1287,0,1287
TELANGANA,SURYAPET,2021-01-17,1,659,0,660
TELANGANA,SURYAPET,2021-01-18,2,1062,0,1064
TELANGANA,SURYAPET,2021-01-19,0,813,0,813
TELANGANA,SURYAPET,2021-01-20,0,1134,0,1134
TELANGANA,VIKARABAD,2021-01-16,0,590,0,590
TELANGANA,VIKARABAD,2021-01-17,0,250,0,250
TELANGANA,VIKARABAD,2021-01-18,0,584,0,584
TELANGANA,VIKARABAD,2021-01-19,0,461,0,461
TELANGANA,VIKARABAD,2021-01-20,0,452,0,452
TELANGANA,WANAPARTHY,2021-01-16,0,236,0,236
TELANGANA,WANAPARTHY,2021-01-17,0,145,0,145
TELANGANA,WANAPARTHY,2021-01-18,0,338,0,338
TELANGANA,WANAPARTHY,2021-01-19,0,256,0,256
TELANGANA,WANAPARTHY,2021-01-20,0,184,0,184
TELANGANA,WARANGAL RURAL,2021-01-16,1,364,0,365
TELANGANA,WARANGAL RURAL,2021-01-17,2,176,1,179
TELANGANA,WARANGAL RURAL,2021-01-18,4,338,0,342
TELANGANA,WARANGAL RURAL,2021-01-19,0,166,0,166
TELANGANA,WARANGAL RURAL,2021-01-20,0,243,0,243
TELANGANA,WARANGAL URBAN,2021-01-16,0,1748,0,1748
TELANGANA,WARANGAL URBAN,2021-01-17,2,1095,0,1097
TELANGANA,WARANGAL URBAN,2021-01-18,0,1355,0,1355
TELANGANA,WARANGAL URBAN,2021-01-19,1,1125,0,1126
TELANGANA,WARANGAL URBAN,2021-01-20,1,1250,0,1251
TELANGANA,YADADRI BHUVANAGIRI,2021-01-16,0,170,0,170
TELANGANA,YADADRI BHUVANAGIRI,2021-01-17,0,47,0,47
TELANGANA,YADADRI BHUVANAGIRI,2021-01-18,0,268,0,268
TELANGANA,YADADRI BHUVANAGIRI,2021-01-19,0,206,0,206
TELANGANA,YADADRI BHUVANAGIRI,2021-01-20,0,182,0,182
TRIPURA,DHALAI,2021-01-16,0,28,0,28
TRIPURA,DHALAI,2021-01-17,0,2,0,2
TRIPURA,DHALAI,2021-01-18,0,12,0,12
TRIPURA,DHALAI,2021-01-19,0,9,0,9
TRIPURA,DHALAI,2021-01-20,0,60,0,60
TRIPURA,GOMATI,2021-01-16,1,66,0,67
TRIPURA,GOMATI,2021-01-17,0,14,0,14
TRIPURA,GOMATI,2021-01-18,0,45,0,45
TRIPURA,GOMATI,2021-01-19,0,32,0,32
TRIPURA,GOMATI,2021-01-20,0,46,0,46
TRIPURA,KHOWAI,2021-01-16,0,74,0,74
TRIPURA,KHOWAI,2021-01-17,5,59,0,64
TRIPURA,KHOWAI,2021-01-18,1,50,0,51
TRIPURA,KHOWAI,2021-01-19,0,55,0,55
TRIPURA,KHOWAI,2021-01-20,0,22,0,22
TRIPURA,NORTH TRIPURA,2021-01-16,0,111,0,111
TRIPURA,NORTH TRIPURA,2021-01-17,2,65,0,67
TRIPURA,NORTH TRIPURA,2021-01-18,0,110,0,110
TRIPURA,NORTH TRIPURA,2021-01-19,0,82,0,82
TRIPURA,NORTH TRIPURA,2021-01-20,0,81,0,81
TRIPURA,SEPAHIJALA,2021-01-16,1,50,0,51
TRIPURA,SEPAHIJALA,2021-01-17,0,41,0,41
TRIPURA,SEPAHIJALA,2021-01-18,0,51,0,51
TRIPURA,SEPAHIJALA,2021-01-19,0,48,0,48
TRIPURA,SEPAHIJALA,2021-01-20,0,75,0,75
TRIPURA,SOUTH TRIPURA,2021-01-16,1,111,0,112
TRIPURA,SOUTH TRIPURA,2021-01-17,0,95,0,95
TRIPURA,SOUTH TRIPURA,2021-01-18,0,58,0,58
TRIPURA,SOUTH TRIPURA,2021-01-19,0,145,0,145
TRIPURA,SOUTH TRIPURA,2021-01-20,0,121,0,121
TRIPURA,UNAKOTI,2021-01-16,0,8,0,8
TRIPURA,UNAKOTI,2021-01-17,0,2,0,2
TRIPURA,UNAKOTI,2021-01-18,0,10,0,10
TRIPURA,UNAKOTI,2021-01-19,1,12,0,13
TRIPURA,UNAKOTI,2021-01-20,0,5,0,5
TRIPURA,WEST TRIPURA,2021-01-16,1,283,0,284
TRIPURA,WEST TRIPURA,2021-01-17,0,113,0,113
TRIPURA,WEST TRIPURA,2021-01-18,2,290,0,292
TRIPURA,WEST TRIPURA,2021-01-19,1,260,0,261
TRIPURA,WEST TRIPURA,2021-01-20,5,311,0,316
UTTAR PRADESH,AGRA,2021-01-16,7,2668,8,2683
UTTAR PRADESH,AGRA,2021-01-17,14,1530,10,1554
UTTAR PRADESH,AGRA,2021-01-18,10,943,4,957
UTTAR PRADESH,AGRA,2021-01-19,6,3166,11,3183
UTTAR PRADESH,AGRA,2021-01-20,6,2631,2,2639
UTTAR PRADESH,ALIGARH,2021-01-16,6,2453,0,2459
UTTAR PRADESH,ALIGARH,2021-01-17,6,2030,26,2062
UTTAR PRADESH,ALIGARH,2021-01-18,5,2484,0,2489
UTTAR PRADESH,ALIGARH,2021-01-19,10,2403,3,2416
UTTAR PRADESH,ALIGARH,2021-01-20,9,3184,0,3193
UTTAR PRADESH,AMBEDKAR NAGAR,2021-01-16,3,1782,0,1785
UTTAR PRADESH,AMBEDKAR NAGAR,2021-01-17,3,916,0,919
UTTAR PRADESH,AMBEDKAR NAGAR,2021-01-18,0,426,1,427
UTTAR PRADESH,AMBEDKAR NAGAR,2021-01-19,1,2361,1,2363
UTTAR PRADESH,AMBEDKAR NAGAR,2021-01-20,1,1270,1,1272
UTTAR PRADESH,AMETHI,2021-01-16,6,832,0,838
UTTAR PRADESH,AMETHI,2021-01-17,3,1158,40,1201
UTTAR PRADESH,AMETHI,2021-01-18,3,329,0,332
UTTAR PRADESH,AMETHI,2021-01-19,11,2006,82,2099
UTTAR PRADESH,AMETHI,2021-01-20,6,1101,0,1107
UTTAR PRADESH,AMROHA,2021-01-16,1,715,0,716
UTTAR PRADESH,AMROHA,2021-01-17,5,1161,1,1167
UTTAR PRADESH,AMROHA,2021-01-18,2,587,0,589
UTTAR PRADESH,AMROHA,2021-01-19,1,1332,1,1334
UTTAR PRADESH,AMROHA,2021-01-20,2,1041,0,1043
UTTAR PRADESH,AURAIYA,2021-01-16,1,897,28,926
UTTAR PRADESH,AURAIYA,2021-01-17,4,505,56,565
UTTAR PRADESH,AURAIYA,2021-01-18,2,487,38,527
UTTAR PRADESH,AURAIYA,2021-01-19,0,1384,32,1416
UTTAR PRADESH,AURAIYA,2021-01-20,0,684,70,754
UTTAR PRADESH,AYODHYA,2021-01-16,8,2829,1,2838
UTTAR PRADESH,AYODHYA,2021-01-17,14,735,19,768
UTTAR PRADESH,AYODHYA,2021-01-18,5,1413,22,1440
UTTAR PRADESH,AYODHYA,2021-01-19,12,1861,8,1881
UTTAR PRADESH,AYODHYA,2021-01-20,11,1609,2,1622
UTTAR PRADESH,AZAMGARH,2021-01-16,1,761,12,774
UTTAR PRADESH,AZAMGARH,2021-01-17,1,879,1,881
UTTAR PRADESH,AZAMGARH,2021-01-18,0,751,1,752
UTTAR PRADESH,AZAMGARH,2021-01-19,0,1601,0,1601
UTTAR PRADESH,AZAMGARH,2021-01-20,2,795,12,809
UTTAR PRADESH,BAGHPAT,2021-01-16,4,1215,6,1225
UTTAR PRADESH,BAGHPAT,2021-01-17,1,1198,23,1222
UTTAR PRADESH,BAGHPAT,2021-01-18,4,1074,5,1083
UTTAR PRADESH,BAGHPAT,2021-01-19,1,1543,10,1554
UTTAR PRADESH,BAGHPAT,2021-01-20,4,1358,15,1377
UTTAR PRADESH,BAHRAICH,2021-01-16,2,1853,39,1894
UTTAR PRADESH,BAHRAICH,2021-01-17,12,1666,34,1712
UTTAR PRADESH,BAHRAICH,2021-01-18,6,1506,17,1529
UTTAR PRADESH,BAHRAICH,2021-01-19,4,1873,4,1881
UTTAR PRADESH,BAHRAICH,2021-01-20,0,1613,10,1623
UTTAR PRADESH,BALLIA,2021-01-16,4,1008,3,1015
UTTAR PRADESH,BALLIA,2021-01-17,8,824,2,834
UTTAR PRADESH,BALLIA,2021-01-18,3,692,0,695
UTTAR PRADESH,BALLIA,2021-01-19,2,1700,15,1717
UTTAR PRADESH,BALLIA,2021-01-20,3,822,2,827
UTTAR PRADESH,BALRAMPUR,2021-01-16,4,1612,20,1636
UTTAR PRADESH,BALRAMPUR,2021-01-17,4,1046,0,1050
UTTAR PRADESH,BALRAMPUR,2021-01-18,16,535,1,552
UTTAR PRADESH,BALRAMPUR,2021-01-19,7,1806,0,1813
UTTAR PRADESH,BALRAMPUR,2021-01-20,18,1331,0,1349
UTTAR PRADESH,BANDA,2021-01-16,2,2026,11,2039
UTTAR PRADESH,BANDA,2021-01-17,2,1649,0,1651
UTTAR PRADESH,BANDA,2021-01-18,1,1305,3,1309
UTTAR PRADESH,BANDA,2021-01-19,3,2805,55,2863
UTTAR PRADESH,BANDA,2021-01-20,5,2079,6,2090
UTTAR PRADESH,BARABANKI,2021-01-16,7,1116,33,1156
UTTAR PRADESH,BARABANKI,2021-01-17,0,1485,1,1486
UTTAR PRADESH,BARABANKI,2021-01-18,1,645,3,649
UTTAR PRADESH,BARABANKI,2021-01-19,3,2101,7,2111
UTTAR PRADESH,BARABANKI,2021-01-20,5,1450,0,1455
UTTAR PRADESH,BAREILLY,2021-01-16,13,2397,1,2411
UTTAR PRADESH,BAREILLY,2021-01-17,10,1650,2,1662
UTTAR PRADESH,BAREILLY,2021-01-18,15,1387,3,1405
UTTAR PRADESH,BAREILLY,2021-01-19,12,3911,2,3925
UTTAR PRADESH,BAREILLY,2021-01-20,8,1606,2,1616
UTTAR PRADESH,BASTI,2021-01-16,10,1106,6,1122
UTTAR PRADESH,BASTI,2021-01-17,8,1113,74,1195
UTTAR PRADESH,BASTI,2021-01-18,3,438,42,483
UTTAR PRADESH,BASTI,2021-01-19,4,1359,52,1415
UTTAR PRADESH,BASTI,2021-01-20,7,1450,39,1496
UTTAR PRADESH,BHADOHI,2021-01-16,2,1788,0,1790
UTTAR PRADESH,BHADOHI,2021-01-17,0,1498,0,1498
UTTAR PRADESH,BHADOHI,2021-01-18,1,1408,0,1409
UTTAR PRADESH,BHADOHI,2021-01-19,0,1525,0,1525
UTTAR PRADESH,BHADOHI,2021-01-20,1,1422,81,1504
UTTAR PRADESH,BIJNOR,2021-01-16,7,1564,3,1574
UTTAR PRADESH,BIJNOR,2021-01-17,4,1579,0,1583
UTTAR PRADESH,BIJNOR,2021-01-18,0,130,7,137
UTTAR PRADESH,BIJNOR,2021-01-19,3,2764,1,2768
UTTAR PRADESH,BIJNOR,2021-01-20,9,1765,3,1777
UTTAR PRADESH,BUDAUN,2021-01-16,1,1741,15,1757
UTTAR PRADESH,BUDAUN,2021-01-17,1,1898,24,1923
UTTAR PRADESH,BUDAUN,2021-01-18,3,608,0,611
UTTAR PRADESH,BUDAUN,2021-01-19,3,1558,37,1598
UTTAR PRADESH,BUDAUN,2021-01-20,3,3184,10,3197
UTTAR PRADESH,BULANDSHAHR,2021-01-16,4,2167,15,2186
UTTAR PRADESH,BULANDSHAHR,2021-01-17,9,195,1,205
UTTAR PRADESH,BULANDSHAHR,2021-01-18,2,483,16,501
UTTAR PRADESH,BULANDSHAHR,2021-01-19,5,705,2,712
UTTAR PRADESH,BULANDSHAHR,2021-01-20,3,4919,8,4930
UTTAR PRADESH,CHANDAULI,2021-01-16,2,1286,91,1379
UTTAR PRADESH,CHANDAULI,2021-01-17,2,975,2,979
UTTAR PRADESH,CHANDAULI,2021-01-18,3,550,5,558
UTTAR PRADESH,CHANDAULI,2021-01-19,10,1743,2,1755
UTTAR PRADESH,CHANDAULI,2021-01-20,1,1217,15,1233
UTTAR PRADESH,CHITRAKOOT,2021-01-16,0,1349,10,1359
UTTAR PRADESH,CHITRAKOOT,2021-01-17,0,1093,6,1099
UTTAR PRADESH,CHITRAKOOT,2021-01-18,0,963,0,963
UTTAR PRADESH,CHITRAKOOT,2021-01-19,0,1537,0,1537
UTTAR PRADESH,CHITRAKOOT,2021-01-20,0,1250,10,1260
UTTAR PRADESH,DEORIA,2021-01-16,3,446,2,451
UTTAR PRADESH,DEORIA,2021-01-17,2,208,492,702
UTTAR PRADESH,DEORIA,2021-01-18,1,625,5,631
UTTAR PRADESH,DEORIA,2021-01-19,2,941,1,944
UTTAR PRADESH,DEORIA,2021-01-20,0,872,53,925
UTTAR PRADESH,ETAH,2021-01-16,0,1264,1,1265
UTTAR PRADESH,ETAH,2021-01-17,1,1231,6,1238
UTTAR PRADESH,ETAH,2021-01-18,0,987,43,1030
UTTAR PRADESH,ETAH,2021-01-19,2,1289,5,1296
UTTAR PRADESH,ETAH,2021-01-20,1,1143,64,1208
UTTAR PRADESH,ETAWAH,2021-01-16,3,2376,108,2487
UTTAR PRADESH,ETAWAH,2021-01-17,1,1543,110,1654
UTTAR PRADESH,ETAWAH,2021-01-18,1,1233,31,1265
UTTAR PRADESH,ETAWAH,2021-01-19,3,1455,17,1475
UTTAR PRADESH,ETAWAH,2021-01-20,1,2529,108,2638
UTTAR PRADESH,FARRUKHABAD,2021-01-16,1,1056,68,1125
UTTAR PRADESH,FARRUKHABAD,2021-01-17,0,545,30,575
UTTAR PRADESH,FARRUKHABAD,2021-01-18,1,979,45,1025
UTTAR PRADESH,FARRUKHABAD,2021-01-19,2,1317,6,1325
UTTAR PRADESH,FARRUKHABAD,2021-01-20,2,1439,17,1458
UTTAR PRADESH,FATEHPUR,2021-01-16,1,1500,82,1583
UTTAR PRADESH,FATEHPUR,2021-01-17,2,1686,57,1745
UTTAR PRADESH,FATEHPUR,2021-01-18,2,894,36,932
UTTAR PRADESH,FATEHPUR,2021-01-19,3,1883,116,2002
UTTAR PRADESH,FATEHPUR,2021-01-20,1,1412,3,1416
UTTAR PRADESH,FIROZABAD,2021-01-16,4,2340,24,2368
UTTAR PRADESH,FIROZABAD,2021-01-17,0,1790,2,1792
UTTAR PRADESH,FIROZABAD,2021-01-18,4,2227,3,2234
UTTAR PRADESH,FIROZABAD,2021-01-19,2,1997,11,2010
UTTAR PRADESH,FIROZABAD,2021-01-20,1,1559,21,1581
UTTAR PRADESH,GAUTAM BUDDHA NAGAR,2021-01-16,54,2582,33,2669
UTTAR PRADESH,GAUTAM BUDDHA NAGAR,2021-01-17,40,2770,49,2859
UTTAR PRADESH,GAUTAM BUDDHA NAGAR,2021-01-18,40,2196,25,2261
UTTAR PRADESH,GAUTAM BUDDHA NAGAR,2021-01-19,22,3686,40,3748
UTTAR PRADESH,GAUTAM BUDDHA NAGAR,2021-01-20,37,3299,61,3397
UTTAR PRADESH,GHAZIABAD,2021-01-16,49,1697,52,1798
UTTAR PRADESH,GHAZIABAD,2021-01-17,27,1328,9,1364
UTTAR PRADESH,GHAZIABAD,2021-01-18,54,2029,17,2100
UTTAR PRADESH,GHAZIABAD,2021-01-19,52,5626,86,5764
UTTAR PRADESH,GHAZIABAD,2021-01-20,33,3538,18,3589
UTTAR PRADESH,GHAZIPUR,2021-01-16,4,779,15,798
UTTAR PRADESH,GHAZIPUR,2021-01-17,2,832,82,916
UTTAR PRADESH,GHAZIPUR,2021-01-18,0,453,0,453
UTTAR PRADESH,GHAZIPUR,2021-01-19,4,1383,16,1403
UTTAR PRADESH,GHAZIPUR,2021-01-20,2,912,5,919
UTTAR PRADESH,GONDA,2021-01-16,3,1248,1,1252
UTTAR PRADESH,GONDA,2021-01-17,0,1091,0,1091
UTTAR PRADESH,GONDA,2021-01-18,1,1189,0,1190
UTTAR PRADESH,GONDA,2021-01-19,0,1831,2,1833
UTTAR PRADESH,GONDA,2021-01-20,0,1466,58,1524
UTTAR PRADESH,GORAKHPUR,2021-01-16,4,2747,9,2760
UTTAR PRADESH,GORAKHPUR,2021-01-17,12,2858,69,2939
UTTAR PRADESH,GORAKHPUR,2021-01-18,10,2177,312,2499
UTTAR PRADESH,GORAKHPUR,2021-01-19,6,2397,36,2439
UTTAR PRADESH,GORAKHPUR,2021-01-20,9,3707,330,4046
UTTAR PRADESH,HAMIRPUR,2021-01-16,3,1092,6,1101
UTTAR PRADESH,HAMIRPUR,2021-01-17,0,717,0,717
UTTAR PRADESH,HAMIRPUR,2021-01-18,0,952,3,955
UTTAR PRADESH,HAMIRPUR,2021-01-19,0,1168,6,1174
UTTAR PRADESH,HAMIRPUR,2021-01-20,0,834,0,834
UTTAR PRADESH,HAPUR,2021-01-16,4,2058,1,2063
UTTAR PRADESH,HAPUR,2021-01-17,0,347,25,372
UTTAR PRADESH,HAPUR,2021-01-18,3,1899,0,1902
UTTAR PRADESH,HAPUR,2021-01-19,6,748,11,765
UTTAR PRADESH,HAPUR,2021-01-20,0,1268,45,1313
UTTAR PRADESH,HARDOI,2021-01-16,1,1355,18,1374
UTTAR PRADESH,HARDOI,2021-01-17,1,1057,33,1091
UTTAR PRADESH,HARDOI,2021-01-18,4,1176,5,1185
UTTAR PRADESH,HARDOI,2021-01-19,2,1693,0,1695
UTTAR PRADESH,HARDOI,2021-01-20,3,1292,6,1301
UTTAR PRADESH,HATHRAS,2021-01-16,1,1649,0,1650
UTTAR PRADESH,HATHRAS,2021-01-17,3,1431,0,1434
UTTAR PRADESH,HATHRAS,2021-01-18,0,1183,0,1183
UTTAR PRADESH,HATHRAS,2021-01-19,0,556,10,566
UTTAR PRADESH,HATHRAS,2021-01-20,2,1432,2,1436
UTTAR PRADESH,JALAUN,2021-01-16,2,1179,2,1183
UTTAR PRADESH,JALAUN,2021-01-17,0,729,0,729
UTTAR PRADESH,JALAUN,2021-01-18,0,220,0,220
UTTAR PRADESH,JALAUN,2021-01-19,2,2322,3,2327
UTTAR PRADESH,JALAUN,2021-01-20,1,821,2,824
UTTAR PRADESH,JAUNPUR,2021-01-16,5,1111,0,1116
UTTAR PRADESH,JAUNPUR,2021-01-17,2,1607,1,1610
UTTAR PRADESH,JAUNPUR,2021-01-18,6,978,0,984
UTTAR PRADESH,JAUNPUR,2021-01-19,5,2054,0,2059
UTTAR PRADESH,JAUNPUR,2021-01-20,3,1645,7,1655
UTTAR PRADESH,JHANSI,2021-01-16,11,3214,3,3228
UTTAR PRADESH,JHANSI,2021-01-17,12,2508,4,2524
UTTAR PRADESH,JHANSI,2021-01-18,2,2173,2,2177
UTTAR PRADESH,JHANSI,2021-01-19,22,3979,11,4012
UTTAR PRADESH,JHANSI,2021-01-20,11,3132,3,3146
UTTAR PRADESH,KANNAUJ,2021-01-16,1,1425,0,1426
UTTAR PRADESH,KANNAUJ,2021-01-17,0,1202,0,1202
UTTAR PRADESH,KANNAUJ,2021-01-18,0,1355,0,1355
UTTAR PRADESH,KANNAUJ,2021-01-19,2,1713,2,1717
UTTAR PRADESH,KANNAUJ,2021-01-20,0,1415,1,1416
UTTAR PRADESH,KANPUR DEHAT,2021-01-16,1,953,1,955
UTTAR PRADESH,KANPUR DEHAT,2021-01-17,1,931,2,934
UTTAR PRADESH,KANPUR DEHAT,2021-01-18,1,706,8,715
UTTAR PRADESH,KANPUR DEHAT,2021-01-19,1,1166,3,1170
UTTAR PRADESH,KANPUR DEHAT,2021-01-20,2,961,8,971
UTTAR PRADESH,KANPUR NAGAR,2021-01-16,11,3139,15,3165
UTTAR PRADESH,KANPUR NAGAR,2021-01-17,26,3372,6,3404
UTTAR PRADESH,KANPUR NAGAR,2021-01-18,16,1662,0,1678
UTTAR PRADESH,KANPUR NAGAR,2021-01-19,29,5136,19,5184
UTTAR PRADESH,KANPUR NAGAR,2021-01-20,9,3442,28,3479
UTTAR PRADESH,KASGANJ,2021-01-16,0,2020,127,2147
UTTAR PRADESH,KASGANJ,2021-01-17,3,297,0,300
UTTAR PRADESH,KASGANJ,2021-01-18,1,2230,22,2253
UTTAR PRADESH,KASGANJ,2021-01-19,0,1803,6,1809
UTTAR PRADESH,KASGANJ,2021-01-20,1,875,90,966
UTTAR PRADESH,KAUSHAMBI,2021-01-16,0,1562,1,1563
UTTAR PRADESH,KAUSHAMBI,2021-01-17,1,1511,6,1518
UTTAR PRADESH,KAUSHAMBI,2021-01-18,0,1540,0,1540
UTTAR PRADESH,KAUSHAMBI,2021-01-19,0,1782,0,1782
UTTAR PRADESH,KAUSHAMBI,2021-01-20,0,1888,0,1888
UTTAR PRADESH,KHERI,2021-01-16,8,1435,1,1444
UTTAR PRADESH,KHERI,2021-01-17,6,1766,8,1780
UTTAR PRADESH,KHERI,2021-01-18,8,710,0,718
UTTAR PRADESH,KHERI,2021-01-19,3,2665,3,2671
UTTAR PRADESH,KHERI,2021-01-20,6,2501,91,2598
UTTAR PRADESH,KUSHI NAGAR,2021-01-16,2,1211,26,1239
UTTAR PRADESH,KUSHI NAGAR,2021-01-17,1,1304,5,1310
UTTAR PRADESH,KUSHI NAGAR,2021-01-18,0,449,6,455
UTTAR PRADESH,KUSHI NAGAR,2021-01-19,3,1504,18,1525
UTTAR PRADESH,KUSHI NAGAR,2021-01-20,0,911,32,943
UTTAR PRADESH,LALITPUR,2021-01-16,1,1316,0,1317
UTTAR PRADESH,LALITPUR,2021-01-17,0,1405,0,1405
UTTAR PRADESH,LALITPUR,2021-01-18,0,1132,0,1132
UTTAR PRADESH,LALITPUR,2021-01-19,8,1567,0,1575
UTTAR PRADESH,LALITPUR,2021-01-20,3,1704,1,1708
UTTAR PRADESH,LUCKNOW,2021-01-16,106,6019,209,6334
UTTAR PRADESH,LUCKNOW,2021-01-17,97,5634,309,6040
UTTAR PRADESH,LUCKNOW,2021-01-18,73,4273,41,4387
UTTAR PRADESH,LUCKNOW,2021-01-19,98,8778,546,9422
UTTAR PRADESH,LUCKNOW,2021-01-20,87,6591,261,6939
UTTAR PRADESH,MAHARAJGANJ,2021-01-16,3,1147,18,1168
UTTAR PRADESH,MAHARAJGANJ,2021-01-17,1,693,53,747
UTTAR PRADESH,MAHARAJGANJ,2021-01-18,2,377,30,409
UTTAR PRADESH,MAHARAJGANJ,2021-01-19,3,1497,274,1774
UTTAR PRADESH,MAHARAJGANJ,2021-01-20,0,1020,129,1149
UTTAR PRADESH,MAHOBA,2021-01-16,0,741,0,741
UTTAR PRADESH,MAHOBA,2021-01-17,0,364,0,364
UTTAR PRADESH,MAHOBA,2021-01-18,0,578,5,583
UTTAR PRADESH,MAHOBA,2021-01-19,0,1185,25,1210
UTTAR PRADESH,MAHOBA,2021-01-20,0,814,1,815
UTTAR PRADESH,MAINPURI,2021-01-16,3,1719,85,1807
UTTAR PRADESH,MAINPURI,2021-01-17,2,1421,2,1425
UTTAR PRADESH,MAINPURI,2021-01-18,0,532,0,532
UTTAR PRADESH,MAINPURI,2021-01-19,8,3118,1,3127
UTTAR PRADESH,MAINPURI,2021-01-20,3,1746,5,1754
UTTAR PRADESH,MATHURA,2021-01-16,9,1144,0,1153
UTTAR PRADESH,MATHURA,2021-01-17,6,2022,8,2036
UTTAR PRADESH,MATHURA,2021-01-18,1,848,1,850
UTTAR PRADESH,MATHURA,2021-01-19,5,1964,6,1975
UTTAR PRADESH,MATHURA,2021-01-20,2,1157,9,1168
UTTAR PRADESH,MAU,2021-01-16,1,1012,0,1013
UTTAR PRADESH,MAU,2021-01-17,1,776,1,778
UTTAR PRADESH,MAU,2021-01-18,0,316,1,317
UTTAR PRADESH,MAU,2021-01-19,1,2623,5,2629
UTTAR PRADESH,MAU,2021-01-20,0,1589,5,1594
UTTAR PRADESH,MEERUT,2021-01-16,33,3063,8,3104
UTTAR PRADESH,MEERUT,2021-01-17,17,3159,4,3180
UTTAR PRADESH,MEERUT,2021-01-18,24,3342,11,3377
UTTAR PRADESH,MEERUT,2021-01-19,29,5177,34,5240
UTTAR PRADESH,MEERUT,2021-01-20,18,3130,29,3177
UTTAR PRADESH,MIRZAPUR,2021-01-16,1,1468,0,1469
UTTAR PRADESH,MIRZAPUR,2021-01-17,3,1650,0,1653
UTTAR PRADESH,MIRZAPUR,2021-01-18,0,1137,1,1138
UTTAR PRADESH,MIRZAPUR,2021-01-19,0,2300,0,2300
UTTAR PRADESH,MIRZAPUR,2021-01-20,0,2029,0,2029
UTTAR PRADESH,MORADABAD,2021-01-16,3,2848,10,2861
UTTAR PRADESH,MORADABAD,2021-01-17,4,2771,1,2776
UTTAR PRADESH,MORADABAD,2021-01-18,4,2055,0,2059
UTTAR PRADESH,MORADABAD,2021-01-19,2,3648,1,3651
UTTAR PRADESH,MORADABAD,2021-01-20,4,3192,0,3196
UTTAR PRADESH,MUZAFFARNAGAR,2021-01-16,18,2193,4,2215
UTTAR PRADESH,MUZAFFARNAGAR,2021-01-17,11,1148,6,1165
UTTAR PRADESH,MUZAFFARNAGAR,2021-01-18,10,719,3,732
UTTAR PRADESH,MUZAFFARNAGAR,2021-01-19,13,2156,5,2174
UTTAR PRADESH,MUZAFFARNAGAR,2021-01-20,15,1701,10,1726
UTTAR PRADESH,PILIBHIT,2021-01-16,0,1463,9,1472
UTTAR PRADESH,PILIBHIT,2021-01-17,2,1070,0,1072
UTTAR PRADESH,PILIBHIT,2021-01-18,0,992,0,992
UTTAR PRADESH,PILIBHIT,2021-01-19,3,2251,22,2276
UTTAR PRADESH,PILIBHIT,2021-01-20,0,1923,7,1930
UTTAR PRADESH,PRATAPGARH,2021-01-16,3,1471,54,1528
UTTAR PRADESH,PRATAPGARH,2021-01-17,2,2076,112,2190
UTTAR PRADESH,PRATAPGARH,2021-01-18,3,1282,92,1377
UTTAR PRADESH,PRATAPGARH,2021-01-19,0,2249,92,2341
UTTAR PRADESH,PRATAPGARH,2021-01-20,5,1255,107,1367
UTTAR PRADESH,PRAYAGRAJ,2021-01-16,35,4119,3,4157
UTTAR PRADESH,PRAYAGRAJ,2021-01-17,30,3902,1,3933
UTTAR PRADESH,PRAYAGRAJ,2021-01-18,15,2491,1,2507
UTTAR PRADESH,PRAYAGRAJ,2021-01-19,29,4843,3,4875
UTTAR PRADESH,PRAYAGRAJ,2021-01-20,11,4758,1,4770
UTTAR PRADESH,RAE BARELI,2021-01-16,6,2931,2,2939
UTTAR PRADESH,RAE BARELI,2021-01-17,19,1437,2,1458
UTTAR PRADESH,RAE BARELI,2021-01-18,14,2292,0,2306
UTTAR PRADESH,RAE BARELI,2021-01-19,30,2619,6,2655
UTTAR PRADESH,RAE BARELI,2021-01-20,5,1778,4,1787
UTTAR PRADESH,RAMPUR,2021-01-16,0,1728,25,1753
UTTAR PRADESH,RAMPUR,2021-01-17,4,1605,18,1627
UTTAR PRADESH,RAMPUR,2021-01-18,3,735,74,812
UTTAR PRADESH,RAMPUR,2021-01-19,3,2401,82,2486
UTTAR PRADESH,RAMPUR,2021-01-20,1,1440,0,1441
UTTAR PRADESH,SAHARANPUR,2021-01-16,13,3071,10,3094
UTTAR PRADESH,SAHARANPUR,2021-01-17,16,2754,34,2804
UTTAR PRADESH,SAHARANPUR,2021-01-18,9,2535,3,2547
UTTAR PRADESH,SAHARANPUR,2021-01-19,14,3084,21,3119
UTTAR PRADESH,SAHARANPUR,2021-01-20,8,2319,28,2355
UTTAR PRADESH,SAMBHAL,2021-01-16,1,908,20,929
UTTAR PRADESH,SAMBHAL,2021-01-17,1,1074,23,1098
UTTAR PRADESH,SAMBHAL,2021-01-18,0,922,10,932
UTTAR PRADESH,SAMBHAL,2021-01-19,1,1012,10,1023
UTTAR PRADESH,SAMBHAL,2021-01-20,0,1262,15,1277
UTTAR PRADESH,SANT KABEER NAGAR,2021-01-16,14,1204,12,1230
UTTAR PRADESH,SANT KABEER NAGAR,2021-01-17,17,1419,10,1446
UTTAR PRADESH,SANT KABEER NAGAR,2021-01-18,7,680,16,703
UTTAR PRADESH,SANT KABEER NAGAR,2021-01-19,5,1897,16,1918
UTTAR PRADESH,SANT KABEER NAGAR,2021-01-20,4,1366,1,1371
UTTAR PRADESH,SHAHJAHANPUR,2021-01-16,13,1715,22,1750
UTTAR PRADESH,SHAHJAHANPUR,2021-01-17,2,1161,5,1168
UTTAR PRADESH,SHAHJAHANPUR,2021-01-18,7,1444,74,1525
UTTAR PRADESH,SHAHJAHANPUR,2021-01-19,5,1027,63,1095
UTTAR PRADESH,SHAHJAHANPUR,2021-01-20,5,2203,79,2287
UTTAR PRADESH,SHAMLI,2021-01-16,8,1553,14,1575
UTTAR PRADESH,SHAMLI,2021-01-17,1,1547,0,1548
UTTAR PRADESH,SHAMLI,2021-01-18,1,727,0,728
UTTAR PRADESH,SHAMLI,2021-01-19,3,1750,1,1754
UTTAR PRADESH,SHAMLI,2021-01-20,0,2354,0,2354
UTTAR PRADESH,SHRAVASTI,2021-01-16,3,867,0,870
UTTAR PRADESH,SHRAVASTI,2021-01-17,2,747,0,749
UTTAR PRADESH,SHRAVASTI,2021-01-18,2,811,0,813
UTTAR PRADESH,SHRAVASTI,2021-01-19,5,1022,0,1027
UTTAR PRADESH,SHRAVASTI,2021-01-20,4,932,0,936
UTTAR PRADESH,SIDDHARTH NAGAR,2021-01-16,5,687,0,692
UTTAR PRADESH,SIDDHARTH NAGAR,2021-01-17,2,1160,10,1172
UTTAR PRADESH,SIDDHARTH NAGAR,2021-01-18,4,479,1,484
UTTAR PRADESH,SIDDHARTH NAGAR,2021-01-19,11,1444,0,1455
UTTAR PRADESH,SIDDHARTH NAGAR,2021-01-20,2,1171,1,1174
UTTAR PRADESH,SITAPUR,2021-01-16,2,1536,14,1552
UTTAR PRADESH,SITAPUR,2021-01-17,1,1691,2,1694
UTTAR PRADESH,SITAPUR,2021-01-18,3,1609,5,1617
UTTAR PRADESH,SITAPUR,2021-01-19,2,1798,6,1806
UTTAR PRADESH,SITAPUR,2021-01-20,0,1501,58,1559
UTTAR PRADESH,SONBHADRA,2021-01-16,2,1495,0,1497
UTTAR PRADESH,SONBHADRA,2021-01-17,2,1384,13,1399
UTTAR PRADESH,SONBHADRA,2021-01-18,8,1440,0,1448
UTTAR PRADESH,SONBHADRA,2021-01-19,4,333,1048,1385
UTTAR PRADESH,SONBHADRA,2021-01-20,5,2232,43,2280
UTTAR PRADESH,SULTANPUR,2021-01-16,5,1027,18,1050
UTTAR PRADESH,SULTANPUR,2021-01-17,6,940,61,1007
UTTAR PRADESH,SULTANPUR,2021-01-18,2,473,6,481
UTTAR PRADESH,SULTANPUR,2021-01-19,10,1198,16,1224
UTTAR PRADESH,SULTANPUR,2021-01-20,5,1064,19,1088
UTTAR PRADESH,UNNAO,2021-01-16,2,1669,11,1682
UTTAR PRADESH,UNNAO,2021-01-17,1,1236,5,1242
UTTAR PRADESH,UNNAO,2021-01-18,0,1946,50,1996
UTTAR PRADESH,UNNAO,2021-01-19,3,2095,10,2108
UTTAR PRADESH,UNNAO,2021-01-20,2,1823,12,1837
UTTAR PRADESH,VARANASI,2021-01-16,24,3559,43,3626
UTTAR PRADESH,VARANASI,2021-01-17,21,1558,34,1613
UTTAR PRADESH,VARANASI,2021-01-18,16,2465,15,2496
UTTAR PRADESH,VARANASI,2021-01-19,41,3334,83,3458
UTTAR PRADESH,VARANASI,2021-01-20,27,2744,59,2830
UTTARAKHAND,ALMORA,2021-01-16,4,162,0,166
UTTARAKHAND,ALMORA,2021-01-17,1,13,0,14
UTTARAKHAND,ALMORA,2021-01-18,7,126,0,133
UTTARAKHAND,ALMORA,2021-01-19,8,176,0,184
UTTARAKHAND,ALMORA,2021-01-20,8,179,0,187
UTTARAKHAND,BAGESHWAR,2021-01-16,1,355,3,359
UTTARAKHAND,BAGESHWAR,2021-01-17,0,6,0,6
UTTARAKHAND,BAGESHWAR,2021-01-18,0,213,1,214
UTTARAKHAND,BAGESHWAR,2021-01-19,1,112,1,114
UTTARAKHAND,BAGESHWAR,2021-01-20,1,408,2,411
UTTARAKHAND,CHAMOLI,2021-01-16,5,403,12,420
UTTARAKHAND,CHAMOLI,2021-01-17,3,176,1,180
UTTARAKHAND,CHAMOLI,2021-01-18,2,98,0,100
UTTARAKHAND,CHAMOLI,2021-01-19,0,556,60,616
UTTARAKHAND,CHAMOLI,2021-01-20,2,104,2,108
UTTARAKHAND,CHAMPAWAT,2021-01-16,0,409,0,409
UTTARAKHAND,CHAMPAWAT,2021-01-17,3,568,0,571
UTTARAKHAND,CHAMPAWAT,2021-01-18,0,25,0,25
UTTARAKHAND,CHAMPAWAT,2021-01-19,0,322,0,322
UTTARAKHAND,CHAMPAWAT,2021-01-20,1,471,0,472
UTTARAKHAND,DEHRADUN,2021-01-16,65,3627,4,3696
UTTARAKHAND,DEHRADUN,2021-01-17,66,2187,11,2264
UTTARAKHAND,DEHRADUN,2021-01-18,42,3260,4,3306
UTTARAKHAND,DEHRADUN,2021-01-19,90,2948,11,3049
UTTARAKHAND,DEHRADUN,2021-01-20,60,3575,30,3665
UTTARAKHAND,HARIDWAR,2021-01-16,17,2305,6,2328
UTTARAKHAND,HARIDWAR,2021-01-17,12,1466,7,1485
UTTARAKHAND,HARIDWAR,2021-01-18,25,2357,1,2383
UTTARAKHAND,HARIDWAR,2021-01-19,12,2667,33,2712
UTTARAKHAND,HARIDWAR,2021-01-20,15,2061,23,2099
UTTARAKHAND,NAINITAL,2021-01-16,39,1716,7,1762
UTTARAKHAND,NAINITAL,2021-01-17,13,1344,1,1358
UTTARAKHAND,NAINITAL,2021-01-18,38,1003,6,1047
UTTARAKHAND,NAINITAL,2021-01-19,37,1348,2,1387
UTTARAKHAND,NAINITAL,2021-01-20,35,1547,10,1592
UTTARAKHAND,PAURI GARHWAL,2021-01-16,0,555,83,638
UTTARAKHAND,PAURI GARHWAL,2021-01-17,2,456,5,463
UTTARAKHAND,PAURI GARHWAL,2021-01-18,1,462,2,465
UTTARAKHAND,PAURI GARHWAL,2021-01-19,3,471,11,485
UTTARAKHAND,PAURI GARHWAL,2021-01-20,1,536,6,543
UTTARAKHAND,PITHORAGARH,2021-01-16,3,253,0,256
UTTARAKHAND,PITHORAGARH,2021-01-17,0,36,2,38
UTTARAKHAND,PITHORAGARH,2021-01-18,2,188,2,192
UTTARAKHAND,PITHORAGARH,2021-01-19,2,365,0,367
UTTARAKHAND,PITHORAGARH,2021-01-20,1,54,0,55
UTTARAKHAND,RUDRA PRAYAG,2021-01-16,1,90,0,91
UTTARAKHAND,RUDRA PRAYAG,2021-01-17,3,60,0,63
UTTARAKHAND,RUDRA PRAYAG,2021-01-18,2,42,0,44
UTTARAKHAND,RUDRA PRAYAG,2021-01-19,0,39,0,39
UTTARAKHAND,RUDRA PRAYAG,2021-01-20,0,160,1,161
UTTARAKHAND,TEHRI GARHWAL,2021-01-16,4,376,11,391
UTTARAKHAND,TEHRI GARHWAL,2021-01-17,0,261,0,261
UTTARAKHAND,TEHRI GARHWAL,2021-01-18,1,225,0,226
UTTARAKHAND,TEHRI GARHWAL,2021-01-19,2,413,0,415
UTTARAKHAND,TEHRI GARHWAL,2021-01-20,3,255,2,260
UTTARAKHAND,UDAM SINGH NAGAR,2021-01-16,18,3055,30,3103
UTTARAKHAND,UDAM SINGH NAGAR,2021-01-17,16,1432,3,1451
UTTARAKHAND,UDAM SINGH NAGAR,2021-01-18,5,3264,33,3302
UTTARAKHAND,UDAM SINGH NAGAR,2021-01-19,8,2327,49,2384
UTTARAKHAND,UDAM SINGH NAGAR,2021-01-20,12,2047,59,2118
UTTARAKHAND,UTTAR KASHI,2021-01-16,0,821,1,822
UTTARAKHAND,UTTAR KASHI,2021-01-17,2,181,5,188
UTTARAKHAND,UTTAR KASHI,2021-01-18,3,339,0,342
UTTARAKHAND,UTTAR KASHI,2021-01-19,11,646,4,661
UTTARAKHAND,UTTAR KASHI,2021-01-20,0,243,4,247
WEST BENGAL,24 PARAGANAS NORTH,2021-01-16,140,4552,46,4738
WEST BENGAL,24 PARAGANAS NORTH,2021-01-17,103,2958,24,3085
WEST BENGAL,24 PARAGANAS NORTH,2021-01-18,85,3941,37,4063
WEST BENGAL,24 PARAGANAS NORTH,2021-01-19,138,4072,47,4257
WEST BENGAL,24 PARAGANAS NORTH,2021-01-20,88,4316,31,4435
WEST BENGAL,24 PARAGANAS SOUTH,2021-01-16,19,2881,5,2905
WEST BENGAL,24 PARAGANAS SOUTH,2021-01-17,15,2648,9,2672
WEST BENGAL,24 PARAGANAS SOUTH,2021-01-18,17,3051,4,3072
WEST BENGAL,24 PARAGANAS SOUTH,2021-01-19,21,2710,2,2733
WEST BENGAL,24 PARAGANAS SOUTH,2021-01-20,19,4019,9,4047
WEST BENGAL,ALIPURDUAR,2021-01-16,0,504,0,504
WEST BENGAL,ALIPURDUAR,2021-01-17,1,546,0,547
WEST BENGAL,ALIPURDUAR,2021-01-18,1,691,0,692
WEST BENGAL,ALIPURDUAR,2021-01-19,1,737,0,738
WEST BENGAL,ALIPURDUAR,2021-01-20,2,177,0,179
WEST BENGAL,BANKURA,2021-01-16,25,575,8,608
WEST BENGAL,BANKURA,2021-01-17,20,438,4,462
WEST BENGAL,BANKURA,2021-01-18,11,738,1,750
WEST BENGAL,BANKURA,2021-01-19,7,578,4,589
WEST BENGAL,BANKURA,2021-01-20,26,863,1,890
WEST BENGAL,BIRBHUM,2021-01-16,10,1133,5,1148
WEST BENGAL,BIRBHUM,2021-01-17,2,643,2,647
WEST BENGAL,BIRBHUM,2021-01-18,12,864,3,879
WEST BENGAL,BIRBHUM,2021-01-19,17,1144,10,1171
WEST BENGAL,BIRBHUM,2021-01-20,5,887,13,905
WEST BENGAL,COOCHBEHAR,2021-01-16,7,2172,0,2179
WEST BENGAL,COOCHBEHAR,2021-01-17,1,707,0,708
WEST BENGAL,COOCHBEHAR,2021-01-18,3,1991,0,1994
WEST BENGAL,COOCHBEHAR,2021-01-19,1,2066,0,2067
WEST BENGAL,COOCHBEHAR,2021-01-20,0,2036,0,2036
WEST BENGAL,DARJEELING,2021-01-16,18,634,2,654
WEST BENGAL,DARJEELING,2021-01-17,10,288,1,299
WEST BENGAL,DARJEELING,2021-01-18,9,427,0,436
WEST BENGAL,DARJEELING,2021-01-19,20,953,1,974
WEST BENGAL,DARJEELING,2021-01-20,15,569,0,584
WEST BENGAL,DINAJPUR DAKSHIN,2021-01-16,0,579,1,580
WEST BENGAL,DINAJPUR DAKSHIN,2021-01-17,0,683,0,683
WEST BENGAL,DINAJPUR DAKSHIN,2021-01-18,2,727,0,729
WEST BENGAL,DINAJPUR DAKSHIN,2021-01-19,2,839,0,841
WEST BENGAL,DINAJPUR DAKSHIN,2021-01-20,3,777,0,780
WEST BENGAL,DINAJPUR UTTAR,2021-01-16,3,369,0,372
WEST BENGAL,DINAJPUR UTTAR,2021-01-17,5,293,0,298
WEST BENGAL,DINAJPUR UTTAR,2021-01-18,6,265,0,271
WEST BENGAL,DINAJPUR UTTAR,2021-01-19,9,214,0,223
WEST BENGAL,DINAJPUR UTTAR,2021-01-20,3,297,0,300
WEST BENGAL,HOOGHLY,2021-01-16,22,1140,0,1162
WEST BENGAL,HOOGHLY,2021-01-17,15,556,107,678
WEST BENGAL,HOOGHLY,2021-01-18,16,1142,3,1161
WEST BENGAL,HOOGHLY,2021-01-19,20,1088,0,1108
WEST BENGAL,HOOGHLY,2021-01-20,20,1254,82,1356
WEST BENGAL,HOWRAH,2021-01-16,16,1598,2,1616
WEST BENGAL,HOWRAH,2021-01-17,12,709,80,801
WEST BENGAL,HOWRAH,2021-01-18,13,1590,65,1668
WEST BENGAL,HOWRAH,2021-01-19,26,1280,122,1428
WEST BENGAL,HOWRAH,2021-01-20,30,1411,199,1640
WEST BENGAL,JALPAIGURI,2021-01-16,9,399,0,408
WEST BENGAL,JALPAIGURI,2021-01-17,13,223,0,236
WEST BENGAL,JALPAIGURI,2021-01-18,2,548,0,550
WEST BENGAL,JALPAIGURI,2021-01-19,9,517,0,526
WEST BENGAL,JALPAIGURI,2021-01-20,6,626,0,632
WEST BENGAL,JHARGRAM,2021-01-16,1,18,0,19
WEST BENGAL,JHARGRAM,2021-01-17,5,59,0,64
WEST BENGAL,JHARGRAM,2021-01-18,1,40,0,41
WEST BENGAL,JHARGRAM,2021-01-19,2,72,0,74
WEST BENGAL,JHARGRAM,2021-01-20,3,55,0,58
WEST BENGAL,KALIMPONG,2021-01-16,1,97,0,98
WEST BENGAL,KALIMPONG,2021-01-17,1,181,0,182
WEST BENGAL,KALIMPONG,2021-01-18,0,301,0,301
WEST BENGAL,KALIMPONG,2021-01-19,0,169,0,169
WEST BENGAL,KALIMPONG,2021-01-20,1,268,0,269
WEST BENGAL,KOLKATA,2021-01-16,173,2894,11,3078
WEST BENGAL,KOLKATA,2021-01-17,132,1650,9,1791
WEST BENGAL,KOLKATA,2021-01-18,139,3257,15,3411
WEST BENGAL,KOLKATA,2021-01-19,146,3326,21,3493
WEST BENGAL,KOLKATA,2021-01-20,141,3254,10,3405
WEST BENGAL,MALDAH,2021-01-16,2,778,7,787
WEST BENGAL,MALDAH,2021-01-17,1,256,9,266
WEST BENGAL,MALDAH,2021-01-18,1,1229,4,1234
WEST BENGAL,MALDAH,2021-01-19,2,1033,26,1061
WEST BENGAL,MALDAH,2021-01-20,4,704,3,711
WEST BENGAL,MEDINIPUR EAST,2021-01-16,18,1040,3,1061
WEST BENGAL,MEDINIPUR EAST,2021-01-17,11,991,0,1002
WEST BENGAL,MEDINIPUR EAST,2021-01-18,7,788,3,798
WEST BENGAL,MEDINIPUR EAST,2021-01-19,4,901,3,908
WEST BENGAL,MEDINIPUR EAST,2021-01-20,12,1189,4,1205
WEST BENGAL,MEDINIPUR WEST,2021-01-16,1,450,3,454
WEST BENGAL,MEDINIPUR WEST,2021-01-17,6,340,7,353
WEST BENGAL,MEDINIPUR WEST,2021-01-18,4,571,4,579
WEST BENGAL,MEDINIPUR WEST,2021-01-19,4,425,1,430
WEST BENGAL,MEDINIPUR WEST,2021-01-20,6,588,11,605
WEST BENGAL,MURSHIDABAD,2021-01-16,15,1389,17,1421
WEST BENGAL,MURSHIDABAD,2021-01-17,8,987,5,1000
WEST BENGAL,MURSHIDABAD,2021-01-18,10,962,10,982
WEST BENGAL,MURSHIDABAD,2021-01-19,4,1122,5,1131
WEST BENGAL,MURSHIDABAD,2021-01-20,10,1013,8,1031
WEST BENGAL,NADIA,2021-01-16,15,904,21,940
WEST BENGAL,NADIA,2021-01-17,16,756,5,777
WEST BENGAL,NADIA,2021-01-18,13,875,24,912
WEST BENGAL,NADIA,2021-01-19,21,810,10,841
WEST BENGAL,NADIA,2021-01-20,18,885,15,918
WEST BENGAL,PASCHIM BARDHAMAN,2021-01-16,19,745,5,769
WEST BENGAL,PASCHIM BARDHAMAN,2021-01-17,19,736,1,756
WEST BENGAL,PASCHIM BARDHAMAN,2021-01-18,28,712,2,742
WEST BENGAL,PASCHIM BARDHAMAN,2021-01-19,25,750,7,782
WEST BENGAL,PASCHIM BARDHAMAN,2021-01-20,26,880,7,913
WEST BENGAL,PURBA BARDHAMAN,2021-01-16,12,731,1,744
WEST BENGAL,PURBA BARDHAMAN,2021-01-17,13,821,0,834
WEST BENGAL,PURBA BARDHAMAN,2021-01-18,2,741,0,743
WEST BENGAL,PURBA BARDHAMAN,2021-01-19,6,802,0,808
WEST BENGAL,PURBA BARDHAMAN,2021-01-20,5,921,2,928
WEST BENGAL,PURULIA,2021-01-16,4,551,0,555
WEST BENGAL,PURULIA,2021-01-17,2,735,0,737
WEST BENGAL,PURULIA,2021-01-18,2,419,0,421
WEST BENGAL,PURULIA,2021-01-19,6,540,1,547
WEST BENGAL,PURULIA,2021-01-20,6,692,0,698
ANDAMAN AND NICOBAR ISLANDS,NICOBARS,2021-01-21,0,27,0,27
ANDAMAN AND NICOBAR ISLANDS,NICOBARS,2021-01-22,0,23,0,23
ANDAMAN AND NICOBAR ISLANDS,NICOBARS,2021-01-23,0,17,0,17
ANDAMAN AND NICOBAR ISLANDS,NICOBARS,2021-01-24,0,16,0,16
ANDAMAN AND NICOBAR ISLANDS,NICOBARS,2021-01-25,0,37,0,37
ANDAMAN AND NICOBAR ISLANDS,NORTH AND MIDDLE ANDAMAN,2021-01-21,0,5,0,5
ANDAMAN AND NICOBAR ISLANDS,NORTH AND MIDDLE ANDAMAN,2021-01-22,0,21,0,21
ANDAMAN AND NICOBAR ISLANDS,NORTH AND MIDDLE ANDAMAN,2021-01-23,0,8,0,8
ANDAMAN AND NICOBAR ISLANDS,NORTH AND MIDDLE ANDAMAN,2021-01-24,0,32,0,32
ANDAMAN AND NICOBAR ISLANDS,NORTH AND MIDDLE ANDAMAN,2021-01-25,0,12,0,12
ANDAMAN AND NICOBAR ISLANDS,SOUTH ANDAMANS,2021-01-21,0,630,0,630
ANDAMAN AND NICOBAR ISLANDS,SOUTH ANDAMANS,2021-01-22,1,700,0,701
ANDAMAN AND NICOBAR ISLANDS,SOUTH ANDAMANS,2021-01-23,0,434,0,434
ANDAMAN AND NICOBAR ISLANDS,SOUTH ANDAMANS,2021-01-24,2,244,0,246
ANDAMAN AND NICOBAR ISLANDS,SOUTH ANDAMANS,2021-01-25,0,714,0,714
ANDHRA PRADESH,ANANTAPUR,2021-01-21,1,60,0,61
ANDHRA PRADESH,ANANTAPUR,2021-01-22,21,6920,0,6941
ANDHRA PRADESH,ANANTAPUR,2021-01-23,9,4701,0,4710
ANDHRA PRADESH,ANANTAPUR,2021-01-24,5,3743,0,3748
ANDHRA PRADESH,ANANTAPUR,2021-01-25,7,2291,0,2298
ANDHRA PRADESH,CHITTOOR,2021-01-21,1,88,0,89
ANDHRA PRADESH,CHITTOOR,2021-01-22,52,6007,1,6060
ANDHRA PRADESH,CHITTOOR,2021-01-23,31,3470,1,3502
ANDHRA PRADESH,CHITTOOR,2021-01-24,25,2586,0,2611
ANDHRA PRADESH,CHITTOOR,2021-01-25,26,3503,0,3529
ANDHRA PRADESH,EAST GODAVARI,2021-01-21,0,22,1,23
ANDHRA PRADESH,EAST GODAVARI,2021-01-22,43,3756,1,3800
ANDHRA PRADESH,EAST GODAVARI,2021-01-23,15,806,0,821
ANDHRA PRADESH,EAST GODAVARI,2021-01-24,14,2548,0,2562
ANDHRA PRADESH,EAST GODAVARI,2021-01-25,19,2717,0,2736
ANDHRA PRADESH,GUNTUR,2021-01-21,0,23,0,23
ANDHRA PRADESH,GUNTUR,2021-01-22,37,4966,0,5003
ANDHRA PRADESH,GUNTUR,2021-01-23,16,3061,0,3077
ANDHRA PRADESH,GUNTUR,2021-01-24,8,1591,0,1599
ANDHRA PRADESH,GUNTUR,2021-01-25,22,899,0,921
ANDHRA PRADESH,KRISHNA,2021-01-21,0,18,0,18
ANDHRA PRADESH,KRISHNA,2021-01-22,48,8014,0,8062
ANDHRA PRADESH,KRISHNA,2021-01-23,25,1743,0,1768
ANDHRA PRADESH,KRISHNA,2021-01-24,12,2381,0,2393
ANDHRA PRADESH,KRISHNA,2021-01-25,42,2075,0,2117
ANDHRA PRADESH,KURNOOL,2021-01-21,0,21,0,21
ANDHRA PRADESH,KURNOOL,2021-01-22,20,7514,0,7534
ANDHRA PRADESH,KURNOOL,2021-01-23,9,3249,0,3258
ANDHRA PRADESH,KURNOOL,2021-01-24,4,2433,0,2437
ANDHRA PRADESH,KURNOOL,2021-01-25,4,1902,0,1906
ANDHRA PRADESH,PRAKASAM,2021-01-21,0,11,0,11
ANDHRA PRADESH,PRAKASAM,2021-01-22,28,5882,1,5911
ANDHRA PRADESH,PRAKASAM,2021-01-23,7,3853,3,3863
ANDHRA PRADESH,PRAKASAM,2021-01-24,17,2591,0,2608
ANDHRA PRADESH,PRAKASAM,2021-01-25,6,2113,0,2119
ANDHRA PRADESH,SPSR NELLORE,2021-01-21,0,21,0,21
ANDHRA PRADESH,SPSR NELLORE,2021-01-22,13,8836,1,8850
ANDHRA PRADESH,SPSR NELLORE,2021-01-23,9,3155,0,3164
ANDHRA PRADESH,SPSR NELLORE,2021-01-24,5,3708,0,3713
ANDHRA PRADESH,SPSR NELLORE,2021-01-25,10,1943,0,1953
ANDHRA PRADESH,SRIKAKULAM,2021-01-21,0,29,5,34
ANDHRA PRADESH,SRIKAKULAM,2021-01-22,13,4712,0,4725
ANDHRA PRADESH,SRIKAKULAM,2021-01-23,7,2814,0,2821
ANDHRA PRADESH,SRIKAKULAM,2021-01-24,5,2314,0,2319
ANDHRA PRADESH,SRIKAKULAM,2021-01-25,8,1320,0,1328
ANDHRA PRADESH,VISAKHAPATANAM,2021-01-21,3,128,1,132
ANDHRA PRADESH,VISAKHAPATANAM,2021-01-22,52,5755,0,5807
ANDHRA PRADESH,VISAKHAPATANAM,2021-01-23,51,2795,0,2846
ANDHRA PRADESH,VISAKHAPATANAM,2021-01-24,11,1269,0,1280
ANDHRA PRADESH,VISAKHAPATANAM,2021-01-25,35,4002,0,4037
ANDHRA PRADESH,VIZIANAGARAM,2021-01-21,0,13,0,13
ANDHRA PRADESH,VIZIANAGARAM,2021-01-22,5,3546,0,3551
ANDHRA PRADESH,VIZIANAGARAM,2021-01-23,2,2010,0,2012
ANDHRA PRADESH,VIZIANAGARAM,2021-01-24,1,278,1,280
ANDHRA PRADESH,VIZIANAGARAM,2021-01-25,0,1885,0,1885
ANDHRA PRADESH,WEST GODAVARI,2021-01-21,3,11,0,14
ANDHRA PRADESH,WEST GODAVARI,2021-01-22,30,5446,0,5476
ANDHRA PRADESH,WEST GODAVARI,2021-01-23,30,3893,0,3923
ANDHRA PRADESH,WEST GODAVARI,2021-01-24,3,1021,0,1024
ANDHRA PRADESH,WEST GODAVARI,2021-01-25,17,1781,0,1798
ANDHRA PRADESH,Y.S.R.,2021-01-21,3,21,0,24
ANDHRA PRADESH,Y.S.R.,2021-01-22,28,10622,0,10650
ANDHRA PRADESH,Y.S.R.,2021-01-23,9,3355,1,3365
ANDHRA PRADESH,Y.S.R.,2021-01-24,1,5115,0,5116
ANDHRA PRADESH,Y.S.R.,2021-01-25,11,327,0,338
ARUNACHAL PRADESH,ANJAW,2021-01-21,0,2,0,2
ARUNACHAL PRADESH,ANJAW,2021-01-22,0,1,0,1
ARUNACHAL PRADESH,ANJAW,2021-01-23,0,2,0,2
ARUNACHAL PRADESH,ANJAW,2021-01-24,0,2,0,2
ARUNACHAL PRADESH,CHANGLANG,2021-01-22,0,1,0,1
ARUNACHAL PRADESH,CHANGLANG,2021-01-24,0,4,0,4
ARUNACHAL PRADESH,CHANGLANG,2021-01-25,0,1,0,1
ARUNACHAL PRADESH,DIBANG VALLEY,2021-01-22,0,2,0,2
ARUNACHAL PRADESH,DIBANG VALLEY,2021-01-25,0,1,0,1
ARUNACHAL PRADESH,EAST KAMENG,2021-01-21,0,2,0,2
ARUNACHAL PRADESH,EAST KAMENG,2021-01-22,0,3,0,3
ARUNACHAL PRADESH,EAST SIANG,2021-01-21,1,19,0,20
ARUNACHAL PRADESH,EAST SIANG,2021-01-22,0,27,0,27
ARUNACHAL PRADESH,EAST SIANG,2021-01-23,0,24,0,24
ARUNACHAL PRADESH,EAST SIANG,2021-01-24,0,1,0,1
ARUNACHAL PRADESH,EAST SIANG,2021-01-25,0,17,0,17
ARUNACHAL PRADESH,KRA  DAADI,2021-01-23,0,1,0,1
ARUNACHAL PRADESH,LEPARADA,2021-01-21,0,2,0,2
ARUNACHAL PRADESH,LOHIT,2021-01-21,0,6,0,6
ARUNACHAL PRADESH,LOHIT,2021-01-22,0,1,0,1
ARUNACHAL PRADESH,LOHIT,2021-01-23,0,3,0,3
ARUNACHAL PRADESH,LOWER DIBANG VALLEY,2021-01-22,0,25,0,25
ARUNACHAL PRADESH,LOWER SIANG,2021-01-21,0,7,0,7
ARUNACHAL PRADESH,LOWER SIANG,2021-01-23,0,27,0,27
ARUNACHAL PRADESH,LOWER SIANG,2021-01-24,1,22,0,23
ARUNACHAL PRADESH,LOWER SIANG,2021-01-25,0,5,0,5
ARUNACHAL PRADESH,LOWER SUBANSIRI,2021-01-21,0,20,0,20
ARUNACHAL PRADESH,LOWER SUBANSIRI,2021-01-22,0,1,0,1
ARUNACHAL PRADESH,LOWER SUBANSIRI,2021-01-23,0,13,0,13
ARUNACHAL PRADESH,LOWER SUBANSIRI,2021-01-25,0,1,0,1
ARUNACHAL PRADESH,NAMSAI,2021-01-21,0,1,0,1
ARUNACHAL PRADESH,NAMSAI,2021-01-22,0,1,0,1
ARUNACHAL PRADESH,NAMSAI,2021-01-23,0,1,0,1
ARUNACHAL PRADESH,NAMSAI,2021-01-25,0,3,0,3
ARUNACHAL PRADESH,PAPUM PARE,2021-01-21,0,12,0,12
ARUNACHAL PRADESH,PAPUM PARE,2021-01-22,0,13,0,13
ARUNACHAL PRADESH,PAPUM PARE,2021-01-23,1,10,0,11
ARUNACHAL PRADESH,PAPUM PARE,2021-01-24,0,3,0,3
ARUNACHAL PRADESH,PAPUM PARE,2021-01-25,1,31,0,32
ARUNACHAL PRADESH,SHI YOMI,2021-01-24,0,1,0,1
ARUNACHAL PRADESH,SIANG,2021-01-22,0,1,0,1
ARUNACHAL PRADESH,SIANG,2021-01-23,0,1,0,1
ARUNACHAL PRADESH,SIANG,2021-01-25,0,1,0,1
ARUNACHAL PRADESH,TAWANG,2021-01-21,0,32,0,32
ARUNACHAL PRADESH,TAWANG,2021-01-22,0,33,0,33
ARUNACHAL PRADESH,TAWANG,2021-01-24,0,30,0,30
ARUNACHAL PRADESH,TAWANG,2021-01-25,0,3,0,3
ARUNACHAL PRADESH,UPPER SUBANSIRI,2021-01-22,0,3,0,3
ARUNACHAL PRADESH,UPPER SUBANSIRI,2021-01-24,0,2,0,2
ARUNACHAL PRADESH,WEST KAMENG,2021-01-21,0,77,0,77
ARUNACHAL PRADESH,WEST KAMENG,2021-01-22,0,38,0,38
ARUNACHAL PRADESH,WEST KAMENG,2021-01-23,0,97,0,97
ARUNACHAL PRADESH,WEST KAMENG,2021-01-24,2,51,0,53
ARUNACHAL PRADESH,WEST KAMENG,2021-01-25,0,11,0,11
ARUNACHAL PRADESH,WEST SIANG,2021-01-23,0,2,0,2
ASSAM,BAKSA,2021-01-21,0,67,0,67
ASSAM,BAKSA,2021-01-22,1,69,0,70
ASSAM,BAKSA,2021-01-23,0,40,0,40
ASSAM,BAKSA,2021-01-24,0,8,0,8
ASSAM,BAKSA,2021-01-25,0,111,0,111
ASSAM,BARPETA,2021-01-21,0,189,1,190
ASSAM,BARPETA,2021-01-22,0,167,0,167
ASSAM,BARPETA,2021-01-23,0,119,0,119
ASSAM,BARPETA,2021-01-24,0,57,0,57
ASSAM,BARPETA,2021-01-25,0,140,0,140
ASSAM,BISWANATH,2021-01-21,0,35,0,35
ASSAM,BISWANATH,2021-01-22,0,49,0,49
ASSAM,BISWANATH,2021-01-23,0,24,0,24
ASSAM,BISWANATH,2021-01-24,0,4,0,4
ASSAM,BISWANATH,2021-01-25,0,68,0,68
ASSAM,BONGAIGAON,2021-01-21,0,356,0,356
ASSAM,BONGAIGAON,2021-01-22,0,392,0,392
ASSAM,BONGAIGAON,2021-01-23,0,222,0,222
ASSAM,BONGAIGAON,2021-01-24,0,81,0,81
ASSAM,BONGAIGAON,2021-01-25,0,332,0,332
ASSAM,CACHAR,2021-01-21,1,2526,14,2541
ASSAM,CACHAR,2021-01-22,1,184,15,200
ASSAM,CACHAR,2021-01-23,2,243,1,246
ASSAM,CACHAR,2021-01-24,3,78,0,81
ASSAM,CACHAR,2021-01-25,4,224,7,235
ASSAM,CHARAIDEO,2021-01-21,0,110,0,110
ASSAM,CHARAIDEO,2021-01-22,0,168,0,168
ASSAM,CHARAIDEO,2021-01-23,0,152,0,152
ASSAM,CHARAIDEO,2021-01-24,0,50,0,50
ASSAM,CHARAIDEO,2021-01-25,0,261,0,261
ASSAM,CHIRANG,2021-01-21,2,177,0,179
ASSAM,CHIRANG,2021-01-22,0,90,0,90
ASSAM,CHIRANG,2021-01-23,0,64,0,64
ASSAM,CHIRANG,2021-01-24,0,7,0,7
ASSAM,CHIRANG,2021-01-25,0,99,0,99
ASSAM,DARRANG,2021-01-21,1,548,0,549
ASSAM,DARRANG,2021-01-22,2,462,0,464
ASSAM,DARRANG,2021-01-23,0,335,0,335
ASSAM,DARRANG,2021-01-24,0,99,0,99
ASSAM,DARRANG,2021-01-25,0,514,0,514
ASSAM,DHEMAJI,2021-01-21,0,77,0,77
ASSAM,DHEMAJI,2021-01-22,0,81,0,81
ASSAM,DHEMAJI,2021-01-23,0,80,0,80
ASSAM,DHEMAJI,2021-01-24,0,33,0,33
ASSAM,DHEMAJI,2021-01-25,0,41,0,41
ASSAM,DHUBRI,2021-01-21,0,219,0,219
ASSAM,DHUBRI,2021-01-22,0,234,0,234
ASSAM,DHUBRI,2021-01-23,0,293,0,293
ASSAM,DHUBRI,2021-01-24,0,16,0,16
ASSAM,DHUBRI,2021-01-25,0,283,0,283
ASSAM,DIBRUGARH,2021-01-21,0,511,1,512
ASSAM,DIBRUGARH,2021-01-22,9,270,2,281
ASSAM,DIBRUGARH,2021-01-23,6,421,4,431
ASSAM,DIBRUGARH,2021-01-24,1,111,0,112
ASSAM,DIBRUGARH,2021-01-25,12,486,0,498
ASSAM,DIMA HASAO,2021-01-21,1,68,0,69
ASSAM,DIMA HASAO,2021-01-22,0,35,0,35
ASSAM,DIMA HASAO,2021-01-23,9,73,0,82
ASSAM,DIMA HASAO,2021-01-24,0,24,0,24
ASSAM,DIMA HASAO,2021-01-25,0,20,0,20
ASSAM,GOALPARA,2021-01-21,1,315,0,316
ASSAM,GOALPARA,2021-01-22,0,506,0,506
ASSAM,GOALPARA,2021-01-23,0,526,0,526
ASSAM,GOALPARA,2021-01-24,0,258,0,258
ASSAM,GOALPARA,2021-01-25,0,765,0,765
ASSAM,GOLAGHAT,2021-01-21,41,282,0,323
ASSAM,GOLAGHAT,2021-01-22,31,327,0,358
ASSAM,GOLAGHAT,2021-01-23,0,153,0,153
ASSAM,GOLAGHAT,2021-01-24,0,92,0,92
ASSAM,GOLAGHAT,2021-01-25,46,596,0,642
ASSAM,HAILAKANDI,2021-01-21,0,395,0,395
ASSAM,HAILAKANDI,2021-01-22,1,276,1,278
ASSAM,HAILAKANDI,2021-01-23,1,379,3,383
ASSAM,HAILAKANDI,2021-01-24,0,103,0,103
ASSAM,HAILAKANDI,2021-01-25,0,294,0,294
ASSAM,HOJAI,2021-01-21,0,77,0,77
ASSAM,HOJAI,2021-01-22,1,119,0,120
ASSAM,HOJAI,2021-01-23,0,66,0,66
ASSAM,HOJAI,2021-01-24,0,19,0,19
ASSAM,HOJAI,2021-01-25,0,169,0,169
ASSAM,JORHAT,2021-01-21,1,884,3,888
ASSAM,JORHAT,2021-01-22,4,675,0,679
ASSAM,JORHAT,2021-01-23,2,442,0,444
ASSAM,JORHAT,2021-01-24,1,151,0,152
ASSAM,JORHAT,2021-01-25,2,758,2,762
ASSAM,KAMRUP,2021-01-21,4,549,0,553
ASSAM,KAMRUP,2021-01-22,4,668,0,672
ASSAM,KAMRUP,2021-01-23,2,550,0,552
ASSAM,KAMRUP,2021-01-24,2,193,0,195
ASSAM,KAMRUP,2021-01-25,0,841,0,841
ASSAM,KAMRUP METRO,2021-01-21,7,3512,0,3519
ASSAM,KAMRUP METRO,2021-01-22,12,3451,3,3466
ASSAM,KAMRUP METRO,2021-01-23,3,2923,2,2928
ASSAM,KAMRUP METRO,2021-01-24,5,2371,0,2376
ASSAM,KAMRUP METRO,2021-01-25,11,2964,1,2976
ASSAM,KARBI ANGLONG,2021-01-21,0,65,0,65
ASSAM,KARBI ANGLONG,2021-01-22,0,42,0,42
ASSAM,KARBI ANGLONG,2021-01-23,0,42,0,42
ASSAM,KARBI ANGLONG,2021-01-24,0,5,0,5
ASSAM,KARBI ANGLONG,2021-01-25,0,42,0,42
ASSAM,KARIMGANJ,2021-01-21,1,380,1,382
ASSAM,KARIMGANJ,2021-01-22,2,357,12,371
ASSAM,KARIMGANJ,2021-01-23,0,158,0,158
ASSAM,KARIMGANJ,2021-01-24,0,179,0,179
ASSAM,KARIMGANJ,2021-01-25,2,499,2,503
ASSAM,KOKRAJHAR,2021-01-21,0,33,0,33
ASSAM,KOKRAJHAR,2021-01-22,1,48,0,49
ASSAM,KOKRAJHAR,2021-01-23,0,19,0,19
ASSAM,KOKRAJHAR,2021-01-24,2,12,0,14
ASSAM,KOKRAJHAR,2021-01-25,0,37,0,37
ASSAM,LAKHIMPUR,2021-01-21,0,201,0,201
ASSAM,LAKHIMPUR,2021-01-22,0,228,0,228
ASSAM,LAKHIMPUR,2021-01-23,0,181,0,181
ASSAM,LAKHIMPUR,2021-01-24,0,88,0,88
ASSAM,LAKHIMPUR,2021-01-25,0,311,0,311
ASSAM,MAJULI,2021-01-21,0,7,0,7
ASSAM,MAJULI,2021-01-22,0,10,1,11
ASSAM,MAJULI,2021-01-23,0,6,0,6
ASSAM,MAJULI,2021-01-24,0,7,0,7
ASSAM,MAJULI,2021-01-25,0,4,0,4
ASSAM,MARIGAON,2021-01-21,1,76,0,77
ASSAM,MARIGAON,2021-01-22,0,57,0,57
ASSAM,MARIGAON,2021-01-23,1,45,0,46
ASSAM,MARIGAON,2021-01-24,0,35,0,35
ASSAM,MARIGAON,2021-01-25,1,71,0,72
ASSAM,NAGAON,2021-01-21,0,400,1,401
ASSAM,NAGAON,2021-01-22,1,508,1,510
ASSAM,NAGAON,2021-01-23,3,363,0,366
ASSAM,NAGAON,2021-01-24,0,70,0,70
ASSAM,NAGAON,2021-01-25,3,740,1,744
ASSAM,NALBARI,2021-01-21,0,99,0,99
ASSAM,NALBARI,2021-01-22,0,110,0,110
ASSAM,NALBARI,2021-01-23,0,101,0,101
ASSAM,NALBARI,2021-01-24,0,15,0,15
ASSAM,NALBARI,2021-01-25,0,72,0,72
ASSAM,SIVASAGAR,2021-01-21,0,391,0,391
ASSAM,SIVASAGAR,2021-01-22,1,491,1,493
ASSAM,SIVASAGAR,2021-01-23,0,262,0,262
ASSAM,SIVASAGAR,2021-01-24,0,59,0,59
ASSAM,SIVASAGAR,2021-01-25,0,147,0,147
ASSAM,SONITPUR,2021-01-21,2,266,0,268
ASSAM,SONITPUR,2021-01-22,0,322,0,322
ASSAM,SONITPUR,2021-01-23,1,178,0,179
ASSAM,SONITPUR,2021-01-24,3,135,0,138
ASSAM,SONITPUR,2021-01-25,0,293,0,293
ASSAM,SOUTH SALMARA MANCACHAR,2021-01-21,2,58,0,60
ASSAM,SOUTH SALMARA MANCACHAR,2021-01-22,0,20,0,20
ASSAM,SOUTH SALMARA MANCACHAR,2021-01-23,0,28,0,28
ASSAM,SOUTH SALMARA MANCACHAR,2021-01-24,0,2,0,2
ASSAM,SOUTH SALMARA MANCACHAR,2021-01-25,0,30,0,30
ASSAM,TINSUKIA,2021-01-21,5,161,0,166
ASSAM,TINSUKIA,2021-01-22,1,521,0,522
ASSAM,TINSUKIA,2021-01-23,2,330,4,336
ASSAM,TINSUKIA,2021-01-24,4,197,0,201
ASSAM,TINSUKIA,2021-01-25,0,245,0,245
ASSAM,UDALGURI,2021-01-21,0,55,0,55
ASSAM,UDALGURI,2021-01-22,0,65,0,65
ASSAM,UDALGURI,2021-01-23,0,50,0,50
ASSAM,UDALGURI,2021-01-24,0,4,0,4
ASSAM,UDALGURI,2021-01-25,0,23,0,23
ASSAM,WEST KARBI ANGLONG,2021-01-22,0,26,0,26
ASSAM,WEST KARBI ANGLONG,2021-01-23,0,1,0,1
ASSAM,WEST KARBI ANGLONG,2021-01-25,0,7,0,7
BIHAR,ARARIA,2021-01-21,12,678,0,690
BIHAR,ARARIA,2021-01-22,1,1072,0,1073
BIHAR,ARARIA,2021-01-23,0,820,2,822
BIHAR,ARARIA,2021-01-24,0,76,0,76
BIHAR,ARARIA,2021-01-25,7,961,0,968
BIHAR,ARWAL,2021-01-21,11,1952,7,1970
BIHAR,ARWAL,2021-01-22,0,1365,4,1369
BIHAR,ARWAL,2021-01-23,0,600,3,603
BIHAR,ARWAL,2021-01-24,0,339,0,339
BIHAR,ARWAL,2021-01-25,0,942,12,954
BIHAR,AURANGABAD,2021-01-21,1,1162,0,1163
BIHAR,AURANGABAD,2021-01-22,4,1015,0,1019
BIHAR,AURANGABAD,2021-01-23,1,642,0,643
BIHAR,AURANGABAD,2021-01-24,0,769,0,769
BIHAR,AURANGABAD,2021-01-25,2,2044,0,2046
BIHAR,BANKA,2021-01-21,5,1691,1,1697
BIHAR,BANKA,2021-01-22,7,1808,0,1815
BIHAR,BANKA,2021-01-23,1,2287,134,2422
BIHAR,BANKA,2021-01-24,0,1257,194,1451
BIHAR,BANKA,2021-01-25,2,1866,0,1868
BIHAR,BEGUSARAI,2021-01-21,7,4837,1,4845
BIHAR,BEGUSARAI,2021-01-22,7,5413,1,5421
BIHAR,BEGUSARAI,2021-01-23,3,3272,0,3275
BIHAR,BEGUSARAI,2021-01-24,4,1261,0,1265
BIHAR,BEGUSARAI,2021-01-25,8,2570,0,2578
BIHAR,BHAGALPUR,2021-01-21,4,3326,177,3507
BIHAR,BHAGALPUR,2021-01-22,10,3433,156,3599
BIHAR,BHAGALPUR,2021-01-23,1,3289,264,3554
BIHAR,BHAGALPUR,2021-01-24,3,1795,178,1976
BIHAR,BHAGALPUR,2021-01-25,4,2385,126,2515
BIHAR,BHOJPUR,2021-01-21,0,1245,190,1435
BIHAR,BHOJPUR,2021-01-22,1,1385,46,1432
BIHAR,BHOJPUR,2021-01-23,3,1359,71,1433
BIHAR,BHOJPUR,2021-01-24,0,658,64,722
BIHAR,BHOJPUR,2021-01-25,1,1676,34,1711
BIHAR,BUXAR,2021-01-21,0,1748,69,1817
BIHAR,BUXAR,2021-01-22,0,1078,38,1116
BIHAR,BUXAR,2021-01-23,1,2105,18,2124
BIHAR,BUXAR,2021-01-24,1,702,0,703
BIHAR,BUXAR,2021-01-25,0,1426,72,1498
BIHAR,DARBHANGA,2021-01-21,8,2221,0,2229
BIHAR,DARBHANGA,2021-01-22,6,2323,10,2339
BIHAR,DARBHANGA,2021-01-23,1,1930,0,1931
BIHAR,DARBHANGA,2021-01-24,10,2063,8,2081
BIHAR,DARBHANGA,2021-01-25,2,1725,0,1727
BIHAR,GAYA,2021-01-21,8,2914,20,2942
BIHAR,GAYA,2021-01-22,1,2950,0,2951
BIHAR,GAYA,2021-01-23,1,1518,57,1576
BIHAR,GAYA,2021-01-24,9,1770,74,1853
BIHAR,GAYA,2021-01-25,11,2879,51,2941
BIHAR,GOPALGANJ,2021-01-21,1,853,2,856
BIHAR,GOPALGANJ,2021-01-22,2,189,16,207
BIHAR,GOPALGANJ,2021-01-23,0,435,0,435
BIHAR,GOPALGANJ,2021-01-24,2,723,30,755
BIHAR,GOPALGANJ,2021-01-25,0,511,0,511
BIHAR,JAMUI,2021-01-21,0,735,0,735
BIHAR,JAMUI,2021-01-22,0,585,0,585
BIHAR,JAMUI,2021-01-23,0,954,0,954
BIHAR,JAMUI,2021-01-24,1,427,0,428
BIHAR,JAMUI,2021-01-25,1,1109,0,1110
BIHAR,JEHANABAD,2021-01-21,0,1139,0,1139
BIHAR,JEHANABAD,2021-01-22,3,1030,57,1090
BIHAR,JEHANABAD,2021-01-23,1,917,1,919
BIHAR,JEHANABAD,2021-01-24,1,789,70,860
BIHAR,JEHANABAD,2021-01-25,1,895,5,901
BIHAR,KAIMUR (BHABUA),2021-01-21,3,1590,0,1593
BIHAR,KAIMUR (BHABUA),2021-01-22,1,2530,0,2531
BIHAR,KAIMUR (BHABUA),2021-01-23,6,1410,0,1416
BIHAR,KAIMUR (BHABUA),2021-01-24,0,2052,0,2052
BIHAR,KAIMUR (BHABUA),2021-01-25,0,1484,0,1484
BIHAR,KATIHAR,2021-01-21,0,2160,0,2160
BIHAR,KATIHAR,2021-01-22,0,1951,0,1951
BIHAR,KATIHAR,2021-01-23,0,1583,0,1583
BIHAR,KATIHAR,2021-01-24,0,1070,1,1071
BIHAR,KATIHAR,2021-01-25,1,1458,0,1459
BIHAR,KHAGARIA,2021-01-21,2,969,0,971
BIHAR,KHAGARIA,2021-01-22,1,1380,1,1382
BIHAR,KHAGARIA,2021-01-23,1,1712,0,1713
BIHAR,KHAGARIA,2021-01-24,0,1775,0,1775
BIHAR,KHAGARIA,2021-01-25,0,1555,0,1555
BIHAR,KISHANGANJ,2021-01-21,0,816,1,817
BIHAR,KISHANGANJ,2021-01-22,0,1101,4,1105
BIHAR,KISHANGANJ,2021-01-23,0,681,2,683
BIHAR,KISHANGANJ,2021-01-24,0,372,0,372
BIHAR,KISHANGANJ,2021-01-25,0,745,2,747
BIHAR,LAKHISARAI,2021-01-21,0,513,0,513
BIHAR,LAKHISARAI,2021-01-22,1,1616,0,1617
BIHAR,LAKHISARAI,2021-01-23,0,686,0,686
BIHAR,LAKHISARAI,2021-01-24,0,603,0,603
BIHAR,LAKHISARAI,2021-01-25,3,66,0,69
BIHAR,MADHEPURA,2021-01-21,2,1645,0,1647
BIHAR,MADHEPURA,2021-01-22,1,1646,0,1647
BIHAR,MADHEPURA,2021-01-23,0,850,0,850
BIHAR,MADHEPURA,2021-01-24,0,972,0,972
BIHAR,MADHEPURA,2021-01-25,1,1415,0,1416
BIHAR,MADHUBANI,2021-01-21,3,1409,18,1430
BIHAR,MADHUBANI,2021-01-22,3,2199,0,2202
BIHAR,MADHUBANI,2021-01-23,1,1409,6,1416
BIHAR,MADHUBANI,2021-01-24,2,762,8,772
BIHAR,MADHUBANI,2021-01-25,3,1347,6,1356
BIHAR,MUNGER,2021-01-21,2,1305,13,1320
BIHAR,MUNGER,2021-01-22,4,2020,4,2028
BIHAR,MUNGER,2021-01-23,4,1783,10,1797
BIHAR,MUNGER,2021-01-24,1,364,0,365
BIHAR,MUNGER,2021-01-25,1,1552,16,1569
BIHAR,MUZAFFARPUR,2021-01-21,5,2372,0,2377
BIHAR,MUZAFFARPUR,2021-01-22,2,2238,0,2240
BIHAR,MUZAFFARPUR,2021-01-23,2,1760,0,1762
BIHAR,MUZAFFARPUR,2021-01-24,2,1680,1,1683
BIHAR,MUZAFFARPUR,2021-01-25,7,2410,1,2418
BIHAR,NALANDA,2021-01-21,5,3479,3,3487
BIHAR,NALANDA,2021-01-22,4,3205,149,3358
BIHAR,NALANDA,2021-01-23,3,2919,262,3184
BIHAR,NALANDA,2021-01-24,0,2800,0,2800
BIHAR,NALANDA,2021-01-25,3,3409,464,3876
BIHAR,NAWADA,2021-01-21,0,1140,0,1140
BIHAR,NAWADA,2021-01-22,1,1288,0,1289
BIHAR,NAWADA,2021-01-23,17,1215,0,1232
BIHAR,NAWADA,2021-01-24,0,1213,0,1213
BIHAR,NAWADA,2021-01-25,0,1115,0,1115
BIHAR,PASHCHIM CHAMPARAN,2021-01-21,2,1412,0,1414
BIHAR,PASHCHIM CHAMPARAN,2021-01-22,0,2077,0,2077
BIHAR,PASHCHIM CHAMPARAN,2021-01-23,0,1596,0,1596
BIHAR,PASHCHIM CHAMPARAN,2021-01-24,0,1787,0,1787
BIHAR,PASHCHIM CHAMPARAN,2021-01-25,0,1787,1,1788
BIHAR,PATNA,2021-01-21,88,5720,1,5809
BIHAR,PATNA,2021-01-22,77,5726,4,5807
BIHAR,PATNA,2021-01-23,85,4541,3,4629
BIHAR,PATNA,2021-01-24,43,4192,7,4242
BIHAR,PATNA,2021-01-25,83,4384,4,4471
BIHAR,PURBI CHAMPARAN,2021-01-21,2,3115,5,3122
BIHAR,PURBI CHAMPARAN,2021-01-22,1,2825,7,2833
BIHAR,PURBI CHAMPARAN,2021-01-23,3,2358,2,2363
BIHAR,PURBI CHAMPARAN,2021-01-24,3,3453,3,3459
BIHAR,PURBI CHAMPARAN,2021-01-25,4,2383,5,2392
BIHAR,PURNIA,2021-01-21,0,1439,0,1439
BIHAR,PURNIA,2021-01-22,1,924,40,965
BIHAR,PURNIA,2021-01-23,3,1192,0,1195
BIHAR,PURNIA,2021-01-24,0,554,38,592
BIHAR,PURNIA,2021-01-25,2,837,0,839
BIHAR,ROHTAS,2021-01-21,0,2773,201,2974
BIHAR,ROHTAS,2021-01-22,4,2132,70,2206
BIHAR,ROHTAS,2021-01-23,1,1592,87,1680
BIHAR,ROHTAS,2021-01-24,0,1036,0,1036
BIHAR,ROHTAS,2021-01-25,1,2763,1,2765
BIHAR,SAHARSA,2021-01-21,3,860,0,863
BIHAR,SAHARSA,2021-01-22,3,685,1,689
BIHAR,SAHARSA,2021-01-23,0,505,4,509
BIHAR,SAHARSA,2021-01-24,0,336,0,336
BIHAR,SAHARSA,2021-01-25,6,757,0,763
BIHAR,SAMASTIPUR,2021-01-21,3,2870,110,2983
BIHAR,SAMASTIPUR,2021-01-22,3,2989,62,3054
BIHAR,SAMASTIPUR,2021-01-23,4,3159,35,3198
BIHAR,SAMASTIPUR,2021-01-24,1,2311,72,2384
BIHAR,SAMASTIPUR,2021-01-25,0,3006,25,3031
BIHAR,SARAN,2021-01-21,1,2762,1,2764
BIHAR,SARAN,2021-01-22,5,2421,2,2428
BIHAR,SARAN,2021-01-23,4,2429,0,2433
BIHAR,SARAN,2021-01-24,0,1281,0,1281
BIHAR,SARAN,2021-01-25,15,1933,2,1950
BIHAR,SHEIKHPURA,2021-01-21,0,400,24,424
BIHAR,SHEIKHPURA,2021-01-22,0,537,3,540
BIHAR,SHEIKHPURA,2021-01-23,0,318,6,324
BIHAR,SHEIKHPURA,2021-01-24,0,415,1,416
BIHAR,SHEIKHPURA,2021-01-25,0,455,1,456
BIHAR,SHEOHAR,2021-01-21,1,717,1,719
BIHAR,SHEOHAR,2021-01-22,3,583,0,586
BIHAR,SHEOHAR,2021-01-23,0,831,0,831
BIHAR,SHEOHAR,2021-01-24,0,616,0,616
BIHAR,SHEOHAR,2021-01-25,3,844,0,847
BIHAR,SITAMARHI,2021-01-21,9,1681,0,1690
BIHAR,SITAMARHI,2021-01-22,4,1635,1,1640
BIHAR,SITAMARHI,2021-01-23,6,881,0,887
BIHAR,SITAMARHI,2021-01-24,1,1338,5,1344
BIHAR,SITAMARHI,2021-01-25,1,1306,0,1307
BIHAR,SIWAN,2021-01-21,2,2209,1,2212
BIHAR,SIWAN,2021-01-22,0,1650,0,1650
BIHAR,SIWAN,2021-01-23,1,1883,0,1884
BIHAR,SIWAN,2021-01-24,0,1420,0,1420
BIHAR,SIWAN,2021-01-25,7,1517,0,1524
BIHAR,SUPAUL,2021-01-21,0,1629,19,1648
BIHAR,SUPAUL,2021-01-22,2,1599,50,1651
BIHAR,SUPAUL,2021-01-23,2,1167,5,1174
BIHAR,SUPAUL,2021-01-24,1,1601,0,1602
BIHAR,SUPAUL,2021-01-25,1,1412,0,1413
BIHAR,VAISHALI,2021-01-21,1,2913,1,2915
BIHAR,VAISHALI,2021-01-22,7,3891,2,3900
BIHAR,VAISHALI,2021-01-23,3,3055,49,3107
BIHAR,VAISHALI,2021-01-24,0,2089,4,2093
BIHAR,VAISHALI,2021-01-25,4,3980,1,3985
CHANDIGARH,CHANDIGARH,2021-01-21,19,1402,49,1470
CHANDIGARH,CHANDIGARH,2021-01-22,28,1584,16,1628
CHANDIGARH,CHANDIGARH,2021-01-23,38,1437,4,1479
CHANDIGARH,CHANDIGARH,2021-01-24,36,595,7,638
CHANDIGARH,CHANDIGARH,2021-01-25,21,1214,29,1264
CHHATTISGARH,BALOD,2021-01-21,15,1007,0,1022
CHHATTISGARH,BALOD,2021-01-22,17,1213,0,1230
CHHATTISGARH,BALOD,2021-01-23,13,868,0,881
CHHATTISGARH,BALOD,2021-01-24,9,598,0,607
CHHATTISGARH,BALOD,2021-01-25,5,744,0,749
CHHATTISGARH,BALODA BAZAR,2021-01-21,33,495,15,543
CHHATTISGARH,BALODA BAZAR,2021-01-22,33,683,0,716
CHHATTISGARH,BALODA BAZAR,2021-01-23,11,524,2,537
CHHATTISGARH,BALODA BAZAR,2021-01-24,8,193,6,207
CHHATTISGARH,BALODA BAZAR,2021-01-25,19,554,4,577
CHHATTISGARH,BALRAMPUR,2021-01-21,7,644,2,653
CHHATTISGARH,BALRAMPUR,2021-01-22,4,486,0,490
CHHATTISGARH,BALRAMPUR,2021-01-23,2,381,0,383
CHHATTISGARH,BALRAMPUR,2021-01-24,1,261,0,262
CHHATTISGARH,BALRAMPUR,2021-01-25,7,370,0,377
CHHATTISGARH,BASTAR,2021-01-21,3,1069,0,1072
CHHATTISGARH,BASTAR,2021-01-22,6,1388,1,1395
CHHATTISGARH,BASTAR,2021-01-23,1,1091,0,1092
CHHATTISGARH,BASTAR,2021-01-24,1,945,1,947
CHHATTISGARH,BASTAR,2021-01-25,5,936,0,941
CHHATTISGARH,BEMETARA,2021-01-21,15,554,0,569
CHHATTISGARH,BEMETARA,2021-01-22,12,392,0,404
CHHATTISGARH,BEMETARA,2021-01-23,6,581,1,588
CHHATTISGARH,BEMETARA,2021-01-24,6,171,0,177
CHHATTISGARH,BEMETARA,2021-01-25,13,453,0,466
CHHATTISGARH,BIJAPUR,2021-01-21,2,558,0,560
CHHATTISGARH,BIJAPUR,2021-01-22,2,257,0,259
CHHATTISGARH,BIJAPUR,2021-01-23,0,148,0,148
CHHATTISGARH,BIJAPUR,2021-01-24,2,56,0,58
CHHATTISGARH,BIJAPUR,2021-01-25,0,134,0,134
CHHATTISGARH,BILASPUR,2021-01-21,82,1452,13,1547
CHHATTISGARH,BILASPUR,2021-01-22,23,1286,5,1314
CHHATTISGARH,BILASPUR,2021-01-23,26,862,17,905
CHHATTISGARH,BILASPUR,2021-01-24,28,851,21,900
CHHATTISGARH,BILASPUR,2021-01-25,53,1008,16,1077
CHHATTISGARH,DANTEWADA,2021-01-21,6,326,0,332
CHHATTISGARH,DANTEWADA,2021-01-22,0,404,0,404
CHHATTISGARH,DANTEWADA,2021-01-23,4,190,0,194
CHHATTISGARH,DANTEWADA,2021-01-24,1,268,0,269
CHHATTISGARH,DANTEWADA,2021-01-25,1,177,0,178
CHHATTISGARH,DHAMTARI,2021-01-21,19,627,26,672
CHHATTISGARH,DHAMTARI,2021-01-22,16,549,14,579
CHHATTISGARH,DHAMTARI,2021-01-23,20,565,12,597
CHHATTISGARH,DHAMTARI,2021-01-24,6,269,10,285
CHHATTISGARH,DHAMTARI,2021-01-25,23,551,12,586
CHHATTISGARH,DURG,2021-01-21,63,1143,7,1213
CHHATTISGARH,DURG,2021-01-22,65,1127,8,1200
CHHATTISGARH,DURG,2021-01-23,63,914,0,977
CHHATTISGARH,DURG,2021-01-24,60,697,3,760
CHHATTISGARH,DURG,2021-01-25,49,697,1,747
CHHATTISGARH,GARIYABAND,2021-01-21,9,319,18,346
CHHATTISGARH,GARIYABAND,2021-01-22,4,383,4,391
CHHATTISGARH,GARIYABAND,2021-01-23,16,382,10,408
CHHATTISGARH,GARIYABAND,2021-01-24,6,154,4,164
CHHATTISGARH,GARIYABAND,2021-01-25,5,238,1,244
CHHATTISGARH,GAURELLA PENDRA MARWAHI,2021-01-21,4,228,2,234
CHHATTISGARH,GAURELLA PENDRA MARWAHI,2021-01-22,4,74,0,78
CHHATTISGARH,GAURELLA PENDRA MARWAHI,2021-01-23,1,57,0,58
CHHATTISGARH,GAURELLA PENDRA MARWAHI,2021-01-24,0,124,0,124
CHHATTISGARH,GAURELLA PENDRA MARWAHI,2021-01-25,0,205,0,205
CHHATTISGARH,JANJGIR CHAMPA,2021-01-21,22,1022,0,1044
CHHATTISGARH,JANJGIR CHAMPA,2021-01-22,23,1508,2,1533
CHHATTISGARH,JANJGIR CHAMPA,2021-01-23,12,1462,1,1475
CHHATTISGARH,JANJGIR CHAMPA,2021-01-24,14,655,2,671
CHHATTISGARH,JANJGIR CHAMPA,2021-01-25,13,1103,0,1116
CHHATTISGARH,JASHPUR,2021-01-21,14,382,3,399
CHHATTISGARH,JASHPUR,2021-01-22,10,179,0,189
CHHATTISGARH,JASHPUR,2021-01-23,15,305,1,321
CHHATTISGARH,JASHPUR,2021-01-24,10,203,0,213
CHHATTISGARH,JASHPUR,2021-01-25,4,138,0,142
CHHATTISGARH,KABIRDHAM,2021-01-21,6,397,4,407
CHHATTISGARH,KABIRDHAM,2021-01-22,12,441,0,453
CHHATTISGARH,KABIRDHAM,2021-01-23,0,544,0,544
CHHATTISGARH,KABIRDHAM,2021-01-24,9,199,0,208
CHHATTISGARH,KABIRDHAM,2021-01-25,7,405,0,412
CHHATTISGARH,KANKER,2021-01-21,10,631,0,641
CHHATTISGARH,KANKER,2021-01-22,11,720,0,731
CHHATTISGARH,KANKER,2021-01-23,7,479,0,486
CHHATTISGARH,KANKER,2021-01-24,6,136,0,142
CHHATTISGARH,KANKER,2021-01-25,4,461,0,465
CHHATTISGARH,KONDAGAON,2021-01-21,7,207,0,214
CHHATTISGARH,KONDAGAON,2021-01-22,1,305,0,306
CHHATTISGARH,KONDAGAON,2021-01-23,2,376,1,379
CHHATTISGARH,KONDAGAON,2021-01-24,4,431,0,435
CHHATTISGARH,KONDAGAON,2021-01-25,8,577,0,585
CHHATTISGARH,KORBA,2021-01-21,6,808,0,814
CHHATTISGARH,KORBA,2021-01-22,10,1044,0,1054
CHHATTISGARH,KORBA,2021-01-23,7,1041,0,1048
CHHATTISGARH,KORBA,2021-01-24,6,751,0,757
CHHATTISGARH,KORBA,2021-01-25,6,1190,0,1196
CHHATTISGARH,KOREA,2021-01-21,15,763,1,779
CHHATTISGARH,KOREA,2021-01-22,17,855,5,877
CHHATTISGARH,KOREA,2021-01-23,9,675,0,684
CHHATTISGARH,KOREA,2021-01-24,6,391,2,399
CHHATTISGARH,KOREA,2021-01-25,9,657,0,666
CHHATTISGARH,MAHASAMUND,2021-01-21,18,1592,0,1610
CHHATTISGARH,MAHASAMUND,2021-01-22,22,1652,1,1675
CHHATTISGARH,MAHASAMUND,2021-01-23,26,972,0,998
CHHATTISGARH,MAHASAMUND,2021-01-24,28,878,1,907
CHHATTISGARH,MAHASAMUND,2021-01-25,15,1326,2,1343
CHHATTISGARH,MUNGELI,2021-01-21,6,610,0,616
CHHATTISGARH,MUNGELI,2021-01-22,5,535,0,540
CHHATTISGARH,MUNGELI,2021-01-23,5,626,3,634
CHHATTISGARH,MUNGELI,2021-01-24,3,384,3,390
CHHATTISGARH,MUNGELI,2021-01-25,5,613,1,619
CHHATTISGARH,NARAYANPUR,2021-01-21,1,101,1,103
CHHATTISGARH,NARAYANPUR,2021-01-22,1,124,0,125
CHHATTISGARH,NARAYANPUR,2021-01-23,1,246,0,247
CHHATTISGARH,NARAYANPUR,2021-01-24,0,217,0,217
CHHATTISGARH,NARAYANPUR,2021-01-25,1,70,0,71
CHHATTISGARH,RAIGARH,2021-01-21,52,1523,1,1576
CHHATTISGARH,RAIGARH,2021-01-22,32,1134,2,1168
CHHATTISGARH,RAIGARH,2021-01-23,29,1162,1,1192
CHHATTISGARH,RAIGARH,2021-01-24,14,761,0,775
CHHATTISGARH,RAIGARH,2021-01-25,37,1031,0,1068
CHHATTISGARH,RAIPUR,2021-01-21,110,2163,21,2294
CHHATTISGARH,RAIPUR,2021-01-22,116,1564,17,1697
CHHATTISGARH,RAIPUR,2021-01-23,86,1965,11,2062
CHHATTISGARH,RAIPUR,2021-01-24,60,1008,27,1095
CHHATTISGARH,RAIPUR,2021-01-25,136,1658,11,1805
CHHATTISGARH,RAJNANDGAON,2021-01-21,31,1673,9,1713
CHHATTISGARH,RAJNANDGAON,2021-01-22,26,1464,3,1493
CHHATTISGARH,RAJNANDGAON,2021-01-23,21,1260,5,1286
CHHATTISGARH,RAJNANDGAON,2021-01-24,22,451,1,474
CHHATTISGARH,RAJNANDGAON,2021-01-25,32,605,0,637
CHHATTISGARH,SUKMA,2021-01-21,0,150,0,150
CHHATTISGARH,SUKMA,2021-01-22,0,160,0,160
CHHATTISGARH,SUKMA,2021-01-23,0,157,0,157
CHHATTISGARH,SUKMA,2021-01-24,1,370,1,372
CHHATTISGARH,SUKMA,2021-01-25,3,339,0,342
CHHATTISGARH,SURAJPUR,2021-01-21,26,1145,3,1174
CHHATTISGARH,SURAJPUR,2021-01-22,18,1130,1,1149
CHHATTISGARH,SURAJPUR,2021-01-23,6,949,3,958
CHHATTISGARH,SURAJPUR,2021-01-24,6,855,1,862
CHHATTISGARH,SURAJPUR,2021-01-25,14,1274,1,1289
CHHATTISGARH,SURGUJA,2021-01-21,22,701,1,724
CHHATTISGARH,SURGUJA,2021-01-22,8,806,0,814
CHHATTISGARH,SURGUJA,2021-01-23,17,749,4,770
CHHATTISGARH,SURGUJA,2021-01-24,12,245,2,259
CHHATTISGARH,SURGUJA,2021-01-25,13,706,2,721
DADRA AND NAGAR HAVELI,DADRA AND NAGAR HAVELI,2021-01-21,1,338,0,339
DADRA AND NAGAR HAVELI,DADRA AND NAGAR HAVELI,2021-01-22,0,189,0,189
DADRA AND NAGAR HAVELI,DADRA AND NAGAR HAVELI,2021-01-23,0,185,0,185
DADRA AND NAGAR HAVELI,DADRA AND NAGAR HAVELI,2021-01-24,2,165,0,167
DADRA AND NAGAR HAVELI,DADRA AND NAGAR HAVELI,2021-01-25,1,179,0,180
DAMAN AND DIU,DAMAN,2021-01-21,0,65,0,65
DAMAN AND DIU,DAMAN,2021-01-22,0,67,0,67
DAMAN AND DIU,DAMAN,2021-01-23,0,91,0,91
DAMAN AND DIU,DAMAN,2021-01-24,1,105,0,106
DAMAN AND DIU,DAMAN,2021-01-25,1,2,0,3
DAMAN AND DIU,DIU,2021-01-21,2,56,0,58
DAMAN AND DIU,DIU,2021-01-22,0,22,0,22
DAMAN AND DIU,DIU,2021-01-23,1,22,0,23
DAMAN AND DIU,DIU,2021-01-24,0,43,0,43
DAMAN AND DIU,DIU,2021-01-25,0,7,1,8
DELHI,CENTRAL,2021-01-21,31,5219,86,5336
DELHI,CENTRAL,2021-01-22,16,5454,8,5478
DELHI,CENTRAL,2021-01-23,14,3996,17,4027
DELHI,CENTRAL,2021-01-24,4,3423,7,3434
DELHI,CENTRAL,2021-01-25,11,4461,13,4485
DELHI,EAST,2021-01-21,13,3733,3,3749
DELHI,EAST,2021-01-22,14,4446,1,4461
DELHI,EAST,2021-01-23,20,3684,1,3705
DELHI,EAST,2021-01-24,8,2024,1,2033
DELHI,EAST,2021-01-25,16,6290,1,6307
DELHI,NEW DELHI,2021-01-21,46,7478,18,7542
DELHI,NEW DELHI,2021-01-22,41,7741,27,7809
DELHI,NEW DELHI,2021-01-23,42,5766,13,5821
DELHI,NEW DELHI,2021-01-24,21,4788,16,4825
DELHI,NEW DELHI,2021-01-25,25,6151,28,6204
DELHI,NORTH,2021-01-21,12,6955,9,6976
DELHI,NORTH,2021-01-22,15,7848,38,7901
DELHI,NORTH,2021-01-23,6,6211,20,6237
DELHI,NORTH,2021-01-24,10,6492,3,6505
DELHI,NORTH,2021-01-25,10,6399,62,6471
DELHI,NORTH EAST,2021-01-21,15,5266,11,5292
DELHI,NORTH EAST,2021-01-22,7,5723,24,5754
DELHI,NORTH EAST,2021-01-23,1,4557,26,4584
DELHI,NORTH EAST,2021-01-24,7,3867,23,3897
DELHI,NORTH EAST,2021-01-25,8,4524,61,4593
DELHI,NORTH WEST,2021-01-21,58,6698,33,6789
DELHI,NORTH WEST,2021-01-22,33,7834,69,7936
DELHI,NORTH WEST,2021-01-23,24,5822,11,5857
DELHI,NORTH WEST,2021-01-24,35,5199,13,5247
DELHI,NORTH WEST,2021-01-25,26,5276,27,5329
DELHI,SHAHDARA,2021-01-21,7,6268,2,6277
DELHI,SHAHDARA,2021-01-22,8,6986,1,6995
DELHI,SHAHDARA,2021-01-23,4,6130,1,6135
DELHI,SHAHDARA,2021-01-24,5,3386,4,3395
DELHI,SHAHDARA,2021-01-25,3,6186,4,6193
DELHI,SOUTH,2021-01-21,32,7233,67,7332
DELHI,SOUTH,2021-01-22,32,6378,24,6434
DELHI,SOUTH,2021-01-23,23,6223,12,6258
DELHI,SOUTH,2021-01-24,36,4316,23,4375
DELHI,SOUTH,2021-01-25,39,5480,64,5583
DELHI,SOUTH EAST,2021-01-21,26,6092,0,6118
DELHI,SOUTH EAST,2021-01-22,35,6743,4,6782
DELHI,SOUTH EAST,2021-01-23,27,5219,1,5247
DELHI,SOUTH EAST,2021-01-24,16,4034,1,4051
DELHI,SOUTH EAST,2021-01-25,14,4586,0,4600
DELHI,SOUTH WEST,2021-01-21,29,5932,15,5976
DELHI,SOUTH WEST,2021-01-22,19,6561,16,6596
DELHI,SOUTH WEST,2021-01-23,16,4935,4,4955
DELHI,SOUTH WEST,2021-01-24,16,3990,5,4011
DELHI,SOUTH WEST,2021-01-25,29,4871,5,4905
DELHI,WEST,2021-01-21,41,10459,8,10508
DELHI,WEST,2021-01-22,37,10722,18,10777
DELHI,WEST,2021-01-23,34,9475,15,9524
DELHI,WEST,2021-01-24,16,6646,9,6671
DELHI,WEST,2021-01-25,22,10315,30,10367
GOA,NORTH GOA,2021-01-21,38,837,1,876
GOA,NORTH GOA,2021-01-22,47,721,0,768
GOA,NORTH GOA,2021-01-23,31,826,1,858
GOA,NORTH GOA,2021-01-24,27,517,4,548
GOA,NORTH GOA,2021-01-25,36,762,1,799
GOA,SOUTH GOA,2021-01-21,35,936,0,971
GOA,SOUTH GOA,2021-01-22,36,849,1,886
GOA,SOUTH GOA,2021-01-23,42,875,0,917
GOA,SOUTH GOA,2021-01-24,23,329,1,353
GOA,SOUTH GOA,2021-01-25,40,1092,1,1133
GUJARAT,AHMADABAD,2021-01-21,78,5514,117,5709
GUJARAT,AHMADABAD,2021-01-22,62,6542,106,6710
GUJARAT,AHMADABAD,2021-01-23,107,5620,59,5786
GUJARAT,AHMADABAD,2021-01-24,68,4518,12,4598
GUJARAT,AHMADABAD,2021-01-25,86,5895,72,6053
GUJARAT,AMRELI,2021-01-21,11,960,75,1046
GUJARAT,AMRELI,2021-01-22,19,756,50,825
GUJARAT,AMRELI,2021-01-23,4,297,7,308
GUJARAT,AMRELI,2021-01-24,1,543,0,544
GUJARAT,AMRELI,2021-01-25,4,934,7,945
GUJARAT,ANAND,2021-01-21,10,344,15,369
GUJARAT,ANAND,2021-01-22,5,285,20,310
GUJARAT,ANAND,2021-01-23,4,317,0,321
GUJARAT,ANAND,2021-01-24,2,72,0,74
GUJARAT,ANAND,2021-01-25,2,321,0,323
GUJARAT,ARVALLI,2021-01-21,0,885,6,891
GUJARAT,ARVALLI,2021-01-22,3,516,0,519
GUJARAT,ARVALLI,2021-01-23,1,329,1,331
GUJARAT,ARVALLI,2021-01-24,1,120,1,122
GUJARAT,ARVALLI,2021-01-25,1,177,0,178
GUJARAT,BANAS KANTHA,2021-01-21,0,319,0,319
GUJARAT,BANAS KANTHA,2021-01-22,0,224,0,224
GUJARAT,BANAS KANTHA,2021-01-23,3,151,3,157
GUJARAT,BANAS KANTHA,2021-01-24,0,35,0,35
GUJARAT,BANAS KANTHA,2021-01-25,0,221,0,221
GUJARAT,BHARUCH,2021-01-21,10,381,5,396
GUJARAT,BHARUCH,2021-01-22,8,289,3,300
GUJARAT,BHARUCH,2021-01-23,3,189,5,197
GUJARAT,BHARUCH,2021-01-24,8,63,0,71
GUJARAT,BHARUCH,2021-01-25,7,347,6,360
GUJARAT,BHAVNAGAR,2021-01-21,8,798,0,806
GUJARAT,BHAVNAGAR,2021-01-22,7,1502,0,1509
GUJARAT,BHAVNAGAR,2021-01-23,9,753,1,763
GUJARAT,BHAVNAGAR,2021-01-24,2,583,0,585
GUJARAT,BHAVNAGAR,2021-01-25,5,897,0,902
GUJARAT,BOTAD,2021-01-21,0,225,0,225
GUJARAT,BOTAD,2021-01-22,0,332,0,332
GUJARAT,BOTAD,2021-01-23,0,263,0,263
GUJARAT,BOTAD,2021-01-24,0,152,0,152
GUJARAT,BOTAD,2021-01-25,0,431,0,431
GUJARAT,CHHOTAUDEPUR,2021-01-21,1,96,0,97
GUJARAT,CHHOTAUDEPUR,2021-01-22,3,120,0,123
GUJARAT,CHHOTAUDEPUR,2021-01-23,1,57,0,58
GUJARAT,CHHOTAUDEPUR,2021-01-24,0,12,0,12
GUJARAT,CHHOTAUDEPUR,2021-01-25,0,107,0,107
GUJARAT,DANG,2021-01-21,0,55,0,55
GUJARAT,DANG,2021-01-22,3,90,0,93
GUJARAT,DANG,2021-01-23,0,56,0,56
GUJARAT,DANG,2021-01-24,0,17,0,17
GUJARAT,DANG,2021-01-25,2,88,0,90
GUJARAT,DEVBHUMI DWARKA,2021-01-21,4,149,0,153
GUJARAT,DEVBHUMI DWARKA,2021-01-22,3,180,0,183
GUJARAT,DEVBHUMI DWARKA,2021-01-23,4,70,2,76
GUJARAT,DEVBHUMI DWARKA,2021-01-24,0,55,0,55
GUJARAT,DEVBHUMI DWARKA,2021-01-25,2,96,0,98
GUJARAT,DOHAD,2021-01-21,10,541,0,551
GUJARAT,DOHAD,2021-01-22,18,599,0,617
GUJARAT,DOHAD,2021-01-23,20,364,1,385
GUJARAT,DOHAD,2021-01-24,40,549,0,589
GUJARAT,DOHAD,2021-01-25,12,697,0,709
GUJARAT,GANDHINAGAR,2021-01-21,6,923,3,932
GUJARAT,GANDHINAGAR,2021-01-22,9,793,5,807
GUJARAT,GANDHINAGAR,2021-01-23,11,620,1,632
GUJARAT,GANDHINAGAR,2021-01-24,6,344,0,350
GUJARAT,GANDHINAGAR,2021-01-25,7,889,7,903
GUJARAT,GIR SOMNATH,2021-01-21,6,237,0,243
GUJARAT,GIR SOMNATH,2021-01-22,11,224,0,235
GUJARAT,GIR SOMNATH,2021-01-23,3,168,1,172
GUJARAT,GIR SOMNATH,2021-01-24,1,166,3,170
GUJARAT,GIR SOMNATH,2021-01-25,5,137,0,142
GUJARAT,JAMNAGAR,2021-01-21,10,1260,1,1271
GUJARAT,JAMNAGAR,2021-01-22,4,1072,2,1078
GUJARAT,JAMNAGAR,2021-01-23,11,1392,2,1405
GUJARAT,JAMNAGAR,2021-01-24,6,413,3,422
GUJARAT,JAMNAGAR,2021-01-25,6,534,1,541
GUJARAT,JUNAGADH,2021-01-21,10,711,0,721
GUJARAT,JUNAGADH,2021-01-22,3,590,0,593
GUJARAT,JUNAGADH,2021-01-23,12,272,1,285
GUJARAT,JUNAGADH,2021-01-24,7,113,0,120
GUJARAT,JUNAGADH,2021-01-25,4,392,0,396
GUJARAT,KACHCHH,2021-01-21,27,530,20,577
GUJARAT,KACHCHH,2021-01-22,29,645,61,735
GUJARAT,KACHCHH,2021-01-23,23,460,32,515
GUJARAT,KACHCHH,2021-01-24,24,299,2,325
GUJARAT,KACHCHH,2021-01-25,29,664,17,710
GUJARAT,KHEDA,2021-01-21,29,580,3,612
GUJARAT,KHEDA,2021-01-22,11,587,1,599
GUJARAT,KHEDA,2021-01-23,2,503,1,506
GUJARAT,KHEDA,2021-01-24,8,148,1,157
GUJARAT,KHEDA,2021-01-25,2,445,1,448
GUJARAT,MAHESANA,2021-01-21,1,397,3,401
GUJARAT,MAHESANA,2021-01-22,7,603,3,613
GUJARAT,MAHESANA,2021-01-23,1,370,0,371
GUJARAT,MAHESANA,2021-01-24,5,218,1,224
GUJARAT,MAHESANA,2021-01-25,0,475,4,479
GUJARAT,MAHISAGAR,2021-01-21,5,295,0,300
GUJARAT,MAHISAGAR,2021-01-22,5,186,0,191
GUJARAT,MAHISAGAR,2021-01-23,6,281,0,287
GUJARAT,MAHISAGAR,2021-01-24,2,108,0,110
GUJARAT,MAHISAGAR,2021-01-25,3,208,0,211
GUJARAT,MORBI,2021-01-21,10,315,34,359
GUJARAT,MORBI,2021-01-22,4,375,10,389
GUJARAT,MORBI,2021-01-23,4,305,3,312
GUJARAT,MORBI,2021-01-24,7,228,15,250
GUJARAT,MORBI,2021-01-25,5,533,20,558
GUJARAT,NARMADA,2021-01-21,1,65,0,66
GUJARAT,NARMADA,2021-01-22,3,52,0,55
GUJARAT,NARMADA,2021-01-23,1,43,0,44
GUJARAT,NARMADA,2021-01-24,5,31,0,36
GUJARAT,NARMADA,2021-01-25,0,12,0,12
GUJARAT,NAVSARI,2021-01-21,1,274,1,276
GUJARAT,NAVSARI,2021-01-22,2,251,2,255
GUJARAT,NAVSARI,2021-01-23,3,185,0,188
GUJARAT,NAVSARI,2021-01-24,0,62,0,62
GUJARAT,NAVSARI,2021-01-25,1,238,1,240
GUJARAT,PANCH MAHALS,2021-01-21,15,417,0,432
GUJARAT,PANCH MAHALS,2021-01-22,3,564,2,569
GUJARAT,PANCH MAHALS,2021-01-23,5,309,0,314
GUJARAT,PANCH MAHALS,2021-01-24,5,266,0,271
GUJARAT,PANCH MAHALS,2021-01-25,10,481,0,491
GUJARAT,PATAN,2021-01-21,1,450,1,452
GUJARAT,PATAN,2021-01-22,0,361,2,363
GUJARAT,PATAN,2021-01-23,1,254,4,259
GUJARAT,PATAN,2021-01-24,0,23,0,23
GUJARAT,PATAN,2021-01-25,0,249,1,250
GUJARAT,PORBANDAR,2021-01-21,2,218,0,220
GUJARAT,PORBANDAR,2021-01-22,0,129,0,129
GUJARAT,PORBANDAR,2021-01-23,1,173,0,174
GUJARAT,PORBANDAR,2021-01-24,4,111,0,115
GUJARAT,PORBANDAR,2021-01-25,0,176,0,176
GUJARAT,RAJKOT,2021-01-21,44,1776,80,1900
GUJARAT,RAJKOT,2021-01-22,49,1758,24,1831
GUJARAT,RAJKOT,2021-01-23,74,1185,11,1270
GUJARAT,RAJKOT,2021-01-24,37,444,25,506
GUJARAT,RAJKOT,2021-01-25,58,1586,12,1656
GUJARAT,SABAR KANTHA,2021-01-21,6,169,13,188
GUJARAT,SABAR KANTHA,2021-01-22,5,161,6,172
GUJARAT,SABAR KANTHA,2021-01-23,3,91,5,99
GUJARAT,SABAR KANTHA,2021-01-24,2,100,7,109
GUJARAT,SABAR KANTHA,2021-01-25,1,189,12,202
GUJARAT,SURAT,2021-01-21,68,1730,22,1820
GUJARAT,SURAT,2021-01-22,88,1711,24,1823
GUJARAT,SURAT,2021-01-23,46,1386,3,1435
GUJARAT,SURAT,2021-01-24,23,763,0,786
GUJARAT,SURAT,2021-01-25,44,2189,10,2243
GUJARAT,SURENDRANAGAR,2021-01-21,7,174,0,181
GUJARAT,SURENDRANAGAR,2021-01-22,0,401,19,420
GUJARAT,SURENDRANAGAR,2021-01-23,0,134,0,134
GUJARAT,SURENDRANAGAR,2021-01-24,0,166,0,166
GUJARAT,SURENDRANAGAR,2021-01-25,1,326,0,327
GUJARAT,TAPI,2021-01-21,6,129,0,135
GUJARAT,TAPI,2021-01-22,1,93,1,95
GUJARAT,TAPI,2021-01-23,3,140,5,148
GUJARAT,TAPI,2021-01-24,1,54,0,55
GUJARAT,TAPI,2021-01-25,5,179,3,187
GUJARAT,VADODARA,2021-01-21,81,2229,57,2367
GUJARAT,VADODARA,2021-01-22,73,2062,44,2179
GUJARAT,VADODARA,2021-01-23,62,1149,10,1221
GUJARAT,VADODARA,2021-01-24,44,483,7,534
GUJARAT,VADODARA,2021-01-25,65,1464,8,1537
GUJARAT,VALSAD,2021-01-21,2,412,0,414
GUJARAT,VALSAD,2021-01-22,0,468,1,469
GUJARAT,VALSAD,2021-01-23,1,270,0,271
GUJARAT,VALSAD,2021-01-24,4,189,0,193
GUJARAT,VALSAD,2021-01-25,6,488,0,494
HARYANA,AMBALA,2021-01-21,39,754,15,808
HARYANA,AMBALA,2021-01-22,25,687,4,716
HARYANA,AMBALA,2021-01-23,20,533,4,557
HARYANA,AMBALA,2021-01-24,9,117,3,129
HARYANA,AMBALA,2021-01-25,22,405,8,435
HARYANA,BHIWANI,2021-01-21,3,1116,0,1119
HARYANA,BHIWANI,2021-01-22,1,937,0,938
HARYANA,BHIWANI,2021-01-23,1,1136,0,1137
HARYANA,BHIWANI,2021-01-24,1,1666,0,1667
HARYANA,BHIWANI,2021-01-25,1,1148,1,1150
HARYANA,CHARKI DADRI,2021-01-21,2,339,0,341
HARYANA,CHARKI DADRI,2021-01-22,0,269,0,269
HARYANA,CHARKI DADRI,2021-01-23,0,113,0,113
HARYANA,CHARKI DADRI,2021-01-24,1,121,0,122
HARYANA,CHARKI DADRI,2021-01-25,0,509,1,510
HARYANA,FARIDABAD,2021-01-21,28,897,3,928
HARYANA,FARIDABAD,2021-01-22,23,821,6,850
HARYANA,FARIDABAD,2021-01-23,22,782,6,810
HARYANA,FARIDABAD,2021-01-24,16,314,1,331
HARYANA,FARIDABAD,2021-01-25,14,786,2,802
HARYANA,FATEHABAD,2021-01-21,3,321,0,324
HARYANA,FATEHABAD,2021-01-22,2,315,0,317
HARYANA,FATEHABAD,2021-01-23,3,258,1,262
HARYANA,FATEHABAD,2021-01-24,3,385,0,388
HARYANA,FATEHABAD,2021-01-25,0,651,7,658
HARYANA,GURUGRAM,2021-01-21,46,3323,21,3390
HARYANA,GURUGRAM,2021-01-22,39,3115,8,3162
HARYANA,GURUGRAM,2021-01-23,43,2528,25,2596
HARYANA,GURUGRAM,2021-01-24,34,2193,12,2239
HARYANA,GURUGRAM,2021-01-25,41,2420,15,2476
HARYANA,HISAR,2021-01-21,4,2158,0,2162
HARYANA,HISAR,2021-01-22,3,1927,6,1936
HARYANA,HISAR,2021-01-23,7,1518,0,1525
HARYANA,HISAR,2021-01-24,4,1289,0,1293
HARYANA,HISAR,2021-01-25,3,1554,0,1557
HARYANA,JHAJJAR,2021-01-21,1,2245,0,2246
HARYANA,JHAJJAR,2021-01-22,1,1158,0,1159
HARYANA,JHAJJAR,2021-01-23,2,1250,0,1252
HARYANA,JHAJJAR,2021-01-24,1,1026,0,1027
HARYANA,JHAJJAR,2021-01-25,1,1139,1,1141
HARYANA,JIND,2021-01-21,3,713,2,718
HARYANA,JIND,2021-01-22,2,556,1,559
HARYANA,JIND,2021-01-23,6,763,8,777
HARYANA,JIND,2021-01-24,3,454,0,457
HARYANA,JIND,2021-01-25,1,377,4,382
HARYANA,KAITHAL,2021-01-21,8,478,3,489
HARYANA,KAITHAL,2021-01-22,2,164,2,168
HARYANA,KAITHAL,2021-01-23,9,352,0,361
HARYANA,KAITHAL,2021-01-24,0,231,6,237
HARYANA,KAITHAL,2021-01-25,4,271,1,276
HARYANA,KARNAL,2021-01-21,24,1579,8,1611
HARYANA,KARNAL,2021-01-22,7,1294,0,1301
HARYANA,KARNAL,2021-01-23,13,1335,2,1350
HARYANA,KARNAL,2021-01-24,1,69,1,71
HARYANA,KARNAL,2021-01-25,17,446,1,464
HARYANA,KURUKSHETRA,2021-01-21,11,752,5,768
HARYANA,KURUKSHETRA,2021-01-22,4,1046,2,1052
HARYANA,KURUKSHETRA,2021-01-23,13,738,1,752
HARYANA,KURUKSHETRA,2021-01-24,3,654,0,657
HARYANA,KURUKSHETRA,2021-01-25,7,780,11,798
HARYANA,MAHENDRAGARH,2021-01-21,0,329,1,330
HARYANA,MAHENDRAGARH,2021-01-22,0,234,0,234
HARYANA,MAHENDRAGARH,2021-01-23,0,215,1,216
HARYANA,MAHENDRAGARH,2021-01-24,0,15,0,15
HARYANA,MAHENDRAGARH,2021-01-25,0,257,1,258
HARYANA,NUH,2021-01-21,0,852,1,853
HARYANA,NUH,2021-01-22,1,392,0,393
HARYANA,NUH,2021-01-23,0,830,0,830
HARYANA,NUH,2021-01-24,0,253,0,253
HARYANA,NUH,2021-01-25,1,399,0,400
HARYANA,PALWAL,2021-01-21,0,179,0,179
HARYANA,PALWAL,2021-01-22,1,205,0,206
HARYANA,PALWAL,2021-01-23,0,36,0,36
HARYANA,PALWAL,2021-01-24,1,18,0,19
HARYANA,PALWAL,2021-01-25,1,322,0,323
HARYANA,PANCHKULA,2021-01-21,9,380,2,391
HARYANA,PANCHKULA,2021-01-22,20,803,5,828
HARYANA,PANCHKULA,2021-01-23,14,772,4,790
HARYANA,PANCHKULA,2021-01-24,10,476,1,487
HARYANA,PANCHKULA,2021-01-25,16,337,5,358
HARYANA,PANIPAT,2021-01-21,11,739,1,751
HARYANA,PANIPAT,2021-01-22,3,955,1,959
HARYANA,PANIPAT,2021-01-23,6,532,1,539
HARYANA,PANIPAT,2021-01-24,4,765,0,769
HARYANA,PANIPAT,2021-01-25,2,462,0,464
HARYANA,REWARI,2021-01-21,0,337,6,343
HARYANA,REWARI,2021-01-22,0,226,1,227
HARYANA,REWARI,2021-01-23,2,247,1,250
HARYANA,REWARI,2021-01-24,2,125,5,132
HARYANA,REWARI,2021-01-25,1,246,2,249
HARYANA,ROHTAK,2021-01-21,9,847,1,857
HARYANA,ROHTAK,2021-01-22,6,617,0,623
HARYANA,ROHTAK,2021-01-23,2,699,0,701
HARYANA,ROHTAK,2021-01-24,19,632,0,651
HARYANA,ROHTAK,2021-01-25,12,449,1,462
HARYANA,SIRSA,2021-01-21,1,1354,44,1399
HARYANA,SIRSA,2021-01-22,1,1400,23,1424
HARYANA,SIRSA,2021-01-23,11,1233,0,1244
HARYANA,SIRSA,2021-01-24,0,950,24,974
HARYANA,SIRSA,2021-01-25,4,1495,18,1517
HARYANA,SONIPAT,2021-01-21,6,1969,0,1975
HARYANA,SONIPAT,2021-01-22,4,1723,0,1727
HARYANA,SONIPAT,2021-01-23,4,1097,0,1101
HARYANA,SONIPAT,2021-01-24,2,706,0,708
HARYANA,SONIPAT,2021-01-25,12,1348,0,1360
HARYANA,YAMUNANAGAR,2021-01-21,23,926,6,955
HARYANA,YAMUNANAGAR,2021-01-22,1,668,0,669
HARYANA,YAMUNANAGAR,2021-01-23,15,682,2,699
HARYANA,YAMUNANAGAR,2021-01-24,2,528,1,531
HARYANA,YAMUNANAGAR,2021-01-25,4,760,7,771
HIMACHAL PRADESH,BILASPUR,2021-01-21,2,189,2,193
HIMACHAL PRADESH,BILASPUR,2021-01-22,1,270,0,271
HIMACHAL PRADESH,BILASPUR,2021-01-23,2,267,4,273
HIMACHAL PRADESH,BILASPUR,2021-01-24,0,253,1,254
HIMACHAL PRADESH,BILASPUR,2021-01-25,1,47,0,48
HIMACHAL PRADESH,CHAMBA,2021-01-21,2,360,2,364
HIMACHAL PRADESH,CHAMBA,2021-01-22,2,342,7,351
HIMACHAL PRADESH,CHAMBA,2021-01-23,1,380,2,383
HIMACHAL PRADESH,CHAMBA,2021-01-24,1,308,5,314
HIMACHAL PRADESH,CHAMBA,2021-01-25,2,464,7,473
HIMACHAL PRADESH,HAMIRPUR,2021-01-21,4,276,2,282
HIMACHAL PRADESH,HAMIRPUR,2021-01-22,2,307,1,310
HIMACHAL PRADESH,HAMIRPUR,2021-01-23,5,312,2,319
HIMACHAL PRADESH,HAMIRPUR,2021-01-24,2,303,2,307
HIMACHAL PRADESH,HAMIRPUR,2021-01-25,0,98,1,99
HIMACHAL PRADESH,KANGRA,2021-01-21,11,1583,5,1599
HIMACHAL PRADESH,KANGRA,2021-01-22,7,1311,2,1320
HIMACHAL PRADESH,KANGRA,2021-01-23,6,989,1,996
HIMACHAL PRADESH,KANGRA,2021-01-24,3,1230,0,1233
HIMACHAL PRADESH,KANGRA,2021-01-25,6,1428,2,1436
HIMACHAL PRADESH,KINNAUR,2021-01-21,3,8,0,11
HIMACHAL PRADESH,KINNAUR,2021-01-22,0,18,0,18
HIMACHAL PRADESH,KINNAUR,2021-01-23,0,2,0,2
HIMACHAL PRADESH,KINNAUR,2021-01-24,0,3,0,3
HIMACHAL PRADESH,KINNAUR,2021-01-25,0,2,0,2
HIMACHAL PRADESH,KULLU,2021-01-21,4,154,3,161
HIMACHAL PRADESH,KULLU,2021-01-22,1,229,1,231
HIMACHAL PRADESH,KULLU,2021-01-23,2,129,3,134
HIMACHAL PRADESH,KULLU,2021-01-24,1,134,3,138
HIMACHAL PRADESH,KULLU,2021-01-25,0,142,1,143
HIMACHAL PRADESH,LAHUL AND SPITI,2021-01-21,0,3,0,3
HIMACHAL PRADESH,LAHUL AND SPITI,2021-01-22,0,1,0,1
HIMACHAL PRADESH,LAHUL AND SPITI,2021-01-24,0,1,0,1
HIMACHAL PRADESH,LAHUL AND SPITI,2021-01-25,0,3,0,3
HIMACHAL PRADESH,MANDI,2021-01-21,4,332,8,344
HIMACHAL PRADESH,MANDI,2021-01-22,4,266,5,275
HIMACHAL PRADESH,MANDI,2021-01-23,2,269,9,280
HIMACHAL PRADESH,MANDI,2021-01-24,1,116,8,125
HIMACHAL PRADESH,MANDI,2021-01-25,1,201,2,204
HIMACHAL PRADESH,SHIMLA,2021-01-21,10,441,2,453
HIMACHAL PRADESH,SHIMLA,2021-01-22,1,509,13,523
HIMACHAL PRADESH,SHIMLA,2021-01-23,3,352,10,365
HIMACHAL PRADESH,SHIMLA,2021-01-24,6,227,4,237
HIMACHAL PRADESH,SHIMLA,2021-01-25,9,225,9,243
HIMACHAL PRADESH,SIRMAUR,2021-01-21,6,332,0,338
HIMACHAL PRADESH,SIRMAUR,2021-01-22,13,305,0,318
HIMACHAL PRADESH,SIRMAUR,2021-01-23,7,378,3,388
HIMACHAL PRADESH,SIRMAUR,2021-01-24,6,301,1,308
HIMACHAL PRADESH,SIRMAUR,2021-01-25,3,80,0,83
HIMACHAL PRADESH,SOLAN,2021-01-21,5,519,1,525
HIMACHAL PRADESH,SOLAN,2021-01-22,4,437,2,443
HIMACHAL PRADESH,SOLAN,2021-01-23,6,523,0,529
HIMACHAL PRADESH,SOLAN,2021-01-24,3,372,0,375
HIMACHAL PRADESH,SOLAN,2021-01-25,4,107,0,111
HIMACHAL PRADESH,UNA,2021-01-21,1,345,2,348
HIMACHAL PRADESH,UNA,2021-01-22,3,419,1,423
HIMACHAL PRADESH,UNA,2021-01-23,4,524,0,528
HIMACHAL PRADESH,UNA,2021-01-24,0,726,0,726
HIMACHAL PRADESH,UNA,2021-01-25,2,594,1,597
INDIA,INDIA,2021-01-21,8,4,0,12
INDIA,INDIA,2021-01-22,10,0,0,10
INDIA,INDIA,2021-01-23,4,3,0,7
INDIA,INDIA,2021-01-24,3,0,0,3
INDIA,INDIA,2021-01-25,6,6,0,12
JAMMU AND KASHMIR,ANANTNAG,2021-01-21,3,305,0,308
JAMMU AND KASHMIR,ANANTNAG,2021-01-22,2,207,0,209
JAMMU AND KASHMIR,ANANTNAG,2021-01-23,2,279,0,281
JAMMU AND KASHMIR,ANANTNAG,2021-01-24,0,99,0,99
JAMMU AND KASHMIR,ANANTNAG,2021-01-25,3,443,0,446
JAMMU AND KASHMIR,BANDIPORA,2021-01-21,1,112,0,113
JAMMU AND KASHMIR,BANDIPORA,2021-01-22,0,70,0,70
JAMMU AND KASHMIR,BANDIPORA,2021-01-23,0,20,0,20
JAMMU AND KASHMIR,BANDIPORA,2021-01-25,2,189,7,198
JAMMU AND KASHMIR,BARAMULLA,2021-01-21,21,907,0,928
JAMMU AND KASHMIR,BARAMULLA,2021-01-22,16,557,0,573
JAMMU AND KASHMIR,BARAMULLA,2021-01-23,28,363,1,392
JAMMU AND KASHMIR,BARAMULLA,2021-01-24,5,411,0,416
JAMMU AND KASHMIR,BARAMULLA,2021-01-25,16,512,0,528
JAMMU AND KASHMIR,BUDGAM,2021-01-21,1,1071,1,1073
JAMMU AND KASHMIR,BUDGAM,2021-01-22,7,625,1,633
JAMMU AND KASHMIR,BUDGAM,2021-01-23,8,622,0,630
JAMMU AND KASHMIR,BUDGAM,2021-01-24,3,242,0,245
JAMMU AND KASHMIR,BUDGAM,2021-01-25,7,848,2,857
JAMMU AND KASHMIR,DODA,2021-01-21,5,106,0,111
JAMMU AND KASHMIR,DODA,2021-01-22,0,79,0,79
JAMMU AND KASHMIR,DODA,2021-01-23,2,33,0,35
JAMMU AND KASHMIR,DODA,2021-01-24,0,10,0,10
JAMMU AND KASHMIR,DODA,2021-01-25,0,62,1,63
JAMMU AND KASHMIR,GANDERBAL,2021-01-21,3,352,0,355
JAMMU AND KASHMIR,GANDERBAL,2021-01-22,4,199,0,203
JAMMU AND KASHMIR,GANDERBAL,2021-01-23,2,131,0,133
JAMMU AND KASHMIR,GANDERBAL,2021-01-24,0,102,0,102
JAMMU AND KASHMIR,GANDERBAL,2021-01-25,0,170,0,170
JAMMU AND KASHMIR,JAMMU,2021-01-21,54,1464,0,1518
JAMMU AND KASHMIR,JAMMU,2021-01-22,57,1418,0,1475
JAMMU AND KASHMIR,JAMMU,2021-01-23,38,855,2,895
JAMMU AND KASHMIR,JAMMU,2021-01-24,16,560,0,576
JAMMU AND KASHMIR,JAMMU,2021-01-25,25,610,1,636
JAMMU AND KASHMIR,KATHUA,2021-01-21,0,49,0,49
JAMMU AND KASHMIR,KATHUA,2021-01-22,0,271,0,271
JAMMU AND KASHMIR,KATHUA,2021-01-23,1,189,0,190
JAMMU AND KASHMIR,KATHUA,2021-01-24,0,28,0,28
JAMMU AND KASHMIR,KATHUA,2021-01-25,1,28,0,29
JAMMU AND KASHMIR,KISHTWAR,2021-01-21,0,178,0,178
JAMMU AND KASHMIR,KISHTWAR,2021-01-22,4,108,0,112
JAMMU AND KASHMIR,KISHTWAR,2021-01-23,0,40,0,40
JAMMU AND KASHMIR,KISHTWAR,2021-01-24,2,63,0,65
JAMMU AND KASHMIR,KISHTWAR,2021-01-25,2,95,0,97
JAMMU AND KASHMIR,KULGAM,2021-01-21,2,696,0,698
JAMMU AND KASHMIR,KULGAM,2021-01-22,0,404,0,404
JAMMU AND KASHMIR,KULGAM,2021-01-23,0,213,0,213
JAMMU AND KASHMIR,KULGAM,2021-01-24,0,50,0,50
JAMMU AND KASHMIR,KULGAM,2021-01-25,2,280,0,282
JAMMU AND KASHMIR,KUPWARA,2021-01-21,1,362,0,363
JAMMU AND KASHMIR,KUPWARA,2021-01-22,8,265,0,273
JAMMU AND KASHMIR,KUPWARA,2021-01-23,3,31,0,34
JAMMU AND KASHMIR,KUPWARA,2021-01-24,0,3,0,3
JAMMU AND KASHMIR,KUPWARA,2021-01-25,0,108,0,108
JAMMU AND KASHMIR,POONCH,2021-01-21,5,368,0,373
JAMMU AND KASHMIR,POONCH,2021-01-22,0,319,1,320
JAMMU AND KASHMIR,POONCH,2021-01-23,0,293,0,293
JAMMU AND KASHMIR,POONCH,2021-01-24,0,111,0,111
JAMMU AND KASHMIR,POONCH,2021-01-25,0,318,0,318
JAMMU AND KASHMIR,PULWAMA,2021-01-21,8,525,1,534
JAMMU AND KASHMIR,PULWAMA,2021-01-22,1,392,0,393
JAMMU AND KASHMIR,PULWAMA,2021-01-23,8,474,1,483
JAMMU AND KASHMIR,PULWAMA,2021-01-24,2,183,0,185
JAMMU AND KASHMIR,PULWAMA,2021-01-25,16,537,8,561
JAMMU AND KASHMIR,RAJOURI,2021-01-21,1,318,0,319
JAMMU AND KASHMIR,RAJOURI,2021-01-22,0,214,0,214
JAMMU AND KASHMIR,RAJOURI,2021-01-23,1,251,0,252
JAMMU AND KASHMIR,RAJOURI,2021-01-24,0,183,0,183
JAMMU AND KASHMIR,RAJOURI,2021-01-25,0,117,0,117
JAMMU AND KASHMIR,RAMBAN,2021-01-21,2,365,0,367
JAMMU AND KASHMIR,RAMBAN,2021-01-22,1,281,0,282
JAMMU AND KASHMIR,RAMBAN,2021-01-23,1,251,0,252
JAMMU AND KASHMIR,RAMBAN,2021-01-24,1,106,0,107
JAMMU AND KASHMIR,RAMBAN,2021-01-25,0,141,0,141
JAMMU AND KASHMIR,REASI,2021-01-21,2,159,1,162
JAMMU AND KASHMIR,REASI,2021-01-22,5,114,0,119
JAMMU AND KASHMIR,REASI,2021-01-23,2,190,0,192
JAMMU AND KASHMIR,REASI,2021-01-24,2,39,0,41
JAMMU AND KASHMIR,REASI,2021-01-25,3,163,0,166
JAMMU AND KASHMIR,SAMBA,2021-01-21,0,132,1,133
JAMMU AND KASHMIR,SAMBA,2021-01-22,2,202,0,204
JAMMU AND KASHMIR,SAMBA,2021-01-23,1,80,0,81
JAMMU AND KASHMIR,SAMBA,2021-01-24,0,181,0,181
JAMMU AND KASHMIR,SAMBA,2021-01-25,1,111,0,112
JAMMU AND KASHMIR,SHOPIAN,2021-01-21,3,197,0,200
JAMMU AND KASHMIR,SHOPIAN,2021-01-22,10,132,0,142
JAMMU AND KASHMIR,SHOPIAN,2021-01-23,1,24,0,25
JAMMU AND KASHMIR,SHOPIAN,2021-01-24,0,2,0,2
JAMMU AND KASHMIR,SHOPIAN,2021-01-25,6,122,0,128
JAMMU AND KASHMIR,SRINAGAR,2021-01-21,35,2357,11,2403
JAMMU AND KASHMIR,SRINAGAR,2021-01-22,24,2435,0,2459
JAMMU AND KASHMIR,SRINAGAR,2021-01-23,33,573,3,609
JAMMU AND KASHMIR,SRINAGAR,2021-01-24,14,1683,0,1697
JAMMU AND KASHMIR,SRINAGAR,2021-01-25,31,2924,7,2962
JAMMU AND KASHMIR,UDHAMPUR,2021-01-21,3,641,0,644
JAMMU AND KASHMIR,UDHAMPUR,2021-01-22,1,521,0,522
JAMMU AND KASHMIR,UDHAMPUR,2021-01-23,4,338,0,342
JAMMU AND KASHMIR,UDHAMPUR,2021-01-24,3,190,1,194
JAMMU AND KASHMIR,UDHAMPUR,2021-01-25,13,421,0,434
JHARKHAND,BOKARO,2021-01-21,15,644,2,661
JHARKHAND,BOKARO,2021-01-22,4,567,1,572
JHARKHAND,BOKARO,2021-01-23,2,598,1,601
JHARKHAND,BOKARO,2021-01-24,3,67,0,70
JHARKHAND,BOKARO,2021-01-25,8,1100,1,1109
JHARKHAND,CHATRA,2021-01-21,1,537,0,538
JHARKHAND,CHATRA,2021-01-22,0,125,0,125
JHARKHAND,CHATRA,2021-01-23,0,241,0,241
JHARKHAND,CHATRA,2021-01-24,1,304,0,305
JHARKHAND,CHATRA,2021-01-25,0,295,0,295
JHARKHAND,DEOGHAR,2021-01-21,5,2066,5,2076
JHARKHAND,DEOGHAR,2021-01-22,4,1188,0,1192
JHARKHAND,DEOGHAR,2021-01-23,1,1136,2,1139
JHARKHAND,DEOGHAR,2021-01-24,3,762,0,765
JHARKHAND,DEOGHAR,2021-01-25,1,1192,0,1193
JHARKHAND,DHANBAD,2021-01-21,3,771,0,774
JHARKHAND,DHANBAD,2021-01-22,10,691,0,701
JHARKHAND,DHANBAD,2021-01-23,0,68,0,68
JHARKHAND,DHANBAD,2021-01-24,0,121,1,122
JHARKHAND,DHANBAD,2021-01-25,3,429,0,432
JHARKHAND,DUMKA,2021-01-21,1,509,0,510
JHARKHAND,DUMKA,2021-01-22,0,579,0,579
JHARKHAND,DUMKA,2021-01-23,0,853,0,853
JHARKHAND,DUMKA,2021-01-24,1,297,0,298
JHARKHAND,DUMKA,2021-01-25,0,416,0,416
JHARKHAND,EAST SINGHBUM,2021-01-21,8,1543,0,1551
JHARKHAND,EAST SINGHBUM,2021-01-22,15,2278,22,2315
JHARKHAND,EAST SINGHBUM,2021-01-23,10,1673,3,1686
JHARKHAND,EAST SINGHBUM,2021-01-24,10,691,0,701
JHARKHAND,EAST SINGHBUM,2021-01-25,34,1944,0,1978
JHARKHAND,GARHWA,2021-01-21,3,290,0,293
JHARKHAND,GARHWA,2021-01-22,0,129,1,130
JHARKHAND,GARHWA,2021-01-23,0,116,0,116
JHARKHAND,GARHWA,2021-01-24,4,510,0,514
JHARKHAND,GARHWA,2021-01-25,0,718,0,718
JHARKHAND,GIRIDIH,2021-01-21,1,631,0,632
JHARKHAND,GIRIDIH,2021-01-22,2,649,0,651
JHARKHAND,GIRIDIH,2021-01-23,0,18,0,18
JHARKHAND,GIRIDIH,2021-01-24,2,10,0,12
JHARKHAND,GIRIDIH,2021-01-25,0,446,1,447
JHARKHAND,GODDA,2021-01-21,1,366,0,367
JHARKHAND,GODDA,2021-01-22,2,1167,2,1171
JHARKHAND,GODDA,2021-01-23,0,908,0,908
JHARKHAND,GODDA,2021-01-24,0,318,0,318
JHARKHAND,GODDA,2021-01-25,4,464,0,468
JHARKHAND,GUMLA,2021-01-21,3,46,0,49
JHARKHAND,GUMLA,2021-01-22,5,370,0,375
JHARKHAND,GUMLA,2021-01-23,4,19,0,23
JHARKHAND,GUMLA,2021-01-24,0,138,0,138
JHARKHAND,GUMLA,2021-01-25,0,1040,0,1040
JHARKHAND,HAZARIBAGH,2021-01-21,3,339,0,342
JHARKHAND,HAZARIBAGH,2021-01-22,1,495,0,496
JHARKHAND,HAZARIBAGH,2021-01-23,1,430,0,431
JHARKHAND,HAZARIBAGH,2021-01-24,5,223,0,228
JHARKHAND,HAZARIBAGH,2021-01-25,1,653,0,654
JHARKHAND,JAMTARA,2021-01-21,3,270,2,275
JHARKHAND,JAMTARA,2021-01-22,0,279,2,281
JHARKHAND,JAMTARA,2021-01-23,0,216,15,231
JHARKHAND,JAMTARA,2021-01-24,1,129,1,131
JHARKHAND,JAMTARA,2021-01-25,0,243,21,264
JHARKHAND,KHUNTI,2021-01-21,0,205,0,205
JHARKHAND,KHUNTI,2021-01-22,0,501,0,501
JHARKHAND,KHUNTI,2021-01-23,0,435,0,435
JHARKHAND,KHUNTI,2021-01-24,1,80,0,81
JHARKHAND,KHUNTI,2021-01-25,0,581,0,581
JHARKHAND,KODERMA,2021-01-21,0,498,0,498
JHARKHAND,KODERMA,2021-01-22,2,565,0,567
JHARKHAND,KODERMA,2021-01-23,0,442,0,442
JHARKHAND,KODERMA,2021-01-24,0,207,0,207
JHARKHAND,KODERMA,2021-01-25,3,78,0,81
JHARKHAND,LATEHAR,2021-01-21,0,37,3,40
JHARKHAND,LATEHAR,2021-01-22,0,100,0,100
JHARKHAND,LATEHAR,2021-01-23,0,74,0,74
JHARKHAND,LATEHAR,2021-01-24,0,67,0,67
JHARKHAND,LATEHAR,2021-01-25,0,605,6,611
JHARKHAND,LOHARDAGA,2021-01-21,2,126,0,128
JHARKHAND,LOHARDAGA,2021-01-22,1,74,0,75
JHARKHAND,LOHARDAGA,2021-01-23,0,606,0,606
JHARKHAND,LOHARDAGA,2021-01-24,0,28,0,28
JHARKHAND,LOHARDAGA,2021-01-25,0,38,0,38
JHARKHAND,PAKUR,2021-01-21,0,767,0,767
JHARKHAND,PAKUR,2021-01-22,0,417,0,417
JHARKHAND,PAKUR,2021-01-23,1,258,0,259
JHARKHAND,PAKUR,2021-01-24,0,581,0,581
JHARKHAND,PAKUR,2021-01-25,1,570,0,571
JHARKHAND,PALAMU,2021-01-21,1,968,2,971
JHARKHAND,PALAMU,2021-01-22,3,843,1,847
JHARKHAND,PALAMU,2021-01-23,6,2291,7,2304
JHARKHAND,PALAMU,2021-01-24,13,1783,1,1797
JHARKHAND,PALAMU,2021-01-25,1,1624,0,1625
JHARKHAND,RAMGARH,2021-01-21,1,399,0,400
JHARKHAND,RAMGARH,2021-01-22,2,149,0,151
JHARKHAND,RAMGARH,2021-01-23,3,385,0,388
JHARKHAND,RAMGARH,2021-01-24,0,262,0,262
JHARKHAND,RAMGARH,2021-01-25,5,463,0,468
JHARKHAND,RANCHI,2021-01-21,52,895,0,947
JHARKHAND,RANCHI,2021-01-22,64,616,7,687
JHARKHAND,RANCHI,2021-01-23,55,770,1,826
JHARKHAND,RANCHI,2021-01-24,56,568,0,624
JHARKHAND,RANCHI,2021-01-25,50,513,0,563
JHARKHAND,SAHEBGANJ,2021-01-21,1,550,0,551
JHARKHAND,SAHEBGANJ,2021-01-22,1,376,0,377
JHARKHAND,SAHEBGANJ,2021-01-23,0,32,0,32
JHARKHAND,SAHEBGANJ,2021-01-24,0,18,0,18
JHARKHAND,SAHEBGANJ,2021-01-25,0,573,0,573
JHARKHAND,SARAIKELA KHARSAWAN,2021-01-21,0,448,0,448
JHARKHAND,SARAIKELA KHARSAWAN,2021-01-22,1,940,0,941
JHARKHAND,SARAIKELA KHARSAWAN,2021-01-23,1,31,0,32
JHARKHAND,SARAIKELA KHARSAWAN,2021-01-24,0,32,0,32
JHARKHAND,SARAIKELA KHARSAWAN,2021-01-25,2,868,3,873
JHARKHAND,SIMDEGA,2021-01-21,1,347,0,348
JHARKHAND,SIMDEGA,2021-01-22,0,722,0,722
JHARKHAND,SIMDEGA,2021-01-23,0,264,0,264
JHARKHAND,SIMDEGA,2021-01-24,1,443,0,444
JHARKHAND,SIMDEGA,2021-01-25,5,159,0,164
JHARKHAND,WEST SINGHBHUM,2021-01-21,5,1427,0,1432
JHARKHAND,WEST SINGHBHUM,2021-01-22,1,599,0,600
JHARKHAND,WEST SINGHBHUM,2021-01-23,0,868,0,868
JHARKHAND,WEST SINGHBHUM,2021-01-24,2,86,0,88
JHARKHAND,WEST SINGHBHUM,2021-01-25,0,964,0,964
KARNATAKA,BAGALKOTE,2021-01-21,3,2645,11,2659
KARNATAKA,BAGALKOTE,2021-01-22,4,1923,13,1940
KARNATAKA,BAGALKOTE,2021-01-23,0,1890,9,1899
KARNATAKA,BAGALKOTE,2021-01-24,1,1085,1,1087
KARNATAKA,BAGALKOTE,2021-01-25,0,1091,3,1094
KARNATAKA,BALLARI,2021-01-21,7,1567,5,1579
KARNATAKA,BALLARI,2021-01-22,9,1783,11,1803
KARNATAKA,BALLARI,2021-01-23,8,1792,0,1800
KARNATAKA,BALLARI,2021-01-24,2,979,0,981
KARNATAKA,BALLARI,2021-01-25,4,632,0,636
KARNATAKA,BELAGAVI,2021-01-21,20,4179,2,4201
KARNATAKA,BELAGAVI,2021-01-22,25,3298,5,3328
KARNATAKA,BELAGAVI,2021-01-23,23,2230,2,2255
KARNATAKA,BELAGAVI,2021-01-24,2,84,0,86
KARNATAKA,BELAGAVI,2021-01-25,14,3009,7,3030
KARNATAKA,BENGALURU RURAL,2021-01-21,19,1820,3,1842
KARNATAKA,BENGALURU RURAL,2021-01-22,15,1145,0,1160
KARNATAKA,BENGALURU RURAL,2021-01-23,8,1356,1,1365
KARNATAKA,BENGALURU RURAL,2021-01-24,12,386,0,398
KARNATAKA,BENGALURU RURAL,2021-01-25,13,859,0,872
KARNATAKA,BENGALURU URBAN,2021-01-21,354,33007,149,33510
KARNATAKA,BENGALURU URBAN,2021-01-22,378,33871,94,34343
KARNATAKA,BENGALURU URBAN,2021-01-23,334,33002,21,33357
KARNATAKA,BENGALURU URBAN,2021-01-24,242,23284,43,23569
KARNATAKA,BENGALURU URBAN,2021-01-25,298,33662,67,34027
KARNATAKA,BIDAR,2021-01-21,1,1529,0,1530
KARNATAKA,BIDAR,2021-01-22,8,1261,0,1269
KARNATAKA,BIDAR,2021-01-23,5,1336,1,1342
KARNATAKA,BIDAR,2021-01-24,8,998,0,1006
KARNATAKA,BIDAR,2021-01-25,0,638,0,638
KARNATAKA,CHAMARAJANAGARA,2021-01-21,1,868,1,870
KARNATAKA,CHAMARAJANAGARA,2021-01-22,6,1327,0,1333
KARNATAKA,CHAMARAJANAGARA,2021-01-23,0,283,0,283
KARNATAKA,CHAMARAJANAGARA,2021-01-24,5,588,2,595
KARNATAKA,CHAMARAJANAGARA,2021-01-25,1,308,3,312
KARNATAKA,CHIKKABALLAPURA,2021-01-21,19,1708,12,1739
KARNATAKA,CHIKKABALLAPURA,2021-01-22,12,2033,2,2047
KARNATAKA,CHIKKABALLAPURA,2021-01-23,16,1683,2,1701
KARNATAKA,CHIKKABALLAPURA,2021-01-24,13,2548,3,2564
KARNATAKA,CHIKKABALLAPURA,2021-01-25,19,1524,13,1556
KARNATAKA,CHIKKAMAGALURU,2021-01-21,3,1452,7,1462
KARNATAKA,CHIKKAMAGALURU,2021-01-22,4,1100,7,1111
KARNATAKA,CHIKKAMAGALURU,2021-01-23,8,1543,8,1559
KARNATAKA,CHIKKAMAGALURU,2021-01-24,2,550,3,555
KARNATAKA,CHIKKAMAGALURU,2021-01-25,5,514,1,520
KARNATAKA,CHITRADURGA,2021-01-21,19,1496,4,1519
KARNATAKA,CHITRADURGA,2021-01-22,11,1144,2,1157
KARNATAKA,CHITRADURGA,2021-01-23,6,1205,0,1211
KARNATAKA,CHITRADURGA,2021-01-24,11,953,1,965
KARNATAKA,CHITRADURGA,2021-01-25,7,1173,1,1181
KARNATAKA,DAKSHINA KANNADA,2021-01-21,16,2626,10,2652
KARNATAKA,DAKSHINA KANNADA,2021-01-22,32,2983,2,3017
KARNATAKA,DAKSHINA KANNADA,2021-01-23,81,2343,2,2426
KARNATAKA,DAKSHINA KANNADA,2021-01-24,8,1153,1,1162
KARNATAKA,DAKSHINA KANNADA,2021-01-25,20,1983,2,2005
KARNATAKA,DAVANGERE,2021-01-21,8,3405,178,3591
KARNATAKA,DAVANGERE,2021-01-22,10,3425,85,3520
KARNATAKA,DAVANGERE,2021-01-23,11,2790,21,2822
KARNATAKA,DAVANGERE,2021-01-24,4,1781,14,1799
KARNATAKA,DAVANGERE,2021-01-25,16,2514,3,2533
KARNATAKA,DHARWAD,2021-01-21,9,3153,39,3201
KARNATAKA,DHARWAD,2021-01-22,11,2384,17,2412
KARNATAKA,DHARWAD,2021-01-23,5,2509,18,2532
KARNATAKA,DHARWAD,2021-01-24,3,1885,11,1899
KARNATAKA,DHARWAD,2021-01-25,5,1093,2,1100
KARNATAKA,GADAG,2021-01-21,3,1444,49,1496
KARNATAKA,GADAG,2021-01-22,1,1278,147,1426
KARNATAKA,GADAG,2021-01-23,4,869,144,1017
KARNATAKA,GADAG,2021-01-24,1,1247,155,1403
KARNATAKA,GADAG,2021-01-25,0,709,94,803
KARNATAKA,HASSAN,2021-01-21,15,3217,44,3276
KARNATAKA,HASSAN,2021-01-22,14,2540,40,2594
KARNATAKA,HASSAN,2021-01-23,16,3945,72,4033
KARNATAKA,HASSAN,2021-01-24,12,3801,19,3832
KARNATAKA,HASSAN,2021-01-25,19,903,43,965
KARNATAKA,HAVERI,2021-01-21,1,1288,0,1289
KARNATAKA,HAVERI,2021-01-22,0,1050,0,1050
KARNATAKA,HAVERI,2021-01-23,4,666,0,670
KARNATAKA,HAVERI,2021-01-24,0,323,0,323
KARNATAKA,HAVERI,2021-01-25,1,1122,0,1123
KARNATAKA,KALABURAGI,2021-01-21,27,2765,2,2794
KARNATAKA,KALABURAGI,2021-01-22,20,2164,5,2189
KARNATAKA,KALABURAGI,2021-01-23,14,1651,15,1680
KARNATAKA,KALABURAGI,2021-01-24,29,1466,10,1505
KARNATAKA,KALABURAGI,2021-01-25,10,434,1,445
KARNATAKA,KODAGU,2021-01-21,3,720,8,731
KARNATAKA,KODAGU,2021-01-22,6,519,16,541
KARNATAKA,KODAGU,2021-01-23,5,590,27,622
KARNATAKA,KODAGU,2021-01-24,10,972,12,994
KARNATAKA,KODAGU,2021-01-25,0,30,0,30
KARNATAKA,KOLAR,2021-01-21,5,2006,7,2018
KARNATAKA,KOLAR,2021-01-22,1,2020,2,2023
KARNATAKA,KOLAR,2021-01-23,4,2305,3,2312
KARNATAKA,KOLAR,2021-01-24,1,2035,0,2036
KARNATAKA,KOLAR,2021-01-25,2,1087,12,1101
KARNATAKA,KOPPAL,2021-01-21,0,978,2,980
KARNATAKA,KOPPAL,2021-01-22,1,1058,4,1063
KARNATAKA,KOPPAL,2021-01-23,0,944,4,948
KARNATAKA,KOPPAL,2021-01-24,0,550,2,552
KARNATAKA,KOPPAL,2021-01-25,0,237,1,238
KARNATAKA,MANDYA,2021-01-21,5,2719,7,2731
KARNATAKA,MANDYA,2021-01-22,9,2291,0,2300
KARNATAKA,MANDYA,2021-01-23,7,2726,9,2742
KARNATAKA,MANDYA,2021-01-24,4,1142,0,1146
KARNATAKA,MANDYA,2021-01-25,11,1672,4,1687
KARNATAKA,MYSURU,2021-01-21,40,5389,3,5432
KARNATAKA,MYSURU,2021-01-22,43,3657,3,3703
KARNATAKA,MYSURU,2021-01-23,51,4277,4,4332
KARNATAKA,MYSURU,2021-01-24,22,3391,1,3414
KARNATAKA,MYSURU,2021-01-25,30,1949,6,1985
KARNATAKA,RAICHUR,2021-01-21,5,1180,4,1189
KARNATAKA,RAICHUR,2021-01-22,1,1645,3,1649
KARNATAKA,RAICHUR,2021-01-23,3,1041,13,1057
KARNATAKA,RAICHUR,2021-01-24,4,958,0,962
KARNATAKA,RAICHUR,2021-01-25,3,993,1,997
KARNATAKA,RAMANAGARA,2021-01-21,1,790,0,791
KARNATAKA,RAMANAGARA,2021-01-22,0,501,2,503
KARNATAKA,RAMANAGARA,2021-01-23,0,586,0,586
KARNATAKA,RAMANAGARA,2021-01-24,0,255,0,255
KARNATAKA,RAMANAGARA,2021-01-25,1,667,0,668
KARNATAKA,SHIVAMOGGA,2021-01-21,7,2262,7,2276
KARNATAKA,SHIVAMOGGA,2021-01-22,13,1904,18,1935
KARNATAKA,SHIVAMOGGA,2021-01-23,5,1501,2,1508
KARNATAKA,SHIVAMOGGA,2021-01-24,4,227,0,231
KARNATAKA,SHIVAMOGGA,2021-01-25,6,1227,1,1234
KARNATAKA,TUMAKURU,2021-01-21,36,2943,0,2979
KARNATAKA,TUMAKURU,2021-01-22,20,2173,1,2194
KARNATAKA,TUMAKURU,2021-01-23,33,2058,3,2094
KARNATAKA,TUMAKURU,2021-01-24,3,1646,0,1649
KARNATAKA,TUMAKURU,2021-01-25,38,2332,28,2398
KARNATAKA,UDUPI,2021-01-21,11,1149,0,1160
KARNATAKA,UDUPI,2021-01-22,6,1026,0,1032
KARNATAKA,UDUPI,2021-01-23,19,730,0,749
KARNATAKA,UDUPI,2021-01-24,3,747,0,750
KARNATAKA,UDUPI,2021-01-25,10,833,0,843
KARNATAKA,UTTARA KANNADA,2021-01-21,17,1478,102,1597
KARNATAKA,UTTARA KANNADA,2021-01-22,9,1579,90,1678
KARNATAKA,UTTARA KANNADA,2021-01-23,12,1467,41,1520
KARNATAKA,UTTARA KANNADA,2021-01-24,11,1397,84,1492
KARNATAKA,UTTARA KANNADA,2021-01-25,16,667,82,765
KARNATAKA,VIJAYAPURA,2021-01-21,8,1716,0,1724
KARNATAKA,VIJAYAPURA,2021-01-22,2,1943,0,1945
KARNATAKA,VIJAYAPURA,2021-01-23,5,823,0,828
KARNATAKA,VIJAYAPURA,2021-01-24,0,1543,1,1544
KARNATAKA,VIJAYAPURA,2021-01-25,2,1221,0,1223
KARNATAKA,YADGIR,2021-01-21,2,1335,0,1337
KARNATAKA,YADGIR,2021-01-22,1,1374,0,1375
KARNATAKA,YADGIR,2021-01-23,1,981,0,982
KARNATAKA,YADGIR,2021-01-24,2,877,0,879
KARNATAKA,YADGIR,2021-01-25,6,574,1,581
KERALA,ALAPPUZHA,2021-01-21,514,3696,2,4212
KERALA,ALAPPUZHA,2021-01-22,490,2868,4,3362
KERALA,ALAPPUZHA,2021-01-23,352,3001,1,3354
KERALA,ALAPPUZHA,2021-01-24,239,1371,4,1614
KERALA,ALAPPUZHA,2021-01-25,478,2891,7,3376
KERALA,ERNAKULAM,2021-01-21,1070,5797,22,6889
KERALA,ERNAKULAM,2021-01-22,1233,5714,4,6951
KERALA,ERNAKULAM,2021-01-23,1138,5980,20,7138
KERALA,ERNAKULAM,2021-01-24,453,2195,8,2656
KERALA,ERNAKULAM,2021-01-25,1004,6639,20,7663
KERALA,IDUKKI,2021-01-21,323,1914,2,2239
KERALA,IDUKKI,2021-01-22,252,1667,1,1920
KERALA,IDUKKI,2021-01-23,345,1986,11,2342
KERALA,IDUKKI,2021-01-24,133,926,9,1068
KERALA,IDUKKI,2021-01-25,234,1427,2,1663
KERALA,KANNUR,2021-01-21,336,2440,2,2778
KERALA,KANNUR,2021-01-22,426,2252,5,2683
KERALA,KANNUR,2021-01-23,421,2753,0,3174
KERALA,KANNUR,2021-01-24,180,1061,6,1247
KERALA,KANNUR,2021-01-25,314,2326,0,2640
KERALA,KASARAGOD,2021-01-21,82,1270,1,1353
KERALA,KASARAGOD,2021-01-22,136,1629,2,1767
KERALA,KASARAGOD,2021-01-23,177,1531,0,1708
KERALA,KASARAGOD,2021-01-24,28,489,4,521
KERALA,KASARAGOD,2021-01-25,137,1607,0,1744
KERALA,KOLLAM,2021-01-21,668,5260,0,5928
KERALA,KOLLAM,2021-01-22,639,4297,0,4936
KERALA,KOLLAM,2021-01-23,758,4795,0,5553
KERALA,KOLLAM,2021-01-24,319,2172,0,2491
KERALA,KOLLAM,2021-01-25,743,5228,3,5974
KERALA,KOTTAYAM,2021-01-21,707,3308,5,4020
KERALA,KOTTAYAM,2021-01-22,833,3644,2,4479
KERALA,KOTTAYAM,2021-01-23,827,3393,4,4224
KERALA,KOTTAYAM,2021-01-24,324,1650,3,1977
KERALA,KOTTAYAM,2021-01-25,711,3676,8,4395
KERALA,KOZHIKODE,2021-01-21,811,4332,22,5165
KERALA,KOZHIKODE,2021-01-22,903,3944,55,4902
KERALA,KOZHIKODE,2021-01-23,976,4932,55,5963
KERALA,KOZHIKODE,2021-01-24,501,1685,45,2231
KERALA,KOZHIKODE,2021-01-25,618,4534,18,5170
KERALA,MALAPPURAM,2021-01-21,591,3276,2,3869
KERALA,MALAPPURAM,2021-01-22,466,3374,6,3846
KERALA,MALAPPURAM,2021-01-23,497,3250,5,3752
KERALA,MALAPPURAM,2021-01-24,181,1401,2,1584
KERALA,MALAPPURAM,2021-01-25,471,3536,8,4015
KERALA,PALAKKAD,2021-01-21,309,2646,0,2955
KERALA,PALAKKAD,2021-01-22,319,2608,0,2927
KERALA,PALAKKAD,2021-01-23,295,2727,2,3024
KERALA,PALAKKAD,2021-01-24,130,715,0,845
KERALA,PALAKKAD,2021-01-25,266,2322,1,2589
KERALA,PATHANAMTHITTA,2021-01-21,645,2872,4,3521
KERALA,PATHANAMTHITTA,2021-01-22,624,2921,2,3547
KERALA,PATHANAMTHITTA,2021-01-23,590,3100,5,3695
KERALA,PATHANAMTHITTA,2021-01-24,146,1191,2,1339
KERALA,PATHANAMTHITTA,2021-01-25,559,2957,6,3522
KERALA,THIRUVANANTHAPURAM,2021-01-21,614,5669,0,6283
KERALA,THIRUVANANTHAPURAM,2021-01-22,574,4427,0,5001
KERALA,THIRUVANANTHAPURAM,2021-01-23,570,4759,1,5330
KERALA,THIRUVANANTHAPURAM,2021-01-24,351,1793,0,2144
KERALA,THIRUVANANTHAPURAM,2021-01-25,589,4420,0,5009
KERALA,THRISSUR,2021-01-21,569,3942,0,4511
KERALA,THRISSUR,2021-01-22,598,3898,1,4497
KERALA,THRISSUR,2021-01-23,558,3974,0,4532
KERALA,THRISSUR,2021-01-24,262,1481,0,1743
KERALA,THRISSUR,2021-01-25,631,3901,0,4532
KERALA,WAYANAD,2021-01-21,258,1562,2,1822
KERALA,WAYANAD,2021-01-22,303,1190,2,1495
KERALA,WAYANAD,2021-01-23,353,1219,5,1577
KERALA,WAYANAD,2021-01-24,88,691,0,779
KERALA,WAYANAD,2021-01-25,291,1450,4,1745
LADAKH,KARGIL,2021-01-21,0,53,0,53
LADAKH,KARGIL,2021-01-22,0,56,0,56
LADAKH,KARGIL,2021-01-23,0,54,0,54
LADAKH,KARGIL,2021-01-24,0,26,0,26
LADAKH,KARGIL,2021-01-25,0,44,0,44
LADAKH,LEH LADAKH,2021-01-21,1,169,0,170
LADAKH,LEH LADAKH,2021-01-22,1,164,0,165
LADAKH,LEH LADAKH,2021-01-23,17,219,0,236
LADAKH,LEH LADAKH,2021-01-24,0,140,0,140
LADAKH,LEH LADAKH,2021-01-25,1,144,0,145
LAKSHADWEEP,LAKSHADWEEP DISTRICT,2021-01-21,0,148,0,148
LAKSHADWEEP,LAKSHADWEEP DISTRICT,2021-01-22,0,93,0,93
LAKSHADWEEP,LAKSHADWEEP DISTRICT,2021-01-23,0,165,0,165
LAKSHADWEEP,LAKSHADWEEP DISTRICT,2021-01-24,0,189,0,189
LAKSHADWEEP,LAKSHADWEEP DISTRICT,2021-01-25,0,39,0,39
MADHYA PRADESH,AGAR MALWA,2021-01-21,0,302,0,302
MADHYA PRADESH,AGAR MALWA,2021-01-22,0,272,0,272
MADHYA PRADESH,AGAR MALWA,2021-01-23,1,122,0,123
MADHYA PRADESH,AGAR MALWA,2021-01-24,0,299,0,299
MADHYA PRADESH,AGAR MALWA,2021-01-25,5,121,0,126
MADHYA PRADESH,ALIRAJPUR,2021-01-21,2,172,0,174
MADHYA PRADESH,ALIRAJPUR,2021-01-22,2,221,0,223
MADHYA PRADESH,ALIRAJPUR,2021-01-23,1,214,0,215
MADHYA PRADESH,ALIRAJPUR,2021-01-24,0,18,0,18
MADHYA PRADESH,ALIRAJPUR,2021-01-25,0,375,0,375
MADHYA PRADESH,ANUPPUR,2021-01-21,0,41,0,41
MADHYA PRADESH,ANUPPUR,2021-01-22,0,49,0,49
MADHYA PRADESH,ANUPPUR,2021-01-23,3,101,4,108
MADHYA PRADESH,ANUPPUR,2021-01-24,0,139,47,186
MADHYA PRADESH,ANUPPUR,2021-01-25,1,79,23,103
MADHYA PRADESH,ASHOKNAGAR,2021-01-21,0,154,0,154
MADHYA PRADESH,ASHOKNAGAR,2021-01-22,6,191,0,197
MADHYA PRADESH,ASHOKNAGAR,2021-01-23,2,335,0,337
MADHYA PRADESH,ASHOKNAGAR,2021-01-24,0,106,0,106
MADHYA PRADESH,ASHOKNAGAR,2021-01-25,1,317,0,318
MADHYA PRADESH,BALAGHAT,2021-01-21,7,402,8,417
MADHYA PRADESH,BALAGHAT,2021-01-22,3,465,1,469
MADHYA PRADESH,BALAGHAT,2021-01-23,3,498,1,502
MADHYA PRADESH,BALAGHAT,2021-01-24,6,413,1,420
MADHYA PRADESH,BALAGHAT,2021-01-25,7,277,0,284
MADHYA PRADESH,BARWANI,2021-01-21,7,201,0,208
MADHYA PRADESH,BARWANI,2021-01-22,7,173,0,180
MADHYA PRADESH,BARWANI,2021-01-23,7,308,0,315
MADHYA PRADESH,BARWANI,2021-01-24,9,63,1,73
MADHYA PRADESH,BARWANI,2021-01-25,4,299,0,303
MADHYA PRADESH,BETUL,2021-01-21,28,483,8,519
MADHYA PRADESH,BETUL,2021-01-22,7,477,1,485
MADHYA PRADESH,BETUL,2021-01-23,6,773,0,779
MADHYA PRADESH,BETUL,2021-01-24,3,323,1,327
MADHYA PRADESH,BETUL,2021-01-25,9,447,2,458
MADHYA PRADESH,BHIND,2021-01-21,2,477,0,479
MADHYA PRADESH,BHIND,2021-01-22,0,451,0,451
MADHYA PRADESH,BHIND,2021-01-23,2,386,0,388
MADHYA PRADESH,BHIND,2021-01-24,0,292,0,292
MADHYA PRADESH,BHIND,2021-01-25,3,271,0,274
MADHYA PRADESH,BHOPAL,2021-01-21,93,2398,16,2507
MADHYA PRADESH,BHOPAL,2021-01-22,95,2205,8,2308
MADHYA PRADESH,BHOPAL,2021-01-23,95,2611,23,2729
MADHYA PRADESH,BHOPAL,2021-01-24,96,1871,9,1976
MADHYA PRADESH,BHOPAL,2021-01-25,66,1696,24,1786
MADHYA PRADESH,BURHANPUR,2021-01-21,0,166,0,166
MADHYA PRADESH,BURHANPUR,2021-01-22,0,104,0,104
MADHYA PRADESH,BURHANPUR,2021-01-23,0,164,0,164
MADHYA PRADESH,BURHANPUR,2021-01-24,0,146,0,146
MADHYA PRADESH,BURHANPUR,2021-01-25,3,272,0,275
MADHYA PRADESH,CHHATARPUR,2021-01-21,2,412,0,414
MADHYA PRADESH,CHHATARPUR,2021-01-22,3,145,0,148
MADHYA PRADESH,CHHATARPUR,2021-01-23,0,528,3,531
MADHYA PRADESH,CHHATARPUR,2021-01-24,1,261,1,263
MADHYA PRADESH,CHHATARPUR,2021-01-25,2,492,0,494
MADHYA PRADESH,CHHINDWARA,2021-01-21,9,461,31,501
MADHYA PRADESH,CHHINDWARA,2021-01-22,4,515,23,542
MADHYA PRADESH,CHHINDWARA,2021-01-23,6,470,6,482
MADHYA PRADESH,CHHINDWARA,2021-01-24,5,292,1,298
MADHYA PRADESH,CHHINDWARA,2021-01-25,9,340,2,351
MADHYA PRADESH,DAMOH,2021-01-21,8,309,0,317
MADHYA PRADESH,DAMOH,2021-01-22,2,112,0,114
MADHYA PRADESH,DAMOH,2021-01-23,4,261,9,274
MADHYA PRADESH,DAMOH,2021-01-24,3,194,0,197
MADHYA PRADESH,DAMOH,2021-01-25,5,237,0,242
MADHYA PRADESH,DATIA,2021-01-21,3,270,11,284
MADHYA PRADESH,DATIA,2021-01-22,3,347,10,360
MADHYA PRADESH,DATIA,2021-01-23,1,210,6,217
MADHYA PRADESH,DATIA,2021-01-24,1,191,18,210
MADHYA PRADESH,DATIA,2021-01-25,2,255,0,257
MADHYA PRADESH,DEWAS,2021-01-21,6,193,0,199
MADHYA PRADESH,DEWAS,2021-01-22,18,384,1,403
MADHYA PRADESH,DEWAS,2021-01-23,11,228,0,239
MADHYA PRADESH,DEWAS,2021-01-24,6,225,0,231
MADHYA PRADESH,DEWAS,2021-01-25,17,121,0,138
MADHYA PRADESH,DHAR,2021-01-21,4,156,0,160
MADHYA PRADESH,DHAR,2021-01-22,1,179,0,180
MADHYA PRADESH,DHAR,2021-01-23,6,462,0,468
MADHYA PRADESH,DHAR,2021-01-24,0,154,1,155
MADHYA PRADESH,DHAR,2021-01-25,5,515,0,520
MADHYA PRADESH,DINDORI,2021-01-21,1,170,0,171
MADHYA PRADESH,DINDORI,2021-01-22,3,536,0,539
MADHYA PRADESH,DINDORI,2021-01-23,3,292,0,295
MADHYA PRADESH,DINDORI,2021-01-24,0,431,0,431
MADHYA PRADESH,DINDORI,2021-01-25,2,175,0,177
MADHYA PRADESH,EAST NIMAR,2021-01-21,3,443,4,450
MADHYA PRADESH,EAST NIMAR,2021-01-22,5,409,3,417
MADHYA PRADESH,EAST NIMAR,2021-01-23,2,434,0,436
MADHYA PRADESH,EAST NIMAR,2021-01-24,0,276,1,277
MADHYA PRADESH,EAST NIMAR,2021-01-25,3,413,1,417
MADHYA PRADESH,GUNA,2021-01-21,3,518,0,521
MADHYA PRADESH,GUNA,2021-01-22,5,279,0,284
MADHYA PRADESH,GUNA,2021-01-23,3,430,0,433
MADHYA PRADESH,GUNA,2021-01-24,1,301,0,302
MADHYA PRADESH,GUNA,2021-01-25,0,335,1,336
MADHYA PRADESH,GWALIOR,2021-01-21,18,2187,1,2206
MADHYA PRADESH,GWALIOR,2021-01-22,8,2229,5,2242
MADHYA PRADESH,GWALIOR,2021-01-23,5,1415,1,1421
MADHYA PRADESH,GWALIOR,2021-01-24,3,1318,1,1322
MADHYA PRADESH,GWALIOR,2021-01-25,8,1764,4,1776
MADHYA PRADESH,HARDA,2021-01-21,6,185,2,193
MADHYA PRADESH,HARDA,2021-01-22,2,219,0,221
MADHYA PRADESH,HARDA,2021-01-23,2,317,1,320
MADHYA PRADESH,HARDA,2021-01-24,1,337,0,338
MADHYA PRADESH,HARDA,2021-01-25,2,276,1,279
MADHYA PRADESH,HOSHANGABAD,2021-01-21,5,383,0,388
MADHYA PRADESH,HOSHANGABAD,2021-01-22,10,286,0,296
MADHYA PRADESH,HOSHANGABAD,2021-01-23,5,232,1,238
MADHYA PRADESH,HOSHANGABAD,2021-01-24,1,241,0,242
MADHYA PRADESH,HOSHANGABAD,2021-01-25,3,294,3,300
MADHYA PRADESH,INDORE,2021-01-21,54,3534,0,3588
MADHYA PRADESH,INDORE,2021-01-22,55,3540,2,3597
MADHYA PRADESH,INDORE,2021-01-23,47,2649,1,2697
MADHYA PRADESH,INDORE,2021-01-24,30,1719,4,1753
MADHYA PRADESH,INDORE,2021-01-25,48,1797,1,1846
MADHYA PRADESH,JABALPUR,2021-01-21,33,780,2,815
MADHYA PRADESH,JABALPUR,2021-01-22,14,442,14,470
MADHYA PRADESH,JABALPUR,2021-01-23,36,461,7,504
MADHYA PRADESH,JABALPUR,2021-01-24,12,278,0,290
MADHYA PRADESH,JABALPUR,2021-01-25,28,464,12,504
MADHYA PRADESH,JHABUA,2021-01-21,3,247,0,250
MADHYA PRADESH,JHABUA,2021-01-22,1,563,0,564
MADHYA PRADESH,JHABUA,2021-01-23,6,585,0,591
MADHYA PRADESH,JHABUA,2021-01-24,5,253,4,262
MADHYA PRADESH,JHABUA,2021-01-25,1,502,0,503
MADHYA PRADESH,KATNI,2021-01-21,3,136,3,142
MADHYA PRADESH,KATNI,2021-01-22,2,155,0,157
MADHYA PRADESH,KATNI,2021-01-23,1,188,0,189
MADHYA PRADESH,KATNI,2021-01-24,3,306,3,312
MADHYA PRADESH,KATNI,2021-01-25,0,40,0,40
MADHYA PRADESH,KHARGONE,2021-01-21,3,295,0,298
MADHYA PRADESH,KHARGONE,2021-01-22,6,403,0,409
MADHYA PRADESH,KHARGONE,2021-01-23,15,402,0,417
MADHYA PRADESH,KHARGONE,2021-01-24,2,95,6,103
MADHYA PRADESH,KHARGONE,2021-01-25,8,349,0,357
MADHYA PRADESH,MANDLA,2021-01-21,1,59,0,60
MADHYA PRADESH,MANDLA,2021-01-22,3,76,0,79
MADHYA PRADESH,MANDLA,2021-01-23,1,366,0,367
MADHYA PRADESH,MANDLA,2021-01-24,0,186,1,187
MADHYA PRADESH,MANDLA,2021-01-25,0,480,0,480
MADHYA PRADESH,MANDSAUR,2021-01-21,3,211,8,222
MADHYA PRADESH,MANDSAUR,2021-01-22,5,223,1,229
MADHYA PRADESH,MANDSAUR,2021-01-23,4,219,1,224
MADHYA PRADESH,MANDSAUR,2021-01-24,1,98,0,99
MADHYA PRADESH,MANDSAUR,2021-01-25,2,213,0,215
MADHYA PRADESH,MORENA,2021-01-21,2,362,2,366
MADHYA PRADESH,MORENA,2021-01-22,0,361,1,362
MADHYA PRADESH,MORENA,2021-01-23,0,330,1,331
MADHYA PRADESH,MORENA,2021-01-24,1,238,1,240
MADHYA PRADESH,MORENA,2021-01-25,1,469,0,470
MADHYA PRADESH,NARSINGHPUR,2021-01-21,3,408,0,411
MADHYA PRADESH,NARSINGHPUR,2021-01-22,2,199,1,202
MADHYA PRADESH,NARSINGHPUR,2021-01-23,2,596,2,600
MADHYA PRADESH,NARSINGHPUR,2021-01-24,0,442,0,442
MADHYA PRADESH,NARSINGHPUR,2021-01-25,6,497,2,505
MADHYA PRADESH,NEEMUCH,2021-01-21,3,266,1,270
MADHYA PRADESH,NEEMUCH,2021-01-22,4,162,0,166
MADHYA PRADESH,NEEMUCH,2021-01-23,9,244,2,255
MADHYA PRADESH,NEEMUCH,2021-01-24,2,80,0,82
MADHYA PRADESH,NEEMUCH,2021-01-25,1,93,0,94
MADHYA PRADESH,NIWARI,2021-01-21,1,114,0,115
MADHYA PRADESH,NIWARI,2021-01-22,0,76,0,76
MADHYA PRADESH,NIWARI,2021-01-23,1,271,3,275
MADHYA PRADESH,NIWARI,2021-01-24,1,134,1,136
MADHYA PRADESH,NIWARI,2021-01-25,0,158,1,159
MADHYA PRADESH,PANNA,2021-01-21,2,79,0,81
MADHYA PRADESH,PANNA,2021-01-22,1,291,3,295
MADHYA PRADESH,PANNA,2021-01-23,1,127,0,128
MADHYA PRADESH,PANNA,2021-01-24,0,255,0,255
MADHYA PRADESH,PANNA,2021-01-25,1,109,0,110
MADHYA PRADESH,RAISEN,2021-01-21,6,240,0,246
MADHYA PRADESH,RAISEN,2021-01-22,5,161,0,166
MADHYA PRADESH,RAISEN,2021-01-23,4,124,0,128
MADHYA PRADESH,RAISEN,2021-01-24,1,49,0,50
MADHYA PRADESH,RAISEN,2021-01-25,2,158,0,160
MADHYA PRADESH,RAJGARH,2021-01-21,2,213,1,216
MADHYA PRADESH,RAJGARH,2021-01-22,5,277,1,283
MADHYA PRADESH,RAJGARH,2021-01-23,8,404,0,412
MADHYA PRADESH,RAJGARH,2021-01-24,1,270,2,273
MADHYA PRADESH,RAJGARH,2021-01-25,1,213,0,214
MADHYA PRADESH,RATLAM,2021-01-21,4,294,1,299
MADHYA PRADESH,RATLAM,2021-01-22,9,535,6,550
MADHYA PRADESH,RATLAM,2021-01-23,13,363,3,379
MADHYA PRADESH,RATLAM,2021-01-24,2,128,0,130
MADHYA PRADESH,RATLAM,2021-01-25,8,302,1,311
MADHYA PRADESH,REWA,2021-01-21,2,555,1,558
MADHYA PRADESH,REWA,2021-01-22,9,790,4,803
MADHYA PRADESH,REWA,2021-01-23,5,908,3,916
MADHYA PRADESH,REWA,2021-01-24,7,866,8,881
MADHYA PRADESH,REWA,2021-01-25,2,353,0,355
MADHYA PRADESH,SAGAR,2021-01-21,4,912,3,919
MADHYA PRADESH,SAGAR,2021-01-22,9,858,3,870
MADHYA PRADESH,SAGAR,2021-01-23,4,498,0,502
MADHYA PRADESH,SAGAR,2021-01-24,3,1193,5,1201
MADHYA PRADESH,SAGAR,2021-01-25,9,456,1,466
MADHYA PRADESH,SATNA,2021-01-21,10,436,2,448
MADHYA PRADESH,SATNA,2021-01-22,3,473,5,481
MADHYA PRADESH,SATNA,2021-01-23,3,257,0,260
MADHYA PRADESH,SATNA,2021-01-24,0,223,1,224
MADHYA PRADESH,SATNA,2021-01-25,5,288,2,295
MADHYA PRADESH,SEHORE,2021-01-21,1,500,7,508
MADHYA PRADESH,SEHORE,2021-01-22,6,294,0,300
MADHYA PRADESH,SEHORE,2021-01-23,1,462,0,463
MADHYA PRADESH,SEHORE,2021-01-24,3,462,1,466
MADHYA PRADESH,SEHORE,2021-01-25,0,371,7,378
MADHYA PRADESH,SEONI,2021-01-21,2,275,20,297
MADHYA PRADESH,SEONI,2021-01-22,0,280,11,291
MADHYA PRADESH,SEONI,2021-01-23,2,154,211,367
MADHYA PRADESH,SEONI,2021-01-24,3,245,0,248
MADHYA PRADESH,SEONI,2021-01-25,0,223,0,223
MADHYA PRADESH,SHAHDOL,2021-01-21,1,78,0,79
MADHYA PRADESH,SHAHDOL,2021-01-22,0,123,4,127
MADHYA PRADESH,SHAHDOL,2021-01-23,10,46,1,57
MADHYA PRADESH,SHAHDOL,2021-01-24,0,302,41,343
MADHYA PRADESH,SHAHDOL,2021-01-25,2,161,1,164
MADHYA PRADESH,SHAJAPUR,2021-01-21,2,284,0,286
MADHYA PRADESH,SHAJAPUR,2021-01-22,10,355,0,365
MADHYA PRADESH,SHAJAPUR,2021-01-23,2,280,0,282
MADHYA PRADESH,SHAJAPUR,2021-01-24,1,117,0,118
MADHYA PRADESH,SHAJAPUR,2021-01-25,4,418,0,422
MADHYA PRADESH,SHEOPUR,2021-01-21,2,209,1,212
MADHYA PRADESH,SHEOPUR,2021-01-22,2,122,0,124
MADHYA PRADESH,SHEOPUR,2021-01-23,4,165,0,169
MADHYA PRADESH,SHEOPUR,2021-01-24,2,203,0,205
MADHYA PRADESH,SHEOPUR,2021-01-25,0,298,0,298
MADHYA PRADESH,SHIVPURI,2021-01-21,3,211,0,214
MADHYA PRADESH,SHIVPURI,2021-01-22,1,247,12,260
MADHYA PRADESH,SHIVPURI,2021-01-23,2,287,6,295
MADHYA PRADESH,SHIVPURI,2021-01-24,0,191,1,192
MADHYA PRADESH,SHIVPURI,2021-01-25,0,159,0,159
MADHYA PRADESH,SIDHI,2021-01-21,2,239,0,241
MADHYA PRADESH,SIDHI,2021-01-22,0,418,0,418
MADHYA PRADESH,SIDHI,2021-01-23,0,91,0,91
MADHYA PRADESH,SIDHI,2021-01-24,0,187,1,188
MADHYA PRADESH,SIDHI,2021-01-25,5,303,0,308
MADHYA PRADESH,SINGRAULI,2021-01-21,5,245,0,250
MADHYA PRADESH,SINGRAULI,2021-01-22,2,215,0,217
MADHYA PRADESH,SINGRAULI,2021-01-23,1,225,0,226
MADHYA PRADESH,SINGRAULI,2021-01-24,1,253,0,254
MADHYA PRADESH,SINGRAULI,2021-01-25,0,425,0,425
MADHYA PRADESH,TIKAMGARH,2021-01-21,2,262,0,264
MADHYA PRADESH,TIKAMGARH,2021-01-22,6,107,0,113
MADHYA PRADESH,TIKAMGARH,2021-01-23,4,326,7,337
MADHYA PRADESH,TIKAMGARH,2021-01-24,2,144,7,153
MADHYA PRADESH,TIKAMGARH,2021-01-25,2,147,0,149
MADHYA PRADESH,UJJAIN,2021-01-21,1,316,0,317
MADHYA PRADESH,UJJAIN,2021-01-22,10,292,0,302
MADHYA PRADESH,UJJAIN,2021-01-23,17,433,1,451
MADHYA PRADESH,UJJAIN,2021-01-24,0,34,4,38
MADHYA PRADESH,UJJAIN,2021-01-25,8,557,0,565
MADHYA PRADESH,UMARIA,2021-01-21,1,70,0,71
MADHYA PRADESH,UMARIA,2021-01-22,3,148,2,153
MADHYA PRADESH,UMARIA,2021-01-23,1,189,2,192
MADHYA PRADESH,UMARIA,2021-01-24,0,77,0,77
MADHYA PRADESH,UMARIA,2021-01-25,1,219,4,224
MADHYA PRADESH,VIDISHA,2021-01-21,4,251,0,255
MADHYA PRADESH,VIDISHA,2021-01-22,5,186,1,192
MADHYA PRADESH,VIDISHA,2021-01-23,1,147,1,149
MADHYA PRADESH,VIDISHA,2021-01-24,1,30,0,31
MADHYA PRADESH,VIDISHA,2021-01-25,2,58,3,63
MAHARASHTRA,AHMEDNAGAR,2021-01-21,69,1127,1,1197
MAHARASHTRA,AHMEDNAGAR,2021-01-22,120,1364,0,1484
MAHARASHTRA,AHMEDNAGAR,2021-01-23,130,1449,0,1579
MAHARASHTRA,AHMEDNAGAR,2021-01-24,64,1692,1,1757
MAHARASHTRA,AHMEDNAGAR,2021-01-25,110,944,0,1054
MAHARASHTRA,AKOLA,2021-01-21,40,333,0,373
MAHARASHTRA,AKOLA,2021-01-22,37,1081,1,1119
MAHARASHTRA,AKOLA,2021-01-23,33,1160,1,1194
MAHARASHTRA,AKOLA,2021-01-24,50,701,0,751
MAHARASHTRA,AKOLA,2021-01-25,17,929,0,946
MAHARASHTRA,AMRAVATI,2021-01-21,87,664,0,751
MAHARASHTRA,AMRAVATI,2021-01-22,60,542,0,602
MAHARASHTRA,AMRAVATI,2021-01-23,53,341,0,394
MAHARASHTRA,AMRAVATI,2021-01-24,37,208,0,245
MAHARASHTRA,AMRAVATI,2021-01-25,70,590,1,661
MAHARASHTRA,AURANGABAD,2021-01-21,46,1590,0,1636
MAHARASHTRA,AURANGABAD,2021-01-22,32,1888,2,1922
MAHARASHTRA,AURANGABAD,2021-01-23,40,1054,0,1094
MAHARASHTRA,AURANGABAD,2021-01-24,29,1021,0,1050
MAHARASHTRA,AURANGABAD,2021-01-25,22,1282,0,1304
MAHARASHTRA,BEED,2021-01-21,39,589,0,628
MAHARASHTRA,BEED,2021-01-22,51,691,0,742
MAHARASHTRA,BEED,2021-01-23,41,646,0,687
MAHARASHTRA,BEED,2021-01-24,21,625,0,646
MAHARASHTRA,BEED,2021-01-25,47,930,0,977
MAHARASHTRA,BHANDARA,2021-01-21,14,325,0,339
MAHARASHTRA,BHANDARA,2021-01-22,23,605,0,628
MAHARASHTRA,BHANDARA,2021-01-23,14,511,0,525
MAHARASHTRA,BHANDARA,2021-01-24,17,277,0,294
MAHARASHTRA,BHANDARA,2021-01-25,15,591,0,606
MAHARASHTRA,BULDHANA,2021-01-21,48,420,21,489
MAHARASHTRA,BULDHANA,2021-01-22,46,468,5,519
MAHARASHTRA,BULDHANA,2021-01-23,62,787,32,881
MAHARASHTRA,BULDHANA,2021-01-24,34,680,2,716
MAHARASHTRA,BULDHANA,2021-01-25,35,837,3,875
MAHARASHTRA,CHANDRAPUR,2021-01-21,25,678,0,703
MAHARASHTRA,CHANDRAPUR,2021-01-22,22,947,5,974
MAHARASHTRA,CHANDRAPUR,2021-01-23,25,1507,3,1535
MAHARASHTRA,CHANDRAPUR,2021-01-24,20,894,17,931
MAHARASHTRA,CHANDRAPUR,2021-01-25,25,1055,2,1082
MAHARASHTRA,DHULE,2021-01-21,9,380,53,442
MAHARASHTRA,DHULE,2021-01-22,17,448,138,603
MAHARASHTRA,DHULE,2021-01-23,15,300,63,378
MAHARASHTRA,DHULE,2021-01-24,6,269,0,275
MAHARASHTRA,DHULE,2021-01-25,13,280,106,399
MAHARASHTRA,GADCHIROLI,2021-01-21,5,584,2,591
MAHARASHTRA,GADCHIROLI,2021-01-22,7,511,1,519
MAHARASHTRA,GADCHIROLI,2021-01-23,3,508,0,511
MAHARASHTRA,GADCHIROLI,2021-01-24,2,234,1,237
MAHARASHTRA,GADCHIROLI,2021-01-25,12,756,0,768
MAHARASHTRA,GONDIA,2021-01-21,9,357,0,366
MAHARASHTRA,GONDIA,2021-01-22,12,609,0,621
MAHARASHTRA,GONDIA,2021-01-23,21,299,0,320
MAHARASHTRA,GONDIA,2021-01-24,9,128,0,137
MAHARASHTRA,GONDIA,2021-01-25,23,566,0,589
MAHARASHTRA,HINGOLI,2021-01-21,8,258,0,266
MAHARASHTRA,HINGOLI,2021-01-22,6,279,0,285
MAHARASHTRA,HINGOLI,2021-01-23,9,608,0,617
MAHARASHTRA,HINGOLI,2021-01-24,4,400,0,404
MAHARASHTRA,HINGOLI,2021-01-25,9,605,0,614
MAHARASHTRA,JALGAON,2021-01-21,35,1556,0,1591
MAHARASHTRA,JALGAON,2021-01-22,45,1285,0,1330
MAHARASHTRA,JALGAON,2021-01-23,26,1145,1,1172
MAHARASHTRA,JALGAON,2021-01-24,24,1094,0,1118
MAHARASHTRA,JALGAON,2021-01-25,20,1462,0,1482
MAHARASHTRA,JALNA,2021-01-21,26,508,0,534
MAHARASHTRA,JALNA,2021-01-22,16,487,0,503
MAHARASHTRA,JALNA,2021-01-23,12,427,0,439
MAHARASHTRA,JALNA,2021-01-24,0,288,0,288
MAHARASHTRA,JALNA,2021-01-25,24,452,0,476
MAHARASHTRA,KOLHAPUR,2021-01-21,23,1120,4,1147
MAHARASHTRA,KOLHAPUR,2021-01-22,13,894,4,911
MAHARASHTRA,KOLHAPUR,2021-01-23,15,1104,1,1120
MAHARASHTRA,KOLHAPUR,2021-01-24,7,790,2,799
MAHARASHTRA,KOLHAPUR,2021-01-25,6,593,1,600
MAHARASHTRA,LATUR,2021-01-21,63,2079,2,2144
MAHARASHTRA,LATUR,2021-01-22,52,2310,0,2362
MAHARASHTRA,LATUR,2021-01-23,41,2152,3,2196
MAHARASHTRA,LATUR,2021-01-24,73,1930,8,2011
MAHARASHTRA,LATUR,2021-01-25,44,1142,2,1188
MAHARASHTRA,MUMBAI,2021-01-21,439,12356,39,12834
MAHARASHTRA,MUMBAI,2021-01-22,424,13043,24,13491
MAHARASHTRA,MUMBAI,2021-01-23,445,12860,21,13326
MAHARASHTRA,MUMBAI,2021-01-24,367,8836,10,9213
MAHARASHTRA,MUMBAI,2021-01-25,361,9514,28,9903
MAHARASHTRA,MUMBAI SUBURBAN,2021-01-21,129,2826,3,2958
MAHARASHTRA,MUMBAI SUBURBAN,2021-01-22,106,2799,3,2908
MAHARASHTRA,MUMBAI SUBURBAN,2021-01-23,119,2710,3,2832
MAHARASHTRA,MUMBAI SUBURBAN,2021-01-24,71,1819,0,1890
MAHARASHTRA,MUMBAI SUBURBAN,2021-01-25,89,1924,3,2016
MAHARASHTRA,NAGPUR,2021-01-21,304,3092,19,3415
MAHARASHTRA,NAGPUR,2021-01-22,311,2921,25,3257
MAHARASHTRA,NAGPUR,2021-01-23,372,3242,37,3651
MAHARASHTRA,NAGPUR,2021-01-24,249,2635,15,2899
MAHARASHTRA,NAGPUR,2021-01-25,235,2922,30,3187
MAHARASHTRA,NANDED,2021-01-21,41,1494,23,1558
MAHARASHTRA,NANDED,2021-01-22,21,1201,15,1237
MAHARASHTRA,NANDED,2021-01-23,6,832,10,848
MAHARASHTRA,NANDED,2021-01-24,7,1903,11,1921
MAHARASHTRA,NANDED,2021-01-25,51,1773,2,1826
MAHARASHTRA,NANDURBAR,2021-01-21,54,328,1,383
MAHARASHTRA,NANDURBAR,2021-01-22,44,183,0,227
MAHARASHTRA,NANDURBAR,2021-01-23,26,38,1,65
MAHARASHTRA,NANDURBAR,2021-01-24,37,27,0,64
MAHARASHTRA,NANDURBAR,2021-01-25,53,315,0,368
MAHARASHTRA,NASHIK,2021-01-21,126,1127,0,1253
MAHARASHTRA,NASHIK,2021-01-22,162,2055,0,2217
MAHARASHTRA,NASHIK,2021-01-23,162,2516,0,2678
MAHARASHTRA,NASHIK,2021-01-24,43,1243,0,1286
MAHARASHTRA,NASHIK,2021-01-25,227,2870,0,3097
MAHARASHTRA,OSMANABAD,2021-01-21,26,389,0,415
MAHARASHTRA,OSMANABAD,2021-01-22,22,310,1,333
MAHARASHTRA,OSMANABAD,2021-01-23,17,274,3,294
MAHARASHTRA,OSMANABAD,2021-01-24,7,273,1,281
MAHARASHTRA,OSMANABAD,2021-01-25,30,140,4,174
MAHARASHTRA,PALGHAR,2021-01-21,40,831,1,872
MAHARASHTRA,PALGHAR,2021-01-22,50,915,1,966
MAHARASHTRA,PALGHAR,2021-01-23,43,1096,2,1141
MAHARASHTRA,PALGHAR,2021-01-24,16,310,3,329
MAHARASHTRA,PALGHAR,2021-01-25,28,1174,3,1205
MAHARASHTRA,PARBHANI,2021-01-21,14,157,2,173
MAHARASHTRA,PARBHANI,2021-01-22,5,97,0,102
MAHARASHTRA,PARBHANI,2021-01-23,10,180,0,190
MAHARASHTRA,PARBHANI,2021-01-24,6,267,0,273
MAHARASHTRA,PARBHANI,2021-01-25,4,203,0,207
MAHARASHTRA,PUNE,2021-01-21,629,7078,61,7768
MAHARASHTRA,PUNE,2021-01-22,538,6886,41,7465
MAHARASHTRA,PUNE,2021-01-23,556,5899,101,6556
MAHARASHTRA,PUNE,2021-01-24,281,3552,81,3914
MAHARASHTRA,PUNE,2021-01-25,546,5702,39,6287
MAHARASHTRA,RAIGAD,2021-01-21,46,1030,4,1080
MAHARASHTRA,RAIGAD,2021-01-22,68,1104,1,1173
MAHARASHTRA,RAIGAD,2021-01-23,43,898,0,941
MAHARASHTRA,RAIGAD,2021-01-24,63,1103,3,1169
MAHARASHTRA,RAIGAD,2021-01-25,42,801,1,844
MAHARASHTRA,RATNAGIRI,2021-01-21,10,140,0,150
MAHARASHTRA,RATNAGIRI,2021-01-22,21,248,1,270
MAHARASHTRA,RATNAGIRI,2021-01-23,10,113,0,123
MAHARASHTRA,RATNAGIRI,2021-01-24,2,73,1,76
MAHARASHTRA,RATNAGIRI,2021-01-25,8,149,0,157
MAHARASHTRA,SANGLI,2021-01-21,20,671,2,693
MAHARASHTRA,SANGLI,2021-01-22,12,829,1,842
MAHARASHTRA,SANGLI,2021-01-23,28,790,0,818
MAHARASHTRA,SANGLI,2021-01-24,14,443,2,459
MAHARASHTRA,SANGLI,2021-01-25,11,1093,0,1104
MAHARASHTRA,SATARA,2021-01-21,71,907,0,978
MAHARASHTRA,SATARA,2021-01-22,68,464,0,532
MAHARASHTRA,SATARA,2021-01-23,66,567,1,634
MAHARASHTRA,SATARA,2021-01-24,42,783,6,831
MAHARASHTRA,SATARA,2021-01-25,70,511,1,582
MAHARASHTRA,SINDHUDURG,2021-01-21,17,267,0,284
MAHARASHTRA,SINDHUDURG,2021-01-22,13,219,1,233
MAHARASHTRA,SINDHUDURG,2021-01-23,5,141,0,146
MAHARASHTRA,SINDHUDURG,2021-01-24,12,53,0,65
MAHARASHTRA,SINDHUDURG,2021-01-25,20,268,0,288
MAHARASHTRA,SOLAPUR,2021-01-21,60,2700,16,2776
MAHARASHTRA,SOLAPUR,2021-01-22,74,2516,7,2597
MAHARASHTRA,SOLAPUR,2021-01-23,54,2029,3,2086
MAHARASHTRA,SOLAPUR,2021-01-24,55,1637,1,1693
MAHARASHTRA,SOLAPUR,2021-01-25,73,2622,4,2699
MAHARASHTRA,THANE,2021-01-21,362,7077,24,7463
MAHARASHTRA,THANE,2021-01-22,356,8605,15,8976
MAHARASHTRA,THANE,2021-01-23,399,7362,15,7776
MAHARASHTRA,THANE,2021-01-24,277,9345,34,9656
MAHARASHTRA,THANE,2021-01-25,313,6577,5,6895
MAHARASHTRA,WARDHA,2021-01-21,32,760,7,799
MAHARASHTRA,WARDHA,2021-01-22,42,600,7,649
MAHARASHTRA,WARDHA,2021-01-23,37,592,3,632
MAHARASHTRA,WARDHA,2021-01-24,29,211,0,240
MAHARASHTRA,WARDHA,2021-01-25,26,705,3,734
MAHARASHTRA,WASHIM,2021-01-21,21,434,2,457
MAHARASHTRA,WASHIM,2021-01-22,26,318,2,346
MAHARASHTRA,WASHIM,2021-01-23,13,323,0,336
MAHARASHTRA,WASHIM,2021-01-24,19,747,1,767
MAHARASHTRA,WASHIM,2021-01-25,9,610,0,619
MAHARASHTRA,YAVATMAL,2021-01-21,63,588,0,651
MAHARASHTRA,YAVATMAL,2021-01-22,46,488,0,534
MAHARASHTRA,YAVATMAL,2021-01-23,61,711,1,773
MAHARASHTRA,YAVATMAL,2021-01-24,54,441,0,495
MAHARASHTRA,YAVATMAL,2021-01-25,68,528,1,597
MANIPUR,BISHNUPUR,2021-01-21,2,114,0,116
MANIPUR,BISHNUPUR,2021-01-22,0,61,0,61
MANIPUR,BISHNUPUR,2021-01-23,0,84,0,84
MANIPUR,BISHNUPUR,2021-01-24,1,57,0,58
MANIPUR,BISHNUPUR,2021-01-25,0,79,0,79
MANIPUR,CHANDEL,2021-01-21,1,44,0,45
MANIPUR,CHANDEL,2021-01-22,0,15,0,15
MANIPUR,CHANDEL,2021-01-23,1,38,0,39
MANIPUR,CHANDEL,2021-01-24,0,17,0,17
MANIPUR,CHANDEL,2021-01-25,0,51,0,51
MANIPUR,CHURACHANDPUR,2021-01-21,1,83,0,84
MANIPUR,CHURACHANDPUR,2021-01-22,4,72,0,76
MANIPUR,CHURACHANDPUR,2021-01-23,4,120,0,124
MANIPUR,CHURACHANDPUR,2021-01-24,3,48,0,51
MANIPUR,CHURACHANDPUR,2021-01-25,0,116,0,116
MANIPUR,IMPHAL EAST,2021-01-21,1,243,0,244
MANIPUR,IMPHAL EAST,2021-01-22,1,196,0,197
MANIPUR,IMPHAL EAST,2021-01-23,6,207,0,213
MANIPUR,IMPHAL EAST,2021-01-24,3,170,0,173
MANIPUR,IMPHAL EAST,2021-01-25,6,179,1,186
MANIPUR,IMPHAL WEST,2021-01-21,37,1051,0,1088
MANIPUR,IMPHAL WEST,2021-01-22,84,1004,1,1089
MANIPUR,IMPHAL WEST,2021-01-23,32,883,0,915
MANIPUR,IMPHAL WEST,2021-01-24,32,604,0,636
MANIPUR,IMPHAL WEST,2021-01-25,12,586,0,598
MANIPUR,JIRIBAM,2021-01-21,0,2,0,2
MANIPUR,JIRIBAM,2021-01-22,0,1,0,1
MANIPUR,JIRIBAM,2021-01-23,0,1,0,1
MANIPUR,JIRIBAM,2021-01-24,0,2,0,2
MANIPUR,JIRIBAM,2021-01-25,0,1,0,1
MANIPUR,KAKCHING,2021-01-21,7,81,0,88
MANIPUR,KAKCHING,2021-01-22,7,99,0,106
MANIPUR,KAKCHING,2021-01-23,5,84,0,89
MANIPUR,KAKCHING,2021-01-24,13,63,0,76
MANIPUR,KAKCHING,2021-01-25,3,92,0,95
MANIPUR,KAMJONG,2021-01-21,0,4,0,4
MANIPUR,KAMJONG,2021-01-22,0,4,0,4
MANIPUR,KAMJONG,2021-01-23,0,7,0,7
MANIPUR,KAMJONG,2021-01-24,0,3,0,3
MANIPUR,KAMJONG,2021-01-25,0,9,0,9
MANIPUR,KANGPOKPI,2021-01-21,0,33,0,33
MANIPUR,KANGPOKPI,2021-01-22,1,45,0,46
MANIPUR,KANGPOKPI,2021-01-23,1,33,0,34
MANIPUR,KANGPOKPI,2021-01-24,0,15,0,15
MANIPUR,KANGPOKPI,2021-01-25,0,33,0,33
MANIPUR,NONEY,2021-01-21,0,3,0,3
MANIPUR,NONEY,2021-01-22,0,3,0,3
MANIPUR,NONEY,2021-01-23,0,1,0,1
MANIPUR,NONEY,2021-01-25,0,2,0,2
MANIPUR,PHERZAWL,2021-01-23,0,1,0,1
MANIPUR,SENAPATI,2021-01-21,2,13,0,15
MANIPUR,SENAPATI,2021-01-22,0,34,0,34
MANIPUR,SENAPATI,2021-01-23,0,45,0,45
MANIPUR,SENAPATI,2021-01-24,0,22,0,22
MANIPUR,SENAPATI,2021-01-25,0,50,0,50
MANIPUR,TAMENGLONG,2021-01-21,0,22,0,22
MANIPUR,TAMENGLONG,2021-01-22,0,90,0,90
MANIPUR,TAMENGLONG,2021-01-23,2,37,0,39
MANIPUR,TAMENGLONG,2021-01-24,3,43,0,46
MANIPUR,TAMENGLONG,2021-01-25,2,48,0,50
MANIPUR,TENGNOUPAL,2021-01-21,2,2,0,4
MANIPUR,TENGNOUPAL,2021-01-22,0,5,0,5
MANIPUR,TENGNOUPAL,2021-01-24,0,4,0,4
MANIPUR,TENGNOUPAL,2021-01-25,0,10,0,10
MANIPUR,THOUBAL,2021-01-21,4,170,0,174
MANIPUR,THOUBAL,2021-01-22,6,95,0,101
MANIPUR,THOUBAL,2021-01-23,4,155,0,159
MANIPUR,THOUBAL,2021-01-24,8,92,0,100
MANIPUR,THOUBAL,2021-01-25,0,53,0,53
MANIPUR,UKHRUL,2021-01-21,12,154,0,166
MANIPUR,UKHRUL,2021-01-22,2,159,0,161
MANIPUR,UKHRUL,2021-01-23,0,263,0,263
MANIPUR,UKHRUL,2021-01-24,9,236,0,245
MANIPUR,UKHRUL,2021-01-25,4,165,0,169
MEGHALAYA,EAST GARO HILLS,2021-01-21,0,30,0,30
MEGHALAYA,EAST GARO HILLS,2021-01-22,0,17,0,17
MEGHALAYA,EAST GARO HILLS,2021-01-23,0,15,0,15
MEGHALAYA,EAST GARO HILLS,2021-01-24,0,3,0,3
MEGHALAYA,EAST GARO HILLS,2021-01-25,0,29,0,29
MEGHALAYA,EAST JAINTIA HILLS,2021-01-21,0,91,0,91
MEGHALAYA,EAST JAINTIA HILLS,2021-01-22,0,15,0,15
MEGHALAYA,EAST JAINTIA HILLS,2021-01-23,0,8,0,8
MEGHALAYA,EAST JAINTIA HILLS,2021-01-24,1,6,0,7
MEGHALAYA,EAST JAINTIA HILLS,2021-01-25,0,40,0,40
MEGHALAYA,EAST KHASI HILLS,2021-01-21,9,815,0,824
MEGHALAYA,EAST KHASI HILLS,2021-01-22,9,692,0,701
MEGHALAYA,EAST KHASI HILLS,2021-01-23,10,477,1,488
MEGHALAYA,EAST KHASI HILLS,2021-01-24,1,134,1,136
MEGHALAYA,EAST KHASI HILLS,2021-01-25,6,785,1,792
MEGHALAYA,NORTH GARO HILLS,2021-01-21,0,64,0,64
MEGHALAYA,NORTH GARO HILLS,2021-01-22,0,8,0,8
MEGHALAYA,NORTH GARO HILLS,2021-01-23,0,5,0,5
MEGHALAYA,NORTH GARO HILLS,2021-01-25,0,45,0,45
MEGHALAYA,RI BHOI,2021-01-21,2,57,1,60
MEGHALAYA,RI BHOI,2021-01-22,1,71,0,72
MEGHALAYA,RI BHOI,2021-01-23,0,36,0,36
MEGHALAYA,RI BHOI,2021-01-24,0,17,0,17
MEGHALAYA,RI BHOI,2021-01-25,1,93,0,94
MEGHALAYA,SOUTH GARO HILLS,2021-01-21,0,11,0,11
MEGHALAYA,SOUTH GARO HILLS,2021-01-22,0,8,0,8
MEGHALAYA,SOUTH GARO HILLS,2021-01-23,0,15,0,15
MEGHALAYA,SOUTH GARO HILLS,2021-01-24,0,6,0,6
MEGHALAYA,SOUTH GARO HILLS,2021-01-25,0,10,0,10
MEGHALAYA,SOUTH WEST GARO HILLS,2021-01-21,0,27,0,27
MEGHALAYA,SOUTH WEST GARO HILLS,2021-01-22,1,28,0,29
MEGHALAYA,SOUTH WEST GARO HILLS,2021-01-23,0,21,0,21
MEGHALAYA,SOUTH WEST GARO HILLS,2021-01-24,0,57,0,57
MEGHALAYA,SOUTH WEST GARO HILLS,2021-01-25,0,37,0,37
MEGHALAYA,SOUTH WEST KHASI HILLS,2021-01-21,0,15,0,15
MEGHALAYA,SOUTH WEST KHASI HILLS,2021-01-22,0,14,0,14
MEGHALAYA,SOUTH WEST KHASI HILLS,2021-01-23,0,2,0,2
MEGHALAYA,SOUTH WEST KHASI HILLS,2021-01-24,0,32,0,32
MEGHALAYA,SOUTH WEST KHASI HILLS,2021-01-25,0,11,0,11
MEGHALAYA,WEST GARO HILLS,2021-01-21,1,210,0,211
MEGHALAYA,WEST GARO HILLS,2021-01-22,0,187,0,187
MEGHALAYA,WEST GARO HILLS,2021-01-23,0,132,0,132
MEGHALAYA,WEST GARO HILLS,2021-01-24,0,10,0,10
MEGHALAYA,WEST GARO HILLS,2021-01-25,0,237,0,237
MEGHALAYA,WEST JAINTIA HILLS,2021-01-21,0,81,0,81
MEGHALAYA,WEST JAINTIA HILLS,2021-01-22,0,29,0,29
MEGHALAYA,WEST JAINTIA HILLS,2021-01-23,0,44,0,44
MEGHALAYA,WEST JAINTIA HILLS,2021-01-24,0,52,0,52
MEGHALAYA,WEST JAINTIA HILLS,2021-01-25,0,75,0,75
MEGHALAYA,WEST KHASI HILLS,2021-01-21,1,99,0,100
MEGHALAYA,WEST KHASI HILLS,2021-01-22,0,95,0,95
MEGHALAYA,WEST KHASI HILLS,2021-01-23,0,43,0,43
MEGHALAYA,WEST KHASI HILLS,2021-01-24,0,18,0,18
MEGHALAYA,WEST KHASI HILLS,2021-01-25,1,126,0,127
MIZORAM,AIZAWL,2021-01-21,3,516,0,519
MIZORAM,AIZAWL,2021-01-22,3,646,0,649
MIZORAM,AIZAWL,2021-01-23,2,461,2,465
MIZORAM,AIZAWL,2021-01-24,0,124,1,125
MIZORAM,AIZAWL,2021-01-25,6,735,0,741
MIZORAM,CHAMPHAI,2021-01-21,0,63,0,63
MIZORAM,CHAMPHAI,2021-01-22,0,24,0,24
MIZORAM,CHAMPHAI,2021-01-23,0,34,0,34
MIZORAM,CHAMPHAI,2021-01-25,0,14,0,14
MIZORAM,HNAHTHIAL,2021-01-21,0,8,0,8
MIZORAM,HNAHTHIAL,2021-01-22,0,27,0,27
MIZORAM,HNAHTHIAL,2021-01-23,0,53,0,53
MIZORAM,HNAHTHIAL,2021-01-24,0,1,0,1
MIZORAM,HNAHTHIAL,2021-01-25,0,34,0,34
MIZORAM,KHAWZAWL,2021-01-21,0,1,0,1
MIZORAM,KHAWZAWL,2021-01-22,0,19,0,19
MIZORAM,KHAWZAWL,2021-01-23,0,4,0,4
MIZORAM,KHAWZAWL,2021-01-24,0,3,0,3
MIZORAM,KHAWZAWL,2021-01-25,0,3,0,3
MIZORAM,KOLASIB,2021-01-21,0,73,0,73
MIZORAM,KOLASIB,2021-01-22,0,247,0,247
MIZORAM,KOLASIB,2021-01-23,0,99,0,99
MIZORAM,KOLASIB,2021-01-24,0,52,0,52
MIZORAM,KOLASIB,2021-01-25,0,124,0,124
MIZORAM,LAWNGTLAI,2021-01-21,1,145,0,146
MIZORAM,LAWNGTLAI,2021-01-22,0,65,0,65
MIZORAM,LAWNGTLAI,2021-01-23,0,22,0,22
MIZORAM,LAWNGTLAI,2021-01-25,0,90,0,90
MIZORAM,LUNGLEI,2021-01-21,0,189,0,189
MIZORAM,LUNGLEI,2021-01-22,0,94,0,94
MIZORAM,LUNGLEI,2021-01-23,0,78,0,78
MIZORAM,LUNGLEI,2021-01-24,0,7,0,7
MIZORAM,LUNGLEI,2021-01-25,0,34,0,34
MIZORAM,MAMIT,2021-01-21,0,87,0,87
MIZORAM,MAMIT,2021-01-22,0,49,0,49
MIZORAM,MAMIT,2021-01-23,0,48,0,48
MIZORAM,MAMIT,2021-01-24,0,4,0,4
MIZORAM,MAMIT,2021-01-25,0,56,0,56
MIZORAM,SAIHA,2021-01-21,0,26,0,26
MIZORAM,SAIHA,2021-01-22,0,1,0,1
MIZORAM,SAIHA,2021-01-23,0,29,0,29
MIZORAM,SAIHA,2021-01-24,0,4,0,4
MIZORAM,SAIHA,2021-01-25,0,24,0,24
MIZORAM,SAITUAL,2021-01-21,0,10,0,10
MIZORAM,SAITUAL,2021-01-22,0,29,0,29
MIZORAM,SAITUAL,2021-01-23,0,15,0,15
MIZORAM,SAITUAL,2021-01-24,0,2,0,2
MIZORAM,SAITUAL,2021-01-25,0,42,0,42
MIZORAM,SERCHHIP,2021-01-21,0,54,0,54
MIZORAM,SERCHHIP,2021-01-22,0,18,0,18
MIZORAM,SERCHHIP,2021-01-23,0,26,0,26
MIZORAM,SERCHHIP,2021-01-24,0,55,0,55
MIZORAM,SERCHHIP,2021-01-25,0,12,0,12
NAGALAND,DIMAPUR,2021-01-21,0,99,0,99
NAGALAND,DIMAPUR,2021-01-22,5,91,0,96
NAGALAND,DIMAPUR,2021-01-23,0,46,0,46
NAGALAND,DIMAPUR,2021-01-24,0,23,0,23
NAGALAND,DIMAPUR,2021-01-25,3,69,0,72
NAGALAND,KIPHIRE,2021-01-21,0,2,0,2
NAGALAND,KIPHIRE,2021-01-22,0,9,0,9
NAGALAND,KOHIMA,2021-01-21,5,21,0,26
NAGALAND,KOHIMA,2021-01-22,0,11,0,11
NAGALAND,KOHIMA,2021-01-23,5,6,0,11
NAGALAND,KOHIMA,2021-01-24,0,4,0,4
NAGALAND,KOHIMA,2021-01-25,2,62,0,64
NAGALAND,LONGLENG,2021-01-21,0,1,0,1
NAGALAND,LONGLENG,2021-01-25,0,2,0,2
NAGALAND,MOKOKCHUNG,2021-01-21,6,12,0,18
NAGALAND,MOKOKCHUNG,2021-01-22,8,45,0,53
NAGALAND,MOKOKCHUNG,2021-01-23,0,4,0,4
NAGALAND,MOKOKCHUNG,2021-01-24,1,16,0,17
NAGALAND,MOKOKCHUNG,2021-01-25,4,35,0,39
NAGALAND,MON,2021-01-22,0,16,0,16
NAGALAND,PEREN,2021-01-21,1,1,0,2
NAGALAND,PEREN,2021-01-22,0,1,0,1
NAGALAND,PEREN,2021-01-23,0,1,0,1
NAGALAND,PEREN,2021-01-25,0,2,0,2
NAGALAND,PHEK,2021-01-21,13,6,0,19
NAGALAND,PHEK,2021-01-22,0,2,0,2
NAGALAND,PHEK,2021-01-23,0,3,0,3
NAGALAND,PHEK,2021-01-25,0,9,0,9
NAGALAND,TUENSANG,2021-01-21,0,1,0,1
NAGALAND,TUENSANG,2021-01-22,0,1,0,1
NAGALAND,WOKHA,2021-01-22,1,1,0,2
NAGALAND,WOKHA,2021-01-23,6,0,0,6
NAGALAND,ZUNHEBOTO,2021-01-21,0,1,0,1
NAGALAND,ZUNHEBOTO,2021-01-22,0,1,0,1
NAGALAND,ZUNHEBOTO,2021-01-25,0,1,0,1
ODISHA,ANUGUL,2021-01-21,10,449,0,459
ODISHA,ANUGUL,2021-01-22,11,520,0,531
ODISHA,ANUGUL,2021-01-23,3,536,0,539
ODISHA,ANUGUL,2021-01-24,2,334,0,336
ODISHA,ANUGUL,2021-01-25,6,511,0,517
ODISHA,BALANGIR,2021-01-21,2,1246,3,1251
ODISHA,BALANGIR,2021-01-22,5,1091,1,1097
ODISHA,BALANGIR,2021-01-23,2,1119,1,1122
ODISHA,BALANGIR,2021-01-24,0,949,0,949
ODISHA,BALANGIR,2021-01-25,1,1119,1,1121
ODISHA,BALESHWAR,2021-01-21,7,2076,7,2090
ODISHA,BALESHWAR,2021-01-22,13,2013,12,2038
ODISHA,BALESHWAR,2021-01-23,7,1604,1,1612
ODISHA,BALESHWAR,2021-01-24,2,1442,3,1447
ODISHA,BALESHWAR,2021-01-25,12,3043,0,3055
ODISHA,BARGARH,2021-01-21,9,487,0,496
ODISHA,BARGARH,2021-01-22,14,498,0,512
ODISHA,BARGARH,2021-01-23,5,536,0,541
ODISHA,BARGARH,2021-01-24,1,375,0,376
ODISHA,BARGARH,2021-01-25,7,450,0,457
ODISHA,BHADRAK,2021-01-21,8,695,0,703
ODISHA,BHADRAK,2021-01-22,2,644,0,646
ODISHA,BHADRAK,2021-01-23,7,475,0,482
ODISHA,BHADRAK,2021-01-24,1,469,0,470
ODISHA,BHADRAK,2021-01-25,0,784,0,784
ODISHA,BOUDH,2021-01-21,0,380,0,380
ODISHA,BOUDH,2021-01-22,0,102,0,102
ODISHA,BOUDH,2021-01-23,0,211,0,211
ODISHA,BOUDH,2021-01-24,0,375,0,375
ODISHA,BOUDH,2021-01-25,1,262,0,263
ODISHA,CUTTACK,2021-01-21,8,1137,1,1146
ODISHA,CUTTACK,2021-01-22,14,1450,1,1465
ODISHA,CUTTACK,2021-01-23,10,963,0,973
ODISHA,CUTTACK,2021-01-24,5,343,0,348
ODISHA,CUTTACK,2021-01-25,19,1524,0,1543
ODISHA,DEOGARH,2021-01-21,1,279,1,281
ODISHA,DEOGARH,2021-01-22,0,150,0,150
ODISHA,DEOGARH,2021-01-23,4,161,0,165
ODISHA,DEOGARH,2021-01-24,0,90,0,90
ODISHA,DEOGARH,2021-01-25,3,233,0,236
ODISHA,DHENKANAL,2021-01-21,1,652,0,653
ODISHA,DHENKANAL,2021-01-22,1,543,0,544
ODISHA,DHENKANAL,2021-01-23,0,595,0,595
ODISHA,DHENKANAL,2021-01-24,1,210,0,211
ODISHA,DHENKANAL,2021-01-25,4,401,0,405
ODISHA,GAJAPATI,2021-01-21,0,405,0,405
ODISHA,GAJAPATI,2021-01-22,2,251,0,253
ODISHA,GAJAPATI,2021-01-23,3,296,0,299
ODISHA,GAJAPATI,2021-01-24,0,15,0,15
ODISHA,GAJAPATI,2021-01-25,4,379,3,386
ODISHA,GANJAM,2021-01-21,16,1186,0,1202
ODISHA,GANJAM,2021-01-22,5,866,22,893
ODISHA,GANJAM,2021-01-23,5,1033,23,1061
ODISHA,GANJAM,2021-01-24,0,587,1,588
ODISHA,GANJAM,2021-01-25,0,1094,1,1095
ODISHA,JAGATSINGHAPUR,2021-01-21,5,787,0,792
ODISHA,JAGATSINGHAPUR,2021-01-22,4,666,0,670
ODISHA,JAGATSINGHAPUR,2021-01-23,5,657,0,662
ODISHA,JAGATSINGHAPUR,2021-01-24,0,352,0,352
ODISHA,JAGATSINGHAPUR,2021-01-25,3,628,0,631
ODISHA,JAJAPUR,2021-01-21,5,663,1,669
ODISHA,JAJAPUR,2021-01-22,6,795,0,801
ODISHA,JAJAPUR,2021-01-23,0,362,0,362
ODISHA,JAJAPUR,2021-01-24,2,239,0,241
ODISHA,JAJAPUR,2021-01-25,14,505,0,519
ODISHA,JHARSUGUDA,2021-01-21,1,464,0,465
ODISHA,JHARSUGUDA,2021-01-22,2,376,4,382
ODISHA,JHARSUGUDA,2021-01-23,7,364,0,371
ODISHA,JHARSUGUDA,2021-01-24,7,381,0,388
ODISHA,JHARSUGUDA,2021-01-25,4,470,1,475
ODISHA,KALAHANDI,2021-01-21,0,629,0,629
ODISHA,KALAHANDI,2021-01-22,2,373,0,375
ODISHA,KALAHANDI,2021-01-23,3,399,0,402
ODISHA,KALAHANDI,2021-01-24,4,239,0,243
ODISHA,KALAHANDI,2021-01-25,2,278,0,280
ODISHA,KANDHAMAL,2021-01-21,0,695,0,695
ODISHA,KANDHAMAL,2021-01-22,2,901,0,903
ODISHA,KANDHAMAL,2021-01-23,1,744,0,745
ODISHA,KANDHAMAL,2021-01-24,1,726,0,727
ODISHA,KANDHAMAL,2021-01-25,0,765,0,765
ODISHA,KENDRAPARA,2021-01-21,1,920,1,922
ODISHA,KENDRAPARA,2021-01-22,2,963,1,966
ODISHA,KENDRAPARA,2021-01-23,2,732,1,735
ODISHA,KENDRAPARA,2021-01-24,0,662,0,662
ODISHA,KENDRAPARA,2021-01-25,0,1159,1,1160
ODISHA,KENDUJHAR,2021-01-21,5,593,0,598
ODISHA,KENDUJHAR,2021-01-22,3,926,0,929
ODISHA,KENDUJHAR,2021-01-23,2,684,0,686
ODISHA,KENDUJHAR,2021-01-24,0,564,0,564
ODISHA,KENDUJHAR,2021-01-25,3,796,0,799
ODISHA,KHORDHA,2021-01-21,18,1635,5,1658
ODISHA,KHORDHA,2021-01-22,9,1375,3,1387
ODISHA,KHORDHA,2021-01-23,16,1300,2,1318
ODISHA,KHORDHA,2021-01-24,7,911,0,918
ODISHA,KHORDHA,2021-01-25,12,1531,4,1547
ODISHA,KORAPUT,2021-01-21,1,1050,0,1051
ODISHA,KORAPUT,2021-01-22,3,986,0,989
ODISHA,KORAPUT,2021-01-23,0,992,0,992
ODISHA,KORAPUT,2021-01-24,1,960,0,961
ODISHA,KORAPUT,2021-01-25,1,1073,0,1074
ODISHA,MALKANGIRI,2021-01-21,0,326,0,326
ODISHA,MALKANGIRI,2021-01-22,0,398,0,398
ODISHA,MALKANGIRI,2021-01-23,0,474,0,474
ODISHA,MALKANGIRI,2021-01-24,0,350,0,350
ODISHA,MALKANGIRI,2021-01-25,1,381,0,382
ODISHA,MAYURBHANJ,2021-01-21,0,1117,0,1117
ODISHA,MAYURBHANJ,2021-01-22,3,1019,0,1022
ODISHA,MAYURBHANJ,2021-01-23,2,972,0,974
ODISHA,MAYURBHANJ,2021-01-24,6,722,0,728
ODISHA,MAYURBHANJ,2021-01-25,3,1058,0,1061
ODISHA,NABARANGPUR,2021-01-21,0,789,0,789
ODISHA,NABARANGPUR,2021-01-22,5,644,0,649
ODISHA,NABARANGPUR,2021-01-23,1,646,2,649
ODISHA,NABARANGPUR,2021-01-24,0,600,0,600
ODISHA,NABARANGPUR,2021-01-25,0,686,1,687
ODISHA,NAYAGARH,2021-01-21,0,590,0,590
ODISHA,NAYAGARH,2021-01-22,1,622,0,623
ODISHA,NAYAGARH,2021-01-23,0,523,0,523
ODISHA,NAYAGARH,2021-01-24,0,598,0,598
ODISHA,NAYAGARH,2021-01-25,1,730,3,734
ODISHA,NUAPADA,2021-01-21,8,258,0,266
ODISHA,NUAPADA,2021-01-22,7,229,0,236
ODISHA,NUAPADA,2021-01-23,4,238,0,242
ODISHA,NUAPADA,2021-01-24,10,116,0,126
ODISHA,NUAPADA,2021-01-25,9,322,0,331
ODISHA,PURI,2021-01-21,22,835,1,858
ODISHA,PURI,2021-01-22,16,804,1,821
ODISHA,PURI,2021-01-23,5,804,0,809
ODISHA,PURI,2021-01-24,2,724,0,726
ODISHA,PURI,2021-01-25,22,959,4,985
ODISHA,RAYAGADA,2021-01-21,1,684,0,685
ODISHA,RAYAGADA,2021-01-22,4,614,2,620
ODISHA,RAYAGADA,2021-01-23,1,612,0,613
ODISHA,RAYAGADA,2021-01-24,3,647,0,650
ODISHA,RAYAGADA,2021-01-25,0,471,0,471
ODISHA,SAMBALPUR,2021-01-21,25,492,0,517
ODISHA,SAMBALPUR,2021-01-22,29,529,1,559
ODISHA,SAMBALPUR,2021-01-23,18,630,1,649
ODISHA,SAMBALPUR,2021-01-24,10,576,0,586
ODISHA,SAMBALPUR,2021-01-25,45,602,1,648
ODISHA,SONEPUR,2021-01-21,0,469,0,469
ODISHA,SONEPUR,2021-01-22,0,399,0,399
ODISHA,SONEPUR,2021-01-23,0,264,0,264
ODISHA,SONEPUR,2021-01-24,0,223,0,223
ODISHA,SONEPUR,2021-01-25,0,332,0,332
ODISHA,SUNDARGARH,2021-01-21,23,922,0,945
ODISHA,SUNDARGARH,2021-01-22,17,741,1,759
ODISHA,SUNDARGARH,2021-01-23,17,615,0,632
ODISHA,SUNDARGARH,2021-01-24,28,392,0,420
ODISHA,SUNDARGARH,2021-01-25,37,842,0,879
PUDUCHERRY,KARAIKAL,2021-01-21,0,844,0,844
PUDUCHERRY,KARAIKAL,2021-01-22,6,783,0,789
PUDUCHERRY,KARAIKAL,2021-01-23,6,953,0,959
PUDUCHERRY,KARAIKAL,2021-01-24,0,767,0,767
PUDUCHERRY,KARAIKAL,2021-01-25,2,583,0,585
PUDUCHERRY,MAHE,2021-01-21,11,342,0,353
PUDUCHERRY,MAHE,2021-01-22,15,347,0,362
PUDUCHERRY,MAHE,2021-01-23,3,178,0,181
PUDUCHERRY,MAHE,2021-01-24,10,141,0,151
PUDUCHERRY,MAHE,2021-01-25,9,406,0,415
PUDUCHERRY,PONDICHERRY,2021-01-21,13,726,1,740
PUDUCHERRY,PONDICHERRY,2021-01-22,15,661,2,678
PUDUCHERRY,PONDICHERRY,2021-01-23,17,503,3,523
PUDUCHERRY,PONDICHERRY,2021-01-24,18,278,3,299
PUDUCHERRY,PONDICHERRY,2021-01-25,11,603,2,616
PUDUCHERRY,YANAM,2021-01-21,1,81,0,82
PUDUCHERRY,YANAM,2021-01-22,0,156,0,156
PUDUCHERRY,YANAM,2021-01-23,0,58,0,58
PUDUCHERRY,YANAM,2021-01-24,1,41,0,42
PUDUCHERRY,YANAM,2021-01-25,2,134,0,136
PUNJAB,AMRITSAR,2021-01-21,14,1855,14,1883
PUNJAB,AMRITSAR,2021-01-22,23,1753,2,1778
PUNJAB,AMRITSAR,2021-01-23,19,921,10,950
PUNJAB,AMRITSAR,2021-01-24,15,1232,5,1252
PUNJAB,AMRITSAR,2021-01-25,18,1450,0,1468
PUNJAB,BARNALA,2021-01-21,0,191,9,200
PUNJAB,BARNALA,2021-01-22,0,226,0,226
PUNJAB,BARNALA,2021-01-23,0,238,2,240
PUNJAB,BARNALA,2021-01-24,4,160,10,174
PUNJAB,BARNALA,2021-01-25,7,127,10,144
PUNJAB,BATHINDA,2021-01-21,14,1012,9,1035
PUNJAB,BATHINDA,2021-01-22,11,910,11,932
PUNJAB,BATHINDA,2021-01-23,22,785,2,809
PUNJAB,BATHINDA,2021-01-24,20,843,0,863
PUNJAB,BATHINDA,2021-01-25,25,1361,9,1395
PUNJAB,FARIDKOT,2021-01-21,6,153,4,163
PUNJAB,FARIDKOT,2021-01-22,21,205,5,231
PUNJAB,FARIDKOT,2021-01-23,17,233,1,251
PUNJAB,FARIDKOT,2021-01-24,8,200,2,210
PUNJAB,FARIDKOT,2021-01-25,13,122,1,136
PUNJAB,FATEHGARH SAHIB,2021-01-21,10,288,4,302
PUNJAB,FATEHGARH SAHIB,2021-01-22,2,203,2,207
PUNJAB,FATEHGARH SAHIB,2021-01-23,3,234,0,237
PUNJAB,FATEHGARH SAHIB,2021-01-24,3,257,0,260
PUNJAB,FATEHGARH SAHIB,2021-01-25,2,209,1,212
PUNJAB,FAZILKA,2021-01-21,3,159,0,162
PUNJAB,FAZILKA,2021-01-22,0,283,0,283
PUNJAB,FAZILKA,2021-01-23,2,287,2,291
PUNJAB,FAZILKA,2021-01-24,1,335,0,336
PUNJAB,FAZILKA,2021-01-25,0,77,0,77
PUNJAB,FIROZEPUR,2021-01-21,0,148,2,150
PUNJAB,FIROZEPUR,2021-01-22,2,255,2,259
PUNJAB,FIROZEPUR,2021-01-23,2,253,1,256
PUNJAB,FIROZEPUR,2021-01-24,1,185,1,187
PUNJAB,FIROZEPUR,2021-01-25,1,118,0,119
PUNJAB,GURDASPUR,2021-01-21,6,1008,0,1014
PUNJAB,GURDASPUR,2021-01-22,12,946,0,958
PUNJAB,GURDASPUR,2021-01-23,7,985,6,998
PUNJAB,GURDASPUR,2021-01-24,3,1421,5,1429
PUNJAB,GURDASPUR,2021-01-25,7,1126,0,1133
PUNJAB,HOSHIARPUR,2021-01-21,15,1017,15,1047
PUNJAB,HOSHIARPUR,2021-01-22,12,1439,1,1452
PUNJAB,HOSHIARPUR,2021-01-23,12,1372,2,1386
PUNJAB,HOSHIARPUR,2021-01-24,11,1088,2,1101
PUNJAB,HOSHIARPUR,2021-01-25,4,1107,3,1114
PUNJAB,JALANDHAR,2021-01-21,49,3467,212,3728
PUNJAB,JALANDHAR,2021-01-22,31,1863,58,1952
PUNJAB,JALANDHAR,2021-01-23,30,2991,159,3180
PUNJAB,JALANDHAR,2021-01-24,34,2659,13,2706
PUNJAB,JALANDHAR,2021-01-25,27,1215,169,1411
PUNJAB,KAPURTHALA,2021-01-21,4,662,2,668
PUNJAB,KAPURTHALA,2021-01-22,6,476,0,482
PUNJAB,KAPURTHALA,2021-01-23,5,559,7,571
PUNJAB,KAPURTHALA,2021-01-24,8,566,0,574
PUNJAB,KAPURTHALA,2021-01-25,15,1207,3,1225
PUNJAB,LUDHIANA,2021-01-21,53,2258,23,2334
PUNJAB,LUDHIANA,2021-01-22,22,1731,12,1765
PUNJAB,LUDHIANA,2021-01-23,37,2487,5,2529
PUNJAB,LUDHIANA,2021-01-24,45,1535,2,1582
PUNJAB,LUDHIANA,2021-01-25,29,2402,5,2436
PUNJAB,MANSA,2021-01-21,2,396,2,400
PUNJAB,MANSA,2021-01-22,2,365,0,367
PUNJAB,MANSA,2021-01-23,3,400,0,403
PUNJAB,MANSA,2021-01-24,0,238,0,238
PUNJAB,MANSA,2021-01-25,5,246,2,253
PUNJAB,MOGA,2021-01-21,2,197,3,202
PUNJAB,MOGA,2021-01-22,2,198,2,202
PUNJAB,MOGA,2021-01-23,2,177,0,179
PUNJAB,MOGA,2021-01-24,3,122,0,125
PUNJAB,MOGA,2021-01-25,3,125,0,128
PUNJAB,PATHANKOT,2021-01-21,0,374,0,374
PUNJAB,PATHANKOT,2021-01-22,6,666,0,672
PUNJAB,PATHANKOT,2021-01-23,0,498,2,500
PUNJAB,PATHANKOT,2021-01-24,4,576,1,581
PUNJAB,PATHANKOT,2021-01-25,3,436,0,439
PUNJAB,PATIALA,2021-01-21,16,1091,4,1111
PUNJAB,PATIALA,2021-01-22,22,1473,2,1497
PUNJAB,PATIALA,2021-01-23,30,1463,2,1495
PUNJAB,PATIALA,2021-01-24,22,843,1,866
PUNJAB,PATIALA,2021-01-25,32,854,2,888
PUNJAB,RUPNAGAR,2021-01-21,5,479,3,487
PUNJAB,RUPNAGAR,2021-01-22,3,563,8,574
PUNJAB,RUPNAGAR,2021-01-23,2,487,3,492
PUNJAB,RUPNAGAR,2021-01-24,5,411,0,416
PUNJAB,RUPNAGAR,2021-01-25,3,396,1,400
PUNJAB,S.A.S NAGAR,2021-01-21,40,1113,16,1169
PUNJAB,S.A.S NAGAR,2021-01-22,62,992,19,1073
PUNJAB,S.A.S NAGAR,2021-01-23,38,934,4,976
PUNJAB,S.A.S NAGAR,2021-01-24,38,459,1,498
PUNJAB,S.A.S NAGAR,2021-01-25,19,958,6,983
PUNJAB,SANGRUR,2021-01-21,1,1048,4,1053
PUNJAB,SANGRUR,2021-01-22,5,1429,3,1437
PUNJAB,SANGRUR,2021-01-23,3,780,0,783
PUNJAB,SANGRUR,2021-01-24,1,924,2,927
PUNJAB,SANGRUR,2021-01-25,2,1029,1,1032
PUNJAB,SHAHID BHAGAT SINGH NAGAR,2021-01-21,11,103,3,117
PUNJAB,SHAHID BHAGAT SINGH NAGAR,2021-01-22,13,653,0,666
PUNJAB,SHAHID BHAGAT SINGH NAGAR,2021-01-23,8,636,0,644
PUNJAB,SHAHID BHAGAT SINGH NAGAR,2021-01-24,15,1026,0,1041
PUNJAB,SHAHID BHAGAT SINGH NAGAR,2021-01-25,11,103,0,114
PUNJAB,SRI MUKTSAR SAHIB,2021-01-21,1,59,1,61
PUNJAB,SRI MUKTSAR SAHIB,2021-01-22,1,349,1,351
PUNJAB,SRI MUKTSAR SAHIB,2021-01-23,2,260,8,270
PUNJAB,SRI MUKTSAR SAHIB,2021-01-24,3,68,1,72
PUNJAB,SRI MUKTSAR SAHIB,2021-01-25,0,263,0,263
PUNJAB,TARN TARAN,2021-01-21,0,463,0,463
PUNJAB,TARN TARAN,2021-01-22,2,604,4,610
PUNJAB,TARN TARAN,2021-01-23,3,1064,0,1067
PUNJAB,TARN TARAN,2021-01-24,1,1259,3,1263
PUNJAB,TARN TARAN,2021-01-25,1,389,0,390
RAJASTHAN,AJMER,2021-01-21,8,92,721,821
RAJASTHAN,AJMER,2021-01-22,2,115,589,706
RAJASTHAN,AJMER,2021-01-23,7,83,589,679
RAJASTHAN,AJMER,2021-01-24,2,82,369,453
RAJASTHAN,AJMER,2021-01-25,0,53,697,750
RAJASTHAN,ALWAR,2021-01-21,0,1901,12,1913
RAJASTHAN,ALWAR,2021-01-22,1,1232,45,1278
RAJASTHAN,ALWAR,2021-01-23,7,2201,274,2482
RAJASTHAN,ALWAR,2021-01-24,0,1709,170,1879
RAJASTHAN,ALWAR,2021-01-25,5,1744,61,1810
RAJASTHAN,BANSWARA,2021-01-21,4,47,0,51
RAJASTHAN,BANSWARA,2021-01-22,0,138,0,138
RAJASTHAN,BANSWARA,2021-01-23,2,32,0,34
RAJASTHAN,BANSWARA,2021-01-24,7,61,0,68
RAJASTHAN,BANSWARA,2021-01-25,1,25,1,27
RAJASTHAN,BARAN,2021-01-21,1,160,0,161
RAJASTHAN,BARAN,2021-01-22,0,145,2,147
RAJASTHAN,BARAN,2021-01-23,2,165,0,167
RAJASTHAN,BARAN,2021-01-24,1,77,0,78
RAJASTHAN,BARAN,2021-01-25,1,80,1,82
RAJASTHAN,BARMER,2021-01-21,0,176,0,176
RAJASTHAN,BARMER,2021-01-22,0,167,1,168
RAJASTHAN,BARMER,2021-01-23,0,300,0,300
RAJASTHAN,BARMER,2021-01-24,0,144,0,144
RAJASTHAN,BARMER,2021-01-25,1,208,2,211
RAJASTHAN,BHARATPUR,2021-01-21,1,234,5,240
RAJASTHAN,BHARATPUR,2021-01-22,5,320,1,326
RAJASTHAN,BHARATPUR,2021-01-23,3,294,3,300
RAJASTHAN,BHARATPUR,2021-01-24,1,410,5,416
RAJASTHAN,BHARATPUR,2021-01-25,0,26,1,27
RAJASTHAN,BHILWARA,2021-01-21,8,150,7,165
RAJASTHAN,BHILWARA,2021-01-22,18,589,10,617
RAJASTHAN,BHILWARA,2021-01-23,13,397,5,415
RAJASTHAN,BHILWARA,2021-01-24,10,246,0,256
RAJASTHAN,BHILWARA,2021-01-25,6,154,3,163
RAJASTHAN,BIKANER,2021-01-21,0,424,0,424
RAJASTHAN,BIKANER,2021-01-22,0,583,0,583
RAJASTHAN,BIKANER,2021-01-23,0,751,0,751
RAJASTHAN,BIKANER,2021-01-24,0,257,1,258
RAJASTHAN,BIKANER,2021-01-25,0,530,1,531
RAJASTHAN,BUNDI,2021-01-21,0,133,0,133
RAJASTHAN,BUNDI,2021-01-22,0,275,1,276
RAJASTHAN,BUNDI,2021-01-23,0,358,1,359
RAJASTHAN,BUNDI,2021-01-24,0,49,0,49
RAJASTHAN,BUNDI,2021-01-25,3,182,0,185
RAJASTHAN,CHITTORGARH,2021-01-21,8,977,16,1001
RAJASTHAN,CHITTORGARH,2021-01-22,4,787,5,796
RAJASTHAN,CHITTORGARH,2021-01-23,7,998,4,1009
RAJASTHAN,CHITTORGARH,2021-01-24,3,543,1,547
RAJASTHAN,CHITTORGARH,2021-01-25,1,790,2,793
RAJASTHAN,CHURU,2021-01-21,0,205,2,207
RAJASTHAN,CHURU,2021-01-22,0,485,3,488
RAJASTHAN,CHURU,2021-01-23,0,298,4,302
RAJASTHAN,CHURU,2021-01-24,1,45,5,51
RAJASTHAN,CHURU,2021-01-25,1,279,1,281
RAJASTHAN,DAUSA,2021-01-21,1,187,12,200
RAJASTHAN,DAUSA,2021-01-22,0,146,3,149
RAJASTHAN,DAUSA,2021-01-23,2,500,11,513
RAJASTHAN,DAUSA,2021-01-24,1,441,13,455
RAJASTHAN,DAUSA,2021-01-25,0,77,10,87
RAJASTHAN,DHOLPUR,2021-01-21,3,328,3,334
RAJASTHAN,DHOLPUR,2021-01-22,10,522,13,545
RAJASTHAN,DHOLPUR,2021-01-23,0,66,2,68
RAJASTHAN,DHOLPUR,2021-01-24,0,44,0,44
RAJASTHAN,DHOLPUR,2021-01-25,0,406,7,413
RAJASTHAN,DUNGARPUR,2021-01-21,3,159,0,162
RAJASTHAN,DUNGARPUR,2021-01-22,8,459,0,467
RAJASTHAN,DUNGARPUR,2021-01-23,4,281,0,285
RAJASTHAN,DUNGARPUR,2021-01-24,3,168,0,171
RAJASTHAN,DUNGARPUR,2021-01-25,1,108,1,110
RAJASTHAN,GANGANAGAR,2021-01-21,0,10,4,14
RAJASTHAN,GANGANAGAR,2021-01-22,0,24,0,24
RAJASTHAN,GANGANAGAR,2021-01-23,0,23,1,24
RAJASTHAN,GANGANAGAR,2021-01-24,7,29,1,37
RAJASTHAN,GANGANAGAR,2021-01-25,10,41,4,55
RAJASTHAN,HANUMANGARH,2021-01-21,3,597,0,600
RAJASTHAN,HANUMANGARH,2021-01-22,1,871,0,872
RAJASTHAN,HANUMANGARH,2021-01-23,1,884,2,887
RAJASTHAN,HANUMANGARH,2021-01-24,1,1184,0,1185
RAJASTHAN,HANUMANGARH,2021-01-25,0,177,0,177
RAJASTHAN,JAIPUR,2021-01-21,24,2232,279,2535
RAJASTHAN,JAIPUR,2021-01-22,42,2418,260,2720
RAJASTHAN,JAIPUR,2021-01-23,100,2472,308,2880
RAJASTHAN,JAIPUR,2021-01-24,57,1671,276,2004
RAJASTHAN,JAIPUR,2021-01-25,83,2872,242,3197
RAJASTHAN,JAISALMER,2021-01-21,2,621,1,624
RAJASTHAN,JAISALMER,2021-01-22,4,690,2,696
RAJASTHAN,JAISALMER,2021-01-23,3,730,1,734
RAJASTHAN,JAISALMER,2021-01-24,0,394,1,395
RAJASTHAN,JAISALMER,2021-01-25,6,521,1,528
RAJASTHAN,JALORE,2021-01-21,2,1154,0,1156
RAJASTHAN,JALORE,2021-01-22,31,1280,3,1314
RAJASTHAN,JALORE,2021-01-23,9,1519,1,1529
RAJASTHAN,JALORE,2021-01-24,5,1530,1,1536
RAJASTHAN,JALORE,2021-01-25,2,1367,4,1373
RAJASTHAN,JHALAWAR,2021-01-21,0,72,2,74
RAJASTHAN,JHALAWAR,2021-01-22,30,261,20,311
RAJASTHAN,JHALAWAR,2021-01-23,5,356,0,361
RAJASTHAN,JHALAWAR,2021-01-24,11,429,2,442
RAJASTHAN,JHALAWAR,2021-01-25,7,333,4,344
RAJASTHAN,JHUNJHUNU,2021-01-21,0,122,8,130
RAJASTHAN,JHUNJHUNU,2021-01-22,2,103,7,112
RAJASTHAN,JHUNJHUNU,2021-01-23,1,57,6,64
RAJASTHAN,JHUNJHUNU,2021-01-24,0,58,3,61
RAJASTHAN,JHUNJHUNU,2021-01-25,1,46,5,52
RAJASTHAN,JODHPUR,2021-01-21,26,739,2,767
RAJASTHAN,JODHPUR,2021-01-22,18,805,17,840
RAJASTHAN,JODHPUR,2021-01-23,5,927,0,932
RAJASTHAN,JODHPUR,2021-01-24,14,746,1,761
RAJASTHAN,JODHPUR,2021-01-25,6,421,10,437
RAJASTHAN,KARAULI,2021-01-21,2,59,41,102
RAJASTHAN,KARAULI,2021-01-22,0,86,9,95
RAJASTHAN,KARAULI,2021-01-23,3,145,6,154
RAJASTHAN,KARAULI,2021-01-24,1,248,4,253
RAJASTHAN,KARAULI,2021-01-25,8,440,5,453
RAJASTHAN,KOTA,2021-01-21,0,1867,1,1868
RAJASTHAN,KOTA,2021-01-22,54,2743,6,2803
RAJASTHAN,KOTA,2021-01-23,58,1643,3,1704
RAJASTHAN,KOTA,2021-01-24,1,1567,4,1572
RAJASTHAN,KOTA,2021-01-25,99,1796,0,1895
RAJASTHAN,NAGAUR,2021-01-21,80,119,287,486
RAJASTHAN,NAGAUR,2021-01-22,75,471,465,1011
RAJASTHAN,NAGAUR,2021-01-23,14,232,499,745
RAJASTHAN,NAGAUR,2021-01-24,0,285,42,327
RAJASTHAN,NAGAUR,2021-01-25,70,116,236,422
RAJASTHAN,PALI,2021-01-21,1,24,2,27
RAJASTHAN,PALI,2021-01-22,1,10,10,21
RAJASTHAN,PALI,2021-01-23,4,354,7,365
RAJASTHAN,PALI,2021-01-24,3,102,6,111
RAJASTHAN,PALI,2021-01-25,11,595,9,615
RAJASTHAN,PRATAPGARH,2021-01-21,1,10,0,11
RAJASTHAN,PRATAPGARH,2021-01-22,1,7,0,8
RAJASTHAN,PRATAPGARH,2021-01-23,0,9,0,9
RAJASTHAN,PRATAPGARH,2021-01-24,0,4,0,4
RAJASTHAN,PRATAPGARH,2021-01-25,0,10,0,10
RAJASTHAN,RAJSAMAND,2021-01-21,14,736,1,751
RAJASTHAN,RAJSAMAND,2021-01-22,25,491,2,518
RAJASTHAN,RAJSAMAND,2021-01-23,14,612,7,633
RAJASTHAN,RAJSAMAND,2021-01-24,18,473,1,492
RAJASTHAN,RAJSAMAND,2021-01-25,10,353,0,363
RAJASTHAN,SAWAI MADHOPUR,2021-01-21,31,863,11,905
RAJASTHAN,SAWAI MADHOPUR,2021-01-22,1,294,10,305
RAJASTHAN,SAWAI MADHOPUR,2021-01-23,0,392,10,402
RAJASTHAN,SAWAI MADHOPUR,2021-01-24,3,389,7,399
RAJASTHAN,SAWAI MADHOPUR,2021-01-25,14,163,3,180
RAJASTHAN,SIKAR,2021-01-21,0,556,7,563
RAJASTHAN,SIKAR,2021-01-22,3,445,15,463
RAJASTHAN,SIKAR,2021-01-23,5,387,18,410
RAJASTHAN,SIKAR,2021-01-24,0,408,6,414
RAJASTHAN,SIKAR,2021-01-25,3,374,9,386
RAJASTHAN,SIROHI,2021-01-21,0,451,0,451
RAJASTHAN,SIROHI,2021-01-22,25,218,0,243
RAJASTHAN,SIROHI,2021-01-23,15,221,0,236
RAJASTHAN,SIROHI,2021-01-24,0,358,0,358
RAJASTHAN,SIROHI,2021-01-25,20,369,1,390
RAJASTHAN,TONK,2021-01-21,0,171,11,182
RAJASTHAN,TONK,2021-01-22,1,161,23,185
RAJASTHAN,TONK,2021-01-23,0,178,59,237
RAJASTHAN,TONK,2021-01-24,0,183,41,224
RAJASTHAN,TONK,2021-01-25,2,152,38,192
RAJASTHAN,UDAIPUR,2021-01-21,60,640,7,707
RAJASTHAN,UDAIPUR,2021-01-22,48,746,2,796
RAJASTHAN,UDAIPUR,2021-01-23,42,671,1,714
RAJASTHAN,UDAIPUR,2021-01-24,46,479,0,525
RAJASTHAN,UDAIPUR,2021-01-25,27,568,4,599
SIKKIM,EAST DISTRICT,2021-01-21,2,217,0,219
SIKKIM,EAST DISTRICT,2021-01-22,8,166,0,174
SIKKIM,EAST DISTRICT,2021-01-23,2,101,0,103
SIKKIM,EAST DISTRICT,2021-01-24,0,17,0,17
SIKKIM,EAST DISTRICT,2021-01-25,5,202,0,207
SIKKIM,NORTH DISTRICT,2021-01-21,0,7,0,7
SIKKIM,NORTH DISTRICT,2021-01-22,0,4,0,4
SIKKIM,NORTH DISTRICT,2021-01-23,0,7,0,7
SIKKIM,NORTH DISTRICT,2021-01-24,0,4,0,4
SIKKIM,NORTH DISTRICT,2021-01-25,0,3,0,3
SIKKIM,SOUTH DISTRICT,2021-01-21,0,21,0,21
SIKKIM,SOUTH DISTRICT,2021-01-22,0,6,0,6
SIKKIM,SOUTH DISTRICT,2021-01-23,0,36,0,36
SIKKIM,SOUTH DISTRICT,2021-01-24,0,2,0,2
SIKKIM,SOUTH DISTRICT,2021-01-25,0,14,0,14
SIKKIM,WEST DISTRICT,2021-01-21,1,8,0,9
SIKKIM,WEST DISTRICT,2021-01-22,0,1,0,1
SIKKIM,WEST DISTRICT,2021-01-23,0,3,0,3
SIKKIM,WEST DISTRICT,2021-01-24,0,1,0,1
SIKKIM,WEST DISTRICT,2021-01-25,0,3,0,3
TAMIL NADU,ARIYALUR,2021-01-21,1,250,0,251
TAMIL NADU,ARIYALUR,2021-01-22,7,248,0,255
TAMIL NADU,ARIYALUR,2021-01-23,2,90,0,92
TAMIL NADU,ARIYALUR,2021-01-24,1,33,1,35
TAMIL NADU,ARIYALUR,2021-01-25,0,290,0,290
TAMIL NADU,CHENGALPATTU,2021-01-21,40,3660,0,3700
TAMIL NADU,CHENGALPATTU,2021-01-22,26,4143,1,4170
TAMIL NADU,CHENGALPATTU,2021-01-23,35,2435,1,2471
TAMIL NADU,CHENGALPATTU,2021-01-24,23,3157,0,3180
TAMIL NADU,CHENGALPATTU,2021-01-25,29,2674,1,2704
TAMIL NADU,CHENNAI,2021-01-21,195,11756,13,11964
TAMIL NADU,CHENNAI,2021-01-22,196,10676,15,10887
TAMIL NADU,CHENNAI,2021-01-23,218,10519,2,10739
TAMIL NADU,CHENNAI,2021-01-24,171,9330,40,9541
TAMIL NADU,CHENNAI,2021-01-25,182,8065,10,8257
TAMIL NADU,COIMBATORE,2021-01-21,64,2639,0,2703
TAMIL NADU,COIMBATORE,2021-01-22,50,2339,1,2390
TAMIL NADU,COIMBATORE,2021-01-23,54,2380,0,2434
TAMIL NADU,COIMBATORE,2021-01-24,62,2188,0,2250
TAMIL NADU,COIMBATORE,2021-01-25,49,1719,0,1768
TAMIL NADU,CUDDALORE,2021-01-21,3,1420,2,1425
TAMIL NADU,CUDDALORE,2021-01-22,2,1393,0,1395
TAMIL NADU,CUDDALORE,2021-01-23,5,810,1,816
TAMIL NADU,CUDDALORE,2021-01-24,4,453,0,457
TAMIL NADU,CUDDALORE,2021-01-25,1,1299,0,1300
TAMIL NADU,DHARMAPURI,2021-01-21,5,913,0,918
TAMIL NADU,DHARMAPURI,2021-01-22,9,1187,0,1196
TAMIL NADU,DHARMAPURI,2021-01-23,3,929,0,932
TAMIL NADU,DHARMAPURI,2021-01-24,2,841,0,843
TAMIL NADU,DHARMAPURI,2021-01-25,3,606,0,609
TAMIL NADU,DINDIGUL,2021-01-21,17,258,2,277
TAMIL NADU,DINDIGUL,2021-01-22,19,190,0,209
TAMIL NADU,DINDIGUL,2021-01-23,4,299,0,303
TAMIL NADU,DINDIGUL,2021-01-24,7,194,0,201
TAMIL NADU,DINDIGUL,2021-01-25,11,321,0,332
TAMIL NADU,ERODE,2021-01-21,17,1434,0,1451
TAMIL NADU,ERODE,2021-01-22,15,1783,0,1798
TAMIL NADU,ERODE,2021-01-23,28,1590,1,1619
TAMIL NADU,ERODE,2021-01-24,26,1348,0,1374
TAMIL NADU,ERODE,2021-01-25,17,920,0,937
TAMIL NADU,KALLAKURICHI,2021-01-21,2,798,0,800
TAMIL NADU,KALLAKURICHI,2021-01-22,4,777,0,781
TAMIL NADU,KALLAKURICHI,2021-01-23,0,989,0,989
TAMIL NADU,KALLAKURICHI,2021-01-24,0,833,1,834
TAMIL NADU,KALLAKURICHI,2021-01-25,0,314,0,314
TAMIL NADU,KANCHIPURAM,2021-01-21,20,2882,4,2906
TAMIL NADU,KANCHIPURAM,2021-01-22,33,2410,3,2446
TAMIL NADU,KANCHIPURAM,2021-01-23,20,2370,0,2390
TAMIL NADU,KANCHIPURAM,2021-01-24,11,2126,1,2138
TAMIL NADU,KANCHIPURAM,2021-01-25,13,2439,0,2452
TAMIL NADU,KANNIYAKUMARI,2021-01-21,19,2353,5,2377
TAMIL NADU,KANNIYAKUMARI,2021-01-22,12,1543,4,1559
TAMIL NADU,KANNIYAKUMARI,2021-01-23,18,1335,1,1354
TAMIL NADU,KANNIYAKUMARI,2021-01-24,15,1445,1,1461
TAMIL NADU,KANNIYAKUMARI,2021-01-25,9,1750,4,1763
TAMIL NADU,KARUR,2021-01-21,8,1294,1,1303
TAMIL NADU,KARUR,2021-01-22,3,1222,2,1227
TAMIL NADU,KARUR,2021-01-23,4,1065,1,1070
TAMIL NADU,KARUR,2021-01-24,3,1103,2,1108
TAMIL NADU,KARUR,2021-01-25,2,881,0,883
TAMIL NADU,KRISHNAGIRI,2021-01-21,3,1175,0,1178
TAMIL NADU,KRISHNAGIRI,2021-01-22,10,1250,1,1261
TAMIL NADU,KRISHNAGIRI,2021-01-23,8,889,0,897
TAMIL NADU,KRISHNAGIRI,2021-01-24,3,470,2,475
TAMIL NADU,KRISHNAGIRI,2021-01-25,6,1029,1,1036
TAMIL NADU,MADURAI,2021-01-21,21,3594,3,3618
TAMIL NADU,MADURAI,2021-01-22,19,3594,3,3616
TAMIL NADU,MADURAI,2021-01-23,7,3017,2,3026
TAMIL NADU,MADURAI,2021-01-24,9,2080,2,2091
TAMIL NADU,MADURAI,2021-01-25,15,2197,0,2212
TAMIL NADU,NAGAPATTINAM,2021-01-21,8,1053,0,1061
TAMIL NADU,NAGAPATTINAM,2021-01-22,15,1320,0,1335
TAMIL NADU,NAGAPATTINAM,2021-01-23,8,1242,0,1250
TAMIL NADU,NAGAPATTINAM,2021-01-24,4,1253,0,1257
TAMIL NADU,NAGAPATTINAM,2021-01-25,14,378,0,392
TAMIL NADU,NAMAKKAL,2021-01-21,14,1556,0,1570
TAMIL NADU,NAMAKKAL,2021-01-22,9,1806,0,1815
TAMIL NADU,NAMAKKAL,2021-01-23,23,5536,12,5571
TAMIL NADU,NAMAKKAL,2021-01-24,7,689,0,696
TAMIL NADU,NAMAKKAL,2021-01-25,12,1492,1,1505
TAMIL NADU,PERAMBALUR,2021-01-21,0,440,0,440
TAMIL NADU,PERAMBALUR,2021-01-22,1,420,0,421
TAMIL NADU,PERAMBALUR,2021-01-23,1,155,0,156
TAMIL NADU,PERAMBALUR,2021-01-24,0,255,0,255
TAMIL NADU,PERAMBALUR,2021-01-25,0,142,0,142
TAMIL NADU,PUDUKKOTTAI,2021-01-21,3,829,0,832
TAMIL NADU,PUDUKKOTTAI,2021-01-22,2,1046,2,1050
TAMIL NADU,PUDUKKOTTAI,2021-01-23,2,727,0,729
TAMIL NADU,PUDUKKOTTAI,2021-01-24,2,793,0,795
TAMIL NADU,PUDUKKOTTAI,2021-01-25,4,246,0,250
TAMIL NADU,RAMANATHAPURAM,2021-01-21,0,978,1,979
TAMIL NADU,RAMANATHAPURAM,2021-01-22,0,1136,0,1136
TAMIL NADU,RAMANATHAPURAM,2021-01-23,2,896,0,898
TAMIL NADU,RAMANATHAPURAM,2021-01-24,3,785,0,788
TAMIL NADU,RAMANATHAPURAM,2021-01-25,1,895,0,896
TAMIL NADU,RANIPET,2021-01-21,5,2380,0,2385
TAMIL NADU,RANIPET,2021-01-22,5,2774,0,2779
TAMIL NADU,RANIPET,2021-01-23,9,2063,0,2072
TAMIL NADU,RANIPET,2021-01-24,3,491,0,494
TAMIL NADU,RANIPET,2021-01-25,0,181,0,181
TAMIL NADU,SALEM,2021-01-21,13,1357,1,1371
TAMIL NADU,SALEM,2021-01-22,12,1020,0,1032
TAMIL NADU,SALEM,2021-01-23,6,1252,4,1262
TAMIL NADU,SALEM,2021-01-24,25,419,0,444
TAMIL NADU,SALEM,2021-01-25,16,1380,8,1404
TAMIL NADU,SIVAGANGA,2021-01-21,4,631,0,635
TAMIL NADU,SIVAGANGA,2021-01-22,4,976,0,980
TAMIL NADU,SIVAGANGA,2021-01-23,5,534,0,539
TAMIL NADU,SIVAGANGA,2021-01-24,4,357,0,361
TAMIL NADU,SIVAGANGA,2021-01-25,3,215,0,218
TAMIL NADU,TENKASI,2021-01-21,13,752,1,766
TAMIL NADU,TENKASI,2021-01-22,10,662,0,672
TAMIL NADU,TENKASI,2021-01-23,2,716,1,719
TAMIL NADU,TENKASI,2021-01-24,5,703,1,709
TAMIL NADU,TENKASI,2021-01-25,6,643,0,649
TAMIL NADU,THANJAVUR,2021-01-21,5,787,1,793
TAMIL NADU,THANJAVUR,2021-01-22,11,1073,0,1084
TAMIL NADU,THANJAVUR,2021-01-23,10,753,1,764
TAMIL NADU,THANJAVUR,2021-01-24,4,159,0,163
TAMIL NADU,THANJAVUR,2021-01-25,9,666,8,683
TAMIL NADU,THE NILGIRIS,2021-01-21,8,880,4,892
TAMIL NADU,THE NILGIRIS,2021-01-22,6,1045,1,1052
TAMIL NADU,THE NILGIRIS,2021-01-23,11,1035,1,1047
TAMIL NADU,THE NILGIRIS,2021-01-24,8,1024,0,1032
TAMIL NADU,THE NILGIRIS,2021-01-25,9,1034,0,1043
TAMIL NADU,THENI,2021-01-21,9,719,4,732
TAMIL NADU,THENI,2021-01-22,8,906,0,914
TAMIL NADU,THENI,2021-01-23,4,833,0,837
TAMIL NADU,THENI,2021-01-24,1,305,0,306
TAMIL NADU,THENI,2021-01-25,5,1018,0,1023
TAMIL NADU,THIRUVALLUR,2021-01-21,21,3327,7,3355
TAMIL NADU,THIRUVALLUR,2021-01-22,32,2689,12,2733
TAMIL NADU,THIRUVALLUR,2021-01-23,16,2802,1,2819
TAMIL NADU,THIRUVALLUR,2021-01-24,15,1847,3,1865
TAMIL NADU,THIRUVALLUR,2021-01-25,16,2080,4,2100
TAMIL NADU,THIRUVARUR,2021-01-21,10,1122,0,1132
TAMIL NADU,THIRUVARUR,2021-01-22,25,742,0,767
TAMIL NADU,THIRUVARUR,2021-01-23,4,680,1,685
TAMIL NADU,THIRUVARUR,2021-01-24,8,185,0,193
TAMIL NADU,THIRUVARUR,2021-01-25,9,494,7,510
TAMIL NADU,TIRUCHIRAPPALLI,2021-01-21,12,1697,1,1710
TAMIL NADU,TIRUCHIRAPPALLI,2021-01-22,11,1591,0,1602
TAMIL NADU,TIRUCHIRAPPALLI,2021-01-23,20,1316,1,1337
TAMIL NADU,TIRUCHIRAPPALLI,2021-01-24,9,1186,1,1196
TAMIL NADU,TIRUCHIRAPPALLI,2021-01-25,12,1223,0,1235
TAMIL NADU,TIRUNELVELI,2021-01-21,3,1422,1,1426
TAMIL NADU,TIRUNELVELI,2021-01-22,10,1326,2,1338
TAMIL NADU,TIRUNELVELI,2021-01-23,6,1322,0,1328
TAMIL NADU,TIRUNELVELI,2021-01-24,6,515,2,523
TAMIL NADU,TIRUNELVELI,2021-01-25,10,1272,3,1285
TAMIL NADU,TIRUPATHUR,2021-01-21,3,1626,0,1629
TAMIL NADU,TIRUPATHUR,2021-01-22,7,2861,2,2870
TAMIL NADU,TIRUPATHUR,2021-01-23,2,2105,1,2108
TAMIL NADU,TIRUPATHUR,2021-01-24,5,2473,19,2497
TAMIL NADU,TIRUPATHUR,2021-01-25,0,2194,2,2196
TAMIL NADU,TIRUPPUR,2021-01-21,32,2346,3,2381
TAMIL NADU,TIRUPPUR,2021-01-22,30,2369,4,2403
TAMIL NADU,TIRUPPUR,2021-01-23,37,2984,1,3022
TAMIL NADU,TIRUPPUR,2021-01-24,23,1165,0,1188
TAMIL NADU,TIRUPPUR,2021-01-25,7,1413,5,1425
TAMIL NADU,TIRUVANNAMALAI,2021-01-21,4,978,0,982
TAMIL NADU,TIRUVANNAMALAI,2021-01-22,7,987,2,996
TAMIL NADU,TIRUVANNAMALAI,2021-01-23,2,904,1,907
TAMIL NADU,TIRUVANNAMALAI,2021-01-24,4,485,1,490
TAMIL NADU,TIRUVANNAMALAI,2021-01-25,1,373,0,374
TAMIL NADU,TUTICORIN,2021-01-21,4,1057,0,1061
TAMIL NADU,TUTICORIN,2021-01-22,6,1006,1,1013
TAMIL NADU,TUTICORIN,2021-01-23,7,980,0,987
TAMIL NADU,TUTICORIN,2021-01-24,6,923,0,929
TAMIL NADU,TUTICORIN,2021-01-25,2,507,2,511
TAMIL NADU,VELLORE,2021-01-21,14,1829,2,1845
TAMIL NADU,VELLORE,2021-01-22,12,1482,0,1494
TAMIL NADU,VELLORE,2021-01-23,15,1719,1,1735
TAMIL NADU,VELLORE,2021-01-24,6,556,0,562
TAMIL NADU,VELLORE,2021-01-25,13,1696,0,1709
TAMIL NADU,VILLUPURAM,2021-01-21,7,1173,0,1180
TAMIL NADU,VILLUPURAM,2021-01-22,4,1058,1,1063
TAMIL NADU,VILLUPURAM,2021-01-23,4,1004,1,1009
TAMIL NADU,VILLUPURAM,2021-01-24,12,1324,0,1336
TAMIL NADU,VILLUPURAM,2021-01-25,2,538,0,540
TAMIL NADU,VIRUDHUNAGAR,2021-01-21,2,1800,0,1802
TAMIL NADU,VIRUDHUNAGAR,2021-01-22,5,1761,2,1768
TAMIL NADU,VIRUDHUNAGAR,2021-01-23,4,1678,0,1682
TAMIL NADU,VIRUDHUNAGAR,2021-01-24,2,816,0,818
TAMIL NADU,VIRUDHUNAGAR,2021-01-25,1,679,0,680
TELANGANA,ADILABAD,2021-01-21,0,290,0,290
TELANGANA,ADILABAD,2021-01-22,1,291,1,293
TELANGANA,ADILABAD,2021-01-23,0,277,0,277
TELANGANA,ADILABAD,2021-01-24,1,189,0,190
TELANGANA,ADILABAD,2021-01-25,0,468,0,468
TELANGANA,BHADRADRI KOTHAGUDEM,2021-01-21,1,634,0,635
TELANGANA,BHADRADRI KOTHAGUDEM,2021-01-22,0,759,0,759
TELANGANA,BHADRADRI KOTHAGUDEM,2021-01-23,0,702,0,702
TELANGANA,BHADRADRI KOTHAGUDEM,2021-01-24,0,260,0,260
TELANGANA,BHADRADRI KOTHAGUDEM,2021-01-25,0,852,0,852
TELANGANA,HYDERABAD,2021-01-21,20,6102,10,6132
TELANGANA,HYDERABAD,2021-01-22,17,6519,30,6566
TELANGANA,HYDERABAD,2021-01-23,14,6150,31,6195
TELANGANA,HYDERABAD,2021-01-24,13,4263,12,4288
TELANGANA,HYDERABAD,2021-01-25,6,5691,8,5705
TELANGANA,JAGITIAL,2021-01-21,0,359,0,359
TELANGANA,JAGITIAL,2021-01-22,1,437,0,438
TELANGANA,JAGITIAL,2021-01-23,0,366,0,366
TELANGANA,JAGITIAL,2021-01-24,0,215,0,215
TELANGANA,JAGITIAL,2021-01-25,0,565,0,565
TELANGANA,JANGOAN,2021-01-21,0,565,0,565
TELANGANA,JANGOAN,2021-01-22,0,536,0,536
TELANGANA,JANGOAN,2021-01-23,0,594,0,594
TELANGANA,JANGOAN,2021-01-24,1,300,0,301
TELANGANA,JANGOAN,2021-01-25,0,588,0,588
TELANGANA,JAYASHANKAR BHUPALAPALLY,2021-01-21,0,102,0,102
TELANGANA,JAYASHANKAR BHUPALAPALLY,2021-01-22,0,143,0,143
TELANGANA,JAYASHANKAR BHUPALAPALLY,2021-01-23,0,176,0,176
TELANGANA,JAYASHANKAR BHUPALAPALLY,2021-01-24,0,34,0,34
TELANGANA,JAYASHANKAR BHUPALAPALLY,2021-01-25,0,138,0,138
TELANGANA,JOGULAMBA GADWAL,2021-01-21,0,706,0,706
TELANGANA,JOGULAMBA GADWAL,2021-01-22,0,639,0,639
TELANGANA,JOGULAMBA GADWAL,2021-01-23,0,454,0,454
TELANGANA,JOGULAMBA GADWAL,2021-01-24,0,251,0,251
TELANGANA,JOGULAMBA GADWAL,2021-01-25,0,519,0,519
TELANGANA,KAMAREDDY,2021-01-21,0,218,0,218
TELANGANA,KAMAREDDY,2021-01-22,1,245,0,246
TELANGANA,KAMAREDDY,2021-01-23,0,368,0,368
TELANGANA,KAMAREDDY,2021-01-24,0,30,0,30
TELANGANA,KAMAREDDY,2021-01-25,0,468,0,468
TELANGANA,KARIMNAGAR,2021-01-21,1,924,0,925
TELANGANA,KARIMNAGAR,2021-01-22,5,1127,0,1132
TELANGANA,KARIMNAGAR,2021-01-23,0,957,1,958
TELANGANA,KARIMNAGAR,2021-01-24,3,545,0,548
TELANGANA,KARIMNAGAR,2021-01-25,2,1058,0,1060
TELANGANA,KHAMMAM,2021-01-21,0,401,0,401
TELANGANA,KHAMMAM,2021-01-22,0,531,0,531
TELANGANA,KHAMMAM,2021-01-23,0,586,0,586
TELANGANA,KHAMMAM,2021-01-24,0,145,0,145
TELANGANA,KHAMMAM,2021-01-25,0,793,0,793
TELANGANA,KUMURAM BHEEM ASIFABAD,2021-01-21,0,474,0,474
TELANGANA,KUMURAM BHEEM ASIFABAD,2021-01-22,0,492,0,492
TELANGANA,KUMURAM BHEEM ASIFABAD,2021-01-23,0,505,0,505
TELANGANA,KUMURAM BHEEM ASIFABAD,2021-01-24,0,459,0,459
TELANGANA,KUMURAM BHEEM ASIFABAD,2021-01-25,0,556,0,556
TELANGANA,MAHABUBABAD,2021-01-21,0,178,0,178
TELANGANA,MAHABUBABAD,2021-01-22,0,340,0,340
TELANGANA,MAHABUBABAD,2021-01-23,0,407,0,407
TELANGANA,MAHABUBABAD,2021-01-24,0,308,0,308
TELANGANA,MAHABUBABAD,2021-01-25,0,451,0,451
TELANGANA,MAHABUBNAGAR,2021-01-21,0,454,0,454
TELANGANA,MAHABUBNAGAR,2021-01-22,0,459,0,459
TELANGANA,MAHABUBNAGAR,2021-01-23,0,503,0,503
TELANGANA,MAHABUBNAGAR,2021-01-24,0,215,0,215
TELANGANA,MAHABUBNAGAR,2021-01-25,0,476,0,476
TELANGANA,MANCHERIAL,2021-01-21,0,416,0,416
TELANGANA,MANCHERIAL,2021-01-22,0,502,0,502
TELANGANA,MANCHERIAL,2021-01-23,0,595,0,595
TELANGANA,MANCHERIAL,2021-01-24,0,302,0,302
TELANGANA,MANCHERIAL,2021-01-25,0,591,0,591
TELANGANA,MEDAK,2021-01-21,0,218,0,218
TELANGANA,MEDAK,2021-01-22,1,255,0,256
TELANGANA,MEDAK,2021-01-23,0,183,0,183
TELANGANA,MEDAK,2021-01-24,1,104,0,105
TELANGANA,MEDAK,2021-01-25,0,257,0,257
TELANGANA,MEDCHAL MALKAJGIRI,2021-01-21,1,1233,1,1235
TELANGANA,MEDCHAL MALKAJGIRI,2021-01-22,0,1195,1,1196
TELANGANA,MEDCHAL MALKAJGIRI,2021-01-23,1,1418,1,1420
TELANGANA,MEDCHAL MALKAJGIRI,2021-01-24,0,308,0,308
TELANGANA,MEDCHAL MALKAJGIRI,2021-01-25,0,1176,0,1176
TELANGANA,MULUGU,2021-01-21,0,83,0,83
TELANGANA,MULUGU,2021-01-22,0,71,0,71
TELANGANA,MULUGU,2021-01-23,0,106,0,106
TELANGANA,MULUGU,2021-01-24,0,45,0,45
TELANGANA,MULUGU,2021-01-25,0,84,0,84
TELANGANA,NAGARKURNOOL,2021-01-21,1,716,0,717
TELANGANA,NAGARKURNOOL,2021-01-22,0,658,0,658
TELANGANA,NAGARKURNOOL,2021-01-23,0,687,0,687
TELANGANA,NAGARKURNOOL,2021-01-24,0,463,0,463
TELANGANA,NAGARKURNOOL,2021-01-25,0,859,0,859
TELANGANA,NALGONDA,2021-01-21,0,420,0,420
TELANGANA,NALGONDA,2021-01-22,0,435,0,435
TELANGANA,NALGONDA,2021-01-23,0,446,1,447
TELANGANA,NALGONDA,2021-01-24,0,42,0,42
TELANGANA,NALGONDA,2021-01-25,0,639,0,639
TELANGANA,NARAYANPET,2021-01-21,0,183,0,183
TELANGANA,NARAYANPET,2021-01-22,0,225,0,225
TELANGANA,NARAYANPET,2021-01-23,0,140,0,140
TELANGANA,NARAYANPET,2021-01-24,0,49,0,49
TELANGANA,NARAYANPET,2021-01-25,0,275,0,275
TELANGANA,NIRMAL,2021-01-21,0,666,0,666
TELANGANA,NIRMAL,2021-01-22,0,984,0,984
TELANGANA,NIRMAL,2021-01-23,0,723,0,723
TELANGANA,NIRMAL,2021-01-24,0,385,0,385
TELANGANA,NIRMAL,2021-01-25,0,654,0,654
TELANGANA,NIZAMABAD,2021-01-21,1,280,0,281
TELANGANA,NIZAMABAD,2021-01-22,0,206,0,206
TELANGANA,NIZAMABAD,2021-01-23,0,301,0,301
TELANGANA,NIZAMABAD,2021-01-24,1,66,0,67
TELANGANA,NIZAMABAD,2021-01-25,0,380,0,380
TELANGANA,PEDDAPALLI,2021-01-21,0,588,0,588
TELANGANA,PEDDAPALLI,2021-01-22,1,728,0,729
TELANGANA,PEDDAPALLI,2021-01-23,0,805,0,805
TELANGANA,PEDDAPALLI,2021-01-24,0,222,0,222
TELANGANA,PEDDAPALLI,2021-01-25,0,873,0,873
TELANGANA,RAJANNA SIRCILLA,2021-01-21,0,233,0,233
TELANGANA,RAJANNA SIRCILLA,2021-01-22,0,205,0,205
TELANGANA,RAJANNA SIRCILLA,2021-01-23,0,271,0,271
TELANGANA,RAJANNA SIRCILLA,2021-01-24,0,143,0,143
TELANGANA,RAJANNA SIRCILLA,2021-01-25,0,468,0,468
TELANGANA,RANGA REDDY,2021-01-21,5,1625,1,1631
TELANGANA,RANGA REDDY,2021-01-22,1,1850,7,1858
TELANGANA,RANGA REDDY,2021-01-23,2,1522,9,1533
TELANGANA,RANGA REDDY,2021-01-24,2,981,0,983
TELANGANA,RANGA REDDY,2021-01-25,1,1719,1,1721
TELANGANA,SANGAREDDY,2021-01-21,9,704,0,713
TELANGANA,SANGAREDDY,2021-01-22,4,748,0,752
TELANGANA,SANGAREDDY,2021-01-23,0,689,0,689
TELANGANA,SANGAREDDY,2021-01-24,0,348,0,348
TELANGANA,SANGAREDDY,2021-01-25,3,772,0,775
TELANGANA,SIDDIPET,2021-01-21,0,1440,0,1440
TELANGANA,SIDDIPET,2021-01-22,0,1377,0,1377
TELANGANA,SIDDIPET,2021-01-23,0,1323,0,1323
TELANGANA,SIDDIPET,2021-01-24,0,1222,0,1222
TELANGANA,SIDDIPET,2021-01-25,0,1151,0,1151
TELANGANA,SURYAPET,2021-01-21,0,906,0,906
TELANGANA,SURYAPET,2021-01-22,0,832,0,832
TELANGANA,SURYAPET,2021-01-23,0,947,0,947
TELANGANA,SURYAPET,2021-01-24,0,547,0,547
TELANGANA,SURYAPET,2021-01-25,0,846,0,846
TELANGANA,VIKARABAD,2021-01-21,0,474,0,474
TELANGANA,VIKARABAD,2021-01-22,0,418,1,419
TELANGANA,VIKARABAD,2021-01-23,0,393,0,393
TELANGANA,VIKARABAD,2021-01-24,0,244,0,244
TELANGANA,VIKARABAD,2021-01-25,0,418,0,418
TELANGANA,WANAPARTHY,2021-01-21,0,310,0,310
TELANGANA,WANAPARTHY,2021-01-22,0,255,0,255
TELANGANA,WANAPARTHY,2021-01-23,0,186,0,186
TELANGANA,WANAPARTHY,2021-01-24,0,120,0,120
TELANGANA,WANAPARTHY,2021-01-25,0,231,0,231
TELANGANA,WARANGAL RURAL,2021-01-21,2,187,0,189
TELANGANA,WARANGAL RURAL,2021-01-22,1,250,0,251
TELANGANA,WARANGAL RURAL,2021-01-23,4,279,0,283
TELANGANA,WARANGAL RURAL,2021-01-24,1,143,0,144
TELANGANA,WARANGAL RURAL,2021-01-25,0,292,0,292
TELANGANA,WARANGAL URBAN,2021-01-21,0,1162,0,1162
TELANGANA,WARANGAL URBAN,2021-01-22,0,1743,0,1743
TELANGANA,WARANGAL URBAN,2021-01-23,0,1806,0,1806
TELANGANA,WARANGAL URBAN,2021-01-24,1,882,0,883
TELANGANA,WARANGAL URBAN,2021-01-25,0,2191,0,2191
TELANGANA,YADADRI BHUVANAGIRI,2021-01-21,0,190,0,190
TELANGANA,YADADRI BHUVANAGIRI,2021-01-22,0,183,0,183
TELANGANA,YADADRI BHUVANAGIRI,2021-01-23,0,174,0,174
TELANGANA,YADADRI BHUVANAGIRI,2021-01-24,0,22,0,22
TELANGANA,YADADRI BHUVANAGIRI,2021-01-25,0,507,0,507
TRIPURA,DHALAI,2021-01-21,0,50,0,50
TRIPURA,DHALAI,2021-01-22,0,14,0,14
TRIPURA,DHALAI,2021-01-23,0,5,0,5
TRIPURA,DHALAI,2021-01-24,0,5,0,5
TRIPURA,DHALAI,2021-01-25,0,20,0,20
TRIPURA,GOMATI,2021-01-21,1,43,0,44
TRIPURA,GOMATI,2021-01-22,0,44,0,44
TRIPURA,GOMATI,2021-01-23,0,7,0,7
TRIPURA,GOMATI,2021-01-24,0,43,0,43
TRIPURA,GOMATI,2021-01-25,0,31,0,31
TRIPURA,KHOWAI,2021-01-21,2,42,0,44
TRIPURA,KHOWAI,2021-01-22,0,55,0,55
TRIPURA,KHOWAI,2021-01-23,0,19,0,19
TRIPURA,KHOWAI,2021-01-24,0,13,0,13
TRIPURA,KHOWAI,2021-01-25,0,20,0,20
TRIPURA,NORTH TRIPURA,2021-01-21,0,100,0,100
TRIPURA,NORTH TRIPURA,2021-01-22,1,72,0,73
TRIPURA,NORTH TRIPURA,2021-01-23,1,49,0,50
TRIPURA,NORTH TRIPURA,2021-01-24,0,38,0,38
TRIPURA,NORTH TRIPURA,2021-01-25,0,130,0,130
TRIPURA,SEPAHIJALA,2021-01-21,0,81,0,81
TRIPURA,SEPAHIJALA,2021-01-22,0,34,0,34
TRIPURA,SEPAHIJALA,2021-01-23,0,26,0,26
TRIPURA,SEPAHIJALA,2021-01-24,0,59,0,59
TRIPURA,SEPAHIJALA,2021-01-25,0,29,0,29
TRIPURA,SOUTH TRIPURA,2021-01-21,0,105,0,105
TRIPURA,SOUTH TRIPURA,2021-01-22,0,41,0,41
TRIPURA,SOUTH TRIPURA,2021-01-23,0,21,0,21
TRIPURA,SOUTH TRIPURA,2021-01-24,0,98,0,98
TRIPURA,SOUTH TRIPURA,2021-01-25,0,52,0,52
TRIPURA,UNAKOTI,2021-01-21,0,23,0,23
TRIPURA,UNAKOTI,2021-01-22,0,8,0,8
TRIPURA,UNAKOTI,2021-01-23,0,7,0,7
TRIPURA,UNAKOTI,2021-01-25,0,13,0,13
TRIPURA,WEST TRIPURA,2021-01-21,0,202,0,202
TRIPURA,WEST TRIPURA,2021-01-22,2,196,0,198
TRIPURA,WEST TRIPURA,2021-01-23,0,83,0,83
TRIPURA,WEST TRIPURA,2021-01-24,0,141,0,141
TRIPURA,WEST TRIPURA,2021-01-25,1,201,0,202
UTTAR PRADESH,AGRA,2021-01-21,7,2409,2,2418
UTTAR PRADESH,AGRA,2021-01-22,7,2300,14,2321
UTTAR PRADESH,AGRA,2021-01-23,13,2645,6,2664
UTTAR PRADESH,AGRA,2021-01-24,6,1213,5,1224
UTTAR PRADESH,AGRA,2021-01-25,3,1337,3,1343
UTTAR PRADESH,ALIGARH,2021-01-21,9,2895,1,2905
UTTAR PRADESH,ALIGARH,2021-01-22,11,2662,0,2673
UTTAR PRADESH,ALIGARH,2021-01-23,8,3009,1,3018
UTTAR PRADESH,ALIGARH,2021-01-24,10,2235,1,2246
UTTAR PRADESH,ALIGARH,2021-01-25,11,2229,0,2240
UTTAR PRADESH,AMBEDKAR NAGAR,2021-01-21,5,934,0,939
UTTAR PRADESH,AMBEDKAR NAGAR,2021-01-22,0,1524,0,1524
UTTAR PRADESH,AMBEDKAR NAGAR,2021-01-23,1,1047,1,1049
UTTAR PRADESH,AMBEDKAR NAGAR,2021-01-24,0,1031,1,1032
UTTAR PRADESH,AMBEDKAR NAGAR,2021-01-25,1,1798,1,1800
UTTAR PRADESH,AMETHI,2021-01-21,21,991,54,1066
UTTAR PRADESH,AMETHI,2021-01-22,5,746,0,751
UTTAR PRADESH,AMETHI,2021-01-23,2,942,154,1098
UTTAR PRADESH,AMETHI,2021-01-24,3,1881,0,1884
UTTAR PRADESH,AMETHI,2021-01-25,2,1058,20,1080
UTTAR PRADESH,AMROHA,2021-01-21,1,1387,0,1388
UTTAR PRADESH,AMROHA,2021-01-22,1,1122,0,1123
UTTAR PRADESH,AMROHA,2021-01-23,1,475,0,476
UTTAR PRADESH,AMROHA,2021-01-24,2,1548,0,1550
UTTAR PRADESH,AMROHA,2021-01-25,2,984,0,986
UTTAR PRADESH,AURAIYA,2021-01-21,1,805,51,857
UTTAR PRADESH,AURAIYA,2021-01-22,0,951,15,966
UTTAR PRADESH,AURAIYA,2021-01-23,0,766,15,781
UTTAR PRADESH,AURAIYA,2021-01-24,0,820,21,841
UTTAR PRADESH,AURAIYA,2021-01-25,0,663,20,683
UTTAR PRADESH,AYODHYA,2021-01-21,9,1801,16,1826
UTTAR PRADESH,AYODHYA,2021-01-22,4,1484,1,1489
UTTAR PRADESH,AYODHYA,2021-01-23,0,1614,0,1614
UTTAR PRADESH,AYODHYA,2021-01-24,6,1425,0,1431
UTTAR PRADESH,AYODHYA,2021-01-25,10,1378,9,1397
UTTAR PRADESH,AZAMGARH,2021-01-21,4,1054,7,1065
UTTAR PRADESH,AZAMGARH,2021-01-22,1,912,0,913
UTTAR PRADESH,AZAMGARH,2021-01-23,0,979,0,979
UTTAR PRADESH,AZAMGARH,2021-01-24,0,556,24,580
UTTAR PRADESH,AZAMGARH,2021-01-25,2,769,6,777
UTTAR PRADESH,BAGHPAT,2021-01-21,4,1237,20,1261
UTTAR PRADESH,BAGHPAT,2021-01-22,0,1162,111,1273
UTTAR PRADESH,BAGHPAT,2021-01-23,0,1310,11,1321
UTTAR PRADESH,BAGHPAT,2021-01-24,1,744,1,746
UTTAR PRADESH,BAGHPAT,2021-01-25,0,1648,68,1716
UTTAR PRADESH,BAHRAICH,2021-01-21,1,2080,18,2099
UTTAR PRADESH,BAHRAICH,2021-01-22,8,1556,46,1610
UTTAR PRADESH,BAHRAICH,2021-01-23,0,1661,38,1699
UTTAR PRADESH,BAHRAICH,2021-01-24,1,1700,20,1721
UTTAR PRADESH,BAHRAICH,2021-01-25,1,1487,13,1501
UTTAR PRADESH,BALLIA,2021-01-21,0,995,10,1005
UTTAR PRADESH,BALLIA,2021-01-22,3,763,6,772
UTTAR PRADESH,BALLIA,2021-01-23,3,624,0,627
UTTAR PRADESH,BALLIA,2021-01-24,3,1412,22,1437
UTTAR PRADESH,BALLIA,2021-01-25,1,871,140,1012
UTTAR PRADESH,BALRAMPUR,2021-01-21,6,1158,1,1165
UTTAR PRADESH,BALRAMPUR,2021-01-22,3,1310,0,1313
UTTAR PRADESH,BALRAMPUR,2021-01-23,6,894,0,900
UTTAR PRADESH,BALRAMPUR,2021-01-24,1,678,0,679
UTTAR PRADESH,BALRAMPUR,2021-01-25,1,1157,20,1178
UTTAR PRADESH,BANDA,2021-01-21,3,2025,13,2041
UTTAR PRADESH,BANDA,2021-01-22,2,1866,24,1892
UTTAR PRADESH,BANDA,2021-01-23,1,2098,11,2110
UTTAR PRADESH,BANDA,2021-01-24,1,2574,0,2575
UTTAR PRADESH,BANDA,2021-01-25,2,1678,10,1690
UTTAR PRADESH,BARABANKI,2021-01-21,2,1647,24,1673
UTTAR PRADESH,BARABANKI,2021-01-22,2,1305,1,1308
UTTAR PRADESH,BARABANKI,2021-01-23,2,1256,0,1258
UTTAR PRADESH,BARABANKI,2021-01-24,0,787,3,790
UTTAR PRADESH,BARABANKI,2021-01-25,3,899,2,904
UTTAR PRADESH,BAREILLY,2021-01-21,12,5096,11,5119
UTTAR PRADESH,BAREILLY,2021-01-22,9,1832,0,1841
UTTAR PRADESH,BAREILLY,2021-01-23,14,2046,0,2060
UTTAR PRADESH,BAREILLY,2021-01-24,8,2038,2,2048
UTTAR PRADESH,BAREILLY,2021-01-25,22,1460,5,1487
UTTAR PRADESH,BASTI,2021-01-21,32,1167,21,1220
UTTAR PRADESH,BASTI,2021-01-22,48,1209,22,1279
UTTAR PRADESH,BASTI,2021-01-23,31,887,28,946
UTTAR PRADESH,BASTI,2021-01-24,4,734,20,758
UTTAR PRADESH,BASTI,2021-01-25,8,975,36,1019
UTTAR PRADESH,BHADOHI,2021-01-21,1,1497,3,1501
UTTAR PRADESH,BHADOHI,2021-01-22,1,1501,0,1502
UTTAR PRADESH,BHADOHI,2021-01-23,1,1461,0,1462
UTTAR PRADESH,BHADOHI,2021-01-24,2,1518,1,1521
UTTAR PRADESH,BHADOHI,2021-01-25,1,1493,0,1494
UTTAR PRADESH,BIJNOR,2021-01-21,1,1690,6,1697
UTTAR PRADESH,BIJNOR,2021-01-22,2,1839,0,1841
UTTAR PRADESH,BIJNOR,2021-01-23,3,1786,3,1792
UTTAR PRADESH,BIJNOR,2021-01-24,3,1615,5,1623
UTTAR PRADESH,BIJNOR,2021-01-25,8,1378,6,1392
UTTAR PRADESH,BUDAUN,2021-01-21,6,976,37,1019
UTTAR PRADESH,BUDAUN,2021-01-22,5,994,20,1019
UTTAR PRADESH,BUDAUN,2021-01-23,9,2381,15,2405
UTTAR PRADESH,BUDAUN,2021-01-24,4,2750,11,2765
UTTAR PRADESH,BUDAUN,2021-01-25,4,2186,19,2209
UTTAR PRADESH,BULANDSHAHR,2021-01-21,10,1288,1,1299
UTTAR PRADESH,BULANDSHAHR,2021-01-22,3,1614,10,1627
UTTAR PRADESH,BULANDSHAHR,2021-01-23,2,501,41,544
UTTAR PRADESH,BULANDSHAHR,2021-01-24,4,549,6,559
UTTAR PRADESH,BULANDSHAHR,2021-01-25,4,325,33,362
UTTAR PRADESH,CHANDAULI,2021-01-21,0,982,13,995
UTTAR PRADESH,CHANDAULI,2021-01-22,1,1370,16,1387
UTTAR PRADESH,CHANDAULI,2021-01-23,0,940,12,952
UTTAR PRADESH,CHANDAULI,2021-01-24,1,806,11,818
UTTAR PRADESH,CHANDAULI,2021-01-25,3,960,18,981
UTTAR PRADESH,CHITRAKOOT,2021-01-21,0,1119,21,1140
UTTAR PRADESH,CHITRAKOOT,2021-01-22,0,1306,0,1306
UTTAR PRADESH,CHITRAKOOT,2021-01-23,1,1383,0,1384
UTTAR PRADESH,CHITRAKOOT,2021-01-24,0,907,5,912
UTTAR PRADESH,CHITRAKOOT,2021-01-25,3,793,0,796
UTTAR PRADESH,DEORIA,2021-01-21,0,1642,92,1734
UTTAR PRADESH,DEORIA,2021-01-22,0,894,87,981
UTTAR PRADESH,DEORIA,2021-01-23,0,1068,119,1187
UTTAR PRADESH,DEORIA,2021-01-24,0,609,112,721
UTTAR PRADESH,DEORIA,2021-01-25,3,1029,7,1039
UTTAR PRADESH,ETAH,2021-01-21,1,1436,7,1444
UTTAR PRADESH,ETAH,2021-01-22,0,1427,1,1428
UTTAR PRADESH,ETAH,2021-01-23,0,1021,1,1022
UTTAR PRADESH,ETAH,2021-01-24,1,529,0,530
UTTAR PRADESH,ETAH,2021-01-25,0,814,6,820
UTTAR PRADESH,ETAWAH,2021-01-21,1,1366,120,1487
UTTAR PRADESH,ETAWAH,2021-01-22,1,777,167,945
UTTAR PRADESH,ETAWAH,2021-01-23,1,3179,78,3258
UTTAR PRADESH,ETAWAH,2021-01-24,1,609,75,685
UTTAR PRADESH,ETAWAH,2021-01-25,1,494,64,559
UTTAR PRADESH,FARRUKHABAD,2021-01-21,5,1014,25,1044
UTTAR PRADESH,FARRUKHABAD,2021-01-22,2,1154,44,1200
UTTAR PRADESH,FARRUKHABAD,2021-01-23,3,791,60,854
UTTAR PRADESH,FARRUKHABAD,2021-01-24,1,424,17,442
UTTAR PRADESH,FARRUKHABAD,2021-01-25,7,1083,69,1159
UTTAR PRADESH,FATEHPUR,2021-01-21,3,2017,266,2286
UTTAR PRADESH,FATEHPUR,2021-01-22,1,1204,98,1303
UTTAR PRADESH,FATEHPUR,2021-01-23,3,1584,119,1706
UTTAR PRADESH,FATEHPUR,2021-01-24,1,1122,21,1144
UTTAR PRADESH,FATEHPUR,2021-01-25,3,1314,59,1376
UTTAR PRADESH,FIROZABAD,2021-01-21,1,1847,19,1867
UTTAR PRADESH,FIROZABAD,2021-01-22,1,1395,5,1401
UTTAR PRADESH,FIROZABAD,2021-01-23,1,1552,2,1555
UTTAR PRADESH,FIROZABAD,2021-01-24,1,1412,3,1416
UTTAR PRADESH,FIROZABAD,2021-01-25,3,1455,17,1475
UTTAR PRADESH,GAUTAM BUDDHA NAGAR,2021-01-21,24,2706,64,2794
UTTAR PRADESH,GAUTAM BUDDHA NAGAR,2021-01-22,23,3250,20,3293
UTTAR PRADESH,GAUTAM BUDDHA NAGAR,2021-01-23,23,3438,39,3500
UTTAR PRADESH,GAUTAM BUDDHA NAGAR,2021-01-24,37,2389,112,2538
UTTAR PRADESH,GAUTAM BUDDHA NAGAR,2021-01-25,16,1790,7,1813
UTTAR PRADESH,GHAZIABAD,2021-01-21,51,1976,90,2117
UTTAR PRADESH,GHAZIABAD,2021-01-22,48,3619,15,3682
UTTAR PRADESH,GHAZIABAD,2021-01-23,28,3401,76,3505
UTTAR PRADESH,GHAZIABAD,2021-01-24,22,1535,77,1634
UTTAR PRADESH,GHAZIABAD,2021-01-25,34,2555,138,2727
UTTAR PRADESH,GHAZIPUR,2021-01-21,1,894,14,909
UTTAR PRADESH,GHAZIPUR,2021-01-22,2,1103,5,1110
UTTAR PRADESH,GHAZIPUR,2021-01-23,4,1280,17,1301
UTTAR PRADESH,GHAZIPUR,2021-01-24,0,1266,34,1300
UTTAR PRADESH,GHAZIPUR,2021-01-25,1,727,0,728
UTTAR PRADESH,GONDA,2021-01-21,3,1440,9,1452
UTTAR PRADESH,GONDA,2021-01-22,2,1482,102,1586
UTTAR PRADESH,GONDA,2021-01-23,3,1349,0,1352
UTTAR PRADESH,GONDA,2021-01-24,0,1319,99,1418
UTTAR PRADESH,GONDA,2021-01-25,3,1493,2,1498
UTTAR PRADESH,GORAKHPUR,2021-01-21,13,2378,57,2448
UTTAR PRADESH,GORAKHPUR,2021-01-22,7,2111,53,2171
UTTAR PRADESH,GORAKHPUR,2021-01-23,5,2699,119,2823
UTTAR PRADESH,GORAKHPUR,2021-01-24,0,981,6,987
UTTAR PRADESH,GORAKHPUR,2021-01-25,2,2669,23,2694
UTTAR PRADESH,HAMIRPUR,2021-01-21,1,1167,4,1172
UTTAR PRADESH,HAMIRPUR,2021-01-22,1,828,21,850
UTTAR PRADESH,HAMIRPUR,2021-01-23,1,1055,4,1060
UTTAR PRADESH,HAMIRPUR,2021-01-24,0,797,5,802
UTTAR PRADESH,HAMIRPUR,2021-01-25,0,1186,1,1187
UTTAR PRADESH,HAPUR,2021-01-21,3,2124,30,2157
UTTAR PRADESH,HAPUR,2021-01-22,0,1891,10,1901
UTTAR PRADESH,HAPUR,2021-01-23,2,764,49,815
UTTAR PRADESH,HAPUR,2021-01-24,3,537,37,577
UTTAR PRADESH,HAPUR,2021-01-25,2,3132,5,3139
UTTAR PRADESH,HARDOI,2021-01-21,5,1655,13,1673
UTTAR PRADESH,HARDOI,2021-01-22,2,1387,12,1401
UTTAR PRADESH,HARDOI,2021-01-23,0,1196,5,1201
UTTAR PRADESH,HARDOI,2021-01-24,5,1038,4,1047
UTTAR PRADESH,HARDOI,2021-01-25,0,1338,1,1339
UTTAR PRADESH,HATHRAS,2021-01-21,0,1283,0,1283
UTTAR PRADESH,HATHRAS,2021-01-22,0,1236,0,1236
UTTAR PRADESH,HATHRAS,2021-01-23,0,1138,0,1138
UTTAR PRADESH,HATHRAS,2021-01-24,1,1461,5,1467
UTTAR PRADESH,HATHRAS,2021-01-25,0,689,0,689
UTTAR PRADESH,JALAUN,2021-01-21,0,1795,1,1796
UTTAR PRADESH,JALAUN,2021-01-22,2,1597,5,1604
UTTAR PRADESH,JALAUN,2021-01-23,0,1258,4,1262
UTTAR PRADESH,JALAUN,2021-01-24,0,701,4,705
UTTAR PRADESH,JALAUN,2021-01-25,1,988,1,990
UTTAR PRADESH,JAUNPUR,2021-01-21,3,1551,6,1560
UTTAR PRADESH,JAUNPUR,2021-01-22,4,674,20,698
UTTAR PRADESH,JAUNPUR,2021-01-23,3,1548,0,1551
UTTAR PRADESH,JAUNPUR,2021-01-24,2,1190,0,1192
UTTAR PRADESH,JAUNPUR,2021-01-25,5,1993,1,1999
UTTAR PRADESH,JHANSI,2021-01-21,6,2953,17,2976
UTTAR PRADESH,JHANSI,2021-01-22,7,2319,3,2329
UTTAR PRADESH,JHANSI,2021-01-23,8,2102,1,2111
UTTAR PRADESH,JHANSI,2021-01-24,4,2010,3,2017
UTTAR PRADESH,JHANSI,2021-01-25,8,3668,1,3677
UTTAR PRADESH,KANNAUJ,2021-01-21,0,1808,2,1810
UTTAR PRADESH,KANNAUJ,2021-01-22,2,1632,0,1634
UTTAR PRADESH,KANNAUJ,2021-01-23,3,1327,3,1333
UTTAR PRADESH,KANNAUJ,2021-01-24,0,1394,1,1395
UTTAR PRADESH,KANNAUJ,2021-01-25,1,1386,0,1387
UTTAR PRADESH,KANPUR DEHAT,2021-01-21,0,2298,8,2306
UTTAR PRADESH,KANPUR DEHAT,2021-01-22,1,928,1,930
UTTAR PRADESH,KANPUR DEHAT,2021-01-23,0,987,7,994
UTTAR PRADESH,KANPUR DEHAT,2021-01-24,2,2145,3,2150
UTTAR PRADESH,KANPUR DEHAT,2021-01-25,2,1084,0,1086
UTTAR PRADESH,KANPUR NAGAR,2021-01-21,17,3872,34,3923
UTTAR PRADESH,KANPUR NAGAR,2021-01-22,18,3206,17,3241
UTTAR PRADESH,KANPUR NAGAR,2021-01-23,17,3026,3,3046
UTTAR PRADESH,KANPUR NAGAR,2021-01-24,24,3105,26,3155
UTTAR PRADESH,KANPUR NAGAR,2021-01-25,29,2624,14,2667
UTTAR PRADESH,KASGANJ,2021-01-21,0,1531,4,1535
UTTAR PRADESH,KASGANJ,2021-01-22,1,1767,115,1883
UTTAR PRADESH,KASGANJ,2021-01-23,1,880,1,882
UTTAR PRADESH,KASGANJ,2021-01-24,2,980,54,1036
UTTAR PRADESH,KASGANJ,2021-01-25,0,1182,2,1184
UTTAR PRADESH,KAUSHAMBI,2021-01-21,0,1778,2,1780
UTTAR PRADESH,KAUSHAMBI,2021-01-22,1,1814,0,1815
UTTAR PRADESH,KAUSHAMBI,2021-01-23,0,1380,3,1383
UTTAR PRADESH,KAUSHAMBI,2021-01-24,0,1878,1,1879
UTTAR PRADESH,KAUSHAMBI,2021-01-25,2,1643,0,1645
UTTAR PRADESH,KHERI,2021-01-21,13,1922,16,1951
UTTAR PRADESH,KHERI,2021-01-22,4,1212,0,1216
UTTAR PRADESH,KHERI,2021-01-23,2,1672,20,1694
UTTAR PRADESH,KHERI,2021-01-24,1,1628,1,1630
UTTAR PRADESH,KHERI,2021-01-25,5,1464,1,1470
UTTAR PRADESH,KUSHI NAGAR,2021-01-21,1,947,0,948
UTTAR PRADESH,KUSHI NAGAR,2021-01-22,2,1514,39,1555
UTTAR PRADESH,KUSHI NAGAR,2021-01-23,0,1015,4,1019
UTTAR PRADESH,KUSHI NAGAR,2021-01-24,0,537,4,541
UTTAR PRADESH,KUSHI NAGAR,2021-01-25,1,927,27,955
UTTAR PRADESH,LALITPUR,2021-01-21,3,849,2,854
UTTAR PRADESH,LALITPUR,2021-01-22,2,1844,0,1846
UTTAR PRADESH,LALITPUR,2021-01-23,1,1313,1,1315
UTTAR PRADESH,LALITPUR,2021-01-24,0,1279,0,1279
UTTAR PRADESH,LALITPUR,2021-01-25,3,1362,4,1369
UTTAR PRADESH,LUCKNOW,2021-01-21,57,6789,202,7048
UTTAR PRADESH,LUCKNOW,2021-01-22,52,6008,254,6314
UTTAR PRADESH,LUCKNOW,2021-01-23,38,5534,301,5873
UTTAR PRADESH,LUCKNOW,2021-01-24,52,5481,117,5650
UTTAR PRADESH,LUCKNOW,2021-01-25,51,5315,123,5489
UTTAR PRADESH,MAHARAJGANJ,2021-01-21,0,2366,49,2415
UTTAR PRADESH,MAHARAJGANJ,2021-01-22,0,992,176,1168
UTTAR PRADESH,MAHARAJGANJ,2021-01-23,2,978,122,1102
UTTAR PRADESH,MAHARAJGANJ,2021-01-24,1,907,119,1027
UTTAR PRADESH,MAHARAJGANJ,2021-01-25,2,366,2,370
UTTAR PRADESH,MAHOBA,2021-01-21,0,787,5,792
UTTAR PRADESH,MAHOBA,2021-01-22,0,911,6,917
UTTAR PRADESH,MAHOBA,2021-01-23,0,730,6,736
UTTAR PRADESH,MAHOBA,2021-01-24,0,681,26,707
UTTAR PRADESH,MAHOBA,2021-01-25,0,724,26,750
UTTAR PRADESH,MAINPURI,2021-01-21,2,1791,1,1794
UTTAR PRADESH,MAINPURI,2021-01-22,1,1541,1,1543
UTTAR PRADESH,MAINPURI,2021-01-23,2,1326,0,1328
UTTAR PRADESH,MAINPURI,2021-01-24,1,1456,0,1457
UTTAR PRADESH,MAINPURI,2021-01-25,1,1239,7,1247
UTTAR PRADESH,MATHURA,2021-01-21,6,1689,11,1706
UTTAR PRADESH,MATHURA,2021-01-22,5,1576,8,1589
UTTAR PRADESH,MATHURA,2021-01-23,2,1265,7,1274
UTTAR PRADESH,MATHURA,2021-01-24,1,1528,33,1562
UTTAR PRADESH,MATHURA,2021-01-25,3,1516,0,1519
UTTAR PRADESH,MAU,2021-01-21,0,1220,10,1230
UTTAR PRADESH,MAU,2021-01-22,0,891,0,891
UTTAR PRADESH,MAU,2021-01-23,0,963,8,971
UTTAR PRADESH,MAU,2021-01-24,0,1232,9,1241
UTTAR PRADESH,MAU,2021-01-25,0,764,3,767
UTTAR PRADESH,MEERUT,2021-01-21,15,4001,2,4018
UTTAR PRADESH,MEERUT,2021-01-22,19,4373,7,4399
UTTAR PRADESH,MEERUT,2021-01-23,15,3962,12,3989
UTTAR PRADESH,MEERUT,2021-01-24,16,3241,5,3262
UTTAR PRADESH,MEERUT,2021-01-25,9,3602,16,3627
UTTAR PRADESH,MIRZAPUR,2021-01-21,2,1613,4,1619
UTTAR PRADESH,MIRZAPUR,2021-01-22,0,1396,0,1396
UTTAR PRADESH,MIRZAPUR,2021-01-23,1,1692,0,1693
UTTAR PRADESH,MIRZAPUR,2021-01-24,1,1500,0,1501
UTTAR PRADESH,MIRZAPUR,2021-01-25,0,1750,0,1750
UTTAR PRADESH,MORADABAD,2021-01-21,17,3247,5,3269
UTTAR PRADESH,MORADABAD,2021-01-22,5,2761,0,2766
UTTAR PRADESH,MORADABAD,2021-01-23,11,2403,6,2420
UTTAR PRADESH,MORADABAD,2021-01-24,8,2744,0,2752
UTTAR PRADESH,MORADABAD,2021-01-25,6,1821,0,1827
UTTAR PRADESH,MUZAFFARNAGAR,2021-01-21,30,1570,2,1602
UTTAR PRADESH,MUZAFFARNAGAR,2021-01-22,4,1836,28,1868
UTTAR PRADESH,MUZAFFARNAGAR,2021-01-23,9,1540,2,1551
UTTAR PRADESH,MUZAFFARNAGAR,2021-01-24,7,1223,0,1230
UTTAR PRADESH,MUZAFFARNAGAR,2021-01-25,4,1180,2,1186
UTTAR PRADESH,PILIBHIT,2021-01-21,4,1554,0,1558
UTTAR PRADESH,PILIBHIT,2021-01-22,0,1382,7,1389
UTTAR PRADESH,PILIBHIT,2021-01-23,2,1514,0,1516
UTTAR PRADESH,PILIBHIT,2021-01-24,0,1171,5,1176
UTTAR PRADESH,PILIBHIT,2021-01-25,0,1378,1,1379
UTTAR PRADESH,PRATAPGARH,2021-01-21,4,1424,94,1522
UTTAR PRADESH,PRATAPGARH,2021-01-22,7,1616,56,1679
UTTAR PRADESH,PRATAPGARH,2021-01-23,7,2627,70,2704
UTTAR PRADESH,PRATAPGARH,2021-01-24,1,1487,68,1556
UTTAR PRADESH,PRATAPGARH,2021-01-25,2,1468,52,1522
UTTAR PRADESH,PRAYAGRAJ,2021-01-21,15,4018,1,4034
UTTAR PRADESH,PRAYAGRAJ,2021-01-22,15,4236,3,4254
UTTAR PRADESH,PRAYAGRAJ,2021-01-23,7,4308,102,4417
UTTAR PRADESH,PRAYAGRAJ,2021-01-24,14,3776,41,3831
UTTAR PRADESH,PRAYAGRAJ,2021-01-25,46,3962,3,4011
UTTAR PRADESH,RAE BARELI,2021-01-21,8,2273,2,2283
UTTAR PRADESH,RAE BARELI,2021-01-22,16,2135,7,2158
UTTAR PRADESH,RAE BARELI,2021-01-23,8,2193,5,2206
UTTAR PRADESH,RAE BARELI,2021-01-24,5,1637,7,1649
UTTAR PRADESH,RAE BARELI,2021-01-25,9,2421,1,2431
UTTAR PRADESH,RAMPUR,2021-01-21,2,1311,46,1359
UTTAR PRADESH,RAMPUR,2021-01-22,10,1271,40,1321
UTTAR PRADESH,RAMPUR,2021-01-23,5,1480,9,1494
UTTAR PRADESH,RAMPUR,2021-01-24,3,1208,18,1229
UTTAR PRADESH,RAMPUR,2021-01-25,6,1666,47,1719
UTTAR PRADESH,SAHARANPUR,2021-01-21,17,7743,36,7796
UTTAR PRADESH,SAHARANPUR,2021-01-22,12,2798,18,2828
UTTAR PRADESH,SAHARANPUR,2021-01-23,15,3085,125,3225
UTTAR PRADESH,SAHARANPUR,2021-01-24,5,2589,16,2610
UTTAR PRADESH,SAHARANPUR,2021-01-25,12,2920,11,2943
UTTAR PRADESH,SAMBHAL,2021-01-21,0,713,94,807
UTTAR PRADESH,SAMBHAL,2021-01-22,0,1733,10,1743
UTTAR PRADESH,SAMBHAL,2021-01-23,2,1347,49,1398
UTTAR PRADESH,SAMBHAL,2021-01-24,0,519,0,519
UTTAR PRADESH,SAMBHAL,2021-01-25,0,2739,23,2762
UTTAR PRADESH,SANT KABEER NAGAR,2021-01-21,4,1872,1,1877
UTTAR PRADESH,SANT KABEER NAGAR,2021-01-22,10,842,0,852
UTTAR PRADESH,SANT KABEER NAGAR,2021-01-23,6,1345,1,1352
UTTAR PRADESH,SANT KABEER NAGAR,2021-01-24,1,1376,3,1380
UTTAR PRADESH,SANT KABEER NAGAR,2021-01-25,5,1333,1,1339
UTTAR PRADESH,SHAHJAHANPUR,2021-01-21,3,649,39,691
UTTAR PRADESH,SHAHJAHANPUR,2021-01-22,1,1145,36,1182
UTTAR PRADESH,SHAHJAHANPUR,2021-01-23,0,1089,88,1177
UTTAR PRADESH,SHAHJAHANPUR,2021-01-24,0,1255,63,1318
UTTAR PRADESH,SHAHJAHANPUR,2021-01-25,2,1301,4,1307
UTTAR PRADESH,SHAMLI,2021-01-21,5,1224,10,1239
UTTAR PRADESH,SHAMLI,2021-01-22,3,1176,5,1184
UTTAR PRADESH,SHAMLI,2021-01-23,1,1776,7,1784
UTTAR PRADESH,SHAMLI,2021-01-24,0,980,0,980
UTTAR PRADESH,SHAMLI,2021-01-25,1,1464,1,1466
UTTAR PRADESH,SHRAVASTI,2021-01-21,3,895,0,898
UTTAR PRADESH,SHRAVASTI,2021-01-22,2,837,0,839
UTTAR PRADESH,SHRAVASTI,2021-01-23,1,925,0,926
UTTAR PRADESH,SHRAVASTI,2021-01-24,0,778,0,778
UTTAR PRADESH,SHRAVASTI,2021-01-25,0,736,0,736
UTTAR PRADESH,SIDDHARTH NAGAR,2021-01-21,6,1143,0,1149
UTTAR PRADESH,SIDDHARTH NAGAR,2021-01-22,2,1018,1,1021
UTTAR PRADESH,SIDDHARTH NAGAR,2021-01-23,1,1043,21,1065
UTTAR PRADESH,SIDDHARTH NAGAR,2021-01-24,2,987,0,989
UTTAR PRADESH,SIDDHARTH NAGAR,2021-01-25,2,730,52,784
UTTAR PRADESH,SITAPUR,2021-01-21,2,1391,25,1418
UTTAR PRADESH,SITAPUR,2021-01-22,4,1484,8,1496
UTTAR PRADESH,SITAPUR,2021-01-23,6,1484,6,1496
UTTAR PRADESH,SITAPUR,2021-01-24,7,1274,10,1291
UTTAR PRADESH,SITAPUR,2021-01-25,2,1498,14,1514
UTTAR PRADESH,SONBHADRA,2021-01-21,3,2162,12,2177
UTTAR PRADESH,SONBHADRA,2021-01-22,1,1847,56,1904
UTTAR PRADESH,SONBHADRA,2021-01-23,8,2003,0,2011
UTTAR PRADESH,SONBHADRA,2021-01-24,2,1818,12,1832
UTTAR PRADESH,SONBHADRA,2021-01-25,6,1760,0,1766
UTTAR PRADESH,SULTANPUR,2021-01-21,5,1123,12,1140
UTTAR PRADESH,SULTANPUR,2021-01-22,2,936,5,943
UTTAR PRADESH,SULTANPUR,2021-01-23,0,1122,16,1138
UTTAR PRADESH,SULTANPUR,2021-01-24,5,668,2,675
UTTAR PRADESH,SULTANPUR,2021-01-25,1,474,3,478
UTTAR PRADESH,UNNAO,2021-01-21,2,1751,141,1894
UTTAR PRADESH,UNNAO,2021-01-22,1,1569,27,1597
UTTAR PRADESH,UNNAO,2021-01-23,0,1527,86,1613
UTTAR PRADESH,UNNAO,2021-01-24,2,1722,26,1750
UTTAR PRADESH,UNNAO,2021-01-25,0,634,44,678
UTTAR PRADESH,VARANASI,2021-01-21,14,2364,143,2521
UTTAR PRADESH,VARANASI,2021-01-22,15,2623,110,2748
UTTAR PRADESH,VARANASI,2021-01-23,21,2723,46,2790
UTTAR PRADESH,VARANASI,2021-01-24,12,2038,112,2162
UTTAR PRADESH,VARANASI,2021-01-25,6,1973,1,1980
UTTARAKHAND,ALMORA,2021-01-21,2,98,0,100
UTTARAKHAND,ALMORA,2021-01-22,3,141,0,144
UTTARAKHAND,ALMORA,2021-01-23,2,175,0,177
UTTARAKHAND,ALMORA,2021-01-24,0,17,0,17
UTTARAKHAND,ALMORA,2021-01-25,1,104,0,105
UTTARAKHAND,BAGESHWAR,2021-01-21,0,107,0,107
UTTARAKHAND,BAGESHWAR,2021-01-22,1,55,0,56
UTTARAKHAND,BAGESHWAR,2021-01-23,0,418,1,419
UTTARAKHAND,BAGESHWAR,2021-01-24,0,7,0,7
UTTARAKHAND,BAGESHWAR,2021-01-25,0,164,0,164
UTTARAKHAND,CHAMOLI,2021-01-21,1,528,39,568
UTTARAKHAND,CHAMOLI,2021-01-22,1,491,20,512
UTTARAKHAND,CHAMOLI,2021-01-23,2,84,2,88
UTTARAKHAND,CHAMOLI,2021-01-24,1,565,43,609
UTTARAKHAND,CHAMOLI,2021-01-25,2,137,0,139
UTTARAKHAND,CHAMPAWAT,2021-01-21,1,74,0,75
UTTARAKHAND,CHAMPAWAT,2021-01-22,1,311,0,312
UTTARAKHAND,CHAMPAWAT,2021-01-23,2,352,0,354
UTTARAKHAND,CHAMPAWAT,2021-01-24,1,284,0,285
UTTARAKHAND,CHAMPAWAT,2021-01-25,0,398,1,399
UTTARAKHAND,DEHRADUN,2021-01-21,50,2804,7,2861
UTTARAKHAND,DEHRADUN,2021-01-22,78,3572,6,3656
UTTARAKHAND,DEHRADUN,2021-01-23,57,3877,26,3960
UTTARAKHAND,DEHRADUN,2021-01-24,22,1782,9,1813
UTTARAKHAND,DEHRADUN,2021-01-25,39,2529,7,2575
UTTARAKHAND,HARIDWAR,2021-01-21,19,1986,42,2047
UTTARAKHAND,HARIDWAR,2021-01-22,16,3572,239,3827
UTTARAKHAND,HARIDWAR,2021-01-23,8,2250,15,2273
UTTARAKHAND,HARIDWAR,2021-01-24,9,3790,108,3907
UTTARAKHAND,HARIDWAR,2021-01-25,13,2568,3,2584
UTTARAKHAND,NAINITAL,2021-01-21,49,1298,5,1352
UTTARAKHAND,NAINITAL,2021-01-22,27,1270,0,1297
UTTARAKHAND,NAINITAL,2021-01-23,27,1226,1,1254
UTTARAKHAND,NAINITAL,2021-01-24,12,619,0,631
UTTARAKHAND,NAINITAL,2021-01-25,19,1231,1,1251
UTTARAKHAND,PAURI GARHWAL,2021-01-21,0,486,8,494
UTTARAKHAND,PAURI GARHWAL,2021-01-22,1,401,3,405
UTTARAKHAND,PAURI GARHWAL,2021-01-23,5,726,5,736
UTTARAKHAND,PAURI GARHWAL,2021-01-24,3,460,7,470
UTTARAKHAND,PAURI GARHWAL,2021-01-25,2,465,1,468
UTTARAKHAND,PITHORAGARH,2021-01-21,3,264,0,267
UTTARAKHAND,PITHORAGARH,2021-01-22,1,48,0,49
UTTARAKHAND,PITHORAGARH,2021-01-23,2,414,2,418
UTTARAKHAND,PITHORAGARH,2021-01-24,0,12,0,12
UTTARAKHAND,PITHORAGARH,2021-01-25,3,300,1,304
UTTARAKHAND,RUDRA PRAYAG,2021-01-21,2,201,0,203
UTTARAKHAND,RUDRA PRAYAG,2021-01-22,3,88,0,91
UTTARAKHAND,RUDRA PRAYAG,2021-01-23,0,139,0,139
UTTARAKHAND,RUDRA PRAYAG,2021-01-24,0,10,0,10
UTTARAKHAND,RUDRA PRAYAG,2021-01-25,1,39,0,40
UTTARAKHAND,TEHRI GARHWAL,2021-01-21,1,190,2,193
UTTARAKHAND,TEHRI GARHWAL,2021-01-22,4,421,1,426
UTTARAKHAND,TEHRI GARHWAL,2021-01-23,2,412,1,415
UTTARAKHAND,TEHRI GARHWAL,2021-01-24,0,250,2,252
UTTARAKHAND,TEHRI GARHWAL,2021-01-25,2,359,0,361
UTTARAKHAND,UDAM SINGH NAGAR,2021-01-21,3,2523,132,2658
UTTARAKHAND,UDAM SINGH NAGAR,2021-01-22,10,1806,29,1845
UTTARAKHAND,UDAM SINGH NAGAR,2021-01-23,9,2761,27,2797
UTTARAKHAND,UDAM SINGH NAGAR,2021-01-24,3,1130,1,1134
UTTARAKHAND,UDAM SINGH NAGAR,2021-01-25,7,2238,55,2300
UTTARAKHAND,UTTAR KASHI,2021-01-21,2,402,1,405
UTTARAKHAND,UTTAR KASHI,2021-01-22,0,506,0,506
UTTARAKHAND,UTTAR KASHI,2021-01-23,0,376,1,377
UTTARAKHAND,UTTAR KASHI,2021-01-24,1,947,12,960
UTTARAKHAND,UTTAR KASHI,2021-01-25,1,340,9,350
WEST BENGAL,24 PARAGANAS NORTH,2021-01-21,86,4311,38,4435
WEST BENGAL,24 PARAGANAS NORTH,2021-01-22,112,4179,42,4333
WEST BENGAL,24 PARAGANAS NORTH,2021-01-23,111,4198,20,4329
WEST BENGAL,24 PARAGANAS NORTH,2021-01-24,66,2811,13,2890
WEST BENGAL,24 PARAGANAS NORTH,2021-01-25,64,3626,11,3701
WEST BENGAL,24 PARAGANAS SOUTH,2021-01-21,17,4009,7,4033
WEST BENGAL,24 PARAGANAS SOUTH,2021-01-22,17,3494,6,3517
WEST BENGAL,24 PARAGANAS SOUTH,2021-01-23,12,3237,4,3253
WEST BENGAL,24 PARAGANAS SOUTH,2021-01-24,11,2010,7,2028
WEST BENGAL,24 PARAGANAS SOUTH,2021-01-25,12,3497,13,3522
WEST BENGAL,ALIPURDUAR,2021-01-21,1,219,0,220
WEST BENGAL,ALIPURDUAR,2021-01-22,1,272,1,274
WEST BENGAL,ALIPURDUAR,2021-01-23,0,331,0,331
WEST BENGAL,ALIPURDUAR,2021-01-24,0,176,0,176
WEST BENGAL,ALIPURDUAR,2021-01-25,2,238,0,240
WEST BENGAL,BANKURA,2021-01-21,12,588,7,607
WEST BENGAL,BANKURA,2021-01-22,20,543,0,563
WEST BENGAL,BANKURA,2021-01-23,13,952,7,972
WEST BENGAL,BANKURA,2021-01-24,12,562,13,587
WEST BENGAL,BANKURA,2021-01-25,7,893,2,902
WEST BENGAL,BIRBHUM,2021-01-21,7,1200,9,1216
WEST BENGAL,BIRBHUM,2021-01-22,5,1074,2,1081
WEST BENGAL,BIRBHUM,2021-01-23,4,818,4,826
WEST BENGAL,BIRBHUM,2021-01-24,1,591,6,598
WEST BENGAL,BIRBHUM,2021-01-25,4,783,5,792
WEST BENGAL,COOCHBEHAR,2021-01-21,1,1944,0,1945
WEST BENGAL,COOCHBEHAR,2021-01-22,4,2117,2,2123
WEST BENGAL,COOCHBEHAR,2021-01-23,3,2169,0,2172
WEST BENGAL,COOCHBEHAR,2021-01-24,1,2050,0,2051
WEST BENGAL,COOCHBEHAR,2021-01-25,1,2097,0,2098
WEST BENGAL,DARJEELING,2021-01-21,20,741,0,761
WEST BENGAL,DARJEELING,2021-01-22,12,1110,0,1122
WEST BENGAL,DARJEELING,2021-01-23,17,484,3,504
WEST BENGAL,DARJEELING,2021-01-24,4,517,3,524
WEST BENGAL,DARJEELING,2021-01-25,5,805,1,811
WEST BENGAL,DINAJPUR DAKSHIN,2021-01-21,3,796,1,800
WEST BENGAL,DINAJPUR DAKSHIN,2021-01-22,3,760,1,764
WEST BENGAL,DINAJPUR DAKSHIN,2021-01-23,0,647,0,647
WEST BENGAL,DINAJPUR DAKSHIN,2021-01-24,1,680,1,682
WEST BENGAL,DINAJPUR DAKSHIN,2021-01-25,0,680,1,681
WEST BENGAL,DINAJPUR UTTAR,2021-01-21,5,190,0,195
WEST BENGAL,DINAJPUR UTTAR,2021-01-22,5,174,1,180
WEST BENGAL,DINAJPUR UTTAR,2021-01-23,2,196,0,198
WEST BENGAL,DINAJPUR UTTAR,2021-01-24,3,169,0,172
WEST BENGAL,DINAJPUR UTTAR,2021-01-25,6,275,0,281
WEST BENGAL,HOOGHLY,2021-01-21,18,980,4,1002
WEST BENGAL,HOOGHLY,2021-01-22,16,1025,129,1170
WEST BENGAL,HOOGHLY,2021-01-23,14,761,12,787
WEST BENGAL,HOOGHLY,2021-01-24,10,510,26,546
WEST BENGAL,HOOGHLY,2021-01-25,8,965,103,1076
WEST BENGAL,HOWRAH,2021-01-21,28,1446,184,1658
WEST BENGAL,HOWRAH,2021-01-22,19,1589,43,1651
WEST BENGAL,HOWRAH,2021-01-23,12,1418,76,1506
WEST BENGAL,HOWRAH,2021-01-24,10,1186,87,1283
WEST BENGAL,HOWRAH,2021-01-25,8,1301,145,1454
WEST BENGAL,JALPAIGURI,2021-01-21,5,700,1,706
WEST BENGAL,JALPAIGURI,2021-01-22,6,438,1,445
WEST BENGAL,JALPAIGURI,2021-01-23,3,381,0,384
WEST BENGAL,JALPAIGURI,2021-01-24,6,93,0,99
WEST BENGAL,JALPAIGURI,2021-01-25,4,343,0,347
WEST BENGAL,JHARGRAM,2021-01-21,0,68,2,70
WEST BENGAL,JHARGRAM,2021-01-22,0,103,0,103
WEST BENGAL,JHARGRAM,2021-01-23,0,20,0,20
WEST BENGAL,JHARGRAM,2021-01-24,1,46,0,47
WEST BENGAL,JHARGRAM,2021-01-25,1,19,0,20
WEST BENGAL,KALIMPONG,2021-01-21,7,128,0,135
WEST BENGAL,KALIMPONG,2021-01-22,0,240,0,240
WEST BENGAL,KALIMPONG,2021-01-23,0,85,0,85
WEST BENGAL,KALIMPONG,2021-01-24,1,142,0,143
WEST BENGAL,KALIMPONG,2021-01-25,0,189,0,189
WEST BENGAL,KOLKATA,2021-01-21,106,3093,13,3212
WEST BENGAL,KOLKATA,2021-01-22,111,3848,15,3974
WEST BENGAL,KOLKATA,2021-01-23,125,2668,14,2807
WEST BENGAL,KOLKATA,2021-01-24,69,1818,3,1890
WEST BENGAL,KOLKATA,2021-01-25,119,3113,9,3241
WEST BENGAL,MALDAH,2021-01-21,5,899,4,908
WEST BENGAL,MALDAH,2021-01-22,4,472,2,478
WEST BENGAL,MALDAH,2021-01-23,1,599,5,605
WEST BENGAL,MALDAH,2021-01-24,3,162,3,168
WEST BENGAL,MALDAH,2021-01-25,5,673,2,680
WEST BENGAL,MEDINIPUR EAST,2021-01-21,8,1098,7,1113
WEST BENGAL,MEDINIPUR EAST,2021-01-22,8,1075,8,1091
WEST BENGAL,MEDINIPUR EAST,2021-01-23,10,654,10,674
WEST BENGAL,MEDINIPUR EAST,2021-01-24,8,674,6,688
WEST BENGAL,MEDINIPUR EAST,2021-01-25,0,867,0,867
WEST BENGAL,MEDINIPUR WEST,2021-01-21,3,621,1,625
WEST BENGAL,MEDINIPUR WEST,2021-01-22,5,585,5,595
WEST BENGAL,MEDINIPUR WEST,2021-01-23,2,408,1,411
WEST BENGAL,MEDINIPUR WEST,2021-01-24,2,374,2,378
WEST BENGAL,MEDINIPUR WEST,2021-01-25,6,550,4,560
WEST BENGAL,MURSHIDABAD,2021-01-21,8,1491,9,1508
WEST BENGAL,MURSHIDABAD,2021-01-22,3,1413,10,1426
WEST BENGAL,MURSHIDABAD,2021-01-23,3,1515,5,1523
WEST BENGAL,MURSHIDABAD,2021-01-24,1,1004,2,1007
WEST BENGAL,MURSHIDABAD,2021-01-25,6,1258,5,1269
WEST BENGAL,NADIA,2021-01-21,15,800,9,824
WEST BENGAL,NADIA,2021-01-22,14,743,7,764
WEST BENGAL,NADIA,2021-01-23,6,903,15,924
WEST BENGAL,NADIA,2021-01-24,5,692,51,748
WEST BENGAL,NADIA,2021-01-25,7,532,46,585
WEST BENGAL,PASCHIM BARDHAMAN,2021-01-21,12,724,2,738
WEST BENGAL,PASCHIM BARDHAMAN,2021-01-22,12,990,3,1005
WEST BENGAL,PASCHIM BARDHAMAN,2021-01-23,27,785,6,818
WEST BENGAL,PASCHIM BARDHAMAN,2021-01-24,14,744,3,761
WEST BENGAL,PASCHIM BARDHAMAN,2021-01-25,10,747,2,759
WEST BENGAL,PURBA BARDHAMAN,2021-01-21,10,943,0,953
WEST BENGAL,PURBA BARDHAMAN,2021-01-22,5,920,1,926
WEST BENGAL,PURBA BARDHAMAN,2021-01-23,2,785,0,787
WEST BENGAL,PURBA BARDHAMAN,2021-01-24,5,766,1,772
WEST BENGAL,PURBA BARDHAMAN,2021-01-25,0,680,1,681
WEST BENGAL,PURULIA,2021-01-21,2,560,0,562
WEST BENGAL,PURULIA,2021-01-22,4,581,0,585
WEST BENGAL,PURULIA,2021-01-23,6,669,0,675
WEST BENGAL,PURULIA,2021-01-24,1,24,1,26
WEST BENGAL,PURULIA,2021-01-25,3,747,0,750
ANDAMAN AND NICOBAR ISLANDS,NICOBARS,2021-01-26,0,10,0,10
ANDAMAN AND NICOBAR ISLANDS,NICOBARS,2021-01-27,0,25,0,25
ANDAMAN AND NICOBAR ISLANDS,NICOBARS,2021-01-28,0,15,0,15
ANDAMAN AND NICOBAR ISLANDS,NICOBARS,2021-01-29,0,32,0,32
ANDAMAN AND NICOBAR ISLANDS,NICOBARS,2021-01-30,0,16,0,16
ANDAMAN AND NICOBAR ISLANDS,NICOBARS,2021-01-31,0,4,0,4
ANDAMAN AND NICOBAR ISLANDS,NORTH AND MIDDLE ANDAMAN,2021-01-26,0,1,0,1
ANDAMAN AND NICOBAR ISLANDS,NORTH AND MIDDLE ANDAMAN,2021-01-27,0,11,0,11
ANDAMAN AND NICOBAR ISLANDS,NORTH AND MIDDLE ANDAMAN,2021-01-28,0,12,0,12
ANDAMAN AND NICOBAR ISLANDS,NORTH AND MIDDLE ANDAMAN,2021-01-29,0,7,0,7
ANDAMAN AND NICOBAR ISLANDS,NORTH AND MIDDLE ANDAMAN,2021-01-30,0,4,0,4
ANDAMAN AND NICOBAR ISLANDS,NORTH AND MIDDLE ANDAMAN,2021-01-31,0,10,0,10
ANDAMAN AND NICOBAR ISLANDS,SOUTH ANDAMANS,2021-01-26,2,301,0,303
ANDAMAN AND NICOBAR ISLANDS,SOUTH ANDAMANS,2021-01-27,2,568,0,570
ANDAMAN AND NICOBAR ISLANDS,SOUTH ANDAMANS,2021-01-28,0,595,0,595
ANDAMAN AND NICOBAR ISLANDS,SOUTH ANDAMANS,2021-01-29,2,542,1,545
ANDAMAN AND NICOBAR ISLANDS,SOUTH ANDAMANS,2021-01-30,1,637,0,638
ANDAMAN AND NICOBAR ISLANDS,SOUTH ANDAMANS,2021-01-31,0,298,0,298
ANDHRA PRADESH,ANANTAPUR,2021-01-26,8,3019,0,3027
ANDHRA PRADESH,ANANTAPUR,2021-01-27,2,2822,1,2825
ANDHRA PRADESH,ANANTAPUR,2021-01-28,13,3585,1,3599
ANDHRA PRADESH,ANANTAPUR,2021-01-29,7,4579,0,4586
ANDHRA PRADESH,ANANTAPUR,2021-01-30,4,3864,0,3868
ANDHRA PRADESH,ANANTAPUR,2021-01-31,6,2458,0,2464
ANDHRA PRADESH,CHITTOOR,2021-01-26,38,1519,0,1557
ANDHRA PRADESH,CHITTOOR,2021-01-27,34,3438,0,3472
ANDHRA PRADESH,CHITTOOR,2021-01-28,26,3637,0,3663
ANDHRA PRADESH,CHITTOOR,2021-01-29,21,3344,1,3366
ANDHRA PRADESH,CHITTOOR,2021-01-30,42,2881,0,2923
ANDHRA PRADESH,CHITTOOR,2021-01-31,5,2165,0,2170
ANDHRA PRADESH,EAST GODAVARI,2021-01-26,14,1368,0,1382
ANDHRA PRADESH,EAST GODAVARI,2021-01-27,7,1091,0,1098
ANDHRA PRADESH,EAST GODAVARI,2021-01-28,16,2909,0,2925
ANDHRA PRADESH,EAST GODAVARI,2021-01-29,11,1604,0,1615
ANDHRA PRADESH,EAST GODAVARI,2021-01-30,15,679,0,694
ANDHRA PRADESH,EAST GODAVARI,2021-01-31,9,1455,0,1464
ANDHRA PRADESH,GUNTUR,2021-01-26,12,4504,0,4516
ANDHRA PRADESH,GUNTUR,2021-01-27,17,1830,0,1847
ANDHRA PRADESH,GUNTUR,2021-01-28,19,3019,0,3038
ANDHRA PRADESH,GUNTUR,2021-01-29,17,5027,0,5044
ANDHRA PRADESH,GUNTUR,2021-01-30,13,5572,0,5585
ANDHRA PRADESH,GUNTUR,2021-01-31,8,966,0,974
ANDHRA PRADESH,KRISHNA,2021-01-26,35,2916,0,2951
ANDHRA PRADESH,KRISHNA,2021-01-27,40,1781,0,1821
ANDHRA PRADESH,KRISHNA,2021-01-28,22,3079,0,3101
ANDHRA PRADESH,KRISHNA,2021-01-29,27,2346,0,2373
ANDHRA PRADESH,KRISHNA,2021-01-30,25,2021,0,2046
ANDHRA PRADESH,KRISHNA,2021-01-31,16,3901,0,3917
ANDHRA PRADESH,KURNOOL,2021-01-26,10,3829,0,3839
ANDHRA PRADESH,KURNOOL,2021-01-27,10,1085,0,1095
ANDHRA PRADESH,KURNOOL,2021-01-28,3,3681,0,3684
ANDHRA PRADESH,KURNOOL,2021-01-29,15,3981,2,3998
ANDHRA PRADESH,KURNOOL,2021-01-30,12,3363,0,3375
ANDHRA PRADESH,KURNOOL,2021-01-31,2,2378,0,2380
ANDHRA PRADESH,PRAKASAM,2021-01-26,5,2178,0,2183
ANDHRA PRADESH,PRAKASAM,2021-01-27,6,1641,1,1648
ANDHRA PRADESH,PRAKASAM,2021-01-28,3,4134,1,4138
ANDHRA PRADESH,PRAKASAM,2021-01-29,3,3732,0,3735
ANDHRA PRADESH,PRAKASAM,2021-01-30,6,2865,0,2871
ANDHRA PRADESH,PRAKASAM,2021-01-31,1,2108,0,2109
ANDHRA PRADESH,SPSR NELLORE,2021-01-26,7,2948,0,2955
ANDHRA PRADESH,SPSR NELLORE,2021-01-27,8,1815,0,1823
ANDHRA PRADESH,SPSR NELLORE,2021-01-28,12,2232,0,2244
ANDHRA PRADESH,SPSR NELLORE,2021-01-29,6,2799,0,2805
ANDHRA PRADESH,SPSR NELLORE,2021-01-30,3,3902,0,3905
ANDHRA PRADESH,SPSR NELLORE,2021-01-31,2,2545,0,2547
ANDHRA PRADESH,SRIKAKULAM,2021-01-26,6,3301,0,3307
ANDHRA PRADESH,SRIKAKULAM,2021-01-27,1,1109,0,1110
ANDHRA PRADESH,SRIKAKULAM,2021-01-28,5,2334,0,2339
ANDHRA PRADESH,SRIKAKULAM,2021-01-29,2,2223,0,2225
ANDHRA PRADESH,SRIKAKULAM,2021-01-30,4,1991,1,1996
ANDHRA PRADESH,SRIKAKULAM,2021-01-31,2,2152,0,2154
ANDHRA PRADESH,VISAKHAPATANAM,2021-01-26,25,2985,2,3012
ANDHRA PRADESH,VISAKHAPATANAM,2021-01-27,29,2099,0,2128
ANDHRA PRADESH,VISAKHAPATANAM,2021-01-28,28,3301,0,3329
ANDHRA PRADESH,VISAKHAPATANAM,2021-01-29,31,2781,0,2812
ANDHRA PRADESH,VISAKHAPATANAM,2021-01-30,22,3802,0,3824
ANDHRA PRADESH,VISAKHAPATANAM,2021-01-31,15,3047,0,3062
ANDHRA PRADESH,VIZIANAGARAM,2021-01-26,0,435,0,435
ANDHRA PRADESH,VIZIANAGARAM,2021-01-27,2,1155,0,1157
ANDHRA PRADESH,VIZIANAGARAM,2021-01-28,4,2293,0,2297
ANDHRA PRADESH,VIZIANAGARAM,2021-01-29,1,1523,0,1524
ANDHRA PRADESH,VIZIANAGARAM,2021-01-30,0,1487,0,1487
ANDHRA PRADESH,VIZIANAGARAM,2021-01-31,1,72,0,73
ANDHRA PRADESH,WEST GODAVARI,2021-01-26,6,888,1,895
ANDHRA PRADESH,WEST GODAVARI,2021-01-27,18,2634,0,2652
ANDHRA PRADESH,WEST GODAVARI,2021-01-28,9,1835,0,1844
ANDHRA PRADESH,WEST GODAVARI,2021-01-29,11,1983,0,1994
ANDHRA PRADESH,WEST GODAVARI,2021-01-30,13,2505,1,2519
ANDHRA PRADESH,WEST GODAVARI,2021-01-31,2,1058,0,1060
ANDHRA PRADESH,Y.S.R.,2021-01-26,3,3873,0,3876
ANDHRA PRADESH,Y.S.R.,2021-01-27,6,319,0,325
ANDHRA PRADESH,Y.S.R.,2021-01-28,5,3514,0,3519
ANDHRA PRADESH,Y.S.R.,2021-01-29,13,5661,0,5674
ANDHRA PRADESH,Y.S.R.,2021-01-30,2,2992,0,2994
ANDHRA PRADESH,Y.S.R.,2021-01-31,5,5935,0,5940
ARUNACHAL PRADESH,ANJAW,2021-01-28,0,5,0,5
ARUNACHAL PRADESH,ANJAW,2021-01-29,0,4,0,4
ARUNACHAL PRADESH,ANJAW,2021-01-30,0,1,0,1
ARUNACHAL PRADESH,ANJAW,2021-01-31,0,12,0,12
ARUNACHAL PRADESH,CHANGLANG,2021-01-27,0,2,0,2
ARUNACHAL PRADESH,CHANGLANG,2021-01-28,0,4,0,4
ARUNACHAL PRADESH,CHANGLANG,2021-01-29,0,2,0,2
ARUNACHAL PRADESH,CHANGLANG,2021-01-30,0,4,0,4
ARUNACHAL PRADESH,DIBANG VALLEY,2021-01-28,0,1,0,1
ARUNACHAL PRADESH,DIBANG VALLEY,2021-01-30,0,1,0,1
ARUNACHAL PRADESH,EAST KAMENG,2021-01-26,0,1,0,1
ARUNACHAL PRADESH,EAST KAMENG,2021-01-27,0,2,0,2
ARUNACHAL PRADESH,EAST KAMENG,2021-01-30,0,2,0,2
ARUNACHAL PRADESH,EAST SIANG,2021-01-26,0,3,0,3
ARUNACHAL PRADESH,EAST SIANG,2021-01-27,0,32,0,32
ARUNACHAL PRADESH,EAST SIANG,2021-01-28,0,26,0,26
ARUNACHAL PRADESH,EAST SIANG,2021-01-29,0,37,0,37
ARUNACHAL PRADESH,EAST SIANG,2021-01-30,0,33,0,33
ARUNACHAL PRADESH,EAST SIANG,2021-01-31,0,2,0,2
ARUNACHAL PRADESH,LEPARADA,2021-01-28,0,1,0,1
ARUNACHAL PRADESH,LEPARADA,2021-01-29,1,1,0,2
ARUNACHAL PRADESH,LEPARADA,2021-01-30,9,2,0,11
ARUNACHAL PRADESH,LOHIT,2021-01-27,0,2,0,2
ARUNACHAL PRADESH,LOHIT,2021-01-28,0,2,0,2
ARUNACHAL PRADESH,LOHIT,2021-01-29,0,3,0,3
ARUNACHAL PRADESH,LOHIT,2021-01-31,0,2,0,2
ARUNACHAL PRADESH,LONGDING,2021-01-28,0,1,0,1
ARUNACHAL PRADESH,LONGDING,2021-01-29,0,2,0,2
ARUNACHAL PRADESH,LOWER DIBANG VALLEY,2021-01-27,0,1,0,1
ARUNACHAL PRADESH,LOWER DIBANG VALLEY,2021-01-29,0,35,0,35
ARUNACHAL PRADESH,LOWER DIBANG VALLEY,2021-01-30,0,16,0,16
ARUNACHAL PRADESH,LOWER DIBANG VALLEY,2021-01-31,1,0,0,1
ARUNACHAL PRADESH,LOWER SIANG,2021-01-26,0,8,0,8
ARUNACHAL PRADESH,LOWER SIANG,2021-01-27,0,16,0,16
ARUNACHAL PRADESH,LOWER SIANG,2021-01-28,0,7,0,7
ARUNACHAL PRADESH,LOWER SIANG,2021-01-29,0,11,0,11
ARUNACHAL PRADESH,LOWER SIANG,2021-01-30,0,10,0,10
ARUNACHAL PRADESH,LOWER SIANG,2021-01-31,0,10,0,10
ARUNACHAL PRADESH,LOWER SUBANSIRI,2021-01-26,0,21,0,21
ARUNACHAL PRADESH,LOWER SUBANSIRI,2021-01-27,0,2,0,2
ARUNACHAL PRADESH,LOWER SUBANSIRI,2021-01-28,0,14,0,14
ARUNACHAL PRADESH,LOWER SUBANSIRI,2021-01-29,0,10,0,10
ARUNACHAL PRADESH,LOWER SUBANSIRI,2021-01-30,0,3,0,3
ARUNACHAL PRADESH,NAMSAI,2021-01-26,0,1,0,1
ARUNACHAL PRADESH,NAMSAI,2021-01-27,0,2,0,2
ARUNACHAL PRADESH,NAMSAI,2021-01-28,0,2,0,2
ARUNACHAL PRADESH,PAKKE KESSANG,2021-01-29,0,1,0,1
ARUNACHAL PRADESH,PAPUM PARE,2021-01-26,0,6,0,6
ARUNACHAL PRADESH,PAPUM PARE,2021-01-27,1,18,0,19
ARUNACHAL PRADESH,PAPUM PARE,2021-01-28,0,27,0,27
ARUNACHAL PRADESH,PAPUM PARE,2021-01-29,0,19,0,19
ARUNACHAL PRADESH,PAPUM PARE,2021-01-30,0,45,0,45
ARUNACHAL PRADESH,PAPUM PARE,2021-01-31,0,3,0,3
ARUNACHAL PRADESH,SIANG,2021-01-27,0,1,0,1
ARUNACHAL PRADESH,SIANG,2021-01-28,0,1,0,1
ARUNACHAL PRADESH,TAWANG,2021-01-26,0,43,0,43
ARUNACHAL PRADESH,TAWANG,2021-01-27,0,7,0,7
ARUNACHAL PRADESH,TAWANG,2021-01-28,0,1,0,1
ARUNACHAL PRADESH,TAWANG,2021-01-29,0,37,0,37
ARUNACHAL PRADESH,TAWANG,2021-01-31,0,2,0,2
ARUNACHAL PRADESH,TIRAP,2021-01-27,0,1,0,1
ARUNACHAL PRADESH,UPPER SIANG,2021-01-26,0,1,0,1
ARUNACHAL PRADESH,UPPER SIANG,2021-01-29,1,0,0,1
ARUNACHAL PRADESH,UPPER SIANG,2021-01-30,0,1,0,1
ARUNACHAL PRADESH,UPPER SUBANSIRI,2021-01-28,0,1,0,1
ARUNACHAL PRADESH,UPPER SUBANSIRI,2021-01-29,0,3,0,3
ARUNACHAL PRADESH,WEST KAMENG,2021-01-26,0,1,0,1
ARUNACHAL PRADESH,WEST KAMENG,2021-01-27,0,22,0,22
ARUNACHAL PRADESH,WEST KAMENG,2021-01-28,1,66,0,67
ARUNACHAL PRADESH,WEST KAMENG,2021-01-29,0,132,0,132
ARUNACHAL PRADESH,WEST KAMENG,2021-01-30,0,161,0,161
ARUNACHAL PRADESH,WEST SIANG,2021-01-27,0,1,0,1
ARUNACHAL PRADESH,WEST SIANG,2021-01-28,0,1,0,1
ARUNACHAL PRADESH,WEST SIANG,2021-01-31,0,2,0,2
ASSAM,BAKSA,2021-01-26,0,21,0,21
ASSAM,BAKSA,2021-01-27,0,88,0,88
ASSAM,BAKSA,2021-01-28,0,41,0,41
ASSAM,BAKSA,2021-01-29,0,31,0,31
ASSAM,BAKSA,2021-01-30,0,32,0,32
ASSAM,BAKSA,2021-01-31,0,27,0,27
ASSAM,BARPETA,2021-01-26,0,77,0,77
ASSAM,BARPETA,2021-01-27,0,204,0,204
ASSAM,BARPETA,2021-01-28,1,163,0,164
ASSAM,BARPETA,2021-01-29,0,75,0,75
ASSAM,BARPETA,2021-01-30,2,126,0,128
ASSAM,BARPETA,2021-01-31,0,74,0,74
ASSAM,BISWANATH,2021-01-26,0,9,0,9
ASSAM,BISWANATH,2021-01-27,0,51,0,51
ASSAM,BISWANATH,2021-01-28,0,52,0,52
ASSAM,BISWANATH,2021-01-29,1,27,0,28
ASSAM,BISWANATH,2021-01-30,0,44,0,44
ASSAM,BISWANATH,2021-01-31,0,8,0,8
ASSAM,BONGAIGAON,2021-01-26,0,176,0,176
ASSAM,BONGAIGAON,2021-01-27,0,248,0,248
ASSAM,BONGAIGAON,2021-01-28,1,377,0,378
ASSAM,BONGAIGAON,2021-01-29,0,279,0,279
ASSAM,BONGAIGAON,2021-01-30,0,238,0,238
ASSAM,BONGAIGAON,2021-01-31,0,43,0,43
ASSAM,CACHAR,2021-01-26,0,86,0,86
ASSAM,CACHAR,2021-01-27,4,225,26,255
ASSAM,CACHAR,2021-01-28,2,155,7,164
ASSAM,CACHAR,2021-01-29,2,140,3,145
ASSAM,CACHAR,2021-01-30,0,144,31,175
ASSAM,CACHAR,2021-01-31,1,60,0,61
ASSAM,CHARAIDEO,2021-01-26,0,71,0,71
ASSAM,CHARAIDEO,2021-01-27,0,141,0,141
ASSAM,CHARAIDEO,2021-01-28,0,126,0,126
ASSAM,CHARAIDEO,2021-01-29,0,104,0,104
ASSAM,CHARAIDEO,2021-01-30,0,196,0,196
ASSAM,CHARAIDEO,2021-01-31,0,42,0,42
ASSAM,CHIRANG,2021-01-26,0,10,0,10
ASSAM,CHIRANG,2021-01-27,0,15,0,15
ASSAM,CHIRANG,2021-01-28,0,120,0,120
ASSAM,CHIRANG,2021-01-29,0,50,0,50
ASSAM,CHIRANG,2021-01-30,0,76,0,76
ASSAM,CHIRANG,2021-01-31,0,5,0,5
ASSAM,DARRANG,2021-01-26,0,135,0,135
ASSAM,DARRANG,2021-01-27,0,408,0,408
ASSAM,DARRANG,2021-01-28,0,325,0,325
ASSAM,DARRANG,2021-01-29,0,299,0,299
ASSAM,DARRANG,2021-01-30,0,338,0,338
ASSAM,DARRANG,2021-01-31,0,95,0,95
ASSAM,DHEMAJI,2021-01-26,0,28,0,28
ASSAM,DHEMAJI,2021-01-27,0,116,0,116
ASSAM,DHEMAJI,2021-01-28,0,142,0,142
ASSAM,DHEMAJI,2021-01-29,0,47,0,47
ASSAM,DHEMAJI,2021-01-30,0,81,0,81
ASSAM,DHEMAJI,2021-01-31,0,54,0,54
ASSAM,DHUBRI,2021-01-26,0,86,0,86
ASSAM,DHUBRI,2021-01-27,1,330,0,331
ASSAM,DHUBRI,2021-01-28,1,209,0,210
ASSAM,DHUBRI,2021-01-29,0,220,0,220
ASSAM,DHUBRI,2021-01-30,1,293,0,294
ASSAM,DHUBRI,2021-01-31,0,31,0,31
ASSAM,DIBRUGARH,2021-01-26,2,145,0,147
ASSAM,DIBRUGARH,2021-01-27,11,357,0,368
ASSAM,DIBRUGARH,2021-01-28,2,302,0,304
ASSAM,DIBRUGARH,2021-01-29,4,408,0,412
ASSAM,DIBRUGARH,2021-01-30,3,350,0,353
ASSAM,DIBRUGARH,2021-01-31,2,143,0,145
ASSAM,DIMA HASAO,2021-01-26,0,56,0,56
ASSAM,DIMA HASAO,2021-01-27,0,69,0,69
ASSAM,DIMA HASAO,2021-01-28,2,56,0,58
ASSAM,DIMA HASAO,2021-01-29,0,79,0,79
ASSAM,DIMA HASAO,2021-01-30,3,78,0,81
ASSAM,DIMA HASAO,2021-01-31,0,22,0,22
ASSAM,GOALPARA,2021-01-26,0,162,0,162
ASSAM,GOALPARA,2021-01-27,0,404,0,404
ASSAM,GOALPARA,2021-01-28,0,337,0,337
ASSAM,GOALPARA,2021-01-29,1,471,0,472
ASSAM,GOALPARA,2021-01-30,0,451,0,451
ASSAM,GOALPARA,2021-01-31,0,186,0,186
ASSAM,GOLAGHAT,2021-01-26,1,137,0,138
ASSAM,GOLAGHAT,2021-01-27,72,659,0,731
ASSAM,GOLAGHAT,2021-01-28,12,392,0,404
ASSAM,GOLAGHAT,2021-01-29,56,541,3,600
ASSAM,GOLAGHAT,2021-01-30,28,444,0,472
ASSAM,GOLAGHAT,2021-01-31,0,116,0,116
ASSAM,HAILAKANDI,2021-01-26,0,116,0,116
ASSAM,HAILAKANDI,2021-01-27,0,343,1,344
ASSAM,HAILAKANDI,2021-01-28,0,338,67,405
ASSAM,HAILAKANDI,2021-01-29,3,331,0,334
ASSAM,HAILAKANDI,2021-01-30,0,376,26,402
ASSAM,HAILAKANDI,2021-01-31,0,80,0,80
ASSAM,HOJAI,2021-01-26,0,36,0,36
ASSAM,HOJAI,2021-01-27,0,148,1,149
ASSAM,HOJAI,2021-01-28,0,236,0,236
ASSAM,HOJAI,2021-01-29,0,130,0,130
ASSAM,HOJAI,2021-01-30,0,101,0,101
ASSAM,HOJAI,2021-01-31,0,19,0,19
ASSAM,JORHAT,2021-01-26,1,259,74,334
ASSAM,JORHAT,2021-01-27,6,603,1,610
ASSAM,JORHAT,2021-01-28,2,356,1,359
ASSAM,JORHAT,2021-01-29,3,492,5,500
ASSAM,JORHAT,2021-01-30,1,401,0,402
ASSAM,JORHAT,2021-01-31,0,238,1,239
ASSAM,KAMRUP,2021-01-26,1,198,0,199
ASSAM,KAMRUP,2021-01-27,1,689,0,690
ASSAM,KAMRUP,2021-01-28,1,528,0,529
ASSAM,KAMRUP,2021-01-29,2,656,1,659
ASSAM,KAMRUP,2021-01-30,0,603,0,603
ASSAM,KAMRUP,2021-01-31,0,143,0,143
ASSAM,KAMRUP METRO,2021-01-26,4,1830,1,1835
ASSAM,KAMRUP METRO,2021-01-27,6,2648,1,2655
ASSAM,KAMRUP METRO,2021-01-28,11,3166,1,3178
ASSAM,KAMRUP METRO,2021-01-29,10,2810,2,2822
ASSAM,KAMRUP METRO,2021-01-30,10,2022,2,2034
ASSAM,KAMRUP METRO,2021-01-31,12,1726,1,1739
ASSAM,KARBI ANGLONG,2021-01-26,0,13,0,13
ASSAM,KARBI ANGLONG,2021-01-27,0,51,0,51
ASSAM,KARBI ANGLONG,2021-01-28,1,18,0,19
ASSAM,KARBI ANGLONG,2021-01-29,0,14,0,14
ASSAM,KARBI ANGLONG,2021-01-30,1,143,0,144
ASSAM,KARBI ANGLONG,2021-01-31,1,14,0,15
ASSAM,KARIMGANJ,2021-01-26,0,230,0,230
ASSAM,KARIMGANJ,2021-01-27,0,422,2,424
ASSAM,KARIMGANJ,2021-01-28,0,350,1,351
ASSAM,KARIMGANJ,2021-01-29,2,301,54,357
ASSAM,KARIMGANJ,2021-01-30,1,226,2,229
ASSAM,KARIMGANJ,2021-01-31,0,55,0,55
ASSAM,KOKRAJHAR,2021-01-26,2,14,0,16
ASSAM,KOKRAJHAR,2021-01-27,0,48,0,48
ASSAM,KOKRAJHAR,2021-01-28,0,22,0,22
ASSAM,KOKRAJHAR,2021-01-29,0,41,0,41
ASSAM,KOKRAJHAR,2021-01-30,0,27,0,27
ASSAM,KOKRAJHAR,2021-01-31,0,2,0,2
ASSAM,LAKHIMPUR,2021-01-26,0,83,0,83
ASSAM,LAKHIMPUR,2021-01-27,0,262,0,262
ASSAM,LAKHIMPUR,2021-01-28,0,263,0,263
ASSAM,LAKHIMPUR,2021-01-29,0,256,0,256
ASSAM,LAKHIMPUR,2021-01-30,0,286,0,286
ASSAM,LAKHIMPUR,2021-01-31,0,63,0,63
ASSAM,MAJULI,2021-01-26,0,6,0,6
ASSAM,MAJULI,2021-01-27,0,5,0,5
ASSAM,MAJULI,2021-01-28,0,8,0,8
ASSAM,MAJULI,2021-01-29,0,3,0,3
ASSAM,MAJULI,2021-01-30,1,12,0,13
ASSAM,MAJULI,2021-01-31,0,6,0,6
ASSAM,MARIGAON,2021-01-26,0,19,0,19
ASSAM,MARIGAON,2021-01-27,0,57,0,57
ASSAM,MARIGAON,2021-01-28,0,94,0,94
ASSAM,MARIGAON,2021-01-29,0,53,0,53
ASSAM,MARIGAON,2021-01-30,0,65,0,65
ASSAM,MARIGAON,2021-01-31,0,176,0,176
ASSAM,NAGAON,2021-01-26,3,104,0,107
ASSAM,NAGAON,2021-01-27,3,359,0,362
ASSAM,NAGAON,2021-01-28,0,425,0,425
ASSAM,NAGAON,2021-01-29,1,343,0,344
ASSAM,NAGAON,2021-01-30,0,333,0,333
ASSAM,NAGAON,2021-01-31,0,117,0,117
ASSAM,NALBARI,2021-01-26,1,36,0,37
ASSAM,NALBARI,2021-01-27,0,87,0,87
ASSAM,NALBARI,2021-01-28,0,129,0,129
ASSAM,NALBARI,2021-01-29,0,246,0,246
ASSAM,NALBARI,2021-01-30,0,108,0,108
ASSAM,NALBARI,2021-01-31,0,10,0,10
ASSAM,SIVASAGAR,2021-01-26,0,112,1,113
ASSAM,SIVASAGAR,2021-01-27,0,344,0,344
ASSAM,SIVASAGAR,2021-01-28,2,242,0,244
ASSAM,SIVASAGAR,2021-01-29,0,191,0,191
ASSAM,SIVASAGAR,2021-01-30,0,222,0,222
ASSAM,SIVASAGAR,2021-01-31,0,12,0,12
ASSAM,SONITPUR,2021-01-26,0,170,0,170
ASSAM,SONITPUR,2021-01-27,0,314,0,314
ASSAM,SONITPUR,2021-01-28,2,366,0,368
ASSAM,SONITPUR,2021-01-29,1,239,0,240
ASSAM,SONITPUR,2021-01-30,2,214,0,216
ASSAM,SONITPUR,2021-01-31,1,107,0,108
ASSAM,SOUTH SALMARA MANCACHAR,2021-01-26,0,12,0,12
ASSAM,SOUTH SALMARA MANCACHAR,2021-01-27,0,75,0,75
ASSAM,SOUTH SALMARA MANCACHAR,2021-01-28,0,34,0,34
ASSAM,SOUTH SALMARA MANCACHAR,2021-01-29,0,32,0,32
ASSAM,SOUTH SALMARA MANCACHAR,2021-01-30,0,13,0,13
ASSAM,SOUTH SALMARA MANCACHAR,2021-01-31,0,4,0,4
ASSAM,TINSUKIA,2021-01-26,2,296,2,300
ASSAM,TINSUKIA,2021-01-27,3,537,1,541
ASSAM,TINSUKIA,2021-01-28,1,493,0,494
ASSAM,TINSUKIA,2021-01-29,0,382,0,382
ASSAM,TINSUKIA,2021-01-30,5,209,2,216
ASSAM,TINSUKIA,2021-01-31,0,151,0,151
ASSAM,UDALGURI,2021-01-26,0,10,0,10
ASSAM,UDALGURI,2021-01-27,0,27,0,27
ASSAM,UDALGURI,2021-01-28,0,104,0,104
ASSAM,UDALGURI,2021-01-29,0,14,0,14
ASSAM,UDALGURI,2021-01-30,0,11,0,11
ASSAM,UDALGURI,2021-01-31,0,7,0,7
ASSAM,WEST KARBI ANGLONG,2021-01-26,0,5,0,5
ASSAM,WEST KARBI ANGLONG,2021-01-27,0,10,0,10
ASSAM,WEST KARBI ANGLONG,2021-01-28,0,6,0,6
ASSAM,WEST KARBI ANGLONG,2021-01-29,0,13,0,13
ASSAM,WEST KARBI ANGLONG,2021-01-30,0,13,0,13
BIHAR,ARARIA,2021-01-26,0,608,0,608
BIHAR,ARARIA,2021-01-27,1,625,1,627
BIHAR,ARARIA,2021-01-28,6,675,0,681
BIHAR,ARARIA,2021-01-29,1,743,2,746
BIHAR,ARARIA,2021-01-30,1,791,0,792
BIHAR,ARARIA,2021-01-31,0,288,0,288
BIHAR,ARWAL,2021-01-26,4,736,0,740
BIHAR,ARWAL,2021-01-27,5,1405,15,1425
BIHAR,ARWAL,2021-01-28,0,1576,4,1580
BIHAR,ARWAL,2021-01-29,3,885,6,894
BIHAR,ARWAL,2021-01-30,0,345,1,346
BIHAR,ARWAL,2021-01-31,0,434,0,434
BIHAR,AURANGABAD,2021-01-26,0,643,3,646
BIHAR,AURANGABAD,2021-01-27,2,1413,0,1415
BIHAR,AURANGABAD,2021-01-28,7,736,0,743
BIHAR,AURANGABAD,2021-01-29,11,2052,0,2063
BIHAR,AURANGABAD,2021-01-30,39,1972,0,2011
BIHAR,AURANGABAD,2021-01-31,3,510,0,513
BIHAR,BANKA,2021-01-26,4,1338,91,1433
BIHAR,BANKA,2021-01-27,0,2321,0,2321
BIHAR,BANKA,2021-01-28,3,1892,0,1895
BIHAR,BANKA,2021-01-29,0,2712,196,2908
BIHAR,BANKA,2021-01-30,1,2099,67,2167
BIHAR,BANKA,2021-01-31,0,912,66,978
BIHAR,BEGUSARAI,2021-01-26,1,1000,0,1001
BIHAR,BEGUSARAI,2021-01-27,2,3018,1,3021
BIHAR,BEGUSARAI,2021-01-28,3,2944,0,2947
BIHAR,BEGUSARAI,2021-01-29,4,2033,0,2037
BIHAR,BEGUSARAI,2021-01-30,1,3629,0,3630
BIHAR,BEGUSARAI,2021-01-31,0,356,0,356
BIHAR,BHAGALPUR,2021-01-26,2,1797,220,2019
BIHAR,BHAGALPUR,2021-01-27,7,3321,139,3467
BIHAR,BHAGALPUR,2021-01-28,3,2319,172,2494
BIHAR,BHAGALPUR,2021-01-29,1,2413,25,2439
BIHAR,BHAGALPUR,2021-01-30,4,2040,226,2270
BIHAR,BHAGALPUR,2021-01-31,1,1623,123,1747
BIHAR,BHOJPUR,2021-01-26,0,858,18,876
BIHAR,BHOJPUR,2021-01-27,0,1116,18,1134
BIHAR,BHOJPUR,2021-01-28,2,1288,6,1296
BIHAR,BHOJPUR,2021-01-29,0,943,31,974
BIHAR,BHOJPUR,2021-01-30,1,1522,80,1603
BIHAR,BHOJPUR,2021-01-31,0,787,14,801
BIHAR,BUXAR,2021-01-26,0,659,1,660
BIHAR,BUXAR,2021-01-27,0,1172,83,1255
BIHAR,BUXAR,2021-01-28,0,710,75,785
BIHAR,BUXAR,2021-01-29,1,759,28,788
BIHAR,BUXAR,2021-01-30,1,808,80,889
BIHAR,BUXAR,2021-01-31,1,234,0,235
BIHAR,DARBHANGA,2021-01-26,3,2077,81,2161
BIHAR,DARBHANGA,2021-01-27,4,1631,0,1635
BIHAR,DARBHANGA,2021-01-28,2,2124,17,2143
BIHAR,DARBHANGA,2021-01-29,5,2190,14,2209
BIHAR,DARBHANGA,2021-01-30,3,2330,0,2333
BIHAR,DARBHANGA,2021-01-31,2,1983,1,1986
BIHAR,GAYA,2021-01-26,3,1743,8,1754
BIHAR,GAYA,2021-01-27,17,5539,9,5565
BIHAR,GAYA,2021-01-28,12,9523,0,9535
BIHAR,GAYA,2021-01-29,14,6111,59,6184
BIHAR,GAYA,2021-01-30,8,5650,24,5682
BIHAR,GAYA,2021-01-31,4,2060,13,2077
BIHAR,GOPALGANJ,2021-01-26,0,511,0,511
BIHAR,GOPALGANJ,2021-01-27,1,443,0,444
BIHAR,GOPALGANJ,2021-01-28,3,607,0,610
BIHAR,GOPALGANJ,2021-01-29,1,492,1,494
BIHAR,GOPALGANJ,2021-01-30,0,632,0,632
BIHAR,GOPALGANJ,2021-01-31,4,194,0,198
BIHAR,JAMUI,2021-01-26,0,376,0,376
BIHAR,JAMUI,2021-01-27,0,1100,0,1100
BIHAR,JAMUI,2021-01-28,0,786,0,786
BIHAR,JAMUI,2021-01-29,0,1230,0,1230
BIHAR,JAMUI,2021-01-30,0,808,0,808
BIHAR,JAMUI,2021-01-31,0,635,0,635
BIHAR,JEHANABAD,2021-01-26,0,628,17,645
BIHAR,JEHANABAD,2021-01-27,0,1116,0,1116
BIHAR,JEHANABAD,2021-01-28,1,1039,0,1040
BIHAR,JEHANABAD,2021-01-29,2,1241,19,1262
BIHAR,JEHANABAD,2021-01-30,0,763,30,793
BIHAR,JEHANABAD,2021-01-31,1,762,0,763
BIHAR,KAIMUR (BHABUA),2021-01-26,7,1597,0,1604
BIHAR,KAIMUR (BHABUA),2021-01-27,5,3416,0,3421
BIHAR,KAIMUR (BHABUA),2021-01-28,4,1909,0,1913
BIHAR,KAIMUR (BHABUA),2021-01-29,7,2212,0,2219
BIHAR,KAIMUR (BHABUA),2021-01-30,0,1730,0,1730
BIHAR,KAIMUR (BHABUA),2021-01-31,1,1370,0,1371
BIHAR,KATIHAR,2021-01-26,0,1010,0,1010
BIHAR,KATIHAR,2021-01-27,0,1559,1,1560
BIHAR,KATIHAR,2021-01-28,1,1336,0,1337
BIHAR,KATIHAR,2021-01-29,1,1943,0,1944
BIHAR,KATIHAR,2021-01-30,1,1082,0,1083
BIHAR,KATIHAR,2021-01-31,1,459,2,462
BIHAR,KHAGARIA,2021-01-26,0,1007,0,1007
BIHAR,KHAGARIA,2021-01-27,0,1985,0,1985
BIHAR,KHAGARIA,2021-01-28,0,1471,0,1471
BIHAR,KHAGARIA,2021-01-29,0,1326,5,1331
BIHAR,KHAGARIA,2021-01-30,0,1666,0,1666
BIHAR,KHAGARIA,2021-01-31,1,296,0,297
BIHAR,KISHANGANJ,2021-01-26,0,260,0,260
BIHAR,KISHANGANJ,2021-01-27,0,758,0,758
BIHAR,KISHANGANJ,2021-01-28,2,850,27,879
BIHAR,KISHANGANJ,2021-01-29,0,796,0,796
BIHAR,KISHANGANJ,2021-01-30,0,842,5,847
BIHAR,KISHANGANJ,2021-01-31,0,1068,0,1068
BIHAR,LAKHISARAI,2021-01-26,5,896,6,907
BIHAR,LAKHISARAI,2021-01-27,1,1429,0,1430
BIHAR,LAKHISARAI,2021-01-28,2,834,0,836
BIHAR,LAKHISARAI,2021-01-29,3,559,0,562
BIHAR,LAKHISARAI,2021-01-30,3,328,0,331
BIHAR,LAKHISARAI,2021-01-31,4,671,0,675
BIHAR,MADHEPURA,2021-01-26,0,1032,0,1032
BIHAR,MADHEPURA,2021-01-27,1,1783,0,1784
BIHAR,MADHEPURA,2021-01-28,1,882,0,883
BIHAR,MADHEPURA,2021-01-29,0,1228,0,1228
BIHAR,MADHEPURA,2021-01-30,0,1529,0,1529
BIHAR,MADHEPURA,2021-01-31,0,1304,0,1304
BIHAR,MADHUBANI,2021-01-26,0,484,5,489
BIHAR,MADHUBANI,2021-01-27,5,1697,10,1712
BIHAR,MADHUBANI,2021-01-28,5,1346,17,1368
BIHAR,MADHUBANI,2021-01-29,7,1546,16,1569
BIHAR,MADHUBANI,2021-01-30,4,1377,7,1388
BIHAR,MADHUBANI,2021-01-31,3,194,0,197
BIHAR,MUNGER,2021-01-26,1,734,0,735
BIHAR,MUNGER,2021-01-27,2,1367,44,1413
BIHAR,MUNGER,2021-01-28,1,1020,3,1024
BIHAR,MUNGER,2021-01-29,1,1005,0,1006
BIHAR,MUNGER,2021-01-30,1,1994,55,2050
BIHAR,MUNGER,2021-01-31,0,607,0,607
BIHAR,MUZAFFARPUR,2021-01-26,2,2127,0,2129
BIHAR,MUZAFFARPUR,2021-01-27,1,1851,1,1853
BIHAR,MUZAFFARPUR,2021-01-28,3,2118,1,2122
BIHAR,MUZAFFARPUR,2021-01-29,0,2018,1,2019
BIHAR,MUZAFFARPUR,2021-01-30,1,2643,0,2644
BIHAR,MUZAFFARPUR,2021-01-31,2,2282,0,2284
BIHAR,NALANDA,2021-01-26,3,2409,183,2595
BIHAR,NALANDA,2021-01-27,4,3404,0,3408
BIHAR,NALANDA,2021-01-28,0,3368,396,3764
BIHAR,NALANDA,2021-01-29,3,2670,667,3340
BIHAR,NALANDA,2021-01-30,1,2553,34,2588
BIHAR,NALANDA,2021-01-31,4,2669,0,2673
BIHAR,NAWADA,2021-01-26,0,826,0,826
BIHAR,NAWADA,2021-01-27,0,1193,0,1193
BIHAR,NAWADA,2021-01-28,0,840,0,840
BIHAR,NAWADA,2021-01-29,0,776,0,776
BIHAR,NAWADA,2021-01-30,0,786,0,786
BIHAR,NAWADA,2021-01-31,0,769,0,769
BIHAR,PASHCHIM CHAMPARAN,2021-01-26,3,681,0,684
BIHAR,PASHCHIM CHAMPARAN,2021-01-27,0,1559,1,1560
BIHAR,PASHCHIM CHAMPARAN,2021-01-28,1,1910,0,1911
BIHAR,PASHCHIM CHAMPARAN,2021-01-29,0,1537,0,1537
BIHAR,PASHCHIM CHAMPARAN,2021-01-30,1,557,0,558
BIHAR,PASHCHIM CHAMPARAN,2021-01-31,3,469,0,472
BIHAR,PATNA,2021-01-26,46,2415,3,2464
BIHAR,PATNA,2021-01-27,58,4408,16,4482
BIHAR,PATNA,2021-01-28,51,3382,10,3443
BIHAR,PATNA,2021-01-29,59,4139,8,4206
BIHAR,PATNA,2021-01-30,50,4082,4,4136
BIHAR,PATNA,2021-01-31,33,2641,2,2676
BIHAR,PURBI CHAMPARAN,2021-01-26,3,2765,4,2772
BIHAR,PURBI CHAMPARAN,2021-01-27,0,2959,7,2966
BIHAR,PURBI CHAMPARAN,2021-01-28,0,2497,0,2497
BIHAR,PURBI CHAMPARAN,2021-01-29,0,2791,12,2803
BIHAR,PURBI CHAMPARAN,2021-01-30,0,2619,0,2619
BIHAR,PURBI CHAMPARAN,2021-01-31,0,1064,3,1067
BIHAR,PURNIA,2021-01-26,1,572,185,758
BIHAR,PURNIA,2021-01-27,5,1517,10,1532
BIHAR,PURNIA,2021-01-28,2,1031,7,1040
BIHAR,PURNIA,2021-01-29,5,1392,0,1397
BIHAR,PURNIA,2021-01-30,5,1665,0,1670
BIHAR,PURNIA,2021-01-31,2,649,60,711
BIHAR,ROHTAS,2021-01-26,2,1659,41,1702
BIHAR,ROHTAS,2021-01-27,3,2144,58,2205
BIHAR,ROHTAS,2021-01-28,0,2425,159,2584
BIHAR,ROHTAS,2021-01-29,4,2028,40,2072
BIHAR,ROHTAS,2021-01-30,0,1490,71,1561
BIHAR,ROHTAS,2021-01-31,3,1314,0,1317
BIHAR,SAHARSA,2021-01-26,0,217,0,217
BIHAR,SAHARSA,2021-01-27,1,873,0,874
BIHAR,SAHARSA,2021-01-28,0,647,1,648
BIHAR,SAHARSA,2021-01-29,2,356,0,358
BIHAR,SAHARSA,2021-01-30,0,1094,0,1094
BIHAR,SAHARSA,2021-01-31,0,261,0,261
BIHAR,SAMASTIPUR,2021-01-26,0,2511,23,2534
BIHAR,SAMASTIPUR,2021-01-27,0,2983,161,3144
BIHAR,SAMASTIPUR,2021-01-28,1,2660,72,2733
BIHAR,SAMASTIPUR,2021-01-29,3,3765,23,3791
BIHAR,SAMASTIPUR,2021-01-30,2,3261,44,3307
BIHAR,SAMASTIPUR,2021-01-31,2,2475,33,2510
BIHAR,SARAN,2021-01-26,7,921,0,928
BIHAR,SARAN,2021-01-27,4,1989,4,1997
BIHAR,SARAN,2021-01-28,1,1784,2,1787
BIHAR,SARAN,2021-01-29,1,1538,0,1539
BIHAR,SARAN,2021-01-30,4,1136,0,1140
BIHAR,SARAN,2021-01-31,0,981,0,981
BIHAR,SHEIKHPURA,2021-01-26,0,176,0,176
BIHAR,SHEIKHPURA,2021-01-27,1,269,18,288
BIHAR,SHEIKHPURA,2021-01-28,1,140,6,147
BIHAR,SHEIKHPURA,2021-01-29,0,374,0,374
BIHAR,SHEIKHPURA,2021-01-30,0,303,0,303
BIHAR,SHEIKHPURA,2021-01-31,0,104,0,104
BIHAR,SHEOHAR,2021-01-26,0,286,0,286
BIHAR,SHEOHAR,2021-01-27,3,1064,0,1067
BIHAR,SHEOHAR,2021-01-28,1,782,0,783
BIHAR,SHEOHAR,2021-01-29,0,450,0,450
BIHAR,SHEOHAR,2021-01-30,0,668,0,668
BIHAR,SHEOHAR,2021-01-31,0,945,0,945
BIHAR,SITAMARHI,2021-01-26,0,966,0,966
BIHAR,SITAMARHI,2021-01-27,1,1510,0,1511
BIHAR,SITAMARHI,2021-01-28,0,1678,19,1697
BIHAR,SITAMARHI,2021-01-29,2,1488,4,1494
BIHAR,SITAMARHI,2021-01-30,0,1165,0,1165
BIHAR,SITAMARHI,2021-01-31,4,2046,0,2050
BIHAR,SIWAN,2021-01-26,3,1332,0,1335
BIHAR,SIWAN,2021-01-27,4,1537,1,1542
BIHAR,SIWAN,2021-01-28,5,1903,1,1909
BIHAR,SIWAN,2021-01-29,4,1575,1,1580
BIHAR,SIWAN,2021-01-30,5,950,0,955
BIHAR,SIWAN,2021-01-31,0,900,0,900
BIHAR,SUPAUL,2021-01-26,0,896,65,961
BIHAR,SUPAUL,2021-01-27,3,1341,107,1451
BIHAR,SUPAUL,2021-01-28,2,1290,0,1292
BIHAR,SUPAUL,2021-01-29,0,1496,34,1530
BIHAR,SUPAUL,2021-01-30,1,835,1,837
BIHAR,SUPAUL,2021-01-31,0,1382,0,1382
BIHAR,VAISHALI,2021-01-26,2,1813,0,1815
BIHAR,VAISHALI,2021-01-27,2,3290,177,3469
BIHAR,VAISHALI,2021-01-28,4,3708,8,3720
BIHAR,VAISHALI,2021-01-29,2,3226,98,3326
BIHAR,VAISHALI,2021-01-30,1,2532,0,2533
BIHAR,VAISHALI,2021-01-31,2,1700,0,1702
CHANDIGARH,CHANDIGARH,2021-01-26,29,526,1,556
CHANDIGARH,CHANDIGARH,2021-01-27,72,1393,51,1516
CHANDIGARH,CHANDIGARH,2021-01-28,44,1463,25,1532
CHANDIGARH,CHANDIGARH,2021-01-29,26,1331,3,1360
CHANDIGARH,CHANDIGARH,2021-01-30,27,1305,12,1344
CHANDIGARH,CHANDIGARH,2021-01-31,35,540,4,579
CHHATTISGARH,BALOD,2021-01-26,5,386,0,391
CHHATTISGARH,BALOD,2021-01-27,5,889,0,894
CHHATTISGARH,BALOD,2021-01-28,6,786,0,792
CHHATTISGARH,BALOD,2021-01-29,13,929,0,942
CHHATTISGARH,BALOD,2021-01-30,5,793,0,798
CHHATTISGARH,BALOD,2021-01-31,3,332,1,336
CHHATTISGARH,BALODA BAZAR,2021-01-26,14,146,3,163
CHHATTISGARH,BALODA BAZAR,2021-01-27,30,298,3,331
CHHATTISGARH,BALODA BAZAR,2021-01-28,7,538,1,546
CHHATTISGARH,BALODA BAZAR,2021-01-29,10,402,2,414
CHHATTISGARH,BALODA BAZAR,2021-01-30,26,662,1,689
CHHATTISGARH,BALODA BAZAR,2021-01-31,7,255,2,264
CHHATTISGARH,BALRAMPUR,2021-01-26,0,96,1,97
CHHATTISGARH,BALRAMPUR,2021-01-27,10,269,2,281
CHHATTISGARH,BALRAMPUR,2021-01-28,13,214,0,227
CHHATTISGARH,BALRAMPUR,2021-01-29,7,339,0,346
CHHATTISGARH,BALRAMPUR,2021-01-30,0,212,0,212
CHHATTISGARH,BALRAMPUR,2021-01-31,0,212,0,212
CHHATTISGARH,BASTAR,2021-01-26,3,370,0,373
CHHATTISGARH,BASTAR,2021-01-27,4,1553,0,1557
CHHATTISGARH,BASTAR,2021-01-28,1,1059,0,1060
CHHATTISGARH,BASTAR,2021-01-29,4,1102,0,1106
CHHATTISGARH,BASTAR,2021-01-30,4,1078,5,1087
CHHATTISGARH,BASTAR,2021-01-31,2,898,0,900
CHHATTISGARH,BEMETARA,2021-01-26,2,43,2,47
CHHATTISGARH,BEMETARA,2021-01-27,11,523,0,534
CHHATTISGARH,BEMETARA,2021-01-28,6,343,3,352
CHHATTISGARH,BEMETARA,2021-01-29,13,825,0,838
CHHATTISGARH,BEMETARA,2021-01-30,7,653,0,660
CHHATTISGARH,BEMETARA,2021-01-31,0,130,0,130
CHHATTISGARH,BIJAPUR,2021-01-26,0,45,0,45
CHHATTISGARH,BIJAPUR,2021-01-27,0,148,0,148
CHHATTISGARH,BIJAPUR,2021-01-28,0,160,0,160
CHHATTISGARH,BIJAPUR,2021-01-29,1,108,1,110
CHHATTISGARH,BIJAPUR,2021-01-30,0,281,0,281
CHHATTISGARH,BIJAPUR,2021-01-31,0,71,0,71
CHHATTISGARH,BILASPUR,2021-01-26,36,875,39,950
CHHATTISGARH,BILASPUR,2021-01-27,39,1183,6,1228
CHHATTISGARH,BILASPUR,2021-01-28,50,956,11,1017
CHHATTISGARH,BILASPUR,2021-01-29,41,1120,16,1177
CHHATTISGARH,BILASPUR,2021-01-30,22,1178,21,1221
CHHATTISGARH,BILASPUR,2021-01-31,32,1405,11,1448
CHHATTISGARH,DANTEWADA,2021-01-26,2,144,0,146
CHHATTISGARH,DANTEWADA,2021-01-27,1,166,0,167
CHHATTISGARH,DANTEWADA,2021-01-28,1,294,0,295
CHHATTISGARH,DANTEWADA,2021-01-29,1,379,0,380
CHHATTISGARH,DANTEWADA,2021-01-30,1,168,0,169
CHHATTISGARH,DANTEWADA,2021-01-31,3,151,0,154
CHHATTISGARH,DHAMTARI,2021-01-26,5,183,14,202
CHHATTISGARH,DHAMTARI,2021-01-27,25,679,4,708
CHHATTISGARH,DHAMTARI,2021-01-28,23,396,12,431
CHHATTISGARH,DHAMTARI,2021-01-29,16,584,5,605
CHHATTISGARH,DHAMTARI,2021-01-30,18,556,20,594
CHHATTISGARH,DHAMTARI,2021-01-31,6,105,12,123
CHHATTISGARH,DURG,2021-01-26,41,490,0,531
CHHATTISGARH,DURG,2021-01-27,59,756,3,818
CHHATTISGARH,DURG,2021-01-28,82,1244,5,1331
CHHATTISGARH,DURG,2021-01-29,55,1031,1,1087
CHHATTISGARH,DURG,2021-01-30,73,960,3,1036
CHHATTISGARH,DURG,2021-01-31,49,902,9,960
CHHATTISGARH,GARIYABAND,2021-01-26,1,49,0,50
CHHATTISGARH,GARIYABAND,2021-01-27,3,277,14,294
CHHATTISGARH,GARIYABAND,2021-01-28,7,428,20,455
CHHATTISGARH,GARIYABAND,2021-01-29,6,295,16,317
CHHATTISGARH,GARIYABAND,2021-01-30,6,280,3,289
CHHATTISGARH,GARIYABAND,2021-01-31,6,113,11,130
CHHATTISGARH,GAURELLA PENDRA MARWAHI,2021-01-26,0,103,2,105
CHHATTISGARH,GAURELLA PENDRA MARWAHI,2021-01-27,2,213,0,215
CHHATTISGARH,GAURELLA PENDRA MARWAHI,2021-01-28,2,249,0,251
CHHATTISGARH,GAURELLA PENDRA MARWAHI,2021-01-29,0,169,0,169
CHHATTISGARH,GAURELLA PENDRA MARWAHI,2021-01-30,1,360,0,361
CHHATTISGARH,GAURELLA PENDRA MARWAHI,2021-01-31,3,11,5,19
CHHATTISGARH,JANJGIR CHAMPA,2021-01-26,5,793,1,799
CHHATTISGARH,JANJGIR CHAMPA,2021-01-27,13,1132,0,1145
CHHATTISGARH,JANJGIR CHAMPA,2021-01-28,5,1315,4,1324
CHHATTISGARH,JANJGIR CHAMPA,2021-01-29,16,1998,1,2015
CHHATTISGARH,JANJGIR CHAMPA,2021-01-30,9,2037,12,2058
CHHATTISGARH,JANJGIR CHAMPA,2021-01-31,3,1452,0,1455
CHHATTISGARH,JASHPUR,2021-01-26,2,37,0,39
CHHATTISGARH,JASHPUR,2021-01-27,12,275,0,287
CHHATTISGARH,JASHPUR,2021-01-28,9,202,0,211
CHHATTISGARH,JASHPUR,2021-01-29,8,368,0,376
CHHATTISGARH,JASHPUR,2021-01-30,10,471,0,481
CHHATTISGARH,JASHPUR,2021-01-31,2,60,1,63
CHHATTISGARH,KABIRDHAM,2021-01-26,7,254,0,261
CHHATTISGARH,KABIRDHAM,2021-01-27,3,176,0,179
CHHATTISGARH,KABIRDHAM,2021-01-28,3,374,0,377
CHHATTISGARH,KABIRDHAM,2021-01-29,7,206,0,213
CHHATTISGARH,KABIRDHAM,2021-01-30,11,675,0,686
CHHATTISGARH,KABIRDHAM,2021-01-31,6,61,0,67
CHHATTISGARH,KANKER,2021-01-26,0,209,0,209
CHHATTISGARH,KANKER,2021-01-27,5,276,0,281
CHHATTISGARH,KANKER,2021-01-28,3,380,1,384
CHHATTISGARH,KANKER,2021-01-29,3,288,0,291
CHHATTISGARH,KANKER,2021-01-30,10,324,0,334
CHHATTISGARH,KANKER,2021-01-31,0,312,0,312
CHHATTISGARH,KONDAGAON,2021-01-26,0,6,0,6
CHHATTISGARH,KONDAGAON,2021-01-27,2,320,0,322
CHHATTISGARH,KONDAGAON,2021-01-28,0,216,0,216
CHHATTISGARH,KONDAGAON,2021-01-29,5,519,0,524
CHHATTISGARH,KONDAGAON,2021-01-30,27,1258,0,1285
CHHATTISGARH,KONDAGAON,2021-01-31,4,1043,1,1048
CHHATTISGARH,KORBA,2021-01-26,1,247,0,248
CHHATTISGARH,KORBA,2021-01-27,15,1139,0,1154
CHHATTISGARH,KORBA,2021-01-28,5,579,0,584
CHHATTISGARH,KORBA,2021-01-29,13,1291,0,1304
CHHATTISGARH,KORBA,2021-01-30,11,907,0,918
CHHATTISGARH,KORBA,2021-01-31,5,830,0,835
CHHATTISGARH,KOREA,2021-01-26,5,202,0,207
CHHATTISGARH,KOREA,2021-01-27,10,881,0,891
CHHATTISGARH,KOREA,2021-01-28,2,530,2,534
CHHATTISGARH,KOREA,2021-01-29,17,901,0,918
CHHATTISGARH,KOREA,2021-01-30,7,425,0,432
CHHATTISGARH,KOREA,2021-01-31,3,504,4,511
CHHATTISGARH,MAHASAMUND,2021-01-26,35,917,3,955
CHHATTISGARH,MAHASAMUND,2021-01-27,27,1646,1,1674
CHHATTISGARH,MAHASAMUND,2021-01-28,24,1244,2,1270
CHHATTISGARH,MAHASAMUND,2021-01-29,14,1504,0,1518
CHHATTISGARH,MAHASAMUND,2021-01-30,15,1080,3,1098
CHHATTISGARH,MAHASAMUND,2021-01-31,16,827,2,845
CHHATTISGARH,MUNGELI,2021-01-26,0,99,0,99
CHHATTISGARH,MUNGELI,2021-01-27,5,464,0,469
CHHATTISGARH,MUNGELI,2021-01-28,3,427,1,431
CHHATTISGARH,MUNGELI,2021-01-29,8,621,5,634
CHHATTISGARH,MUNGELI,2021-01-30,1,431,7,439
CHHATTISGARH,MUNGELI,2021-01-31,3,172,0,175
CHHATTISGARH,NARAYANPUR,2021-01-26,0,9,0,9
CHHATTISGARH,NARAYANPUR,2021-01-27,0,128,0,128
CHHATTISGARH,NARAYANPUR,2021-01-28,0,166,0,166
CHHATTISGARH,NARAYANPUR,2021-01-29,0,263,0,263
CHHATTISGARH,NARAYANPUR,2021-01-30,1,195,0,196
CHHATTISGARH,NARAYANPUR,2021-01-31,0,43,0,43
CHHATTISGARH,RAIGARH,2021-01-26,16,716,1,733
CHHATTISGARH,RAIGARH,2021-01-27,32,1273,6,1311
CHHATTISGARH,RAIGARH,2021-01-28,32,1634,22,1688
CHHATTISGARH,RAIGARH,2021-01-29,27,1515,28,1570
CHHATTISGARH,RAIGARH,2021-01-30,34,1727,10,1771
CHHATTISGARH,RAIGARH,2021-01-31,17,761,11,789
CHHATTISGARH,RAIPUR,2021-01-26,117,891,15,1023
CHHATTISGARH,RAIPUR,2021-01-27,126,1212,3,1341
CHHATTISGARH,RAIPUR,2021-01-28,132,1785,14,1931
CHHATTISGARH,RAIPUR,2021-01-29,137,1680,30,1847
CHHATTISGARH,RAIPUR,2021-01-30,125,1856,23,2004
CHHATTISGARH,RAIPUR,2021-01-31,75,1135,27,1237
CHHATTISGARH,RAJNANDGAON,2021-01-26,17,476,0,493
CHHATTISGARH,RAJNANDGAON,2021-01-27,17,594,18,629
CHHATTISGARH,RAJNANDGAON,2021-01-28,26,1317,3,1346
CHHATTISGARH,RAJNANDGAON,2021-01-29,21,1531,0,1552
CHHATTISGARH,RAJNANDGAON,2021-01-30,15,1019,15,1049
CHHATTISGARH,RAJNANDGAON,2021-01-31,7,224,3,234
CHHATTISGARH,SUKMA,2021-01-26,0,40,0,40
CHHATTISGARH,SUKMA,2021-01-27,1,133,0,134
CHHATTISGARH,SUKMA,2021-01-28,0,319,0,319
CHHATTISGARH,SUKMA,2021-01-29,0,198,0,198
CHHATTISGARH,SUKMA,2021-01-30,2,191,0,193
CHHATTISGARH,SUKMA,2021-01-31,0,88,0,88
CHHATTISGARH,SURAJPUR,2021-01-26,4,534,6,544
CHHATTISGARH,SURAJPUR,2021-01-27,17,899,1,917
CHHATTISGARH,SURAJPUR,2021-01-28,8,723,2,733
CHHATTISGARH,SURAJPUR,2021-01-29,14,998,1,1013
CHHATTISGARH,SURAJPUR,2021-01-30,14,880,3,897
CHHATTISGARH,SURAJPUR,2021-01-31,5,604,1,610
CHHATTISGARH,SURGUJA,2021-01-26,10,273,3,286
CHHATTISGARH,SURGUJA,2021-01-27,24,744,0,768
CHHATTISGARH,SURGUJA,2021-01-28,22,385,1,408
CHHATTISGARH,SURGUJA,2021-01-29,5,627,0,632
CHHATTISGARH,SURGUJA,2021-01-30,9,589,0,598
CHHATTISGARH,SURGUJA,2021-01-31,9,356,3,368
DADRA AND NAGAR HAVELI,DADRA AND NAGAR HAVELI,2021-01-26,1,96,0,97
DADRA AND NAGAR HAVELI,DADRA AND NAGAR HAVELI,2021-01-27,0,350,1,351
DADRA AND NAGAR HAVELI,DADRA AND NAGAR HAVELI,2021-01-28,1,244,2,247
DADRA AND NAGAR HAVELI,DADRA AND NAGAR HAVELI,2021-01-29,0,245,0,245
DADRA AND NAGAR HAVELI,DADRA AND NAGAR HAVELI,2021-01-30,0,192,0,192
DADRA AND NAGAR HAVELI,DADRA AND NAGAR HAVELI,2021-01-31,0,106,1,107
DAMAN AND DIU,DAMAN,2021-01-26,0,78,0,78
DAMAN AND DIU,DAMAN,2021-01-27,1,42,0,43
DAMAN AND DIU,DAMAN,2021-01-28,0,99,0,99
DAMAN AND DIU,DAMAN,2021-01-29,0,100,0,100
DAMAN AND DIU,DAMAN,2021-01-30,0,72,0,72
DAMAN AND DIU,DAMAN,2021-01-31,0,50,0,50
DAMAN AND DIU,DIU,2021-01-26,0,4,0,4
DAMAN AND DIU,DIU,2021-01-27,4,119,0,123
DAMAN AND DIU,DIU,2021-01-28,0,35,0,35
DAMAN AND DIU,DIU,2021-01-29,0,26,0,26
DAMAN AND DIU,DIU,2021-01-30,1,30,0,31
DAMAN AND DIU,DIU,2021-01-31,0,54,0,54
DELHI,CENTRAL,2021-01-26,1,2422,5,2428
DELHI,CENTRAL,2021-01-27,23,3594,5,3622
DELHI,CENTRAL,2021-01-28,12,3793,4,3809
DELHI,CENTRAL,2021-01-29,7,5055,41,5103
DELHI,CENTRAL,2021-01-30,14,4534,13,4561
DELHI,CENTRAL,2021-01-31,5,3750,10,3765
DELHI,EAST,2021-01-26,11,2844,0,2855
DELHI,EAST,2021-01-27,11,3894,2,3907
DELHI,EAST,2021-01-28,17,2535,6,2558
DELHI,EAST,2021-01-29,13,4425,1,4439
DELHI,EAST,2021-01-30,14,4053,6,4073
DELHI,EAST,2021-01-31,5,2048,5,2058
DELHI,NEW DELHI,2021-01-26,15,2457,19,2491
DELHI,NEW DELHI,2021-01-27,25,4219,16,4260
DELHI,NEW DELHI,2021-01-28,23,4097,13,4133
DELHI,NEW DELHI,2021-01-29,44,6796,19,6859
DELHI,NEW DELHI,2021-01-30,13,4665,17,4695
DELHI,NEW DELHI,2021-01-31,20,3464,23,3507
DELHI,NORTH,2021-01-26,5,3210,31,3246
DELHI,NORTH,2021-01-27,4,6459,66,6529
DELHI,NORTH,2021-01-28,15,7275,20,7310
DELHI,NORTH,2021-01-29,4,7292,13,7309
DELHI,NORTH,2021-01-30,3,6782,11,6796
DELHI,NORTH,2021-01-31,7,5156,13,5176
DELHI,NORTH EAST,2021-01-26,1,1545,65,1611
DELHI,NORTH EAST,2021-01-27,7,5239,124,5370
DELHI,NORTH EAST,2021-01-28,5,3483,15,3503
DELHI,NORTH EAST,2021-01-29,2,5244,8,5254
DELHI,NORTH EAST,2021-01-30,2,5087,24,5113
DELHI,NORTH EAST,2021-01-31,2,3455,13,3470
DELHI,NORTH WEST,2021-01-26,12,2139,13,2164
DELHI,NORTH WEST,2021-01-27,26,5276,10,5312
DELHI,NORTH WEST,2021-01-28,64,5932,31,6027
DELHI,NORTH WEST,2021-01-29,37,5538,23,5598
DELHI,NORTH WEST,2021-01-30,22,4775,7,4804
DELHI,NORTH WEST,2021-01-31,23,3292,1,3316
DELHI,SHAHDARA,2021-01-26,1,2024,2,2027
DELHI,SHAHDARA,2021-01-27,14,5225,3,5242
DELHI,SHAHDARA,2021-01-28,5,5477,10,5492
DELHI,SHAHDARA,2021-01-29,6,7579,3,7588
DELHI,SHAHDARA,2021-01-30,7,6692,10,6709
DELHI,SHAHDARA,2021-01-31,1,3099,1,3101
DELHI,SOUTH,2021-01-26,25,2975,8,3008
DELHI,SOUTH,2021-01-27,52,5827,43,5922
DELHI,SOUTH,2021-01-28,46,5085,77,5208
DELHI,SOUTH,2021-01-29,28,5195,12,5235
DELHI,SOUTH,2021-01-30,38,4722,8,4768
DELHI,SOUTH,2021-01-31,18,3701,1,3720
DELHI,SOUTH EAST,2021-01-26,6,2816,1,2823
DELHI,SOUTH EAST,2021-01-27,21,4385,0,4406
DELHI,SOUTH EAST,2021-01-28,14,5638,1,5653
DELHI,SOUTH EAST,2021-01-29,14,5585,5,5604
DELHI,SOUTH EAST,2021-01-30,9,5353,0,5362
DELHI,SOUTH EAST,2021-01-31,12,2714,0,2726
DELHI,SOUTH WEST,2021-01-26,19,2207,26,2252
DELHI,SOUTH WEST,2021-01-27,23,4813,3,4839
DELHI,SOUTH WEST,2021-01-28,41,5406,25,5472
DELHI,SOUTH WEST,2021-01-29,29,6854,0,6883
DELHI,SOUTH WEST,2021-01-30,24,5555,5,5584
DELHI,SOUTH WEST,2021-01-31,20,5113,2,5135
DELHI,WEST,2021-01-26,19,4933,6,4958
DELHI,WEST,2021-01-27,29,8657,0,8686
DELHI,WEST,2021-01-28,37,9591,5,9633
DELHI,WEST,2021-01-29,22,9145,2,9169
DELHI,WEST,2021-01-30,20,8268,11,8299
DELHI,WEST,2021-01-31,22,7516,7,7545
GOA,NORTH GOA,2021-01-26,30,633,4,667
GOA,NORTH GOA,2021-01-27,52,742,0,794
GOA,NORTH GOA,2021-01-28,53,737,3,793
GOA,NORTH GOA,2021-01-29,51,865,1,917
GOA,NORTH GOA,2021-01-30,32,704,3,739
GOA,NORTH GOA,2021-01-31,4,548,0,552
GOA,SOUTH GOA,2021-01-26,27,525,1,553
GOA,SOUTH GOA,2021-01-27,42,813,1,856
GOA,SOUTH GOA,2021-01-28,61,779,1,841
GOA,SOUTH GOA,2021-01-29,62,965,1,1028
GOA,SOUTH GOA,2021-01-30,47,871,2,920
GOA,SOUTH GOA,2021-01-31,49,659,0,708
GUJARAT,AHMADABAD,2021-01-26,214,5240,99,5553
GUJARAT,AHMADABAD,2021-01-27,283,5436,108,5827
GUJARAT,AHMADABAD,2021-01-28,154,3459,63,3676
GUJARAT,AHMADABAD,2021-01-29,317,4480,45,4842
GUJARAT,AHMADABAD,2021-01-30,168,4625,53,4846
GUJARAT,AHMADABAD,2021-01-31,44,3833,3,3880
GUJARAT,AMRELI,2021-01-26,1,355,10,366
GUJARAT,AMRELI,2021-01-27,65,858,0,923
GUJARAT,AMRELI,2021-01-28,6,825,0,831
GUJARAT,AMRELI,2021-01-29,0,535,5,540
GUJARAT,AMRELI,2021-01-30,4,694,0,698
GUJARAT,AMRELI,2021-01-31,3,382,0,385
GUJARAT,ANAND,2021-01-26,5,140,4,149
GUJARAT,ANAND,2021-01-27,11,509,12,532
GUJARAT,ANAND,2021-01-28,5,377,26,408
GUJARAT,ANAND,2021-01-29,7,267,24,298
GUJARAT,ANAND,2021-01-30,5,289,21,315
GUJARAT,ANAND,2021-01-31,2,57,0,59
GUJARAT,ARVALLI,2021-01-26,1,79,4,84
GUJARAT,ARVALLI,2021-01-27,3,250,0,253
GUJARAT,ARVALLI,2021-01-28,2,167,5,174
GUJARAT,ARVALLI,2021-01-29,0,145,5,150
GUJARAT,ARVALLI,2021-01-30,17,198,0,215
GUJARAT,ARVALLI,2021-01-31,1,58,0,59
GUJARAT,BANAS KANTHA,2021-01-26,0,38,0,38
GUJARAT,BANAS KANTHA,2021-01-27,1,357,0,358
GUJARAT,BANAS KANTHA,2021-01-28,2,353,0,355
GUJARAT,BANAS KANTHA,2021-01-29,3,389,0,392
GUJARAT,BANAS KANTHA,2021-01-30,2,290,1,293
GUJARAT,BANAS KANTHA,2021-01-31,3,47,0,50
GUJARAT,BHARUCH,2021-01-26,8,109,2,119
GUJARAT,BHARUCH,2021-01-27,8,486,7,501
GUJARAT,BHARUCH,2021-01-28,7,391,0,398
GUJARAT,BHARUCH,2021-01-29,3,488,3,494
GUJARAT,BHARUCH,2021-01-30,12,342,2,356
GUJARAT,BHARUCH,2021-01-31,2,54,0,56
GUJARAT,BHAVNAGAR,2021-01-26,7,682,1,690
GUJARAT,BHAVNAGAR,2021-01-27,4,975,0,979
GUJARAT,BHAVNAGAR,2021-01-28,3,886,0,889
GUJARAT,BHAVNAGAR,2021-01-29,3,958,0,961
GUJARAT,BHAVNAGAR,2021-01-30,6,660,0,666
GUJARAT,BHAVNAGAR,2021-01-31,1,301,0,302
GUJARAT,BOTAD,2021-01-26,0,76,0,76
GUJARAT,BOTAD,2021-01-27,0,368,0,368
GUJARAT,BOTAD,2021-01-28,0,386,0,386
GUJARAT,BOTAD,2021-01-29,0,345,0,345
GUJARAT,BOTAD,2021-01-30,0,309,0,309
GUJARAT,BOTAD,2021-01-31,0,177,0,177
GUJARAT,CHHOTAUDEPUR,2021-01-26,0,4,0,4
GUJARAT,CHHOTAUDEPUR,2021-01-27,1,74,2,77
GUJARAT,CHHOTAUDEPUR,2021-01-28,0,163,0,163
GUJARAT,CHHOTAUDEPUR,2021-01-29,1,256,0,257
GUJARAT,CHHOTAUDEPUR,2021-01-30,0,153,0,153
GUJARAT,CHHOTAUDEPUR,2021-01-31,0,152,0,152
GUJARAT,DANG,2021-01-26,0,7,0,7
GUJARAT,DANG,2021-01-27,0,128,0,128
GUJARAT,DANG,2021-01-28,0,36,0,36
GUJARAT,DANG,2021-01-29,0,81,0,81
GUJARAT,DANG,2021-01-30,0,70,0,70
GUJARAT,DANG,2021-01-31,0,81,0,81
GUJARAT,DEVBHUMI DWARKA,2021-01-26,5,43,1,49
GUJARAT,DEVBHUMI DWARKA,2021-01-27,3,100,2,105
GUJARAT,DEVBHUMI DWARKA,2021-01-28,6,108,0,114
GUJARAT,DEVBHUMI DWARKA,2021-01-29,2,111,1,114
GUJARAT,DEVBHUMI DWARKA,2021-01-30,1,117,0,118
GUJARAT,DEVBHUMI DWARKA,2021-01-31,2,23,0,25
GUJARAT,DOHAD,2021-01-26,5,224,0,229
GUJARAT,DOHAD,2021-01-27,10,420,0,430
GUJARAT,DOHAD,2021-01-28,1,402,0,403
GUJARAT,DOHAD,2021-01-29,5,424,0,429
GUJARAT,DOHAD,2021-01-30,1,279,0,280
GUJARAT,DOHAD,2021-01-31,5,384,0,389
GUJARAT,GANDHINAGAR,2021-01-26,4,512,6,522
GUJARAT,GANDHINAGAR,2021-01-27,6,863,9,878
GUJARAT,GANDHINAGAR,2021-01-28,5,565,3,573
GUJARAT,GANDHINAGAR,2021-01-29,11,918,1,930
GUJARAT,GANDHINAGAR,2021-01-30,7,386,2,395
GUJARAT,GANDHINAGAR,2021-01-31,2,292,0,294
GUJARAT,GIR SOMNATH,2021-01-26,4,79,1,84
GUJARAT,GIR SOMNATH,2021-01-27,5,251,1,257
GUJARAT,GIR SOMNATH,2021-01-28,3,125,1,129
GUJARAT,GIR SOMNATH,2021-01-29,6,245,2,253
GUJARAT,GIR SOMNATH,2021-01-30,4,254,0,258
GUJARAT,GIR SOMNATH,2021-01-31,3,110,0,113
GUJARAT,JAMNAGAR,2021-01-26,8,563,0,571
GUJARAT,JAMNAGAR,2021-01-27,12,1220,0,1232
GUJARAT,JAMNAGAR,2021-01-28,3,722,1,726
GUJARAT,JAMNAGAR,2021-01-29,8,1135,0,1143
GUJARAT,JAMNAGAR,2021-01-30,8,979,3,990
GUJARAT,JAMNAGAR,2021-01-31,5,283,1,289
GUJARAT,JUNAGADH,2021-01-26,6,325,0,331
GUJARAT,JUNAGADH,2021-01-27,3,579,1,583
GUJARAT,JUNAGADH,2021-01-28,7,280,0,287
GUJARAT,JUNAGADH,2021-01-29,8,354,0,362
GUJARAT,JUNAGADH,2021-01-30,11,497,2,510
GUJARAT,JUNAGADH,2021-01-31,5,258,0,263
GUJARAT,KACHCHH,2021-01-26,16,287,18,321
GUJARAT,KACHCHH,2021-01-27,20,597,55,672
GUJARAT,KACHCHH,2021-01-28,18,430,27,475
GUJARAT,KACHCHH,2021-01-29,24,749,26,799
GUJARAT,KACHCHH,2021-01-30,29,485,20,534
GUJARAT,KACHCHH,2021-01-31,16,226,2,244
GUJARAT,KHEDA,2021-01-26,13,226,2,241
GUJARAT,KHEDA,2021-01-27,3,436,0,439
GUJARAT,KHEDA,2021-01-28,6,480,1,487
GUJARAT,KHEDA,2021-01-29,33,348,1,382
GUJARAT,KHEDA,2021-01-30,12,298,0,310
GUJARAT,KHEDA,2021-01-31,2,187,0,189
GUJARAT,MAHESANA,2021-01-26,4,567,3,574
GUJARAT,MAHESANA,2021-01-27,0,292,7,299
GUJARAT,MAHESANA,2021-01-28,3,512,6,521
GUJARAT,MAHESANA,2021-01-29,6,461,1,468
GUJARAT,MAHESANA,2021-01-30,4,435,2,441
GUJARAT,MAHESANA,2021-01-31,4,213,5,222
GUJARAT,MAHISAGAR,2021-01-26,3,49,0,52
GUJARAT,MAHISAGAR,2021-01-27,4,283,1,288
GUJARAT,MAHISAGAR,2021-01-28,2,268,0,270
GUJARAT,MAHISAGAR,2021-01-29,3,292,0,295
GUJARAT,MAHISAGAR,2021-01-30,5,270,0,275
GUJARAT,MAHISAGAR,2021-01-31,1,92,0,93
GUJARAT,MORBI,2021-01-26,5,278,0,283
GUJARAT,MORBI,2021-01-27,9,525,5,539
GUJARAT,MORBI,2021-01-28,10,522,9,541
GUJARAT,MORBI,2021-01-29,4,253,0,257
GUJARAT,MORBI,2021-01-30,8,367,35,410
GUJARAT,MORBI,2021-01-31,6,390,5,401
GUJARAT,NARMADA,2021-01-26,6,32,0,38
GUJARAT,NARMADA,2021-01-27,1,18,5,24
GUJARAT,NARMADA,2021-01-28,3,70,0,73
GUJARAT,NARMADA,2021-01-29,1,28,7,36
GUJARAT,NARMADA,2021-01-30,2,61,0,63
GUJARAT,NARMADA,2021-01-31,2,25,0,27
GUJARAT,NAVSARI,2021-01-26,3,112,2,117
GUJARAT,NAVSARI,2021-01-27,0,303,1,304
GUJARAT,NAVSARI,2021-01-28,5,252,1,258
GUJARAT,NAVSARI,2021-01-29,0,215,1,216
GUJARAT,NAVSARI,2021-01-30,1,205,0,206
GUJARAT,NAVSARI,2021-01-31,0,102,2,104
GUJARAT,PANCH MAHALS,2021-01-26,7,248,1,256
GUJARAT,PANCH MAHALS,2021-01-27,11,455,0,466
GUJARAT,PANCH MAHALS,2021-01-28,2,525,0,527
GUJARAT,PANCH MAHALS,2021-01-29,6,415,1,422
GUJARAT,PANCH MAHALS,2021-01-30,8,269,2,279
GUJARAT,PANCH MAHALS,2021-01-31,3,194,0,197
GUJARAT,PATAN,2021-01-26,4,109,0,113
GUJARAT,PATAN,2021-01-27,2,521,1,524
GUJARAT,PATAN,2021-01-28,0,174,0,174
GUJARAT,PATAN,2021-01-29,0,270,0,270
GUJARAT,PATAN,2021-01-30,1,287,2,290
GUJARAT,PATAN,2021-01-31,0,12,0,12
GUJARAT,PORBANDAR,2021-01-26,0,182,0,182
GUJARAT,PORBANDAR,2021-01-27,0,386,0,386
GUJARAT,PORBANDAR,2021-01-28,0,265,0,265
GUJARAT,PORBANDAR,2021-01-29,0,412,0,412
GUJARAT,PORBANDAR,2021-01-30,0,363,0,363
GUJARAT,PORBANDAR,2021-01-31,0,338,0,338
GUJARAT,RAJKOT,2021-01-26,55,721,16,792
GUJARAT,RAJKOT,2021-01-27,35,1566,12,1613
GUJARAT,RAJKOT,2021-01-28,39,1314,31,1384
GUJARAT,RAJKOT,2021-01-29,67,1325,44,1436
GUJARAT,RAJKOT,2021-01-30,28,1834,47,1909
GUJARAT,RAJKOT,2021-01-31,31,692,42,765
GUJARAT,SABAR KANTHA,2021-01-26,6,95,2,103
GUJARAT,SABAR KANTHA,2021-01-27,7,258,10,275
GUJARAT,SABAR KANTHA,2021-01-28,2,194,11,207
GUJARAT,SABAR KANTHA,2021-01-29,2,113,6,121
GUJARAT,SABAR KANTHA,2021-01-30,4,117,11,132
GUJARAT,SABAR KANTHA,2021-01-31,1,132,1,134
GUJARAT,SURAT,2021-01-26,43,1499,5,1547
GUJARAT,SURAT,2021-01-27,30,2081,31,2142
GUJARAT,SURAT,2021-01-28,39,2222,43,2304
GUJARAT,SURAT,2021-01-29,26,2152,28,2206
GUJARAT,SURAT,2021-01-30,16,1620,2,1638
GUJARAT,SURAT,2021-01-31,13,646,0,659
GUJARAT,SURENDRANAGAR,2021-01-26,0,112,1,113
GUJARAT,SURENDRANAGAR,2021-01-27,0,404,0,404
GUJARAT,SURENDRANAGAR,2021-01-28,4,365,6,375
GUJARAT,SURENDRANAGAR,2021-01-29,1,409,0,410
GUJARAT,SURENDRANAGAR,2021-01-30,0,352,0,352
GUJARAT,SURENDRANAGAR,2021-01-31,2,246,0,248
GUJARAT,TAPI,2021-01-26,4,106,7,117
GUJARAT,TAPI,2021-01-27,1,294,2,297
GUJARAT,TAPI,2021-01-28,1,214,1,216
GUJARAT,TAPI,2021-01-29,4,266,1,271
GUJARAT,TAPI,2021-01-30,3,267,0,270
GUJARAT,TAPI,2021-01-31,2,220,0,222
GUJARAT,VADODARA,2021-01-26,46,636,12,694
GUJARAT,VADODARA,2021-01-27,72,1759,17,1848
GUJARAT,VADODARA,2021-01-28,83,1327,18,1428
GUJARAT,VADODARA,2021-01-29,49,1339,17,1405
GUJARAT,VADODARA,2021-01-30,74,785,38,897
GUJARAT,VADODARA,2021-01-31,61,532,15,608
GUJARAT,VALSAD,2021-01-26,1,267,0,268
GUJARAT,VALSAD,2021-01-27,3,494,0,497
GUJARAT,VALSAD,2021-01-28,5,468,0,473
GUJARAT,VALSAD,2021-01-29,7,475,0,482
GUJARAT,VALSAD,2021-01-30,3,290,0,293
GUJARAT,VALSAD,2021-01-31,1,180,0,181
HARYANA,AMBALA,2021-01-26,10,432,8,450
HARYANA,AMBALA,2021-01-27,17,677,13,707
HARYANA,AMBALA,2021-01-28,19,872,3,894
HARYANA,AMBALA,2021-01-29,19,648,5,672
HARYANA,AMBALA,2021-01-30,13,661,12,686
HARYANA,AMBALA,2021-01-31,14,359,12,385
HARYANA,BHIWANI,2021-01-26,1,466,1,468
HARYANA,BHIWANI,2021-01-27,0,1166,1,1167
HARYANA,BHIWANI,2021-01-28,1,972,0,973
HARYANA,BHIWANI,2021-01-29,0,945,2,947
HARYANA,BHIWANI,2021-01-30,1,697,0,698
HARYANA,BHIWANI,2021-01-31,0,535,2,537
HARYANA,CHARKI DADRI,2021-01-26,0,253,0,253
HARYANA,CHARKI DADRI,2021-01-27,1,395,0,396
HARYANA,CHARKI DADRI,2021-01-28,0,500,0,500
HARYANA,CHARKI DADRI,2021-01-29,0,665,0,665
HARYANA,CHARKI DADRI,2021-01-30,0,258,0,258
HARYANA,CHARKI DADRI,2021-01-31,0,386,0,386
HARYANA,FARIDABAD,2021-01-26,8,342,4,354
HARYANA,FARIDABAD,2021-01-27,9,1062,2,1073
HARYANA,FARIDABAD,2021-01-28,12,949,5,966
HARYANA,FARIDABAD,2021-01-29,17,1478,15,1510
HARYANA,FARIDABAD,2021-01-30,17,754,1,772
HARYANA,FARIDABAD,2021-01-31,12,503,0,515
HARYANA,FATEHABAD,2021-01-26,0,585,10,595
HARYANA,FATEHABAD,2021-01-27,2,126,3,131
HARYANA,FATEHABAD,2021-01-28,1,599,0,600
HARYANA,FATEHABAD,2021-01-29,10,350,1,361
HARYANA,FATEHABAD,2021-01-30,1,89,0,90
HARYANA,FATEHABAD,2021-01-31,2,356,0,358
HARYANA,GURUGRAM,2021-01-26,35,2066,9,2110
HARYANA,GURUGRAM,2021-01-27,28,2654,13,2695
HARYANA,GURUGRAM,2021-01-28,40,2412,9,2461
HARYANA,GURUGRAM,2021-01-29,54,2644,20,2718
HARYANA,GURUGRAM,2021-01-30,24,2910,9,2943
HARYANA,GURUGRAM,2021-01-31,36,2319,9,2364
HARYANA,HISAR,2021-01-26,3,636,5,644
HARYANA,HISAR,2021-01-27,8,1423,0,1431
HARYANA,HISAR,2021-01-28,11,880,1,892
HARYANA,HISAR,2021-01-29,3,1085,0,1088
HARYANA,HISAR,2021-01-30,1,867,2,870
HARYANA,HISAR,2021-01-31,3,503,0,506
HARYANA,JHAJJAR,2021-01-26,0,732,0,732
HARYANA,JHAJJAR,2021-01-27,2,1885,0,1887
HARYANA,JHAJJAR,2021-01-28,0,957,0,957
HARYANA,JHAJJAR,2021-01-29,1,960,1,962
HARYANA,JHAJJAR,2021-01-30,2,725,0,727
HARYANA,JHAJJAR,2021-01-31,3,615,1,619
HARYANA,JIND,2021-01-26,4,138,0,142
HARYANA,JIND,2021-01-27,1,583,1,585
HARYANA,JIND,2021-01-28,4,245,1,250
HARYANA,JIND,2021-01-29,5,450,15,470
HARYANA,JIND,2021-01-30,6,782,0,788
HARYANA,JIND,2021-01-31,1,475,0,476
HARYANA,KAITHAL,2021-01-26,1,64,0,65
HARYANA,KAITHAL,2021-01-27,3,209,2,214
HARYANA,KAITHAL,2021-01-28,5,142,2,149
HARYANA,KAITHAL,2021-01-29,5,230,0,235
HARYANA,KAITHAL,2021-01-30,3,383,2,388
HARYANA,KAITHAL,2021-01-31,2,54,0,56
HARYANA,KARNAL,2021-01-26,3,75,0,78
HARYANA,KARNAL,2021-01-27,12,1094,3,1109
HARYANA,KARNAL,2021-01-28,10,675,2,687
HARYANA,KARNAL,2021-01-29,8,1164,4,1176
HARYANA,KARNAL,2021-01-30,10,776,1,787
HARYANA,KARNAL,2021-01-31,3,105,0,108
HARYANA,KURUKSHETRA,2021-01-26,0,121,1,122
HARYANA,KURUKSHETRA,2021-01-27,16,769,0,785
HARYANA,KURUKSHETRA,2021-01-28,7,952,0,959
HARYANA,KURUKSHETRA,2021-01-29,8,1235,2,1245
HARYANA,KURUKSHETRA,2021-01-30,5,878,0,883
HARYANA,KURUKSHETRA,2021-01-31,2,275,0,277
HARYANA,MAHENDRAGARH,2021-01-26,0,167,1,168
HARYANA,MAHENDRAGARH,2021-01-27,0,499,1,500
HARYANA,MAHENDRAGARH,2021-01-28,0,621,1,622
HARYANA,MAHENDRAGARH,2021-01-29,0,437,2,439
HARYANA,MAHENDRAGARH,2021-01-30,1,103,0,104
HARYANA,MAHENDRAGARH,2021-01-31,1,27,0,28
HARYANA,NUH,2021-01-26,1,265,1,267
HARYANA,NUH,2021-01-27,1,397,0,398
HARYANA,NUH,2021-01-28,0,715,1,716
HARYANA,NUH,2021-01-29,1,496,0,497
HARYANA,NUH,2021-01-30,0,110,0,110
HARYANA,NUH,2021-01-31,0,312,0,312
HARYANA,PALWAL,2021-01-26,2,22,0,24
HARYANA,PALWAL,2021-01-27,0,133,1,134
HARYANA,PALWAL,2021-01-28,1,385,0,386
HARYANA,PALWAL,2021-01-29,1,261,0,262
HARYANA,PALWAL,2021-01-30,2,181,1,184
HARYANA,PALWAL,2021-01-31,0,36,0,36
HARYANA,PANCHKULA,2021-01-26,16,392,0,408
HARYANA,PANCHKULA,2021-01-27,16,321,4,341
HARYANA,PANCHKULA,2021-01-28,13,735,5,753
HARYANA,PANCHKULA,2021-01-29,9,906,2,917
HARYANA,PANCHKULA,2021-01-30,29,860,7,896
HARYANA,PANCHKULA,2021-01-31,13,423,2,438
HARYANA,PANIPAT,2021-01-26,2,905,0,907
HARYANA,PANIPAT,2021-01-27,2,638,1,641
HARYANA,PANIPAT,2021-01-28,6,791,1,798
HARYANA,PANIPAT,2021-01-29,6,621,0,627
HARYANA,PANIPAT,2021-01-30,4,616,0,620
HARYANA,PANIPAT,2021-01-31,9,369,1,379
HARYANA,REWARI,2021-01-26,0,58,0,58
HARYANA,REWARI,2021-01-27,3,287,4,294
HARYANA,REWARI,2021-01-28,3,326,1,330
HARYANA,REWARI,2021-01-29,0,454,3,457
HARYANA,REWARI,2021-01-30,0,372,3,375
HARYANA,REWARI,2021-01-31,0,307,5,312
HARYANA,ROHTAK,2021-01-26,10,290,0,300
HARYANA,ROHTAK,2021-01-27,7,325,1,333
HARYANA,ROHTAK,2021-01-28,3,824,0,827
HARYANA,ROHTAK,2021-01-29,2,701,2,705
HARYANA,ROHTAK,2021-01-30,0,349,0,349
HARYANA,ROHTAK,2021-01-31,1,396,0,397
HARYANA,SIRSA,2021-01-26,1,1079,38,1118
HARYANA,SIRSA,2021-01-27,3,1007,34,1044
HARYANA,SIRSA,2021-01-28,9,1662,13,1684
HARYANA,SIRSA,2021-01-29,4,1082,41,1127
HARYANA,SIRSA,2021-01-30,1,1131,33,1165
HARYANA,SIRSA,2021-01-31,2,656,10,668
HARYANA,SONIPAT,2021-01-26,2,784,0,786
HARYANA,SONIPAT,2021-01-27,5,1240,0,1245
HARYANA,SONIPAT,2021-01-28,4,1655,0,1659
HARYANA,SONIPAT,2021-01-29,7,1679,0,1686
HARYANA,SONIPAT,2021-01-30,1,1073,1,1075
HARYANA,SONIPAT,2021-01-31,1,539,1,541
HARYANA,YAMUNANAGAR,2021-01-26,24,462,1,487
HARYANA,YAMUNANAGAR,2021-01-27,10,880,4,894
HARYANA,YAMUNANAGAR,2021-01-28,6,792,4,802
HARYANA,YAMUNANAGAR,2021-01-29,17,924,2,943
HARYANA,YAMUNANAGAR,2021-01-30,9,365,1,375
HARYANA,YAMUNANAGAR,2021-01-31,3,130,0,133
HIMACHAL PRADESH,BILASPUR,2021-01-26,0,141,0,141
HIMACHAL PRADESH,BILASPUR,2021-01-27,0,179,0,179
HIMACHAL PRADESH,BILASPUR,2021-01-28,1,218,1,220
HIMACHAL PRADESH,BILASPUR,2021-01-29,2,332,1,335
HIMACHAL PRADESH,BILASPUR,2021-01-30,1,258,0,259
HIMACHAL PRADESH,BILASPUR,2021-01-31,0,137,1,138
HIMACHAL PRADESH,CHAMBA,2021-01-26,0,159,4,163
HIMACHAL PRADESH,CHAMBA,2021-01-27,4,494,6,504
HIMACHAL PRADESH,CHAMBA,2021-01-28,4,317,2,323
HIMACHAL PRADESH,CHAMBA,2021-01-29,3,225,1,229
HIMACHAL PRADESH,CHAMBA,2021-01-30,0,238,2,240
HIMACHAL PRADESH,CHAMBA,2021-01-31,0,167,5,172
HIMACHAL PRADESH,HAMIRPUR,2021-01-26,1,270,0,271
HIMACHAL PRADESH,HAMIRPUR,2021-01-27,2,158,0,160
HIMACHAL PRADESH,HAMIRPUR,2021-01-28,0,471,2,473
HIMACHAL PRADESH,HAMIRPUR,2021-01-29,0,560,0,560
HIMACHAL PRADESH,HAMIRPUR,2021-01-30,3,394,1,398
HIMACHAL PRADESH,HAMIRPUR,2021-01-31,2,396,0,398
HIMACHAL PRADESH,KANGRA,2021-01-26,2,1132,2,1136
HIMACHAL PRADESH,KANGRA,2021-01-27,9,920,0,929
HIMACHAL PRADESH,KANGRA,2021-01-28,9,988,0,997
HIMACHAL PRADESH,KANGRA,2021-01-29,10,634,1,645
HIMACHAL PRADESH,KANGRA,2021-01-30,11,1244,1,1256
HIMACHAL PRADESH,KANGRA,2021-01-31,12,320,1,333
HIMACHAL PRADESH,KINNAUR,2021-01-26,0,2,0,2
HIMACHAL PRADESH,KINNAUR,2021-01-27,0,7,0,7
HIMACHAL PRADESH,KINNAUR,2021-01-28,0,6,0,6
HIMACHAL PRADESH,KINNAUR,2021-01-29,20,74,1,95
HIMACHAL PRADESH,KINNAUR,2021-01-30,1,9,0,10
HIMACHAL PRADESH,KINNAUR,2021-01-31,0,13,0,13
HIMACHAL PRADESH,KULLU,2021-01-26,0,30,4,34
HIMACHAL PRADESH,KULLU,2021-01-27,4,163,6,173
HIMACHAL PRADESH,KULLU,2021-01-28,2,107,2,111
HIMACHAL PRADESH,KULLU,2021-01-29,3,76,5,84
HIMACHAL PRADESH,KULLU,2021-01-30,0,152,3,155
HIMACHAL PRADESH,KULLU,2021-01-31,0,71,2,73
HIMACHAL PRADESH,LAHUL AND SPITI,2021-01-28,0,1,0,1
HIMACHAL PRADESH,LAHUL AND SPITI,2021-01-29,0,1,0,1
HIMACHAL PRADESH,MANDI,2021-01-26,1,120,5,126
HIMACHAL PRADESH,MANDI,2021-01-27,9,270,9,288
HIMACHAL PRADESH,MANDI,2021-01-28,10,356,30,396
HIMACHAL PRADESH,MANDI,2021-01-29,11,409,28,448
HIMACHAL PRADESH,MANDI,2021-01-30,45,456,45,546
HIMACHAL PRADESH,MANDI,2021-01-31,20,240,24,284
HIMACHAL PRADESH,SHIMLA,2021-01-26,1,134,4,139
HIMACHAL PRADESH,SHIMLA,2021-01-27,13,544,2,559
HIMACHAL PRADESH,SHIMLA,2021-01-28,10,482,1,493
HIMACHAL PRADESH,SHIMLA,2021-01-29,5,529,4,538
HIMACHAL PRADESH,SHIMLA,2021-01-30,2,451,2,455
HIMACHAL PRADESH,SHIMLA,2021-01-31,5,160,5,170
HIMACHAL PRADESH,SIRMAUR,2021-01-26,5,46,0,51
HIMACHAL PRADESH,SIRMAUR,2021-01-27,3,198,3,204
HIMACHAL PRADESH,SIRMAUR,2021-01-28,8,251,0,259
HIMACHAL PRADESH,SIRMAUR,2021-01-29,5,475,1,481
HIMACHAL PRADESH,SIRMAUR,2021-01-30,2,334,0,336
HIMACHAL PRADESH,SIRMAUR,2021-01-31,1,206,2,209
HIMACHAL PRADESH,SOLAN,2021-01-26,5,258,0,263
HIMACHAL PRADESH,SOLAN,2021-01-27,11,323,0,334
HIMACHAL PRADESH,SOLAN,2021-01-28,7,596,1,604
HIMACHAL PRADESH,SOLAN,2021-01-29,3,473,0,476
HIMACHAL PRADESH,SOLAN,2021-01-30,7,603,0,610
HIMACHAL PRADESH,SOLAN,2021-01-31,4,294,0,298
HIMACHAL PRADESH,UNA,2021-01-26,2,266,0,268
HIMACHAL PRADESH,UNA,2021-01-27,4,709,0,713
HIMACHAL PRADESH,UNA,2021-01-28,6,446,1,453
HIMACHAL PRADESH,UNA,2021-01-29,9,520,0,529
HIMACHAL PRADESH,UNA,2021-01-30,2,534,0,536
HIMACHAL PRADESH,UNA,2021-01-31,1,170,0,171
INDIA,INDIA,2021-01-26,2,2,0,4
INDIA,INDIA,2021-01-27,6,1,0,7
INDIA,INDIA,2021-01-28,9,2,0,11
INDIA,INDIA,2021-01-29,5,3,0,8
INDIA,INDIA,2021-01-30,5,3,1,9
INDIA,INDIA,2021-01-31,4,0,0,4
JAMMU AND KASHMIR,ANANTNAG,2021-01-26,2,12,0,14
JAMMU AND KASHMIR,ANANTNAG,2021-01-27,11,392,2,405
JAMMU AND KASHMIR,ANANTNAG,2021-01-28,8,326,0,334
JAMMU AND KASHMIR,ANANTNAG,2021-01-29,5,375,0,380
JAMMU AND KASHMIR,ANANTNAG,2021-01-30,9,307,0,316
JAMMU AND KASHMIR,ANANTNAG,2021-01-31,1,65,0,66
JAMMU AND KASHMIR,BANDIPORA,2021-01-26,0,12,0,12
JAMMU AND KASHMIR,BANDIPORA,2021-01-27,0,153,1,154
JAMMU AND KASHMIR,BANDIPORA,2021-01-28,1,100,0,101
JAMMU AND KASHMIR,BANDIPORA,2021-01-29,3,107,1,111
JAMMU AND KASHMIR,BANDIPORA,2021-01-30,0,79,3,82
JAMMU AND KASHMIR,BARAMULLA,2021-01-26,5,41,0,46
JAMMU AND KASHMIR,BARAMULLA,2021-01-27,3,237,0,240
JAMMU AND KASHMIR,BARAMULLA,2021-01-28,5,334,0,339
JAMMU AND KASHMIR,BARAMULLA,2021-01-29,6,398,0,404
JAMMU AND KASHMIR,BARAMULLA,2021-01-30,2,90,0,92
JAMMU AND KASHMIR,BARAMULLA,2021-01-31,0,67,0,67
JAMMU AND KASHMIR,BUDGAM,2021-01-26,2,131,0,133
JAMMU AND KASHMIR,BUDGAM,2021-01-27,13,698,1,712
JAMMU AND KASHMIR,BUDGAM,2021-01-28,3,804,0,807
JAMMU AND KASHMIR,BUDGAM,2021-01-29,3,740,0,743
JAMMU AND KASHMIR,BUDGAM,2021-01-30,19,821,0,840
JAMMU AND KASHMIR,BUDGAM,2021-01-31,4,262,0,266
JAMMU AND KASHMIR,DODA,2021-01-26,0,11,0,11
JAMMU AND KASHMIR,DODA,2021-01-27,4,95,0,99
JAMMU AND KASHMIR,DODA,2021-01-28,3,106,0,109
JAMMU AND KASHMIR,DODA,2021-01-29,3,46,0,49
JAMMU AND KASHMIR,DODA,2021-01-30,4,51,0,55
JAMMU AND KASHMIR,DODA,2021-01-31,0,18,0,18
JAMMU AND KASHMIR,GANDERBAL,2021-01-26,0,46,0,46
JAMMU AND KASHMIR,GANDERBAL,2021-01-27,0,210,0,210
JAMMU AND KASHMIR,GANDERBAL,2021-01-28,12,226,0,238
JAMMU AND KASHMIR,GANDERBAL,2021-01-29,0,128,0,128
JAMMU AND KASHMIR,GANDERBAL,2021-01-30,13,127,0,140
JAMMU AND KASHMIR,GANDERBAL,2021-01-31,0,31,0,31
JAMMU AND KASHMIR,JAMMU,2021-01-26,5,159,0,164
JAMMU AND KASHMIR,JAMMU,2021-01-27,24,498,3,525
JAMMU AND KASHMIR,JAMMU,2021-01-28,39,429,3,471
JAMMU AND KASHMIR,JAMMU,2021-01-29,23,480,1,504
JAMMU AND KASHMIR,JAMMU,2021-01-30,27,697,1,725
JAMMU AND KASHMIR,JAMMU,2021-01-31,10,279,2,291
JAMMU AND KASHMIR,KATHUA,2021-01-26,1,28,0,29
JAMMU AND KASHMIR,KATHUA,2021-01-27,0,181,0,181
JAMMU AND KASHMIR,KATHUA,2021-01-28,2,71,0,73
JAMMU AND KASHMIR,KATHUA,2021-01-29,0,30,0,30
JAMMU AND KASHMIR,KATHUA,2021-01-30,2,71,1,74
JAMMU AND KASHMIR,KATHUA,2021-01-31,0,13,0,13
JAMMU AND KASHMIR,KISHTWAR,2021-01-26,1,86,0,87
JAMMU AND KASHMIR,KISHTWAR,2021-01-27,0,76,0,76
JAMMU AND KASHMIR,KISHTWAR,2021-01-28,0,93,0,93
JAMMU AND KASHMIR,KISHTWAR,2021-01-29,7,69,0,76
JAMMU AND KASHMIR,KISHTWAR,2021-01-30,0,47,0,47
JAMMU AND KASHMIR,KISHTWAR,2021-01-31,0,91,0,91
JAMMU AND KASHMIR,KULGAM,2021-01-26,0,209,0,209
JAMMU AND KASHMIR,KULGAM,2021-01-27,1,330,0,331
JAMMU AND KASHMIR,KULGAM,2021-01-28,2,321,0,323
JAMMU AND KASHMIR,KULGAM,2021-01-29,4,391,0,395
JAMMU AND KASHMIR,KULGAM,2021-01-30,1,115,0,116
JAMMU AND KASHMIR,KULGAM,2021-01-31,0,11,0,11
JAMMU AND KASHMIR,KUPWARA,2021-01-26,0,350,0,350
JAMMU AND KASHMIR,KUPWARA,2021-01-27,2,337,0,339
JAMMU AND KASHMIR,KUPWARA,2021-01-28,6,26,0,32
JAMMU AND KASHMIR,KUPWARA,2021-01-29,0,183,0,183
JAMMU AND KASHMIR,KUPWARA,2021-01-30,6,24,0,30
JAMMU AND KASHMIR,KUPWARA,2021-01-31,2,5,0,7
JAMMU AND KASHMIR,POONCH,2021-01-26,0,118,0,118
JAMMU AND KASHMIR,POONCH,2021-01-27,1,295,0,296
JAMMU AND KASHMIR,POONCH,2021-01-28,3,496,0,499
JAMMU AND KASHMIR,POONCH,2021-01-29,0,353,0,353
JAMMU AND KASHMIR,POONCH,2021-01-30,8,281,0,289
JAMMU AND KASHMIR,POONCH,2021-01-31,1,116,0,117
JAMMU AND KASHMIR,PULWAMA,2021-01-26,1,49,0,50
JAMMU AND KASHMIR,PULWAMA,2021-01-27,2,300,1,303
JAMMU AND KASHMIR,PULWAMA,2021-01-28,5,414,2,421
JAMMU AND KASHMIR,PULWAMA,2021-01-29,6,435,2,443
JAMMU AND KASHMIR,PULWAMA,2021-01-30,3,653,10,666
JAMMU AND KASHMIR,PULWAMA,2021-01-31,18,273,0,291
JAMMU AND KASHMIR,RAJOURI,2021-01-26,0,146,0,146
JAMMU AND KASHMIR,RAJOURI,2021-01-27,1,218,0,219
JAMMU AND KASHMIR,RAJOURI,2021-01-28,0,165,0,165
JAMMU AND KASHMIR,RAJOURI,2021-01-29,0,406,0,406
JAMMU AND KASHMIR,RAJOURI,2021-01-30,0,409,0,409
JAMMU AND KASHMIR,RAJOURI,2021-01-31,0,226,0,226
JAMMU AND KASHMIR,RAMBAN,2021-01-26,0,89,0,89
JAMMU AND KASHMIR,RAMBAN,2021-01-27,0,397,0,397
JAMMU AND KASHMIR,RAMBAN,2021-01-28,1,206,1,208
JAMMU AND KASHMIR,RAMBAN,2021-01-29,1,272,0,273
JAMMU AND KASHMIR,RAMBAN,2021-01-30,5,271,0,276
JAMMU AND KASHMIR,RAMBAN,2021-01-31,4,150,0,154
JAMMU AND KASHMIR,REASI,2021-01-26,0,13,0,13
JAMMU AND KASHMIR,REASI,2021-01-27,2,67,1,70
JAMMU AND KASHMIR,REASI,2021-01-28,5,85,0,90
JAMMU AND KASHMIR,REASI,2021-01-29,1,72,0,73
JAMMU AND KASHMIR,REASI,2021-01-30,3,81,0,84
JAMMU AND KASHMIR,REASI,2021-01-31,0,36,0,36
JAMMU AND KASHMIR,SAMBA,2021-01-26,0,137,0,137
JAMMU AND KASHMIR,SAMBA,2021-01-27,2,145,0,147
JAMMU AND KASHMIR,SAMBA,2021-01-28,0,115,0,115
JAMMU AND KASHMIR,SAMBA,2021-01-29,0,253,0,253
JAMMU AND KASHMIR,SAMBA,2021-01-30,1,117,0,118
JAMMU AND KASHMIR,SAMBA,2021-01-31,0,76,0,76
JAMMU AND KASHMIR,SHOPIAN,2021-01-26,0,14,0,14
JAMMU AND KASHMIR,SHOPIAN,2021-01-27,3,88,0,91
JAMMU AND KASHMIR,SHOPIAN,2021-01-28,4,162,0,166
JAMMU AND KASHMIR,SHOPIAN,2021-01-29,2,166,0,168
JAMMU AND KASHMIR,SHOPIAN,2021-01-30,4,321,2,327
JAMMU AND KASHMIR,SHOPIAN,2021-01-31,2,288,0,290
JAMMU AND KASHMIR,SRINAGAR,2021-01-26,16,1559,0,1575
JAMMU AND KASHMIR,SRINAGAR,2021-01-27,41,2411,3,2455
JAMMU AND KASHMIR,SRINAGAR,2021-01-28,37,2599,1,2637
JAMMU AND KASHMIR,SRINAGAR,2021-01-29,60,2390,0,2450
JAMMU AND KASHMIR,SRINAGAR,2021-01-30,43,2634,1,2678
JAMMU AND KASHMIR,SRINAGAR,2021-01-31,12,912,4,928
JAMMU AND KASHMIR,UDHAMPUR,2021-01-26,0,171,0,171
JAMMU AND KASHMIR,UDHAMPUR,2021-01-27,53,624,0,677
JAMMU AND KASHMIR,UDHAMPUR,2021-01-28,28,382,0,410
JAMMU AND KASHMIR,UDHAMPUR,2021-01-29,9,370,0,379
JAMMU AND KASHMIR,UDHAMPUR,2021-01-30,2,312,0,314
JAMMU AND KASHMIR,UDHAMPUR,2021-01-31,38,276,0,314
JHARKHAND,BOKARO,2021-01-26,1,363,11,375
JHARKHAND,BOKARO,2021-01-27,6,1423,2,1431
JHARKHAND,BOKARO,2021-01-28,2,824,0,826
JHARKHAND,BOKARO,2021-01-29,3,532,3,538
JHARKHAND,BOKARO,2021-01-30,7,677,6,690
JHARKHAND,BOKARO,2021-01-31,1,82,1,84
JHARKHAND,CHATRA,2021-01-26,1,22,0,23
JHARKHAND,CHATRA,2021-01-27,2,430,0,432
JHARKHAND,CHATRA,2021-01-28,0,202,1,203
JHARKHAND,CHATRA,2021-01-29,0,94,0,94
JHARKHAND,CHATRA,2021-01-30,1,181,0,182
JHARKHAND,CHATRA,2021-01-31,0,68,1,69
JHARKHAND,DEOGHAR,2021-01-26,0,699,0,699
JHARKHAND,DEOGHAR,2021-01-27,1,830,0,831
JHARKHAND,DEOGHAR,2021-01-28,3,1399,14,1416
JHARKHAND,DEOGHAR,2021-01-29,1,816,24,841
JHARKHAND,DEOGHAR,2021-01-30,5,783,10,798
JHARKHAND,DEOGHAR,2021-01-31,2,475,1,478
JHARKHAND,DHANBAD,2021-01-26,1,43,1,45
JHARKHAND,DHANBAD,2021-01-27,0,457,0,457
JHARKHAND,DHANBAD,2021-01-28,0,473,1,474
JHARKHAND,DHANBAD,2021-01-29,15,282,4,301
JHARKHAND,DHANBAD,2021-01-30,16,556,1,573
JHARKHAND,DHANBAD,2021-01-31,19,971,0,990
JHARKHAND,DUMKA,2021-01-26,0,385,0,385
JHARKHAND,DUMKA,2021-01-27,0,471,0,471
JHARKHAND,DUMKA,2021-01-28,1,411,2,414
JHARKHAND,DUMKA,2021-01-29,0,414,0,414
JHARKHAND,DUMKA,2021-01-30,1,166,0,167
JHARKHAND,DUMKA,2021-01-31,0,268,0,268
JHARKHAND,EAST SINGHBUM,2021-01-26,6,1134,1,1141
JHARKHAND,EAST SINGHBUM,2021-01-27,11,1438,2,1451
JHARKHAND,EAST SINGHBUM,2021-01-28,2,1923,0,1925
JHARKHAND,EAST SINGHBUM,2021-01-29,2,1368,1,1371
JHARKHAND,EAST SINGHBUM,2021-01-30,11,1702,2,1715
JHARKHAND,EAST SINGHBUM,2021-01-31,1,844,1,846
JHARKHAND,GARHWA,2021-01-26,0,497,0,497
JHARKHAND,GARHWA,2021-01-27,1,566,0,567
JHARKHAND,GARHWA,2021-01-28,1,1105,2,1108
JHARKHAND,GARHWA,2021-01-29,0,688,1,689
JHARKHAND,GARHWA,2021-01-30,0,528,1,529
JHARKHAND,GARHWA,2021-01-31,0,520,0,520
JHARKHAND,GIRIDIH,2021-01-26,1,38,2,41
JHARKHAND,GIRIDIH,2021-01-27,0,499,1,500
JHARKHAND,GIRIDIH,2021-01-28,0,535,1,536
JHARKHAND,GIRIDIH,2021-01-29,1,711,0,712
JHARKHAND,GIRIDIH,2021-01-30,1,559,1,561
JHARKHAND,GIRIDIH,2021-01-31,0,8,0,8
JHARKHAND,GODDA,2021-01-26,0,113,0,113
JHARKHAND,GODDA,2021-01-27,0,472,0,472
JHARKHAND,GODDA,2021-01-28,2,319,0,321
JHARKHAND,GODDA,2021-01-29,1,255,1,257
JHARKHAND,GODDA,2021-01-30,4,664,1,669
JHARKHAND,GODDA,2021-01-31,0,396,0,396
JHARKHAND,GUMLA,2021-01-26,0,47,0,47
JHARKHAND,GUMLA,2021-01-27,2,190,0,192
JHARKHAND,GUMLA,2021-01-28,1,600,0,601
JHARKHAND,GUMLA,2021-01-29,3,493,0,496
JHARKHAND,GUMLA,2021-01-30,0,847,0,847
JHARKHAND,GUMLA,2021-01-31,1,189,0,190
JHARKHAND,HAZARIBAGH,2021-01-26,2,708,0,710
JHARKHAND,HAZARIBAGH,2021-01-27,3,317,0,320
JHARKHAND,HAZARIBAGH,2021-01-28,0,683,1,684
JHARKHAND,HAZARIBAGH,2021-01-29,1,390,0,391
JHARKHAND,HAZARIBAGH,2021-01-30,0,147,0,147
JHARKHAND,HAZARIBAGH,2021-01-31,3,40,0,43
JHARKHAND,JAMTARA,2021-01-26,0,3,0,3
JHARKHAND,JAMTARA,2021-01-27,0,123,5,128
JHARKHAND,JAMTARA,2021-01-28,0,189,4,193
JHARKHAND,JAMTARA,2021-01-29,0,89,2,91
JHARKHAND,JAMTARA,2021-01-30,8,284,11,303
JHARKHAND,JAMTARA,2021-01-31,0,179,34,213
JHARKHAND,KHUNTI,2021-01-26,1,238,0,239
JHARKHAND,KHUNTI,2021-01-27,2,736,0,738
JHARKHAND,KHUNTI,2021-01-28,0,156,0,156
JHARKHAND,KHUNTI,2021-01-29,0,341,0,341
JHARKHAND,KHUNTI,2021-01-30,1,402,0,403
JHARKHAND,KHUNTI,2021-01-31,0,70,0,70
JHARKHAND,KODERMA,2021-01-26,0,361,0,361
JHARKHAND,KODERMA,2021-01-27,2,357,0,359
JHARKHAND,KODERMA,2021-01-28,1,374,0,375
JHARKHAND,KODERMA,2021-01-29,3,403,0,406
JHARKHAND,KODERMA,2021-01-30,0,550,0,550
JHARKHAND,KODERMA,2021-01-31,0,191,0,191
JHARKHAND,LATEHAR,2021-01-26,0,48,0,48
JHARKHAND,LATEHAR,2021-01-27,1,679,1,681
JHARKHAND,LATEHAR,2021-01-28,1,541,0,542
JHARKHAND,LATEHAR,2021-01-29,0,144,0,144
JHARKHAND,LATEHAR,2021-01-30,0,106,0,106
JHARKHAND,LATEHAR,2021-01-31,0,5,0,5
JHARKHAND,LOHARDAGA,2021-01-26,0,19,0,19
JHARKHAND,LOHARDAGA,2021-01-27,1,304,0,305
JHARKHAND,LOHARDAGA,2021-01-28,0,147,0,147
JHARKHAND,LOHARDAGA,2021-01-29,0,275,0,275
JHARKHAND,LOHARDAGA,2021-01-30,0,29,0,29
JHARKHAND,LOHARDAGA,2021-01-31,3,36,0,39
JHARKHAND,PAKUR,2021-01-26,0,408,0,408
JHARKHAND,PAKUR,2021-01-27,0,187,0,187
JHARKHAND,PAKUR,2021-01-28,0,852,0,852
JHARKHAND,PAKUR,2021-01-29,0,1212,0,1212
JHARKHAND,PAKUR,2021-01-30,1,1025,1,1027
JHARKHAND,PAKUR,2021-01-31,0,798,0,798
JHARKHAND,PALAMU,2021-01-26,1,592,0,593
JHARKHAND,PALAMU,2021-01-27,2,1250,3,1255
JHARKHAND,PALAMU,2021-01-28,7,1916,0,1923
JHARKHAND,PALAMU,2021-01-29,0,504,1,505
JHARKHAND,PALAMU,2021-01-30,0,1773,0,1773
JHARKHAND,PALAMU,2021-01-31,6,1750,1,1757
JHARKHAND,RAMGARH,2021-01-26,0,237,1,238
JHARKHAND,RAMGARH,2021-01-27,1,332,0,333
JHARKHAND,RAMGARH,2021-01-28,1,312,0,313
JHARKHAND,RAMGARH,2021-01-29,0,70,0,70
JHARKHAND,RAMGARH,2021-01-30,0,191,0,191
JHARKHAND,RAMGARH,2021-01-31,1,32,0,33
JHARKHAND,RANCHI,2021-01-26,47,635,4,686
JHARKHAND,RANCHI,2021-01-27,63,733,0,796
JHARKHAND,RANCHI,2021-01-28,68,675,2,745
JHARKHAND,RANCHI,2021-01-29,39,595,1,635
JHARKHAND,RANCHI,2021-01-30,42,652,1,695
JHARKHAND,RANCHI,2021-01-31,52,345,0,397
JHARKHAND,SAHEBGANJ,2021-01-26,0,350,0,350
JHARKHAND,SAHEBGANJ,2021-01-27,0,163,0,163
JHARKHAND,SAHEBGANJ,2021-01-28,0,144,0,144
JHARKHAND,SAHEBGANJ,2021-01-29,0,823,1,824
JHARKHAND,SAHEBGANJ,2021-01-30,1,191,0,192
JHARKHAND,SAHEBGANJ,2021-01-31,0,141,0,141
JHARKHAND,SARAIKELA KHARSAWAN,2021-01-26,0,21,0,21
JHARKHAND,SARAIKELA KHARSAWAN,2021-01-27,1,508,10,519
JHARKHAND,SARAIKELA KHARSAWAN,2021-01-28,0,711,0,711
JHARKHAND,SARAIKELA KHARSAWAN,2021-01-29,0,571,0,571
JHARKHAND,SARAIKELA KHARSAWAN,2021-01-30,0,582,1,583
JHARKHAND,SARAIKELA KHARSAWAN,2021-01-31,0,13,0,13
JHARKHAND,SIMDEGA,2021-01-26,0,122,0,122
JHARKHAND,SIMDEGA,2021-01-27,0,265,0,265
JHARKHAND,SIMDEGA,2021-01-28,1,341,0,342
JHARKHAND,SIMDEGA,2021-01-29,1,550,0,551
JHARKHAND,SIMDEGA,2021-01-30,0,134,0,134
JHARKHAND,SIMDEGA,2021-01-31,0,96,0,96
JHARKHAND,WEST SINGHBHUM,2021-01-26,0,76,0,76
JHARKHAND,WEST SINGHBHUM,2021-01-27,1,394,0,395
JHARKHAND,WEST SINGHBHUM,2021-01-28,0,477,0,477
JHARKHAND,WEST SINGHBHUM,2021-01-29,1,537,0,538
JHARKHAND,WEST SINGHBHUM,2021-01-30,0,510,0,510
JHARKHAND,WEST SINGHBHUM,2021-01-31,0,9,0,9
KARNATAKA,BAGALKOTE,2021-01-26,3,1742,0,1745
KARNATAKA,BAGALKOTE,2021-01-27,1,1110,9,1120
KARNATAKA,BAGALKOTE,2021-01-28,1,1025,2,1028
KARNATAKA,BAGALKOTE,2021-01-29,3,1560,4,1567
KARNATAKA,BAGALKOTE,2021-01-30,2,1477,11,1490
KARNATAKA,BAGALKOTE,2021-01-31,1,572,0,573
KARNATAKA,BALLARI,2021-01-26,4,698,0,702
KARNATAKA,BALLARI,2021-01-27,5,630,1,636
KARNATAKA,BALLARI,2021-01-28,2,1786,6,1794
KARNATAKA,BALLARI,2021-01-29,4,1190,3,1197
KARNATAKA,BALLARI,2021-01-30,5,1351,1,1357
KARNATAKA,BALLARI,2021-01-31,7,1069,34,1110
KARNATAKA,BELAGAVI,2021-01-26,10,2175,4,2189
KARNATAKA,BELAGAVI,2021-01-27,4,1926,8,1938
KARNATAKA,BELAGAVI,2021-01-28,6,2398,1,2405
KARNATAKA,BELAGAVI,2021-01-29,12,1626,4,1642
KARNATAKA,BELAGAVI,2021-01-30,8,2186,12,2206
KARNATAKA,BELAGAVI,2021-01-31,2,249,0,251
KARNATAKA,BENGALURU RURAL,2021-01-26,7,1161,3,1171
KARNATAKA,BENGALURU RURAL,2021-01-27,12,1758,0,1770
KARNATAKA,BENGALURU RURAL,2021-01-28,13,1548,0,1561
KARNATAKA,BENGALURU RURAL,2021-01-29,7,1356,1,1364
KARNATAKA,BENGALURU RURAL,2021-01-30,23,1731,0,1754
KARNATAKA,BENGALURU RURAL,2021-01-31,7,551,0,558
KARNATAKA,BENGALURU URBAN,2021-01-26,272,23170,182,23624
KARNATAKA,BENGALURU URBAN,2021-01-27,327,31998,115,32440
KARNATAKA,BENGALURU URBAN,2021-01-28,280,29635,191,30106
KARNATAKA,BENGALURU URBAN,2021-01-29,260,32813,84,33157
KARNATAKA,BENGALURU URBAN,2021-01-30,276,32386,24,32686
KARNATAKA,BENGALURU URBAN,2021-01-31,218,24667,40,24925
KARNATAKA,BIDAR,2021-01-26,4,1191,0,1195
KARNATAKA,BIDAR,2021-01-27,9,482,0,491
KARNATAKA,BIDAR,2021-01-28,3,1121,0,1124
KARNATAKA,BIDAR,2021-01-29,2,1199,0,1201
KARNATAKA,BIDAR,2021-01-30,5,1260,0,1265
KARNATAKA,BIDAR,2021-01-31,10,1229,0,1239
KARNATAKA,CHAMARAJANAGARA,2021-01-26,8,1456,0,1464
KARNATAKA,CHAMARAJANAGARA,2021-01-27,1,222,0,223
KARNATAKA,CHAMARAJANAGARA,2021-01-28,3,658,0,661
KARNATAKA,CHAMARAJANAGARA,2021-01-29,1,882,0,883
KARNATAKA,CHAMARAJANAGARA,2021-01-30,4,930,1,935
KARNATAKA,CHAMARAJANAGARA,2021-01-31,2,487,0,489
KARNATAKA,CHIKKABALLAPURA,2021-01-26,2,1218,3,1223
KARNATAKA,CHIKKABALLAPURA,2021-01-27,15,1861,5,1881
KARNATAKA,CHIKKABALLAPURA,2021-01-28,8,2417,2,2427
KARNATAKA,CHIKKABALLAPURA,2021-01-29,15,2596,15,2626
KARNATAKA,CHIKKABALLAPURA,2021-01-30,15,2406,2,2423
KARNATAKA,CHIKKABALLAPURA,2021-01-31,4,1849,4,1857
KARNATAKA,CHIKKAMAGALURU,2021-01-26,5,1272,5,1282
KARNATAKA,CHIKKAMAGALURU,2021-01-27,5,357,1,363
KARNATAKA,CHIKKAMAGALURU,2021-01-28,9,1187,5,1201
KARNATAKA,CHIKKAMAGALURU,2021-01-29,9,929,2,940
KARNATAKA,CHIKKAMAGALURU,2021-01-30,8,1303,7,1318
KARNATAKA,CHIKKAMAGALURU,2021-01-31,6,453,5,464
KARNATAKA,CHITRADURGA,2021-01-26,15,1329,1,1345
KARNATAKA,CHITRADURGA,2021-01-27,11,1443,0,1454
KARNATAKA,CHITRADURGA,2021-01-28,21,780,0,801
KARNATAKA,CHITRADURGA,2021-01-29,12,1876,1,1889
KARNATAKA,CHITRADURGA,2021-01-30,7,1501,0,1508
KARNATAKA,CHITRADURGA,2021-01-31,10,1725,10,1745
KARNATAKA,DAKSHINA KANNADA,2021-01-26,15,1530,2,1547
KARNATAKA,DAKSHINA KANNADA,2021-01-27,49,2938,1,2988
KARNATAKA,DAKSHINA KANNADA,2021-01-28,39,1790,1,1830
KARNATAKA,DAKSHINA KANNADA,2021-01-29,19,1595,14,1628
KARNATAKA,DAKSHINA KANNADA,2021-01-30,42,1102,15,1159
KARNATAKA,DAKSHINA KANNADA,2021-01-31,16,618,2,636
KARNATAKA,DAVANGERE,2021-01-26,4,1573,0,1577
KARNATAKA,DAVANGERE,2021-01-27,5,1214,6,1225
KARNATAKA,DAVANGERE,2021-01-28,9,1040,5,1054
KARNATAKA,DAVANGERE,2021-01-29,14,1015,35,1064
KARNATAKA,DAVANGERE,2021-01-30,8,1076,0,1084
KARNATAKA,DAVANGERE,2021-01-31,1,676,0,677
KARNATAKA,DHARWAD,2021-01-26,16,1683,6,1705
KARNATAKA,DHARWAD,2021-01-27,3,1390,9,1402
KARNATAKA,DHARWAD,2021-01-28,14,1682,4,1700
KARNATAKA,DHARWAD,2021-01-29,6,2076,119,2201
KARNATAKA,DHARWAD,2021-01-30,7,2883,42,2932
KARNATAKA,DHARWAD,2021-01-31,3,1409,12,1424
KARNATAKA,GADAG,2021-01-26,1,963,52,1016
KARNATAKA,GADAG,2021-01-27,0,518,305,823
KARNATAKA,GADAG,2021-01-28,4,1252,123,1379
KARNATAKA,GADAG,2021-01-29,1,952,73,1026
KARNATAKA,GADAG,2021-01-30,6,663,3,672
KARNATAKA,GADAG,2021-01-31,1,928,96,1025
KARNATAKA,HASSAN,2021-01-26,16,1244,16,1276
KARNATAKA,HASSAN,2021-01-27,13,1711,74,1798
KARNATAKA,HASSAN,2021-01-28,8,1402,107,1517
KARNATAKA,HASSAN,2021-01-29,11,1855,182,2048
KARNATAKA,HASSAN,2021-01-30,12,1242,45,1299
KARNATAKA,HASSAN,2021-01-31,14,1546,5,1565
KARNATAKA,HAVERI,2021-01-26,1,887,0,888
KARNATAKA,HAVERI,2021-01-27,1,1182,0,1183
KARNATAKA,HAVERI,2021-01-28,1,1161,0,1162
KARNATAKA,HAVERI,2021-01-29,0,1392,0,1392
KARNATAKA,HAVERI,2021-01-30,0,915,0,915
KARNATAKA,HAVERI,2021-01-31,1,370,1,372
KARNATAKA,KALABURAGI,2021-01-26,15,1346,1,1362
KARNATAKA,KALABURAGI,2021-01-27,15,893,3,911
KARNATAKA,KALABURAGI,2021-01-28,16,1005,2,1023
KARNATAKA,KALABURAGI,2021-01-29,15,1822,1,1838
KARNATAKA,KALABURAGI,2021-01-30,22,1695,5,1722
KARNATAKA,KALABURAGI,2021-01-31,14,1781,2,1797
KARNATAKA,KODAGU,2021-01-26,16,361,12,389
KARNATAKA,KODAGU,2021-01-27,22,412,16,450
KARNATAKA,KODAGU,2021-01-28,17,459,9,485
KARNATAKA,KODAGU,2021-01-29,2,639,3,644
KARNATAKA,KODAGU,2021-01-30,9,812,14,835
KARNATAKA,KODAGU,2021-01-31,32,871,17,920
KARNATAKA,KOLAR,2021-01-26,6,1963,6,1975
KARNATAKA,KOLAR,2021-01-27,8,1044,3,1055
KARNATAKA,KOLAR,2021-01-28,2,1997,15,2014
KARNATAKA,KOLAR,2021-01-29,1,1744,0,1745
KARNATAKA,KOLAR,2021-01-30,4,2036,2,2042
KARNATAKA,KOLAR,2021-01-31,6,1693,1,1700
KARNATAKA,KOPPAL,2021-01-26,0,777,6,783
KARNATAKA,KOPPAL,2021-01-27,0,349,2,351
KARNATAKA,KOPPAL,2021-01-28,0,823,2,825
KARNATAKA,KOPPAL,2021-01-29,3,726,5,734
KARNATAKA,KOPPAL,2021-01-30,0,814,1,815
KARNATAKA,KOPPAL,2021-01-31,0,524,4,528
KARNATAKA,MANDYA,2021-01-26,4,2504,2,2510
KARNATAKA,MANDYA,2021-01-27,6,1299,3,1308
KARNATAKA,MANDYA,2021-01-28,5,2130,1,2136
KARNATAKA,MANDYA,2021-01-29,2,1839,1,1842
KARNATAKA,MANDYA,2021-01-30,4,2247,0,2251
KARNATAKA,MANDYA,2021-01-31,4,1283,3,1290
KARNATAKA,MYSURU,2021-01-26,22,2779,2,2803
KARNATAKA,MYSURU,2021-01-27,39,2607,8,2654
KARNATAKA,MYSURU,2021-01-28,23,2016,4,2043
KARNATAKA,MYSURU,2021-01-29,44,2484,1,2529
KARNATAKA,MYSURU,2021-01-30,45,3530,5,3580
KARNATAKA,MYSURU,2021-01-31,14,2135,0,2149
KARNATAKA,RAICHUR,2021-01-26,1,50,0,51
KARNATAKA,RAICHUR,2021-01-27,3,1446,1,1450
KARNATAKA,RAICHUR,2021-01-28,2,943,6,951
KARNATAKA,RAICHUR,2021-01-29,0,465,3,468
KARNATAKA,RAICHUR,2021-01-30,2,584,2,588
KARNATAKA,RAICHUR,2021-01-31,1,1231,6,1238
KARNATAKA,RAMANAGARA,2021-01-26,1,579,0,580
KARNATAKA,RAMANAGARA,2021-01-27,2,471,1,474
KARNATAKA,RAMANAGARA,2021-01-28,0,675,1,676
KARNATAKA,RAMANAGARA,2021-01-29,0,1023,0,1023
KARNATAKA,RAMANAGARA,2021-01-30,1,514,0,515
KARNATAKA,RAMANAGARA,2021-01-31,1,263,0,264
KARNATAKA,SHIVAMOGGA,2021-01-26,5,752,1,758
KARNATAKA,SHIVAMOGGA,2021-01-27,10,671,0,681
KARNATAKA,SHIVAMOGGA,2021-01-28,6,1125,0,1131
KARNATAKA,SHIVAMOGGA,2021-01-29,7,482,0,489
KARNATAKA,SHIVAMOGGA,2021-01-30,3,1864,1,1868
KARNATAKA,SHIVAMOGGA,2021-01-31,0,252,1,253
KARNATAKA,TUMAKURU,2021-01-26,10,1365,3,1378
KARNATAKA,TUMAKURU,2021-01-27,21,3281,74,3376
KARNATAKA,TUMAKURU,2021-01-28,26,1860,4,1890
KARNATAKA,TUMAKURU,2021-01-29,40,1784,7,1831
KARNATAKA,TUMAKURU,2021-01-30,28,2206,95,2329
KARNATAKA,TUMAKURU,2021-01-31,27,1247,1,1275
KARNATAKA,UDUPI,2021-01-26,5,798,0,803
KARNATAKA,UDUPI,2021-01-27,14,770,0,784
KARNATAKA,UDUPI,2021-01-28,8,991,1,1000
KARNATAKA,UDUPI,2021-01-29,12,1113,1,1126
KARNATAKA,UDUPI,2021-01-30,10,1134,1,1145
KARNATAKA,UDUPI,2021-01-31,9,260,0,269
KARNATAKA,UTTARA KANNADA,2021-01-26,6,529,10,545
KARNATAKA,UTTARA KANNADA,2021-01-27,11,143,0,154
KARNATAKA,UTTARA KANNADA,2021-01-28,5,1257,146,1408
KARNATAKA,UTTARA KANNADA,2021-01-29,19,1550,103,1672
KARNATAKA,UTTARA KANNADA,2021-01-30,12,1214,65,1291
KARNATAKA,UTTARA KANNADA,2021-01-31,3,945,46,994
KARNATAKA,VIJAYAPURA,2021-01-26,2,402,0,404
KARNATAKA,VIJAYAPURA,2021-01-27,4,868,0,872
KARNATAKA,VIJAYAPURA,2021-01-28,4,840,0,844
KARNATAKA,VIJAYAPURA,2021-01-29,4,1461,0,1465
KARNATAKA,VIJAYAPURA,2021-01-30,4,1020,0,1024
KARNATAKA,VIJAYAPURA,2021-01-31,3,1166,0,1169
KARNATAKA,YADGIR,2021-01-26,1,963,0,964
KARNATAKA,YADGIR,2021-01-27,1,708,0,709
KARNATAKA,YADGIR,2021-01-28,1,1070,0,1071
KARNATAKA,YADGIR,2021-01-29,1,931,0,932
KARNATAKA,YADGIR,2021-01-30,2,937,0,939
KARNATAKA,YADGIR,2021-01-31,3,762,0,765
KERALA,ALAPPUZHA,2021-01-26,429,2210,3,2642
KERALA,ALAPPUZHA,2021-01-27,445,3018,9,3472
KERALA,ALAPPUZHA,2021-01-28,465,2942,6,3413
KERALA,ALAPPUZHA,2021-01-29,601,3213,3,3817
KERALA,ALAPPUZHA,2021-01-30,385,3098,3,3486
KERALA,ALAPPUZHA,2021-01-31,282,1576,1,1859
KERALA,ERNAKULAM,2021-01-26,975,3698,30,4703
KERALA,ERNAKULAM,2021-01-27,863,5523,11,6397
KERALA,ERNAKULAM,2021-01-28,1068,6298,13,7379
KERALA,ERNAKULAM,2021-01-29,988,5502,4,6494
KERALA,ERNAKULAM,2021-01-30,1072,5979,59,7110
KERALA,ERNAKULAM,2021-01-31,364,2577,13,2954
KERALA,IDUKKI,2021-01-26,362,1675,17,2054
KERALA,IDUKKI,2021-01-27,267,1383,20,1670
KERALA,IDUKKI,2021-01-28,362,2211,7,2580
KERALA,IDUKKI,2021-01-29,233,2004,4,2241
KERALA,IDUKKI,2021-01-30,219,1856,7,2082
KERALA,IDUKKI,2021-01-31,111,1059,8,1178
KERALA,KANNUR,2021-01-26,367,2412,1,2780
KERALA,KANNUR,2021-01-27,342,2587,1,2930
KERALA,KANNUR,2021-01-28,380,2181,3,2564
KERALA,KANNUR,2021-01-29,385,2471,8,2864
KERALA,KANNUR,2021-01-30,375,2379,1,2755
KERALA,KANNUR,2021-01-31,153,1191,2,1346
KERALA,KASARAGOD,2021-01-26,102,1393,0,1495
KERALA,KASARAGOD,2021-01-27,116,1573,1,1690
KERALA,KASARAGOD,2021-01-28,139,1401,0,1540
KERALA,KASARAGOD,2021-01-29,112,1394,16,1522
KERALA,KASARAGOD,2021-01-30,94,1402,1,1497
KERALA,KASARAGOD,2021-01-31,45,1055,10,1110
KERALA,KOLLAM,2021-01-26,484,3632,0,4116
KERALA,KOLLAM,2021-01-27,686,4594,0,5280
KERALA,KOLLAM,2021-01-28,664,4882,0,5546
KERALA,KOLLAM,2021-01-29,941,4944,0,5885
KERALA,KOLLAM,2021-01-30,658,4637,0,5295
KERALA,KOLLAM,2021-01-31,243,2380,0,2623
KERALA,KOTTAYAM,2021-01-26,551,2505,13,3069
KERALA,KOTTAYAM,2021-01-27,601,3515,4,4120
KERALA,KOTTAYAM,2021-01-28,654,3657,11,4322
KERALA,KOTTAYAM,2021-01-29,602,3299,9,3910
KERALA,KOTTAYAM,2021-01-30,662,3628,14,4304
KERALA,KOTTAYAM,2021-01-31,287,1325,9,1621
KERALA,KOZHIKODE,2021-01-26,821,3993,34,4848
KERALA,KOZHIKODE,2021-01-27,713,4255,42,5010
KERALA,KOZHIKODE,2021-01-28,813,4295,26,5134
KERALA,KOZHIKODE,2021-01-29,862,4757,36,5655
KERALA,KOZHIKODE,2021-01-30,934,4870,55,5859
KERALA,KOZHIKODE,2021-01-31,552,2506,20,3078
KERALA,MALAPPURAM,2021-01-26,440,2932,6,3378
KERALA,MALAPPURAM,2021-01-27,432,3152,1,3585
KERALA,MALAPPURAM,2021-01-28,411,3205,1,3617
KERALA,MALAPPURAM,2021-01-29,432,3163,7,3602
KERALA,MALAPPURAM,2021-01-30,483,3597,2,4082
KERALA,MALAPPURAM,2021-01-31,372,1497,0,1869
KERALA,PALAKKAD,2021-01-26,259,2396,1,2656
KERALA,PALAKKAD,2021-01-27,284,2484,0,2768
KERALA,PALAKKAD,2021-01-28,247,2369,2,2618
KERALA,PALAKKAD,2021-01-29,307,2798,1,3106
KERALA,PALAKKAD,2021-01-30,288,2872,2,3162
KERALA,PALAKKAD,2021-01-31,162,1090,0,1252
KERALA,PATHANAMTHITTA,2021-01-26,440,2605,5,3050
KERALA,PATHANAMTHITTA,2021-01-27,407,2981,1,3389
KERALA,PATHANAMTHITTA,2021-01-28,563,2923,5,3491
KERALA,PATHANAMTHITTA,2021-01-29,599,3018,5,3622
KERALA,PATHANAMTHITTA,2021-01-30,599,2514,6,3119
KERALA,PATHANAMTHITTA,2021-01-31,133,805,4,942
KERALA,THIRUVANANTHAPURAM,2021-01-26,431,3699,0,4130
KERALA,THIRUVANANTHAPURAM,2021-01-27,567,4308,2,4877
KERALA,THIRUVANANTHAPURAM,2021-01-28,488,5207,0,5695
KERALA,THIRUVANANTHAPURAM,2021-01-29,545,5068,1,5614
KERALA,THIRUVANANTHAPURAM,2021-01-30,425,4217,1,4643
KERALA,THIRUVANANTHAPURAM,2021-01-31,328,2537,2,2867
KERALA,THRISSUR,2021-01-26,446,2712,0,3158
KERALA,THRISSUR,2021-01-27,503,3175,0,3678
KERALA,THRISSUR,2021-01-28,478,3936,1,4415
KERALA,THRISSUR,2021-01-29,678,3654,1,4333
KERALA,THRISSUR,2021-01-30,524,3239,0,3763
KERALA,THRISSUR,2021-01-31,266,1586,0,1852
KERALA,WAYANAD,2021-01-26,259,1164,6,1429
KERALA,WAYANAD,2021-01-27,231,1326,2,1559
KERALA,WAYANAD,2021-01-28,236,1410,3,1649
KERALA,WAYANAD,2021-01-29,208,1159,5,1372
KERALA,WAYANAD,2021-01-30,233,1269,5,1507
KERALA,WAYANAD,2021-01-31,121,951,0,1072
LADAKH,KARGIL,2021-01-26,0,62,0,62
LADAKH,KARGIL,2021-01-27,0,49,0,49
LADAKH,KARGIL,2021-01-28,0,60,0,60
LADAKH,KARGIL,2021-01-29,0,59,0,59
LADAKH,KARGIL,2021-01-30,0,26,0,26
LADAKH,KARGIL,2021-01-31,0,51,0,51
LADAKH,LEH LADAKH,2021-01-26,0,124,0,124
LADAKH,LEH LADAKH,2021-01-27,1,147,0,148
LADAKH,LEH LADAKH,2021-01-28,15,186,2,203
LADAKH,LEH LADAKH,2021-01-29,8,155,0,163
LADAKH,LEH LADAKH,2021-01-30,5,132,0,137
LADAKH,LEH LADAKH,2021-01-31,1,126,0,127
LAKSHADWEEP,LAKSHADWEEP DISTRICT,2021-01-26,0,57,0,57
LAKSHADWEEP,LAKSHADWEEP DISTRICT,2021-01-27,0,107,0,107
LAKSHADWEEP,LAKSHADWEEP DISTRICT,2021-01-28,0,101,0,101
LAKSHADWEEP,LAKSHADWEEP DISTRICT,2021-01-29,0,186,0,186
LAKSHADWEEP,LAKSHADWEEP DISTRICT,2021-01-30,1,191,0,192
LAKSHADWEEP,LAKSHADWEEP DISTRICT,2021-01-31,2,295,0,297
MADHYA PRADESH,AGAR MALWA,2021-01-26,0,172,0,172
MADHYA PRADESH,AGAR MALWA,2021-01-27,0,101,0,101
MADHYA PRADESH,AGAR MALWA,2021-01-28,0,280,0,280
MADHYA PRADESH,AGAR MALWA,2021-01-29,0,223,0,223
MADHYA PRADESH,AGAR MALWA,2021-01-30,0,117,0,117
MADHYA PRADESH,AGAR MALWA,2021-01-31,4,86,0,90
MADHYA PRADESH,ALIRAJPUR,2021-01-26,2,125,0,127
MADHYA PRADESH,ALIRAJPUR,2021-01-27,0,216,0,216
MADHYA PRADESH,ALIRAJPUR,2021-01-28,0,240,0,240
MADHYA PRADESH,ALIRAJPUR,2021-01-29,0,268,0,268
MADHYA PRADESH,ALIRAJPUR,2021-01-30,0,61,0,61
MADHYA PRADESH,ALIRAJPUR,2021-01-31,0,53,3,56
MADHYA PRADESH,ANUPPUR,2021-01-26,2,11,0,13
MADHYA PRADESH,ANUPPUR,2021-01-27,0,62,1,63
MADHYA PRADESH,ANUPPUR,2021-01-28,3,64,2,69
MADHYA PRADESH,ANUPPUR,2021-01-29,0,40,0,40
MADHYA PRADESH,ANUPPUR,2021-01-30,1,125,1,127
MADHYA PRADESH,ANUPPUR,2021-01-31,0,142,7,149
MADHYA PRADESH,ASHOKNAGAR,2021-01-26,0,55,0,55
MADHYA PRADESH,ASHOKNAGAR,2021-01-27,0,63,0,63
MADHYA PRADESH,ASHOKNAGAR,2021-01-28,1,41,0,42
MADHYA PRADESH,ASHOKNAGAR,2021-01-29,0,77,0,77
MADHYA PRADESH,ASHOKNAGAR,2021-01-30,0,112,0,112
MADHYA PRADESH,ASHOKNAGAR,2021-01-31,0,12,0,12
MADHYA PRADESH,BALAGHAT,2021-01-26,2,243,0,245
MADHYA PRADESH,BALAGHAT,2021-01-27,9,678,1,688
MADHYA PRADESH,BALAGHAT,2021-01-28,6,341,1,348
MADHYA PRADESH,BALAGHAT,2021-01-29,5,483,2,490
MADHYA PRADESH,BALAGHAT,2021-01-30,1,250,0,251
MADHYA PRADESH,BALAGHAT,2021-01-31,0,404,1,405
MADHYA PRADESH,BARWANI,2021-01-26,1,345,0,346
MADHYA PRADESH,BARWANI,2021-01-27,2,329,0,331
MADHYA PRADESH,BARWANI,2021-01-28,4,226,0,230
MADHYA PRADESH,BARWANI,2021-01-29,4,215,0,219
MADHYA PRADESH,BARWANI,2021-01-30,3,179,0,182
MADHYA PRADESH,BARWANI,2021-01-31,0,51,1,52
MADHYA PRADESH,BETUL,2021-01-26,2,200,0,202
MADHYA PRADESH,BETUL,2021-01-27,8,372,0,380
MADHYA PRADESH,BETUL,2021-01-28,4,217,1,222
MADHYA PRADESH,BETUL,2021-01-29,8,309,0,317
MADHYA PRADESH,BETUL,2021-01-30,4,238,0,242
MADHYA PRADESH,BETUL,2021-01-31,2,211,0,213
MADHYA PRADESH,BHIND,2021-01-26,0,295,0,295
MADHYA PRADESH,BHIND,2021-01-27,3,439,0,442
MADHYA PRADESH,BHIND,2021-01-28,1,224,0,225
MADHYA PRADESH,BHIND,2021-01-29,0,242,0,242
MADHYA PRADESH,BHIND,2021-01-30,0,371,0,371
MADHYA PRADESH,BHIND,2021-01-31,1,92,0,93
MADHYA PRADESH,BHOPAL,2021-01-26,60,1285,25,1370
MADHYA PRADESH,BHOPAL,2021-01-27,49,1461,10,1520
MADHYA PRADESH,BHOPAL,2021-01-28,70,1691,6,1767
MADHYA PRADESH,BHOPAL,2021-01-29,72,1591,11,1674
MADHYA PRADESH,BHOPAL,2021-01-30,76,1666,14,1756
MADHYA PRADESH,BHOPAL,2021-01-31,61,1119,4,1184
MADHYA PRADESH,BURHANPUR,2021-01-26,3,89,0,92
MADHYA PRADESH,BURHANPUR,2021-01-27,3,254,1,258
MADHYA PRADESH,BURHANPUR,2021-01-28,0,196,0,196
MADHYA PRADESH,BURHANPUR,2021-01-29,0,124,0,124
MADHYA PRADESH,BURHANPUR,2021-01-30,0,215,0,215
MADHYA PRADESH,BURHANPUR,2021-01-31,0,245,0,245
MADHYA PRADESH,CHHATARPUR,2021-01-26,3,84,0,87
MADHYA PRADESH,CHHATARPUR,2021-01-27,3,287,0,290
MADHYA PRADESH,CHHATARPUR,2021-01-28,1,216,0,217
MADHYA PRADESH,CHHATARPUR,2021-01-29,0,217,0,217
MADHYA PRADESH,CHHATARPUR,2021-01-30,2,208,0,210
MADHYA PRADESH,CHHATARPUR,2021-01-31,1,128,0,129
MADHYA PRADESH,CHHINDWARA,2021-01-26,3,344,3,350
MADHYA PRADESH,CHHINDWARA,2021-01-27,10,460,1,471
MADHYA PRADESH,CHHINDWARA,2021-01-28,7,356,1,364
MADHYA PRADESH,CHHINDWARA,2021-01-29,11,438,138,587
MADHYA PRADESH,CHHINDWARA,2021-01-30,5,289,93,387
MADHYA PRADESH,CHHINDWARA,2021-01-31,7,182,0,189
MADHYA PRADESH,DAMOH,2021-01-26,1,34,0,35
MADHYA PRADESH,DAMOH,2021-01-27,1,217,0,218
MADHYA PRADESH,DAMOH,2021-01-28,2,322,0,324
MADHYA PRADESH,DAMOH,2021-01-29,1,143,0,144
MADHYA PRADESH,DAMOH,2021-01-30,2,248,0,250
MADHYA PRADESH,DAMOH,2021-01-31,2,56,0,58
MADHYA PRADESH,DATIA,2021-01-26,0,171,3,174
MADHYA PRADESH,DATIA,2021-01-27,1,129,5,135
MADHYA PRADESH,DATIA,2021-01-28,0,147,0,147
MADHYA PRADESH,DATIA,2021-01-29,1,231,0,232
MADHYA PRADESH,DATIA,2021-01-30,2,143,0,145
MADHYA PRADESH,DATIA,2021-01-31,0,100,6,106
MADHYA PRADESH,DEWAS,2021-01-26,5,69,0,74
MADHYA PRADESH,DEWAS,2021-01-27,7,171,0,178
MADHYA PRADESH,DEWAS,2021-01-28,21,1108,0,1129
MADHYA PRADESH,DEWAS,2021-01-29,0,450,0,450
MADHYA PRADESH,DEWAS,2021-01-30,13,711,0,724
MADHYA PRADESH,DEWAS,2021-01-31,2,55,0,57
MADHYA PRADESH,DHAR,2021-01-26,8,141,0,149
MADHYA PRADESH,DHAR,2021-01-27,2,243,0,245
MADHYA PRADESH,DHAR,2021-01-28,2,242,0,244
MADHYA PRADESH,DHAR,2021-01-29,6,294,0,300
MADHYA PRADESH,DHAR,2021-01-30,10,200,0,210
MADHYA PRADESH,DHAR,2021-01-31,1,38,1,40
MADHYA PRADESH,DINDORI,2021-01-26,0,122,0,122
MADHYA PRADESH,DINDORI,2021-01-27,2,534,0,536
MADHYA PRADESH,DINDORI,2021-01-28,2,344,0,346
MADHYA PRADESH,DINDORI,2021-01-29,3,90,0,93
MADHYA PRADESH,DINDORI,2021-01-30,2,278,0,280
MADHYA PRADESH,DINDORI,2021-01-31,3,185,0,188
MADHYA PRADESH,EAST NIMAR,2021-01-26,2,272,1,275
MADHYA PRADESH,EAST NIMAR,2021-01-27,5,311,0,316
MADHYA PRADESH,EAST NIMAR,2021-01-28,2,449,11,462
MADHYA PRADESH,EAST NIMAR,2021-01-29,0,213,1,214
MADHYA PRADESH,EAST NIMAR,2021-01-30,1,387,1,389
MADHYA PRADESH,EAST NIMAR,2021-01-31,2,226,0,228
MADHYA PRADESH,GUNA,2021-01-26,2,196,0,198
MADHYA PRADESH,GUNA,2021-01-27,2,224,0,226
MADHYA PRADESH,GUNA,2021-01-28,0,275,0,275
MADHYA PRADESH,GUNA,2021-01-29,2,239,0,241
MADHYA PRADESH,GUNA,2021-01-30,0,241,0,241
MADHYA PRADESH,GUNA,2021-01-31,1,183,0,184
MADHYA PRADESH,GWALIOR,2021-01-26,5,796,2,803
MADHYA PRADESH,GWALIOR,2021-01-27,11,1270,0,1281
MADHYA PRADESH,GWALIOR,2021-01-28,13,1195,1,1209
MADHYA PRADESH,GWALIOR,2021-01-29,8,1326,1,1335
MADHYA PRADESH,GWALIOR,2021-01-30,16,1385,0,1401
MADHYA PRADESH,GWALIOR,2021-01-31,3,860,1,864
MADHYA PRADESH,HARDA,2021-01-26,0,228,0,228
MADHYA PRADESH,HARDA,2021-01-27,5,286,0,291
MADHYA PRADESH,HARDA,2021-01-28,0,138,0,138
MADHYA PRADESH,HARDA,2021-01-29,8,219,1,228
MADHYA PRADESH,HARDA,2021-01-30,0,232,0,232
MADHYA PRADESH,HARDA,2021-01-31,1,223,0,224
MADHYA PRADESH,HOSHANGABAD,2021-01-26,5,248,0,253
MADHYA PRADESH,HOSHANGABAD,2021-01-27,4,306,1,311
MADHYA PRADESH,HOSHANGABAD,2021-01-28,2,295,0,297
MADHYA PRADESH,HOSHANGABAD,2021-01-29,5,279,0,284
MADHYA PRADESH,HOSHANGABAD,2021-01-30,3,218,1,222
MADHYA PRADESH,HOSHANGABAD,2021-01-31,0,151,0,151
MADHYA PRADESH,INDORE,2021-01-26,19,1172,5,1196
MADHYA PRADESH,INDORE,2021-01-27,41,1771,1,1813
MADHYA PRADESH,INDORE,2021-01-28,40,1731,0,1771
MADHYA PRADESH,INDORE,2021-01-29,33,1974,0,2007
MADHYA PRADESH,INDORE,2021-01-30,55,1869,0,1924
MADHYA PRADESH,INDORE,2021-01-31,44,1298,0,1342
MADHYA PRADESH,JABALPUR,2021-01-26,12,304,0,316
MADHYA PRADESH,JABALPUR,2021-01-27,13,402,1,416
MADHYA PRADESH,JABALPUR,2021-01-28,13,477,1,491
MADHYA PRADESH,JABALPUR,2021-01-29,8,218,0,226
MADHYA PRADESH,JABALPUR,2021-01-30,10,462,4,476
MADHYA PRADESH,JABALPUR,2021-01-31,10,413,0,423
MADHYA PRADESH,JHABUA,2021-01-26,1,146,0,147
MADHYA PRADESH,JHABUA,2021-01-27,3,399,0,402
MADHYA PRADESH,JHABUA,2021-01-28,3,415,0,418
MADHYA PRADESH,JHABUA,2021-01-29,1,212,0,213
MADHYA PRADESH,JHABUA,2021-01-30,3,228,0,231
MADHYA PRADESH,JHABUA,2021-01-31,2,76,0,78
MADHYA PRADESH,KATNI,2021-01-26,0,8,0,8
MADHYA PRADESH,KATNI,2021-01-27,2,284,0,286
MADHYA PRADESH,KATNI,2021-01-28,0,98,2,100
MADHYA PRADESH,KATNI,2021-01-29,1,226,2,229
MADHYA PRADESH,KATNI,2021-01-30,1,125,0,126
MADHYA PRADESH,KATNI,2021-01-31,1,262,2,265
MADHYA PRADESH,KHARGONE,2021-01-26,1,236,0,237
MADHYA PRADESH,KHARGONE,2021-01-27,4,362,0,366
MADHYA PRADESH,KHARGONE,2021-01-28,4,180,0,184
MADHYA PRADESH,KHARGONE,2021-01-29,2,382,0,384
MADHYA PRADESH,KHARGONE,2021-01-30,1,311,0,312
MADHYA PRADESH,KHARGONE,2021-01-31,4,164,0,168
MADHYA PRADESH,MANDLA,2021-01-26,1,57,0,58
MADHYA PRADESH,MANDLA,2021-01-27,0,266,1,267
MADHYA PRADESH,MANDLA,2021-01-28,0,534,0,534
MADHYA PRADESH,MANDLA,2021-01-29,0,380,0,380
MADHYA PRADESH,MANDLA,2021-01-30,0,368,3,371
MADHYA PRADESH,MANDLA,2021-01-31,0,62,0,62
MADHYA PRADESH,MANDSAUR,2021-01-26,3,153,7,163
MADHYA PRADESH,MANDSAUR,2021-01-27,3,152,1,156
MADHYA PRADESH,MANDSAUR,2021-01-28,0,150,0,150
MADHYA PRADESH,MANDSAUR,2021-01-29,3,212,0,215
MADHYA PRADESH,MANDSAUR,2021-01-30,2,214,0,216
MADHYA PRADESH,MANDSAUR,2021-01-31,1,112,8,121
MADHYA PRADESH,MORENA,2021-01-26,0,172,0,172
MADHYA PRADESH,MORENA,2021-01-27,0,258,3,261
MADHYA PRADESH,MORENA,2021-01-28,0,388,1,389
MADHYA PRADESH,MORENA,2021-01-29,2,300,0,302
MADHYA PRADESH,MORENA,2021-01-30,0,419,0,419
MADHYA PRADESH,MORENA,2021-01-31,1,304,0,305
MADHYA PRADESH,NARSINGHPUR,2021-01-26,2,64,0,66
MADHYA PRADESH,NARSINGHPUR,2021-01-27,0,501,0,501
MADHYA PRADESH,NARSINGHPUR,2021-01-28,0,412,0,412
MADHYA PRADESH,NARSINGHPUR,2021-01-29,2,422,0,424
MADHYA PRADESH,NARSINGHPUR,2021-01-30,2,348,0,350
MADHYA PRADESH,NARSINGHPUR,2021-01-31,1,94,0,95
MADHYA PRADESH,NEEMUCH,2021-01-26,3,49,0,52
MADHYA PRADESH,NEEMUCH,2021-01-27,0,120,0,120
MADHYA PRADESH,NEEMUCH,2021-01-28,2,236,1,239
MADHYA PRADESH,NEEMUCH,2021-01-29,0,124,1,125
MADHYA PRADESH,NEEMUCH,2021-01-30,4,211,2,217
MADHYA PRADESH,NEEMUCH,2021-01-31,1,35,1,37
MADHYA PRADESH,NIWARI,2021-01-26,1,143,0,144
MADHYA PRADESH,NIWARI,2021-01-27,1,66,0,67
MADHYA PRADESH,NIWARI,2021-01-28,0,137,0,137
MADHYA PRADESH,NIWARI,2021-01-29,1,40,0,41
MADHYA PRADESH,NIWARI,2021-01-30,1,74,0,75
MADHYA PRADESH,NIWARI,2021-01-31,0,43,0,43
MADHYA PRADESH,PANNA,2021-01-26,3,61,0,64
MADHYA PRADESH,PANNA,2021-01-27,0,50,0,50
MADHYA PRADESH,PANNA,2021-01-28,1,40,0,41
MADHYA PRADESH,PANNA,2021-01-29,1,65,0,66
MADHYA PRADESH,PANNA,2021-01-30,3,215,0,218
MADHYA PRADESH,PANNA,2021-01-31,1,10,0,11
MADHYA PRADESH,RAISEN,2021-01-26,1,69,1,71
MADHYA PRADESH,RAISEN,2021-01-27,2,115,0,117
MADHYA PRADESH,RAISEN,2021-01-28,3,206,0,209
MADHYA PRADESH,RAISEN,2021-01-29,1,139,0,140
MADHYA PRADESH,RAISEN,2021-01-30,2,117,0,119
MADHYA PRADESH,RAISEN,2021-01-31,0,20,1,21
MADHYA PRADESH,RAJGARH,2021-01-26,3,128,1,132
MADHYA PRADESH,RAJGARH,2021-01-27,9,308,2,319
MADHYA PRADESH,RAJGARH,2021-01-28,3,141,1,145
MADHYA PRADESH,RAJGARH,2021-01-29,5,130,0,135
MADHYA PRADESH,RAJGARH,2021-01-30,0,157,0,157
MADHYA PRADESH,RAJGARH,2021-01-31,0,200,0,200
MADHYA PRADESH,RATLAM,2021-01-26,5,184,4,193
MADHYA PRADESH,RATLAM,2021-01-27,4,194,4,202
MADHYA PRADESH,RATLAM,2021-01-28,11,188,3,202
MADHYA PRADESH,RATLAM,2021-01-29,6,169,1,176
MADHYA PRADESH,RATLAM,2021-01-30,2,147,0,149
MADHYA PRADESH,RATLAM,2021-01-31,8,124,1,133
MADHYA PRADESH,REWA,2021-01-26,3,613,0,616
MADHYA PRADESH,REWA,2021-01-27,5,521,1,527
MADHYA PRADESH,REWA,2021-01-28,9,524,0,533
MADHYA PRADESH,REWA,2021-01-29,3,575,4,582
MADHYA PRADESH,REWA,2021-01-30,1,556,2,559
MADHYA PRADESH,REWA,2021-01-31,0,523,0,523
MADHYA PRADESH,SAGAR,2021-01-26,7,653,9,669
MADHYA PRADESH,SAGAR,2021-01-27,3,426,0,429
MADHYA PRADESH,SAGAR,2021-01-28,9,891,2,902
MADHYA PRADESH,SAGAR,2021-01-29,4,793,0,797
MADHYA PRADESH,SAGAR,2021-01-30,7,669,0,676
MADHYA PRADESH,SAGAR,2021-01-31,9,766,2,777
MADHYA PRADESH,SATNA,2021-01-26,1,183,0,184
MADHYA PRADESH,SATNA,2021-01-27,6,215,0,221
MADHYA PRADESH,SATNA,2021-01-28,1,298,3,302
MADHYA PRADESH,SATNA,2021-01-29,1,241,0,242
MADHYA PRADESH,SATNA,2021-01-30,1,200,2,203
MADHYA PRADESH,SATNA,2021-01-31,0,199,2,201
MADHYA PRADESH,SEHORE,2021-01-26,1,235,0,236
MADHYA PRADESH,SEHORE,2021-01-27,2,316,0,318
MADHYA PRADESH,SEHORE,2021-01-28,2,258,0,260
MADHYA PRADESH,SEHORE,2021-01-29,2,217,1,220
MADHYA PRADESH,SEHORE,2021-01-30,2,310,0,312
MADHYA PRADESH,SEHORE,2021-01-31,2,167,0,169
MADHYA PRADESH,SEONI,2021-01-26,1,252,2,255
MADHYA PRADESH,SEONI,2021-01-27,0,176,1,177
MADHYA PRADESH,SEONI,2021-01-28,2,268,0,270
MADHYA PRADESH,SEONI,2021-01-29,2,182,3,187
MADHYA PRADESH,SEONI,2021-01-30,4,271,0,275
MADHYA PRADESH,SEONI,2021-01-31,0,103,0,103
MADHYA PRADESH,SHAHDOL,2021-01-26,0,4,1,5
MADHYA PRADESH,SHAHDOL,2021-01-27,1,117,3,121
MADHYA PRADESH,SHAHDOL,2021-01-28,7,72,5,84
MADHYA PRADESH,SHAHDOL,2021-01-29,0,270,5,275
MADHYA PRADESH,SHAHDOL,2021-01-30,1,101,0,102
MADHYA PRADESH,SHAHDOL,2021-01-31,0,2,0,2
MADHYA PRADESH,SHAJAPUR,2021-01-26,1,210,0,211
MADHYA PRADESH,SHAJAPUR,2021-01-27,2,186,0,188
MADHYA PRADESH,SHAJAPUR,2021-01-28,2,246,0,248
MADHYA PRADESH,SHAJAPUR,2021-01-29,1,335,0,336
MADHYA PRADESH,SHAJAPUR,2021-01-30,0,78,0,78
MADHYA PRADESH,SHAJAPUR,2021-01-31,0,216,0,216
MADHYA PRADESH,SHEOPUR,2021-01-26,0,51,0,51
MADHYA PRADESH,SHEOPUR,2021-01-27,6,62,0,68
MADHYA PRADESH,SHEOPUR,2021-01-28,4,225,0,229
MADHYA PRADESH,SHEOPUR,2021-01-29,0,53,0,53
MADHYA PRADESH,SHEOPUR,2021-01-30,4,379,0,383
MADHYA PRADESH,SHEOPUR,2021-01-31,2,75,0,77
MADHYA PRADESH,SHIVPURI,2021-01-26,5,172,0,177
MADHYA PRADESH,SHIVPURI,2021-01-27,3,137,0,140
MADHYA PRADESH,SHIVPURI,2021-01-28,1,242,1,244
MADHYA PRADESH,SHIVPURI,2021-01-29,0,191,1,192
MADHYA PRADESH,SHIVPURI,2021-01-30,4,221,1,226
MADHYA PRADESH,SHIVPURI,2021-01-31,1,95,0,96
MADHYA PRADESH,SIDHI,2021-01-26,0,29,0,29
MADHYA PRADESH,SIDHI,2021-01-27,3,107,0,110
MADHYA PRADESH,SIDHI,2021-01-28,0,70,0,70
MADHYA PRADESH,SIDHI,2021-01-29,2,343,0,345
MADHYA PRADESH,SIDHI,2021-01-30,0,108,0,108
MADHYA PRADESH,SIDHI,2021-01-31,0,10,0,10
MADHYA PRADESH,SINGRAULI,2021-01-26,0,6,0,6
MADHYA PRADESH,SINGRAULI,2021-01-27,0,264,0,264
MADHYA PRADESH,SINGRAULI,2021-01-28,2,197,1,200
MADHYA PRADESH,SINGRAULI,2021-01-29,0,201,0,201
MADHYA PRADESH,SINGRAULI,2021-01-30,1,194,0,195
MADHYA PRADESH,SINGRAULI,2021-01-31,0,242,0,242
MADHYA PRADESH,TIKAMGARH,2021-01-26,0,26,0,26
MADHYA PRADESH,TIKAMGARH,2021-01-27,4,333,3,340
MADHYA PRADESH,TIKAMGARH,2021-01-28,0,129,0,129
MADHYA PRADESH,TIKAMGARH,2021-01-29,2,111,0,113
MADHYA PRADESH,TIKAMGARH,2021-01-30,1,237,0,238
MADHYA PRADESH,TIKAMGARH,2021-01-31,0,144,3,147
MADHYA PRADESH,UJJAIN,2021-01-26,3,58,0,61
MADHYA PRADESH,UJJAIN,2021-01-27,7,256,2,265
MADHYA PRADESH,UJJAIN,2021-01-28,16,313,2,331
MADHYA PRADESH,UJJAIN,2021-01-29,9,542,0,551
MADHYA PRADESH,UJJAIN,2021-01-30,6,418,0,424
MADHYA PRADESH,UJJAIN,2021-01-31,3,35,0,38
MADHYA PRADESH,UMARIA,2021-01-26,0,57,0,57
MADHYA PRADESH,UMARIA,2021-01-27,1,227,10,238
MADHYA PRADESH,UMARIA,2021-01-28,2,118,2,122
MADHYA PRADESH,UMARIA,2021-01-29,0,149,10,159
MADHYA PRADESH,UMARIA,2021-01-30,4,114,15,133
MADHYA PRADESH,UMARIA,2021-01-31,0,50,16,66
MADHYA PRADESH,VIDISHA,2021-01-26,1,139,5,145
MADHYA PRADESH,VIDISHA,2021-01-27,2,92,1,95
MADHYA PRADESH,VIDISHA,2021-01-28,0,130,0,130
MADHYA PRADESH,VIDISHA,2021-01-29,3,69,0,72
MADHYA PRADESH,VIDISHA,2021-01-30,1,143,0,144
MADHYA PRADESH,VIDISHA,2021-01-31,2,88,0,90
MAHARASHTRA,AHMEDNAGAR,2021-01-26,122,1937,1,2060
MAHARASHTRA,AHMEDNAGAR,2021-01-27,117,1680,0,1797
MAHARASHTRA,AHMEDNAGAR,2021-01-28,92,1071,0,1163
MAHARASHTRA,AHMEDNAGAR,2021-01-29,82,1218,3,1303
MAHARASHTRA,AHMEDNAGAR,2021-01-30,79,2191,0,2270
MAHARASHTRA,AHMEDNAGAR,2021-01-31,112,1674,22,1808
MAHARASHTRA,AKOLA,2021-01-26,28,643,0,671
MAHARASHTRA,AKOLA,2021-01-27,29,327,3,359
MAHARASHTRA,AKOLA,2021-01-28,64,292,3,359
MAHARASHTRA,AKOLA,2021-01-29,39,290,3,332
MAHARASHTRA,AKOLA,2021-01-30,45,214,0,259
MAHARASHTRA,AKOLA,2021-01-31,49,158,0,207
MAHARASHTRA,AMRAVATI,2021-01-26,83,456,0,539
MAHARASHTRA,AMRAVATI,2021-01-27,99,1245,0,1344
MAHARASHTRA,AMRAVATI,2021-01-28,133,998,1,1132
MAHARASHTRA,AMRAVATI,2021-01-29,152,868,3,1023
MAHARASHTRA,AMRAVATI,2021-01-30,137,663,2,802
MAHARASHTRA,AMRAVATI,2021-01-31,102,610,1,713
MAHARASHTRA,AURANGABAD,2021-01-26,45,1385,0,1430
MAHARASHTRA,AURANGABAD,2021-01-27,36,797,1,834
MAHARASHTRA,AURANGABAD,2021-01-28,60,1382,2,1444
MAHARASHTRA,AURANGABAD,2021-01-29,29,1091,1,1121
MAHARASHTRA,AURANGABAD,2021-01-30,28,305,0,333
MAHARASHTRA,AURANGABAD,2021-01-31,30,474,10,514
MAHARASHTRA,BEED,2021-01-26,45,846,0,891
MAHARASHTRA,BEED,2021-01-27,31,614,0,645
MAHARASHTRA,BEED,2021-01-28,47,950,0,997
MAHARASHTRA,BEED,2021-01-29,29,697,0,726
MAHARASHTRA,BEED,2021-01-30,33,492,0,525
MAHARASHTRA,BEED,2021-01-31,25,513,2,540
MAHARASHTRA,BHANDARA,2021-01-26,16,426,2,444
MAHARASHTRA,BHANDARA,2021-01-27,21,206,2,229
MAHARASHTRA,BHANDARA,2021-01-28,25,605,0,630
MAHARASHTRA,BHANDARA,2021-01-29,10,649,0,659
MAHARASHTRA,BHANDARA,2021-01-30,9,415,0,424
MAHARASHTRA,BHANDARA,2021-01-31,11,347,0,358
MAHARASHTRA,BULDHANA,2021-01-26,38,894,4,936
MAHARASHTRA,BULDHANA,2021-01-27,35,786,5,826
MAHARASHTRA,BULDHANA,2021-01-28,48,915,4,967
MAHARASHTRA,BULDHANA,2021-01-29,60,788,6,854
MAHARASHTRA,BULDHANA,2021-01-30,61,1253,5,1319
MAHARASHTRA,BULDHANA,2021-01-31,28,581,4,613
MAHARASHTRA,CHANDRAPUR,2021-01-26,9,394,1,404
MAHARASHTRA,CHANDRAPUR,2021-01-27,21,733,3,757
MAHARASHTRA,CHANDRAPUR,2021-01-28,20,769,3,792
MAHARASHTRA,CHANDRAPUR,2021-01-29,16,521,1,538
MAHARASHTRA,CHANDRAPUR,2021-01-30,10,511,2,523
MAHARASHTRA,CHANDRAPUR,2021-01-31,6,202,2,210
MAHARASHTRA,DHULE,2021-01-26,8,228,10,246
MAHARASHTRA,DHULE,2021-01-27,8,367,5,380
MAHARASHTRA,DHULE,2021-01-28,5,479,5,489
MAHARASHTRA,DHULE,2021-01-29,9,461,27,497
MAHARASHTRA,DHULE,2021-01-30,18,423,1,442
MAHARASHTRA,DHULE,2021-01-31,2,30,0,32
MAHARASHTRA,GADCHIROLI,2021-01-26,8,343,1,352
MAHARASHTRA,GADCHIROLI,2021-01-27,4,517,1,522
MAHARASHTRA,GADCHIROLI,2021-01-28,5,502,0,507
MAHARASHTRA,GADCHIROLI,2021-01-29,3,354,1,358
MAHARASHTRA,GADCHIROLI,2021-01-30,9,632,1,642
MAHARASHTRA,GADCHIROLI,2021-01-31,6,243,0,249
MAHARASHTRA,GONDIA,2021-01-26,9,72,0,81
MAHARASHTRA,GONDIA,2021-01-27,18,414,0,432
MAHARASHTRA,GONDIA,2021-01-28,1,839,0,840
MAHARASHTRA,GONDIA,2021-01-29,12,955,0,967
MAHARASHTRA,GONDIA,2021-01-30,8,709,0,717
MAHARASHTRA,GONDIA,2021-01-31,9,78,0,87
MAHARASHTRA,HINGOLI,2021-01-26,6,286,1,293
MAHARASHTRA,HINGOLI,2021-01-27,0,821,35,856
MAHARASHTRA,HINGOLI,2021-01-28,7,727,0,734
MAHARASHTRA,HINGOLI,2021-01-29,6,550,0,556
MAHARASHTRA,HINGOLI,2021-01-30,0,458,0,458
MAHARASHTRA,HINGOLI,2021-01-31,12,691,0,703
MAHARASHTRA,JALGAON,2021-01-26,33,2011,2,2046
MAHARASHTRA,JALGAON,2021-01-27,54,1637,0,1691
MAHARASHTRA,JALGAON,2021-01-28,42,1784,0,1826
MAHARASHTRA,JALGAON,2021-01-29,25,1477,0,1502
MAHARASHTRA,JALGAON,2021-01-30,18,1139,3,1160
MAHARASHTRA,JALGAON,2021-01-31,28,816,2,846
MAHARASHTRA,JALNA,2021-01-26,0,255,0,255
MAHARASHTRA,JALNA,2021-01-27,40,338,0,378
MAHARASHTRA,JALNA,2021-01-28,8,356,0,364
MAHARASHTRA,JALNA,2021-01-29,38,613,0,651
MAHARASHTRA,JALNA,2021-01-30,19,429,0,448
MAHARASHTRA,JALNA,2021-01-31,44,140,0,184
MAHARASHTRA,KOLHAPUR,2021-01-26,8,1134,3,1145
MAHARASHTRA,KOLHAPUR,2021-01-27,15,740,2,757
MAHARASHTRA,KOLHAPUR,2021-01-28,28,590,6,624
MAHARASHTRA,KOLHAPUR,2021-01-29,12,1061,2,1075
MAHARASHTRA,KOLHAPUR,2021-01-30,10,924,1,935
MAHARASHTRA,KOLHAPUR,2021-01-31,18,1509,1,1528
MAHARASHTRA,LATUR,2021-01-26,49,1255,5,1309
MAHARASHTRA,LATUR,2021-01-27,47,1238,2,1287
MAHARASHTRA,LATUR,2021-01-28,28,998,7,1033
MAHARASHTRA,LATUR,2021-01-29,51,1018,0,1069
MAHARASHTRA,LATUR,2021-01-30,31,651,2,684
MAHARASHTRA,LATUR,2021-01-31,22,280,3,305
MAHARASHTRA,MUMBAI,2021-01-26,421,10668,15,11104
MAHARASHTRA,MUMBAI,2021-01-27,347,9456,16,9819
MAHARASHTRA,MUMBAI,2021-01-28,489,13052,10,13551
MAHARASHTRA,MUMBAI,2021-01-29,413,13168,27,13608
MAHARASHTRA,MUMBAI,2021-01-30,430,11515,27,11972
MAHARASHTRA,MUMBAI,2021-01-31,323,8833,14,9170
MAHARASHTRA,MUMBAI SUBURBAN,2021-01-26,93,2279,0,2372
MAHARASHTRA,MUMBAI SUBURBAN,2021-01-27,112,2322,5,2439
MAHARASHTRA,MUMBAI SUBURBAN,2021-01-28,106,2969,7,3082
MAHARASHTRA,MUMBAI SUBURBAN,2021-01-29,79,3076,6,3161
MAHARASHTRA,MUMBAI SUBURBAN,2021-01-30,134,2609,2,2745
MAHARASHTRA,MUMBAI SUBURBAN,2021-01-31,66,2004,2,2072
MAHARASHTRA,NAGPUR,2021-01-26,163,1671,1,1835
MAHARASHTRA,NAGPUR,2021-01-27,323,3787,28,4138
MAHARASHTRA,NAGPUR,2021-01-28,339,3056,39,3434
MAHARASHTRA,NAGPUR,2021-01-29,359,3083,23,3465
MAHARASHTRA,NAGPUR,2021-01-30,287,3214,17,3518
MAHARASHTRA,NAGPUR,2021-01-31,218,1358,15,1591
MAHARASHTRA,NANDED,2021-01-26,58,1381,44,1483
MAHARASHTRA,NANDED,2021-01-27,32,1203,4,1239
MAHARASHTRA,NANDED,2021-01-28,31,827,4,862
MAHARASHTRA,NANDED,2021-01-29,31,843,5,879
MAHARASHTRA,NANDED,2021-01-30,51,1246,13,1310
MAHARASHTRA,NANDED,2021-01-31,22,417,2,441
MAHARASHTRA,NANDURBAR,2021-01-26,34,27,0,61
MAHARASHTRA,NANDURBAR,2021-01-27,20,426,0,446
MAHARASHTRA,NANDURBAR,2021-01-28,18,395,0,413
MAHARASHTRA,NANDURBAR,2021-01-29,16,295,5,316
MAHARASHTRA,NANDURBAR,2021-01-30,41,250,0,291
MAHARASHTRA,NANDURBAR,2021-01-31,22,208,0,230
MAHARASHTRA,NASHIK,2021-01-26,106,2027,7,2140
MAHARASHTRA,NASHIK,2021-01-27,242,2496,0,2738
MAHARASHTRA,NASHIK,2021-01-28,117,992,0,1109
MAHARASHTRA,NASHIK,2021-01-29,105,2065,4,2174
MAHARASHTRA,NASHIK,2021-01-30,65,901,1,967
MAHARASHTRA,NASHIK,2021-01-31,98,893,2,993
MAHARASHTRA,OSMANABAD,2021-01-26,22,135,0,157
MAHARASHTRA,OSMANABAD,2021-01-27,21,343,4,368
MAHARASHTRA,OSMANABAD,2021-01-28,7,412,2,421
MAHARASHTRA,OSMANABAD,2021-01-29,27,459,2,488
MAHARASHTRA,OSMANABAD,2021-01-30,17,484,0,501
MAHARASHTRA,OSMANABAD,2021-01-31,8,411,2,421
MAHARASHTRA,PALGHAR,2021-01-26,25,403,1,429
MAHARASHTRA,PALGHAR,2021-01-27,33,1339,3,1375
MAHARASHTRA,PALGHAR,2021-01-28,59,1449,2,1510
MAHARASHTRA,PALGHAR,2021-01-29,50,1593,4,1647
MAHARASHTRA,PALGHAR,2021-01-30,44,1358,3,1405
MAHARASHTRA,PALGHAR,2021-01-31,23,425,1,449
MAHARASHTRA,PARBHANI,2021-01-26,5,78,0,83
MAHARASHTRA,PARBHANI,2021-01-27,12,441,1,454
MAHARASHTRA,PARBHANI,2021-01-28,5,224,0,229
MAHARASHTRA,PARBHANI,2021-01-29,5,224,1,230
MAHARASHTRA,PARBHANI,2021-01-30,11,466,0,477
MAHARASHTRA,PARBHANI,2021-01-31,6,462,0,468
MAHARASHTRA,PUNE,2021-01-26,368,4855,36,5259
MAHARASHTRA,PUNE,2021-01-27,613,7498,95,8206
MAHARASHTRA,PUNE,2021-01-28,565,7104,83,7752
MAHARASHTRA,PUNE,2021-01-29,546,7048,126,7720
MAHARASHTRA,PUNE,2021-01-30,448,5747,45,6240
MAHARASHTRA,PUNE,2021-01-31,273,4404,66,4743
MAHARASHTRA,RAIGAD,2021-01-26,55,1244,2,1301
MAHARASHTRA,RAIGAD,2021-01-27,85,1647,2,1734
MAHARASHTRA,RAIGAD,2021-01-28,58,1361,2,1421
MAHARASHTRA,RAIGAD,2021-01-29,66,1259,1,1326
MAHARASHTRA,RAIGAD,2021-01-30,64,1659,0,1723
MAHARASHTRA,RAIGAD,2021-01-31,36,1320,1,1357
MAHARASHTRA,RATNAGIRI,2021-01-26,5,83,0,88
MAHARASHTRA,RATNAGIRI,2021-01-27,3,186,1,190
MAHARASHTRA,RATNAGIRI,2021-01-28,2,182,0,184
MAHARASHTRA,RATNAGIRI,2021-01-29,5,201,0,206
MAHARASHTRA,RATNAGIRI,2021-01-30,2,171,0,173
MAHARASHTRA,RATNAGIRI,2021-01-31,1,152,0,153
MAHARASHTRA,SANGLI,2021-01-26,16,619,0,635
MAHARASHTRA,SANGLI,2021-01-27,33,1210,1,1244
MAHARASHTRA,SANGLI,2021-01-28,21,853,0,874
MAHARASHTRA,SANGLI,2021-01-29,23,917,0,940
MAHARASHTRA,SANGLI,2021-01-30,18,684,1,703
MAHARASHTRA,SANGLI,2021-01-31,16,286,3,305
MAHARASHTRA,SATARA,2021-01-26,23,215,1,239
MAHARASHTRA,SATARA,2021-01-27,54,456,0,510
MAHARASHTRA,SATARA,2021-01-28,92,479,1,572
MAHARASHTRA,SATARA,2021-01-29,86,688,4,778
MAHARASHTRA,SATARA,2021-01-30,66,1078,8,1152
MAHARASHTRA,SATARA,2021-01-31,66,213,0,279
MAHARASHTRA,SINDHUDURG,2021-01-26,0,163,0,163
MAHARASHTRA,SINDHUDURG,2021-01-27,22,125,0,147
MAHARASHTRA,SINDHUDURG,2021-01-28,19,211,1,231
MAHARASHTRA,SINDHUDURG,2021-01-29,12,313,2,327
MAHARASHTRA,SINDHUDURG,2021-01-30,5,182,1,188
MAHARASHTRA,SINDHUDURG,2021-01-31,9,56,0,65
MAHARASHTRA,SOLAPUR,2021-01-26,79,2937,15,3031
MAHARASHTRA,SOLAPUR,2021-01-27,103,2498,1,2602
MAHARASHTRA,SOLAPUR,2021-01-28,55,1896,29,1980
MAHARASHTRA,SOLAPUR,2021-01-29,89,2133,168,2390
MAHARASHTRA,SOLAPUR,2021-01-30,57,1771,97,1925
MAHARASHTRA,SOLAPUR,2021-01-31,43,1158,2,1203
MAHARASHTRA,THANE,2021-01-26,314,5369,20,5703
MAHARASHTRA,THANE,2021-01-27,375,8498,6,8879
MAHARASHTRA,THANE,2021-01-28,385,10539,11,10935
MAHARASHTRA,THANE,2021-01-29,349,6152,9,6510
MAHARASHTRA,THANE,2021-01-30,326,7328,22,7676
MAHARASHTRA,THANE,2021-01-31,227,4175,4,4406
MAHARASHTRA,WARDHA,2021-01-26,13,154,0,167
MAHARASHTRA,WARDHA,2021-01-27,49,921,4,974
MAHARASHTRA,WARDHA,2021-01-28,37,886,8,931
MAHARASHTRA,WARDHA,2021-01-29,48,580,10,638
MAHARASHTRA,WARDHA,2021-01-30,38,595,7,640
MAHARASHTRA,WARDHA,2021-01-31,27,203,1,231
MAHARASHTRA,WASHIM,2021-01-26,28,523,3,554
MAHARASHTRA,WASHIM,2021-01-27,34,732,2,768
MAHARASHTRA,WASHIM,2021-01-28,17,493,2,512
MAHARASHTRA,WASHIM,2021-01-29,20,482,1,503
MAHARASHTRA,WASHIM,2021-01-30,24,343,1,368
MAHARASHTRA,WASHIM,2021-01-31,15,98,0,113
MAHARASHTRA,YAVATMAL,2021-01-26,76,703,0,779
MAHARASHTRA,YAVATMAL,2021-01-27,27,468,0,495
MAHARASHTRA,YAVATMAL,2021-01-28,54,773,0,827
MAHARASHTRA,YAVATMAL,2021-01-29,102,878,2,982
MAHARASHTRA,YAVATMAL,2021-01-30,61,624,0,685
MAHARASHTRA,YAVATMAL,2021-01-31,45,205,0,250
MANIPUR,BISHNUPUR,2021-01-26,2,45,0,47
MANIPUR,BISHNUPUR,2021-01-27,0,105,0,105
MANIPUR,BISHNUPUR,2021-01-28,1,99,0,100
MANIPUR,BISHNUPUR,2021-01-29,2,108,0,110
MANIPUR,BISHNUPUR,2021-01-30,1,125,0,126
MANIPUR,BISHNUPUR,2021-01-31,3,77,0,80
MANIPUR,CHANDEL,2021-01-26,1,29,0,30
MANIPUR,CHANDEL,2021-01-27,0,37,0,37
MANIPUR,CHANDEL,2021-01-28,0,32,0,32
MANIPUR,CHANDEL,2021-01-29,1,52,0,53
MANIPUR,CHANDEL,2021-01-30,0,23,0,23
MANIPUR,CHANDEL,2021-01-31,0,31,0,31
MANIPUR,CHURACHANDPUR,2021-01-26,0,23,0,23
MANIPUR,CHURACHANDPUR,2021-01-27,2,157,0,159
MANIPUR,CHURACHANDPUR,2021-01-28,1,124,0,125
MANIPUR,CHURACHANDPUR,2021-01-29,1,126,0,127
MANIPUR,CHURACHANDPUR,2021-01-30,5,92,0,97
MANIPUR,CHURACHANDPUR,2021-01-31,2,68,0,70
MANIPUR,IMPHAL EAST,2021-01-26,2,167,0,169
MANIPUR,IMPHAL EAST,2021-01-27,2,163,0,165
MANIPUR,IMPHAL EAST,2021-01-28,2,212,0,214
MANIPUR,IMPHAL EAST,2021-01-29,1,304,0,305
MANIPUR,IMPHAL EAST,2021-01-30,3,188,0,191
MANIPUR,IMPHAL EAST,2021-01-31,2,196,0,198
MANIPUR,IMPHAL WEST,2021-01-26,39,481,1,521
MANIPUR,IMPHAL WEST,2021-01-27,16,639,0,655
MANIPUR,IMPHAL WEST,2021-01-28,16,1052,0,1068
MANIPUR,IMPHAL WEST,2021-01-29,31,766,1,798
MANIPUR,IMPHAL WEST,2021-01-30,12,736,0,748
MANIPUR,IMPHAL WEST,2021-01-31,11,409,0,420
MANIPUR,JIRIBAM,2021-01-26,0,1,0,1
MANIPUR,JIRIBAM,2021-01-27,0,2,0,2
MANIPUR,JIRIBAM,2021-01-28,0,3,0,3
MANIPUR,JIRIBAM,2021-01-29,0,5,0,5
MANIPUR,JIRIBAM,2021-01-31,0,5,0,5
MANIPUR,KAKCHING,2021-01-26,0,34,0,34
MANIPUR,KAKCHING,2021-01-27,0,47,0,47
MANIPUR,KAKCHING,2021-01-28,2,41,0,43
MANIPUR,KAKCHING,2021-01-29,0,69,0,69
MANIPUR,KAKCHING,2021-01-30,9,93,0,102
MANIPUR,KAKCHING,2021-01-31,3,68,0,71
MANIPUR,KAMJONG,2021-01-26,0,17,0,17
MANIPUR,KAMJONG,2021-01-27,0,8,0,8
MANIPUR,KAMJONG,2021-01-28,0,8,0,8
MANIPUR,KAMJONG,2021-01-29,0,14,0,14
MANIPUR,KAMJONG,2021-01-30,0,42,0,42
MANIPUR,KAMJONG,2021-01-31,0,5,0,5
MANIPUR,KANGPOKPI,2021-01-26,0,24,0,24
MANIPUR,KANGPOKPI,2021-01-27,0,33,0,33
MANIPUR,KANGPOKPI,2021-01-28,0,24,0,24
MANIPUR,KANGPOKPI,2021-01-29,0,27,0,27
MANIPUR,KANGPOKPI,2021-01-30,1,25,0,26
MANIPUR,KANGPOKPI,2021-01-31,0,38,0,38
MANIPUR,NONEY,2021-01-26,0,2,0,2
MANIPUR,NONEY,2021-01-28,0,4,0,4
MANIPUR,NONEY,2021-01-29,0,7,0,7
MANIPUR,NONEY,2021-01-30,0,2,0,2
MANIPUR,NONEY,2021-01-31,0,2,0,2
MANIPUR,SENAPATI,2021-01-26,0,45,0,45
MANIPUR,SENAPATI,2021-01-27,0,37,0,37
MANIPUR,SENAPATI,2021-01-28,0,56,0,56
MANIPUR,SENAPATI,2021-01-29,0,76,0,76
MANIPUR,SENAPATI,2021-01-30,2,99,0,101
MANIPUR,SENAPATI,2021-01-31,0,38,0,38
MANIPUR,TAMENGLONG,2021-01-26,0,22,0,22
MANIPUR,TAMENGLONG,2021-01-27,5,81,0,86
MANIPUR,TAMENGLONG,2021-01-28,2,64,0,66
MANIPUR,TAMENGLONG,2021-01-29,0,47,0,47
MANIPUR,TAMENGLONG,2021-01-30,0,41,0,41
MANIPUR,TAMENGLONG,2021-01-31,0,9,0,9
MANIPUR,TENGNOUPAL,2021-01-26,0,5,0,5
MANIPUR,TENGNOUPAL,2021-01-27,0,1,0,1
MANIPUR,TENGNOUPAL,2021-01-28,0,3,0,3
MANIPUR,TENGNOUPAL,2021-01-29,0,5,0,5
MANIPUR,TENGNOUPAL,2021-01-30,2,39,0,41
MANIPUR,TENGNOUPAL,2021-01-31,0,2,0,2
MANIPUR,THOUBAL,2021-01-26,3,130,0,133
MANIPUR,THOUBAL,2021-01-27,0,67,0,67
MANIPUR,THOUBAL,2021-01-28,9,150,0,159
MANIPUR,THOUBAL,2021-01-29,24,148,0,172
MANIPUR,THOUBAL,2021-01-30,0,202,0,202
MANIPUR,THOUBAL,2021-01-31,5,204,0,209
MANIPUR,UKHRUL,2021-01-26,5,178,0,183
MANIPUR,UKHRUL,2021-01-27,4,148,0,152
MANIPUR,UKHRUL,2021-01-28,4,162,0,166
MANIPUR,UKHRUL,2021-01-29,1,222,0,223
MANIPUR,UKHRUL,2021-01-30,7,191,0,198
MANIPUR,UKHRUL,2021-01-31,9,209,0,218
MEGHALAYA,EAST GARO HILLS,2021-01-26,0,22,0,22
MEGHALAYA,EAST GARO HILLS,2021-01-27,0,46,0,46
MEGHALAYA,EAST GARO HILLS,2021-01-28,0,26,0,26
MEGHALAYA,EAST GARO HILLS,2021-01-29,0,16,0,16
MEGHALAYA,EAST GARO HILLS,2021-01-30,1,22,0,23
MEGHALAYA,EAST GARO HILLS,2021-01-31,0,3,0,3
MEGHALAYA,EAST JAINTIA HILLS,2021-01-26,0,29,0,29
MEGHALAYA,EAST JAINTIA HILLS,2021-01-27,0,138,0,138
MEGHALAYA,EAST JAINTIA HILLS,2021-01-28,0,38,0,38
MEGHALAYA,EAST JAINTIA HILLS,2021-01-29,3,129,0,132
MEGHALAYA,EAST JAINTIA HILLS,2021-01-30,0,36,0,36
MEGHALAYA,EAST JAINTIA HILLS,2021-01-31,0,11,0,11
MEGHALAYA,EAST KHASI HILLS,2021-01-26,1,353,0,354
MEGHALAYA,EAST KHASI HILLS,2021-01-27,12,844,1,857
MEGHALAYA,EAST KHASI HILLS,2021-01-28,1,552,0,553
MEGHALAYA,EAST KHASI HILLS,2021-01-29,10,808,0,818
MEGHALAYA,EAST KHASI HILLS,2021-01-30,4,687,0,691
MEGHALAYA,EAST KHASI HILLS,2021-01-31,0,356,0,356
MEGHALAYA,NORTH GARO HILLS,2021-01-26,0,1,0,1
MEGHALAYA,NORTH GARO HILLS,2021-01-27,0,10,0,10
MEGHALAYA,NORTH GARO HILLS,2021-01-28,0,5,0,5
MEGHALAYA,NORTH GARO HILLS,2021-01-29,0,19,0,19
MEGHALAYA,NORTH GARO HILLS,2021-01-30,0,2,0,2
MEGHALAYA,RI BHOI,2021-01-26,0,14,0,14
MEGHALAYA,RI BHOI,2021-01-27,0,134,0,134
MEGHALAYA,RI BHOI,2021-01-28,0,49,0,49
MEGHALAYA,RI BHOI,2021-01-29,1,120,0,121
MEGHALAYA,RI BHOI,2021-01-30,2,42,0,44
MEGHALAYA,RI BHOI,2021-01-31,0,31,0,31
MEGHALAYA,SOUTH GARO HILLS,2021-01-26,0,2,0,2
MEGHALAYA,SOUTH GARO HILLS,2021-01-27,0,12,0,12
MEGHALAYA,SOUTH GARO HILLS,2021-01-28,0,39,0,39
MEGHALAYA,SOUTH GARO HILLS,2021-01-29,0,24,0,24
MEGHALAYA,SOUTH GARO HILLS,2021-01-30,0,6,0,6
MEGHALAYA,SOUTH GARO HILLS,2021-01-31,0,4,0,4
MEGHALAYA,SOUTH WEST GARO HILLS,2021-01-26,0,5,0,5
MEGHALAYA,SOUTH WEST GARO HILLS,2021-01-27,0,12,0,12
MEGHALAYA,SOUTH WEST GARO HILLS,2021-01-28,0,31,0,31
MEGHALAYA,SOUTH WEST GARO HILLS,2021-01-29,0,22,0,22
MEGHALAYA,SOUTH WEST GARO HILLS,2021-01-30,0,8,0,8
MEGHALAYA,SOUTH WEST GARO HILLS,2021-01-31,0,6,0,6
MEGHALAYA,SOUTH WEST KHASI HILLS,2021-01-27,0,26,0,26
MEGHALAYA,SOUTH WEST KHASI HILLS,2021-01-28,0,6,0,6
MEGHALAYA,SOUTH WEST KHASI HILLS,2021-01-29,0,7,0,7
MEGHALAYA,SOUTH WEST KHASI HILLS,2021-01-30,0,6,0,6
MEGHALAYA,SOUTH WEST KHASI HILLS,2021-01-31,0,15,0,15
MEGHALAYA,WEST GARO HILLS,2021-01-26,0,7,0,7
MEGHALAYA,WEST GARO HILLS,2021-01-27,0,186,0,186
MEGHALAYA,WEST GARO HILLS,2021-01-28,0,213,0,213
MEGHALAYA,WEST GARO HILLS,2021-01-29,0,191,0,191
MEGHALAYA,WEST GARO HILLS,2021-01-30,0,76,0,76
MEGHALAYA,WEST GARO HILLS,2021-01-31,0,23,0,23
MEGHALAYA,WEST JAINTIA HILLS,2021-01-26,0,31,0,31
MEGHALAYA,WEST JAINTIA HILLS,2021-01-27,0,41,0,41
MEGHALAYA,WEST JAINTIA HILLS,2021-01-28,1,47,0,48
MEGHALAYA,WEST JAINTIA HILLS,2021-01-29,0,42,0,42
MEGHALAYA,WEST JAINTIA HILLS,2021-01-30,1,83,1,85
MEGHALAYA,WEST JAINTIA HILLS,2021-01-31,0,26,0,26
MEGHALAYA,WEST KHASI HILLS,2021-01-26,0,56,0,56
MEGHALAYA,WEST KHASI HILLS,2021-01-27,0,83,0,83
MEGHALAYA,WEST KHASI HILLS,2021-01-28,0,91,0,91
MEGHALAYA,WEST KHASI HILLS,2021-01-29,0,46,0,46
MEGHALAYA,WEST KHASI HILLS,2021-01-30,3,85,0,88
MEGHALAYA,WEST KHASI HILLS,2021-01-31,0,11,0,11
MIZORAM,AIZAWL,2021-01-26,4,428,0,432
MIZORAM,AIZAWL,2021-01-27,0,662,0,662
MIZORAM,AIZAWL,2021-01-28,1,654,0,655
MIZORAM,AIZAWL,2021-01-29,2,476,0,478
MIZORAM,AIZAWL,2021-01-30,5,548,1,554
MIZORAM,AIZAWL,2021-01-31,1,121,0,122
MIZORAM,CHAMPHAI,2021-01-26,0,1,0,1
MIZORAM,CHAMPHAI,2021-01-27,1,41,0,42
MIZORAM,CHAMPHAI,2021-01-28,0,8,0,8
MIZORAM,CHAMPHAI,2021-01-29,0,4,0,4
MIZORAM,CHAMPHAI,2021-01-30,0,9,0,9
MIZORAM,CHAMPHAI,2021-01-31,0,1,0,1
MIZORAM,HNAHTHIAL,2021-01-26,0,50,0,50
MIZORAM,HNAHTHIAL,2021-01-27,0,67,0,67
MIZORAM,HNAHTHIAL,2021-01-29,1,27,0,28
MIZORAM,HNAHTHIAL,2021-01-30,0,7,0,7
MIZORAM,KHAWZAWL,2021-01-27,0,4,0,4
MIZORAM,KHAWZAWL,2021-01-29,0,8,0,8
MIZORAM,KOLASIB,2021-01-26,1,85,0,86
MIZORAM,KOLASIB,2021-01-27,0,100,0,100
MIZORAM,KOLASIB,2021-01-28,0,159,0,159
MIZORAM,KOLASIB,2021-01-29,0,140,0,140
MIZORAM,KOLASIB,2021-01-30,2,301,1,304
MIZORAM,KOLASIB,2021-01-31,0,326,0,326
MIZORAM,LAWNGTLAI,2021-01-26,0,1,0,1
MIZORAM,LAWNGTLAI,2021-01-27,0,50,0,50
MIZORAM,LAWNGTLAI,2021-01-28,0,8,0,8
MIZORAM,LAWNGTLAI,2021-01-29,0,49,0,49
MIZORAM,LAWNGTLAI,2021-01-30,0,4,0,4
MIZORAM,LUNGLEI,2021-01-26,0,5,0,5
MIZORAM,LUNGLEI,2021-01-27,0,20,0,20
MIZORAM,LUNGLEI,2021-01-28,2,165,0,167
MIZORAM,LUNGLEI,2021-01-29,0,69,0,69
MIZORAM,LUNGLEI,2021-01-30,0,38,0,38
MIZORAM,LUNGLEI,2021-01-31,0,1,0,1
MIZORAM,MAMIT,2021-01-26,0,37,0,37
MIZORAM,MAMIT,2021-01-27,0,47,0,47
MIZORAM,MAMIT,2021-01-28,0,36,0,36
MIZORAM,MAMIT,2021-01-29,0,52,0,52
MIZORAM,MAMIT,2021-01-30,0,29,0,29
MIZORAM,MAMIT,2021-01-31,0,2,0,2
MIZORAM,SAIHA,2021-01-26,0,15,0,15
MIZORAM,SAIHA,2021-01-27,0,15,0,15
MIZORAM,SAIHA,2021-01-28,0,16,0,16
MIZORAM,SAIHA,2021-01-29,1,27,0,28
MIZORAM,SAIHA,2021-01-31,0,25,0,25
MIZORAM,SAITUAL,2021-01-26,0,31,0,31
MIZORAM,SAITUAL,2021-01-27,0,29,0,29
MIZORAM,SAITUAL,2021-01-28,0,63,0,63
MIZORAM,SAITUAL,2021-01-29,0,23,0,23
MIZORAM,SAITUAL,2021-01-30,0,29,0,29
MIZORAM,SAITUAL,2021-01-31,0,2,0,2
MIZORAM,SERCHHIP,2021-01-26,0,8,0,8
MIZORAM,SERCHHIP,2021-01-27,0,32,0,32
MIZORAM,SERCHHIP,2021-01-28,0,12,0,12
MIZORAM,SERCHHIP,2021-01-29,0,43,0,43
MIZORAM,SERCHHIP,2021-01-30,0,112,0,112
MIZORAM,SERCHHIP,2021-01-31,0,1,0,1
NAGALAND,DIMAPUR,2021-01-26,2,41,0,43
NAGALAND,DIMAPUR,2021-01-27,1,105,0,106
NAGALAND,DIMAPUR,2021-01-28,0,79,0,79
NAGALAND,DIMAPUR,2021-01-29,3,100,0,103
NAGALAND,DIMAPUR,2021-01-30,0,109,0,109
NAGALAND,DIMAPUR,2021-01-31,0,53,0,53
NAGALAND,KIPHIRE,2021-01-26,0,1,0,1
NAGALAND,KIPHIRE,2021-01-29,0,1,0,1
NAGALAND,KIPHIRE,2021-01-30,0,1,0,1
NAGALAND,KOHIMA,2021-01-26,0,5,0,5
NAGALAND,KOHIMA,2021-01-27,0,18,0,18
NAGALAND,KOHIMA,2021-01-28,0,6,0,6
NAGALAND,KOHIMA,2021-01-29,0,20,0,20
NAGALAND,KOHIMA,2021-01-30,0,8,0,8
NAGALAND,KOHIMA,2021-01-31,0,6,0,6
NAGALAND,LONGLENG,2021-01-26,0,1,0,1
NAGALAND,LONGLENG,2021-01-27,0,1,0,1
NAGALAND,LONGLENG,2021-01-28,0,1,0,1
NAGALAND,LONGLENG,2021-01-29,0,3,0,3
NAGALAND,MOKOKCHUNG,2021-01-26,6,20,0,26
NAGALAND,MOKOKCHUNG,2021-01-27,0,15,0,15
NAGALAND,MOKOKCHUNG,2021-01-28,0,8,0,8
NAGALAND,MOKOKCHUNG,2021-01-29,7,70,0,77
NAGALAND,MOKOKCHUNG,2021-01-30,0,17,0,17
NAGALAND,MOKOKCHUNG,2021-01-31,0,7,0,7
NAGALAND,MON,2021-01-26,0,1,0,1
NAGALAND,MON,2021-01-27,0,3,0,3
NAGALAND,MON,2021-01-30,0,3,0,3
NAGALAND,MON,2021-01-31,0,1,0,1
NAGALAND,PEREN,2021-01-27,0,1,0,1
NAGALAND,PEREN,2021-01-29,0,1,0,1
NAGALAND,PEREN,2021-01-30,0,2,0,2
NAGALAND,PHEK,2021-01-27,0,3,0,3
NAGALAND,PHEK,2021-01-28,0,13,0,13
NAGALAND,PHEK,2021-01-29,0,1,0,1
NAGALAND,PHEK,2021-01-30,0,3,0,3
NAGALAND,TUENSANG,2021-01-28,0,1,0,1
NAGALAND,TUENSANG,2021-01-30,0,4,0,4
NAGALAND,WOKHA,2021-01-26,0,1,0,1
NAGALAND,WOKHA,2021-01-27,0,1,0,1
NAGALAND,WOKHA,2021-01-28,0,2,0,2
NAGALAND,WOKHA,2021-01-30,0,5,0,5
NAGALAND,ZUNHEBOTO,2021-01-26,0,1,0,1
NAGALAND,ZUNHEBOTO,2021-01-28,0,1,0,1
NAGALAND,ZUNHEBOTO,2021-01-30,0,1,0,1
ODISHA,ANUGUL,2021-01-26,4,370,0,374
ODISHA,ANUGUL,2021-01-27,13,508,0,521
ODISHA,ANUGUL,2021-01-28,5,457,1,463
ODISHA,ANUGUL,2021-01-29,8,439,0,447
ODISHA,ANUGUL,2021-01-30,6,466,0,472
ODISHA,ANUGUL,2021-01-31,9,252,0,261
ODISHA,BALANGIR,2021-01-26,5,984,0,989
ODISHA,BALANGIR,2021-01-27,0,990,0,990
ODISHA,BALANGIR,2021-01-28,1,898,0,899
ODISHA,BALANGIR,2021-01-29,2,1015,1,1018
ODISHA,BALANGIR,2021-01-30,0,1060,1,1061
ODISHA,BALANGIR,2021-01-31,3,817,0,820
ODISHA,BALESHWAR,2021-01-26,4,3019,0,3023
ODISHA,BALESHWAR,2021-01-27,54,3359,0,3413
ODISHA,BALESHWAR,2021-01-28,5,3627,2,3634
ODISHA,BALESHWAR,2021-01-29,8,3406,0,3414
ODISHA,BALESHWAR,2021-01-30,12,3382,17,3411
ODISHA,BALESHWAR,2021-01-31,2,2590,7,2599
ODISHA,BARGARH,2021-01-26,0,372,0,372
ODISHA,BARGARH,2021-01-27,8,382,0,390
ODISHA,BARGARH,2021-01-28,3,484,0,487
ODISHA,BARGARH,2021-01-29,7,424,1,432
ODISHA,BARGARH,2021-01-30,8,518,0,526
ODISHA,BARGARH,2021-01-31,5,287,0,292
ODISHA,BHADRAK,2021-01-26,4,831,0,835
ODISHA,BHADRAK,2021-01-27,0,869,1,870
ODISHA,BHADRAK,2021-01-28,1,803,3,807
ODISHA,BHADRAK,2021-01-29,0,831,4,835
ODISHA,BHADRAK,2021-01-30,0,647,1,648
ODISHA,BHADRAK,2021-01-31,0,460,4,464
ODISHA,BOUDH,2021-01-26,0,135,0,135
ODISHA,BOUDH,2021-01-27,0,443,0,443
ODISHA,BOUDH,2021-01-28,0,205,0,205
ODISHA,BOUDH,2021-01-29,0,304,0,304
ODISHA,BOUDH,2021-01-30,0,202,0,202
ODISHA,BOUDH,2021-01-31,0,257,0,257
ODISHA,CUTTACK,2021-01-26,11,819,0,830
ODISHA,CUTTACK,2021-01-27,8,1538,0,1546
ODISHA,CUTTACK,2021-01-28,10,1204,0,1214
ODISHA,CUTTACK,2021-01-29,5,1466,0,1471
ODISHA,CUTTACK,2021-01-30,5,1089,0,1094
ODISHA,CUTTACK,2021-01-31,4,421,0,425
ODISHA,DEOGARH,2021-01-26,0,165,0,165
ODISHA,DEOGARH,2021-01-27,0,97,0,97
ODISHA,DEOGARH,2021-01-28,0,160,0,160
ODISHA,DEOGARH,2021-01-29,1,165,0,166
ODISHA,DEOGARH,2021-01-30,1,125,0,126
ODISHA,DEOGARH,2021-01-31,0,132,0,132
ODISHA,DHENKANAL,2021-01-26,0,268,0,268
ODISHA,DHENKANAL,2021-01-27,2,441,0,443
ODISHA,DHENKANAL,2021-01-28,1,302,0,303
ODISHA,DHENKANAL,2021-01-29,0,416,0,416
ODISHA,DHENKANAL,2021-01-30,0,248,0,248
ODISHA,DHENKANAL,2021-01-31,11,187,0,198
ODISHA,GAJAPATI,2021-01-26,1,159,0,160
ODISHA,GAJAPATI,2021-01-27,1,343,0,344
ODISHA,GAJAPATI,2021-01-28,2,348,3,353
ODISHA,GAJAPATI,2021-01-29,0,139,0,139
ODISHA,GAJAPATI,2021-01-30,2,414,0,416
ODISHA,GAJAPATI,2021-01-31,1,10,0,11
ODISHA,GANJAM,2021-01-26,2,869,1,872
ODISHA,GANJAM,2021-01-27,1,844,0,845
ODISHA,GANJAM,2021-01-28,1,976,0,977
ODISHA,GANJAM,2021-01-29,0,801,0,801
ODISHA,GANJAM,2021-01-30,0,796,0,796
ODISHA,GANJAM,2021-01-31,0,578,0,578
ODISHA,JAGATSINGHAPUR,2021-01-26,1,385,0,386
ODISHA,JAGATSINGHAPUR,2021-01-27,0,488,3,491
ODISHA,JAGATSINGHAPUR,2021-01-28,4,616,0,620
ODISHA,JAGATSINGHAPUR,2021-01-29,2,764,0,766
ODISHA,JAGATSINGHAPUR,2021-01-30,0,528,0,528
ODISHA,JAGATSINGHAPUR,2021-01-31,2,287,0,289
ODISHA,JAJAPUR,2021-01-26,1,155,2,158
ODISHA,JAJAPUR,2021-01-27,5,614,0,619
ODISHA,JAJAPUR,2021-01-28,5,804,0,809
ODISHA,JAJAPUR,2021-01-29,7,571,4,582
ODISHA,JAJAPUR,2021-01-30,4,403,0,407
ODISHA,JAJAPUR,2021-01-31,2,92,0,94
ODISHA,JHARSUGUDA,2021-01-26,0,245,0,245
ODISHA,JHARSUGUDA,2021-01-27,3,438,0,441
ODISHA,JHARSUGUDA,2021-01-28,4,261,0,265
ODISHA,JHARSUGUDA,2021-01-29,1,288,1,290
ODISHA,JHARSUGUDA,2021-01-30,0,360,0,360
ODISHA,JHARSUGUDA,2021-01-31,4,219,1,224
ODISHA,KALAHANDI,2021-01-26,0,456,1,457
ODISHA,KALAHANDI,2021-01-27,0,723,0,723
ODISHA,KALAHANDI,2021-01-28,2,711,0,713
ODISHA,KALAHANDI,2021-01-29,1,577,0,578
ODISHA,KALAHANDI,2021-01-30,0,715,0,715
ODISHA,KALAHANDI,2021-01-31,0,363,0,363
ODISHA,KANDHAMAL,2021-01-26,0,741,0,741
ODISHA,KANDHAMAL,2021-01-27,0,801,0,801
ODISHA,KANDHAMAL,2021-01-28,0,790,0,790
ODISHA,KANDHAMAL,2021-01-29,0,626,0,626
ODISHA,KANDHAMAL,2021-01-30,0,698,0,698
ODISHA,KANDHAMAL,2021-01-31,0,625,0,625
ODISHA,KENDRAPARA,2021-01-26,1,681,0,682
ODISHA,KENDRAPARA,2021-01-27,2,982,0,984
ODISHA,KENDRAPARA,2021-01-28,6,1094,0,1100
ODISHA,KENDRAPARA,2021-01-29,1,868,0,869
ODISHA,KENDRAPARA,2021-01-30,1,1004,1,1006
ODISHA,KENDRAPARA,2021-01-31,0,585,0,585
ODISHA,KENDUJHAR,2021-01-26,0,574,0,574
ODISHA,KENDUJHAR,2021-01-27,0,924,1,925
ODISHA,KENDUJHAR,2021-01-28,1,696,0,697
ODISHA,KENDUJHAR,2021-01-29,0,795,0,795
ODISHA,KENDUJHAR,2021-01-30,1,632,0,633
ODISHA,KENDUJHAR,2021-01-31,0,487,0,487
ODISHA,KHORDHA,2021-01-26,11,954,1,966
ODISHA,KHORDHA,2021-01-27,12,1368,8,1388
ODISHA,KHORDHA,2021-01-28,4,1457,2,1463
ODISHA,KHORDHA,2021-01-29,15,1326,4,1345
ODISHA,KHORDHA,2021-01-30,14,1141,4,1159
ODISHA,KHORDHA,2021-01-31,8,813,0,821
ODISHA,KORAPUT,2021-01-26,0,887,0,887
ODISHA,KORAPUT,2021-01-27,1,1184,1,1186
ODISHA,KORAPUT,2021-01-28,1,1167,0,1168
ODISHA,KORAPUT,2021-01-29,0,1185,0,1185
ODISHA,KORAPUT,2021-01-30,1,1084,1,1086
ODISHA,KORAPUT,2021-01-31,0,1085,0,1085
ODISHA,MALKANGIRI,2021-01-26,1,414,0,415
ODISHA,MALKANGIRI,2021-01-27,0,417,0,417
ODISHA,MALKANGIRI,2021-01-28,0,411,0,411
ODISHA,MALKANGIRI,2021-01-29,1,456,0,457
ODISHA,MALKANGIRI,2021-01-30,0,317,0,317
ODISHA,MALKANGIRI,2021-01-31,0,227,0,227
ODISHA,MAYURBHANJ,2021-01-26,3,818,0,821
ODISHA,MAYURBHANJ,2021-01-27,2,950,0,952
ODISHA,MAYURBHANJ,2021-01-28,4,996,0,1000
ODISHA,MAYURBHANJ,2021-01-29,2,1067,0,1069
ODISHA,MAYURBHANJ,2021-01-30,5,981,0,986
ODISHA,MAYURBHANJ,2021-01-31,3,729,0,732
ODISHA,NABARANGPUR,2021-01-26,0,439,0,439
ODISHA,NABARANGPUR,2021-01-27,0,663,0,663
ODISHA,NABARANGPUR,2021-01-28,0,511,0,511
ODISHA,NABARANGPUR,2021-01-29,1,690,0,691
ODISHA,NABARANGPUR,2021-01-30,0,642,0,642
ODISHA,NABARANGPUR,2021-01-31,1,531,0,532
ODISHA,NAYAGARH,2021-01-26,0,533,0,533
ODISHA,NAYAGARH,2021-01-27,0,602,0,602
ODISHA,NAYAGARH,2021-01-28,0,522,0,522
ODISHA,NAYAGARH,2021-01-29,0,598,0,598
ODISHA,NAYAGARH,2021-01-30,0,614,1,615
ODISHA,NAYAGARH,2021-01-31,0,349,0,349
ODISHA,NUAPADA,2021-01-26,14,200,0,214
ODISHA,NUAPADA,2021-01-27,5,166,0,171
ODISHA,NUAPADA,2021-01-28,14,200,0,214
ODISHA,NUAPADA,2021-01-29,10,224,0,234
ODISHA,NUAPADA,2021-01-30,3,234,0,237
ODISHA,NUAPADA,2021-01-31,2,151,0,153
ODISHA,PURI,2021-01-26,2,834,0,836
ODISHA,PURI,2021-01-27,6,822,2,830
ODISHA,PURI,2021-01-28,6,921,5,932
ODISHA,PURI,2021-01-29,2,832,0,834
ODISHA,PURI,2021-01-30,6,1103,0,1109
ODISHA,PURI,2021-01-31,13,834,0,847
ODISHA,RAYAGADA,2021-01-26,1,266,0,267
ODISHA,RAYAGADA,2021-01-27,0,672,0,672
ODISHA,RAYAGADA,2021-01-28,0,640,0,640
ODISHA,RAYAGADA,2021-01-29,3,627,0,630
ODISHA,RAYAGADA,2021-01-30,4,605,0,609
ODISHA,RAYAGADA,2021-01-31,1,145,0,146
ODISHA,SAMBALPUR,2021-01-26,18,518,0,536
ODISHA,SAMBALPUR,2021-01-27,13,564,0,577
ODISHA,SAMBALPUR,2021-01-28,19,558,0,577
ODISHA,SAMBALPUR,2021-01-29,9,577,0,586
ODISHA,SAMBALPUR,2021-01-30,11,526,0,537
ODISHA,SAMBALPUR,2021-01-31,8,304,0,312
ODISHA,SONEPUR,2021-01-26,0,255,0,255
ODISHA,SONEPUR,2021-01-27,0,293,0,293
ODISHA,SONEPUR,2021-01-28,0,277,0,277
ODISHA,SONEPUR,2021-01-29,0,341,0,341
ODISHA,SONEPUR,2021-01-30,0,305,0,305
ODISHA,SONEPUR,2021-01-31,0,211,0,211
ODISHA,SUNDARGARH,2021-01-26,4,288,0,292
ODISHA,SUNDARGARH,2021-01-27,31,772,0,803
ODISHA,SUNDARGARH,2021-01-28,17,1265,0,1282
ODISHA,SUNDARGARH,2021-01-29,19,874,0,893
ODISHA,SUNDARGARH,2021-01-30,20,886,0,906
ODISHA,SUNDARGARH,2021-01-31,7,400,0,407
PUDUCHERRY,KARAIKAL,2021-01-26,0,638,0,638
PUDUCHERRY,KARAIKAL,2021-01-27,2,448,0,450
PUDUCHERRY,KARAIKAL,2021-01-28,3,839,1,843
PUDUCHERRY,KARAIKAL,2021-01-29,9,663,0,672
PUDUCHERRY,KARAIKAL,2021-01-30,6,503,0,509
PUDUCHERRY,KARAIKAL,2021-01-31,1,224,0,225
PUDUCHERRY,MAHE,2021-01-26,2,167,0,169
PUDUCHERRY,MAHE,2021-01-27,16,243,0,259
PUDUCHERRY,MAHE,2021-01-28,10,396,0,406
PUDUCHERRY,MAHE,2021-01-29,3,426,0,429
PUDUCHERRY,MAHE,2021-01-30,6,290,0,296
PUDUCHERRY,MAHE,2021-01-31,4,291,0,295
PUDUCHERRY,PONDICHERRY,2021-01-26,20,406,5,431
PUDUCHERRY,PONDICHERRY,2021-01-27,23,552,3,578
PUDUCHERRY,PONDICHERRY,2021-01-28,28,594,4,626
PUDUCHERRY,PONDICHERRY,2021-01-29,17,578,6,601
PUDUCHERRY,PONDICHERRY,2021-01-30,20,672,5,697
PUDUCHERRY,PONDICHERRY,2021-01-31,14,323,18,355
PUDUCHERRY,YANAM,2021-01-26,0,85,0,85
PUDUCHERRY,YANAM,2021-01-27,2,215,0,217
PUDUCHERRY,YANAM,2021-01-28,0,217,0,217
PUDUCHERRY,YANAM,2021-01-29,0,147,0,147
PUDUCHERRY,YANAM,2021-01-30,0,364,0,364
PUDUCHERRY,YANAM,2021-01-31,1,126,0,127
PUNJAB,AMRITSAR,2021-01-26,18,984,1,1003
PUNJAB,AMRITSAR,2021-01-27,11,1273,4,1288
PUNJAB,AMRITSAR,2021-01-28,29,1534,9,1572
PUNJAB,AMRITSAR,2021-01-29,15,1450,11,1476
PUNJAB,AMRITSAR,2021-01-30,12,1045,4,1061
PUNJAB,AMRITSAR,2021-01-31,14,1036,12,1062
PUNJAB,BARNALA,2021-01-26,1,195,0,196
PUNJAB,BARNALA,2021-01-27,3,158,1,162
PUNJAB,BARNALA,2021-01-28,0,215,1,216
PUNJAB,BARNALA,2021-01-29,2,196,0,198
PUNJAB,BARNALA,2021-01-30,6,191,1,198
PUNJAB,BARNALA,2021-01-31,1,154,3,158
PUNJAB,BATHINDA,2021-01-26,5,963,1,969
PUNJAB,BATHINDA,2021-01-27,25,957,13,995
PUNJAB,BATHINDA,2021-01-28,12,1031,5,1048
PUNJAB,BATHINDA,2021-01-29,11,952,3,966
PUNJAB,BATHINDA,2021-01-30,34,693,3,730
PUNJAB,BATHINDA,2021-01-31,4,594,1,599
PUNJAB,FARIDKOT,2021-01-26,9,238,1,248
PUNJAB,FARIDKOT,2021-01-27,16,247,1,264
PUNJAB,FARIDKOT,2021-01-28,7,260,1,268
PUNJAB,FARIDKOT,2021-01-29,2,261,0,263
PUNJAB,FARIDKOT,2021-01-30,13,241,3,257
PUNJAB,FARIDKOT,2021-01-31,2,205,0,207
PUNJAB,FATEHGARH SAHIB,2021-01-26,3,155,2,160
PUNJAB,FATEHGARH SAHIB,2021-01-27,5,360,0,365
PUNJAB,FATEHGARH SAHIB,2021-01-28,5,311,1,317
PUNJAB,FATEHGARH SAHIB,2021-01-29,0,343,0,343
PUNJAB,FATEHGARH SAHIB,2021-01-30,1,112,0,113
PUNJAB,FATEHGARH SAHIB,2021-01-31,0,292,2,294
PUNJAB,FAZILKA,2021-01-26,0,443,7,450
PUNJAB,FAZILKA,2021-01-27,1,113,0,114
PUNJAB,FAZILKA,2021-01-28,6,199,1,206
PUNJAB,FAZILKA,2021-01-29,4,409,12,425
PUNJAB,FAZILKA,2021-01-30,5,441,1,447
PUNJAB,FAZILKA,2021-01-31,0,450,5,455
PUNJAB,FIROZEPUR,2021-01-26,0,163,0,163
PUNJAB,FIROZEPUR,2021-01-27,2,197,0,199
PUNJAB,FIROZEPUR,2021-01-28,1,249,0,250
PUNJAB,FIROZEPUR,2021-01-29,0,254,0,254
PUNJAB,FIROZEPUR,2021-01-30,3,243,0,246
PUNJAB,FIROZEPUR,2021-01-31,1,238,0,239
PUNJAB,GURDASPUR,2021-01-26,12,793,0,805
PUNJAB,GURDASPUR,2021-01-27,2,570,1,573
PUNJAB,GURDASPUR,2021-01-28,8,688,0,696
PUNJAB,GURDASPUR,2021-01-29,3,1915,1,1919
PUNJAB,GURDASPUR,2021-01-30,5,1571,1,1577
PUNJAB,GURDASPUR,2021-01-31,2,640,0,642
PUNJAB,HOSHIARPUR,2021-01-26,4,348,0,352
PUNJAB,HOSHIARPUR,2021-01-27,9,1470,2,1481
PUNJAB,HOSHIARPUR,2021-01-28,8,532,1,541
PUNJAB,HOSHIARPUR,2021-01-29,18,742,0,760
PUNJAB,HOSHIARPUR,2021-01-30,8,1280,90,1378
PUNJAB,HOSHIARPUR,2021-01-31,3,1274,1,1278
PUNJAB,JALANDHAR,2021-01-26,9,1027,15,1051
PUNJAB,JALANDHAR,2021-01-27,35,2557,61,2653
PUNJAB,JALANDHAR,2021-01-28,51,2489,53,2593
PUNJAB,JALANDHAR,2021-01-29,31,2327,3,2361
PUNJAB,JALANDHAR,2021-01-30,45,3686,35,3766
PUNJAB,JALANDHAR,2021-01-31,47,1523,64,1634
PUNJAB,KAPURTHALA,2021-01-26,1,135,0,136
PUNJAB,KAPURTHALA,2021-01-27,14,1114,6,1134
PUNJAB,KAPURTHALA,2021-01-28,3,571,0,574
PUNJAB,KAPURTHALA,2021-01-29,14,979,0,993
PUNJAB,KAPURTHALA,2021-01-30,4,358,1,363
PUNJAB,KAPURTHALA,2021-01-31,10,208,1,219
PUNJAB,LUDHIANA,2021-01-26,60,1214,4,1278
PUNJAB,LUDHIANA,2021-01-27,42,2228,17,2287
PUNJAB,LUDHIANA,2021-01-28,40,1500,4,1544
PUNJAB,LUDHIANA,2021-01-29,46,2163,4,2213
PUNJAB,LUDHIANA,2021-01-30,59,2026,17,2102
PUNJAB,LUDHIANA,2021-01-31,28,2524,10,2562
PUNJAB,MANSA,2021-01-26,0,446,0,446
PUNJAB,MANSA,2021-01-27,1,34,2,37
PUNJAB,MANSA,2021-01-28,4,389,0,393
PUNJAB,MANSA,2021-01-29,2,360,1,363
PUNJAB,MANSA,2021-01-30,3,377,1,381
PUNJAB,MANSA,2021-01-31,0,411,0,411
PUNJAB,MOGA,2021-01-26,1,185,2,188
PUNJAB,MOGA,2021-01-27,7,207,0,214
PUNJAB,MOGA,2021-01-28,5,210,2,217
PUNJAB,MOGA,2021-01-29,1,178,1,180
PUNJAB,MOGA,2021-01-30,7,204,2,213
PUNJAB,MOGA,2021-01-31,4,141,2,147
PUNJAB,PATHANKOT,2021-01-26,4,749,0,753
PUNJAB,PATHANKOT,2021-01-27,2,117,0,119
PUNJAB,PATHANKOT,2021-01-28,2,414,0,416
PUNJAB,PATHANKOT,2021-01-29,1,283,0,284
PUNJAB,PATHANKOT,2021-01-30,2,181,0,183
PUNJAB,PATHANKOT,2021-01-31,0,873,3,876
PUNJAB,PATIALA,2021-01-26,15,686,0,701
PUNJAB,PATIALA,2021-01-27,19,1080,1,1100
PUNJAB,PATIALA,2021-01-28,19,1009,2,1030
PUNJAB,PATIALA,2021-01-29,29,1206,1,1236
PUNJAB,PATIALA,2021-01-30,10,1131,4,1145
PUNJAB,PATIALA,2021-01-31,19,553,0,572
PUNJAB,RUPNAGAR,2021-01-26,8,627,9,644
PUNJAB,RUPNAGAR,2021-01-27,3,301,0,304
PUNJAB,RUPNAGAR,2021-01-28,16,470,1,487
PUNJAB,RUPNAGAR,2021-01-29,8,570,0,578
PUNJAB,RUPNAGAR,2021-01-30,2,520,1,523
PUNJAB,RUPNAGAR,2021-01-31,5,434,1,440
PUNJAB,S.A.S NAGAR,2021-01-26,34,543,1,578
PUNJAB,S.A.S NAGAR,2021-01-27,40,1181,19,1240
PUNJAB,S.A.S NAGAR,2021-01-28,38,990,15,1043
PUNJAB,S.A.S NAGAR,2021-01-29,49,906,3,958
PUNJAB,S.A.S NAGAR,2021-01-30,34,895,4,933
PUNJAB,S.A.S NAGAR,2021-01-31,21,404,2,427
PUNJAB,SANGRUR,2021-01-26,3,923,0,926
PUNJAB,SANGRUR,2021-01-27,4,994,2,1000
PUNJAB,SANGRUR,2021-01-28,2,1076,1,1079
PUNJAB,SANGRUR,2021-01-29,2,1108,3,1113
PUNJAB,SANGRUR,2021-01-30,1,1131,2,1134
PUNJAB,SANGRUR,2021-01-31,4,985,0,989
PUNJAB,SHAHID BHAGAT SINGH NAGAR,2021-01-26,16,894,0,910
PUNJAB,SHAHID BHAGAT SINGH NAGAR,2021-01-27,10,83,0,93
PUNJAB,SHAHID BHAGAT SINGH NAGAR,2021-01-28,16,677,0,693
PUNJAB,SHAHID BHAGAT SINGH NAGAR,2021-01-29,12,732,0,744
PUNJAB,SHAHID BHAGAT SINGH NAGAR,2021-01-30,14,744,3,761
PUNJAB,SHAHID BHAGAT SINGH NAGAR,2021-01-31,12,551,0,563
PUNJAB,SRI MUKTSAR SAHIB,2021-01-26,0,188,2,190
PUNJAB,SRI MUKTSAR SAHIB,2021-01-27,0,50,0,50
PUNJAB,SRI MUKTSAR SAHIB,2021-01-28,3,231,2,236
PUNJAB,SRI MUKTSAR SAHIB,2021-01-29,1,199,6,206
PUNJAB,SRI MUKTSAR SAHIB,2021-01-30,9,253,7,269
PUNJAB,SRI MUKTSAR SAHIB,2021-01-31,2,230,0,232
PUNJAB,TARN TARAN,2021-01-26,1,715,118,834
PUNJAB,TARN TARAN,2021-01-27,1,214,1,216
PUNJAB,TARN TARAN,2021-01-28,2,902,2,906
PUNJAB,TARN TARAN,2021-01-29,1,456,0,457
PUNJAB,TARN TARAN,2021-01-30,1,482,0,483
PUNJAB,TARN TARAN,2021-01-31,1,785,0,786
RAJASTHAN,AJMER,2021-01-26,0,94,303,397
RAJASTHAN,AJMER,2021-01-27,2,66,639,707
RAJASTHAN,AJMER,2021-01-28,7,137,415,559
RAJASTHAN,AJMER,2021-01-29,4,101,457,562
RAJASTHAN,AJMER,2021-01-30,0,73,696,769
RAJASTHAN,AJMER,2021-01-31,1,105,350,456
RAJASTHAN,ALWAR,2021-01-26,206,1249,297,1752
RAJASTHAN,ALWAR,2021-01-27,11,1307,31,1349
RAJASTHAN,ALWAR,2021-01-28,221,1095,11,1327
RAJASTHAN,ALWAR,2021-01-29,141,1547,20,1708
RAJASTHAN,ALWAR,2021-01-30,237,1912,36,2185
RAJASTHAN,ALWAR,2021-01-31,193,2430,27,2650
RAJASTHAN,BANSWARA,2021-01-26,3,35,0,38
RAJASTHAN,BANSWARA,2021-01-27,0,97,0,97
RAJASTHAN,BANSWARA,2021-01-28,0,73,0,73
RAJASTHAN,BANSWARA,2021-01-29,0,37,1,38
RAJASTHAN,BANSWARA,2021-01-30,0,54,0,54
RAJASTHAN,BANSWARA,2021-01-31,0,16,0,16
RAJASTHAN,BARAN,2021-01-26,1,95,0,96
RAJASTHAN,BARAN,2021-01-27,0,119,0,119
RAJASTHAN,BARAN,2021-01-28,3,66,1,70
RAJASTHAN,BARAN,2021-01-29,3,100,0,103
RAJASTHAN,BARAN,2021-01-30,0,149,0,149
RAJASTHAN,BARAN,2021-01-31,0,169,1,170
RAJASTHAN,BARMER,2021-01-26,0,126,0,126
RAJASTHAN,BARMER,2021-01-27,0,357,0,357
RAJASTHAN,BARMER,2021-01-28,1,238,0,239
RAJASTHAN,BARMER,2021-01-29,0,70,0,70
RAJASTHAN,BARMER,2021-01-30,0,172,3,175
RAJASTHAN,BARMER,2021-01-31,2,99,0,101
RAJASTHAN,BHARATPUR,2021-01-26,2,47,2,51
RAJASTHAN,BHARATPUR,2021-01-27,0,48,6,54
RAJASTHAN,BHARATPUR,2021-01-28,1,45,1,47
RAJASTHAN,BHARATPUR,2021-01-29,1,140,1,142
RAJASTHAN,BHARATPUR,2021-01-30,1,78,4,83
RAJASTHAN,BHARATPUR,2021-01-31,2,39,5,46
RAJASTHAN,BHILWARA,2021-01-26,7,271,2,280
RAJASTHAN,BHILWARA,2021-01-27,7,173,1,181
RAJASTHAN,BHILWARA,2021-01-28,6,273,1,280
RAJASTHAN,BHILWARA,2021-01-29,11,287,2,300
RAJASTHAN,BHILWARA,2021-01-30,7,307,8,322
RAJASTHAN,BHILWARA,2021-01-31,7,142,5,154
RAJASTHAN,BIKANER,2021-01-26,12,306,2,320
RAJASTHAN,BIKANER,2021-01-27,0,812,3,815
RAJASTHAN,BIKANER,2021-01-28,0,828,2,830
RAJASTHAN,BIKANER,2021-01-29,0,1056,1,1057
RAJASTHAN,BIKANER,2021-01-30,3,876,1,880
RAJASTHAN,BIKANER,2021-01-31,0,838,0,838
RAJASTHAN,BUNDI,2021-01-26,0,168,1,169
RAJASTHAN,BUNDI,2021-01-27,5,112,0,117
RAJASTHAN,BUNDI,2021-01-28,0,224,0,224
RAJASTHAN,BUNDI,2021-01-29,0,266,0,266
RAJASTHAN,BUNDI,2021-01-30,0,283,0,283
RAJASTHAN,BUNDI,2021-01-31,0,58,0,58
RAJASTHAN,CHITTORGARH,2021-01-26,4,796,4,804
RAJASTHAN,CHITTORGARH,2021-01-27,1,402,2,405
RAJASTHAN,CHITTORGARH,2021-01-28,3,634,6,643
RAJASTHAN,CHITTORGARH,2021-01-29,21,334,2,357
RAJASTHAN,CHITTORGARH,2021-01-30,1,114,0,115
RAJASTHAN,CHITTORGARH,2021-01-31,1,257,2,260
RAJASTHAN,CHURU,2021-01-26,0,542,1,543
RAJASTHAN,CHURU,2021-01-27,0,118,3,121
RAJASTHAN,CHURU,2021-01-28,0,297,2,299
RAJASTHAN,CHURU,2021-01-29,0,366,4,370
RAJASTHAN,CHURU,2021-01-30,0,306,2,308
RAJASTHAN,CHURU,2021-01-31,0,322,1,323
RAJASTHAN,DAUSA,2021-01-26,0,192,9,201
RAJASTHAN,DAUSA,2021-01-27,0,262,16,278
RAJASTHAN,DAUSA,2021-01-28,1,248,7,256
RAJASTHAN,DAUSA,2021-01-29,1,236,6,243
RAJASTHAN,DAUSA,2021-01-30,0,315,12,327
RAJASTHAN,DAUSA,2021-01-31,0,161,19,180
RAJASTHAN,DHOLPUR,2021-01-26,1,17,0,18
RAJASTHAN,DHOLPUR,2021-01-27,1,534,5,540
RAJASTHAN,DHOLPUR,2021-01-28,0,557,3,560
RAJASTHAN,DHOLPUR,2021-01-29,1,802,5,808
RAJASTHAN,DHOLPUR,2021-01-30,1,635,2,638
RAJASTHAN,DHOLPUR,2021-01-31,0,7,2,9
RAJASTHAN,DUNGARPUR,2021-01-26,5,178,0,183
RAJASTHAN,DUNGARPUR,2021-01-27,3,155,0,158
RAJASTHAN,DUNGARPUR,2021-01-28,8,204,0,212
RAJASTHAN,DUNGARPUR,2021-01-29,3,160,0,163
RAJASTHAN,DUNGARPUR,2021-01-30,0,225,0,225
RAJASTHAN,DUNGARPUR,2021-01-31,1,172,0,173
RAJASTHAN,GANGANAGAR,2021-01-26,0,14,0,14
RAJASTHAN,GANGANAGAR,2021-01-27,1,22,0,23
RAJASTHAN,GANGANAGAR,2021-01-28,0,24,0,24
RAJASTHAN,GANGANAGAR,2021-01-29,1,36,1,38
RAJASTHAN,GANGANAGAR,2021-01-30,0,29,2,31
RAJASTHAN,GANGANAGAR,2021-01-31,1,38,2,41
RAJASTHAN,HANUMANGARH,2021-01-26,1,699,0,700
RAJASTHAN,HANUMANGARH,2021-01-27,0,130,0,130
RAJASTHAN,HANUMANGARH,2021-01-28,0,758,1,759
RAJASTHAN,HANUMANGARH,2021-01-29,0,407,1,408
RAJASTHAN,HANUMANGARH,2021-01-30,0,800,0,800
RAJASTHAN,HANUMANGARH,2021-01-31,0,752,0,752
RAJASTHAN,JAIPUR,2021-01-26,22,1495,239,1756
RAJASTHAN,JAIPUR,2021-01-27,64,2113,327,2504
RAJASTHAN,JAIPUR,2021-01-28,62,2090,282,2434
RAJASTHAN,JAIPUR,2021-01-29,70,2687,238,2995
RAJASTHAN,JAIPUR,2021-01-30,85,2026,227,2338
RAJASTHAN,JAIPUR,2021-01-31,54,2605,305,2964
RAJASTHAN,JAISALMER,2021-01-26,0,405,1,406
RAJASTHAN,JAISALMER,2021-01-27,1,490,1,492
RAJASTHAN,JAISALMER,2021-01-28,0,280,0,280
RAJASTHAN,JAISALMER,2021-01-29,0,136,1,137
RAJASTHAN,JAISALMER,2021-01-30,1,202,0,203
RAJASTHAN,JAISALMER,2021-01-31,0,56,1,57
RAJASTHAN,JALORE,2021-01-26,1,822,1,824
RAJASTHAN,JALORE,2021-01-27,19,1701,1,1721
RAJASTHAN,JALORE,2021-01-28,26,1589,0,1615
RAJASTHAN,JALORE,2021-01-29,5,869,0,874
RAJASTHAN,JALORE,2021-01-30,4,240,0,244
RAJASTHAN,JALORE,2021-01-31,3,990,1,994
RAJASTHAN,JHALAWAR,2021-01-26,0,325,0,325
RAJASTHAN,JHALAWAR,2021-01-27,4,361,8,373
RAJASTHAN,JHALAWAR,2021-01-28,2,176,0,178
RAJASTHAN,JHALAWAR,2021-01-29,0,201,1,202
RAJASTHAN,JHALAWAR,2021-01-30,0,161,0,161
RAJASTHAN,JHALAWAR,2021-01-31,0,208,0,208
RAJASTHAN,JHUNJHUNU,2021-01-26,0,69,8,77
RAJASTHAN,JHUNJHUNU,2021-01-27,0,78,4,82
RAJASTHAN,JHUNJHUNU,2021-01-28,1,115,2,118
RAJASTHAN,JHUNJHUNU,2021-01-29,0,106,6,112
RAJASTHAN,JHUNJHUNU,2021-01-30,2,73,5,80
RAJASTHAN,JHUNJHUNU,2021-01-31,0,85,6,91
RAJASTHAN,JODHPUR,2021-01-26,11,743,2,756
RAJASTHAN,JODHPUR,2021-01-27,15,708,3,726
RAJASTHAN,JODHPUR,2021-01-28,13,809,1,823
RAJASTHAN,JODHPUR,2021-01-29,23,840,4,867
RAJASTHAN,JODHPUR,2021-01-30,2,822,4,828
RAJASTHAN,JODHPUR,2021-01-31,12,777,2,791
RAJASTHAN,KARAULI,2021-01-26,11,392,7,410
RAJASTHAN,KARAULI,2021-01-27,10,368,11,389
RAJASTHAN,KARAULI,2021-01-28,1,163,2,166
RAJASTHAN,KARAULI,2021-01-29,3,282,3,288
RAJASTHAN,KARAULI,2021-01-30,0,24,3,27
RAJASTHAN,KARAULI,2021-01-31,0,19,1,20
RAJASTHAN,KOTA,2021-01-26,1,930,2,933
RAJASTHAN,KOTA,2021-01-27,124,2002,1,2127
RAJASTHAN,KOTA,2021-01-28,94,636,2,732
RAJASTHAN,KOTA,2021-01-29,16,1508,1,1525
RAJASTHAN,KOTA,2021-01-30,16,2072,0,2088
RAJASTHAN,KOTA,2021-01-31,3,2032,1,2036
RAJASTHAN,NAGAUR,2021-01-26,9,306,124,439
RAJASTHAN,NAGAUR,2021-01-27,1,211,539,751
RAJASTHAN,NAGAUR,2021-01-28,1,97,360,458
RAJASTHAN,NAGAUR,2021-01-29,0,133,333,466
RAJASTHAN,NAGAUR,2021-01-30,91,79,684,854
RAJASTHAN,NAGAUR,2021-01-31,0,146,232,378
RAJASTHAN,PALI,2021-01-26,1,12,1,14
RAJASTHAN,PALI,2021-01-27,7,420,4,431
RAJASTHAN,PALI,2021-01-28,2,23,0,25
RAJASTHAN,PALI,2021-01-29,0,27,7,34
RAJASTHAN,PALI,2021-01-30,0,25,5,30
RAJASTHAN,PALI,2021-01-31,1,100,5,106
RAJASTHAN,PRATAPGARH,2021-01-26,1,6,0,7
RAJASTHAN,PRATAPGARH,2021-01-27,0,4,0,4
RAJASTHAN,PRATAPGARH,2021-01-28,3,6,0,9
RAJASTHAN,PRATAPGARH,2021-01-29,0,10,0,10
RAJASTHAN,PRATAPGARH,2021-01-30,0,4,0,4
RAJASTHAN,PRATAPGARH,2021-01-31,0,3,0,3
RAJASTHAN,RAJSAMAND,2021-01-26,7,463,2,472
RAJASTHAN,RAJSAMAND,2021-01-27,19,411,0,430
RAJASTHAN,RAJSAMAND,2021-01-28,10,419,0,429
RAJASTHAN,RAJSAMAND,2021-01-29,0,337,4,341
RAJASTHAN,RAJSAMAND,2021-01-30,16,441,0,457
RAJASTHAN,RAJSAMAND,2021-01-31,12,191,1,204
RAJASTHAN,SAWAI MADHOPUR,2021-01-26,0,115,7,122
RAJASTHAN,SAWAI MADHOPUR,2021-01-27,1,126,12,139
RAJASTHAN,SAWAI MADHOPUR,2021-01-28,1,137,6,144
RAJASTHAN,SAWAI MADHOPUR,2021-01-29,0,260,7,267
RAJASTHAN,SAWAI MADHOPUR,2021-01-30,1,43,9,53
RAJASTHAN,SAWAI MADHOPUR,2021-01-31,0,221,13,234
RAJASTHAN,SIKAR,2021-01-26,1,250,5,256
RAJASTHAN,SIKAR,2021-01-27,0,340,10,350
RAJASTHAN,SIKAR,2021-01-28,0,468,13,481
RAJASTHAN,SIKAR,2021-01-29,4,373,6,383
RAJASTHAN,SIKAR,2021-01-30,1,182,6,189
RAJASTHAN,SIKAR,2021-01-31,2,202,14,218
RAJASTHAN,SIROHI,2021-01-26,0,198,3,201
RAJASTHAN,SIROHI,2021-01-27,15,305,0,320
RAJASTHAN,SIROHI,2021-01-28,21,246,0,267
RAJASTHAN,SIROHI,2021-01-29,27,261,0,288
RAJASTHAN,SIROHI,2021-01-30,1,339,0,340
RAJASTHAN,SIROHI,2021-01-31,1,117,1,119
RAJASTHAN,TONK,2021-01-26,1,198,48,247
RAJASTHAN,TONK,2021-01-27,2,169,20,191
RAJASTHAN,TONK,2021-01-28,3,284,43,330
RAJASTHAN,TONK,2021-01-29,0,288,48,336
RAJASTHAN,TONK,2021-01-30,1,368,52,421
RAJASTHAN,TONK,2021-01-31,0,267,69,336
RAJASTHAN,UDAIPUR,2021-01-26,38,635,0,673
RAJASTHAN,UDAIPUR,2021-01-27,20,463,0,483
RAJASTHAN,UDAIPUR,2021-01-28,50,686,0,736
RAJASTHAN,UDAIPUR,2021-01-29,22,557,5,584
RAJASTHAN,UDAIPUR,2021-01-30,18,577,0,595
RAJASTHAN,UDAIPUR,2021-01-31,46,437,0,483
SIKKIM,EAST DISTRICT,2021-01-26,2,159,0,161
SIKKIM,EAST DISTRICT,2021-01-27,6,98,0,104
SIKKIM,EAST DISTRICT,2021-01-28,3,141,0,144
SIKKIM,EAST DISTRICT,2021-01-29,2,127,1,130
SIKKIM,EAST DISTRICT,2021-01-30,2,180,1,183
SIKKIM,EAST DISTRICT,2021-01-31,3,13,0,16
SIKKIM,NORTH DISTRICT,2021-01-27,0,2,0,2
SIKKIM,NORTH DISTRICT,2021-01-28,0,1,0,1
SIKKIM,NORTH DISTRICT,2021-01-29,0,3,0,3
SIKKIM,NORTH DISTRICT,2021-01-30,0,4,0,4
SIKKIM,SOUTH DISTRICT,2021-01-26,0,6,0,6
SIKKIM,SOUTH DISTRICT,2021-01-27,0,26,0,26
SIKKIM,SOUTH DISTRICT,2021-01-28,0,5,0,5
SIKKIM,SOUTH DISTRICT,2021-01-29,0,9,0,9
SIKKIM,SOUTH DISTRICT,2021-01-30,0,38,0,38
SIKKIM,SOUTH DISTRICT,2021-01-31,0,2,0,2
SIKKIM,WEST DISTRICT,2021-01-26,0,6,0,6
SIKKIM,WEST DISTRICT,2021-01-27,0,9,0,9
SIKKIM,WEST DISTRICT,2021-01-28,0,7,0,7
SIKKIM,WEST DISTRICT,2021-01-29,0,6,0,6
SIKKIM,WEST DISTRICT,2021-01-30,0,4,0,4
TAMIL NADU,ARIYALUR,2021-01-26,2,620,0,622
TAMIL NADU,ARIYALUR,2021-01-27,0,407,0,407
TAMIL NADU,ARIYALUR,2021-01-28,4,395,0,399
TAMIL NADU,ARIYALUR,2021-01-29,1,510,0,511
TAMIL NADU,ARIYALUR,2021-01-30,1,105,0,106
TAMIL NADU,ARIYALUR,2021-01-31,1,47,0,48
TAMIL NADU,CHENGALPATTU,2021-01-26,23,3355,0,3378
TAMIL NADU,CHENGALPATTU,2021-01-27,28,2790,1,2819
TAMIL NADU,CHENGALPATTU,2021-01-28,35,2860,0,2895
TAMIL NADU,CHENGALPATTU,2021-01-29,26,2400,0,2426
TAMIL NADU,CHENGALPATTU,2021-01-30,24,3545,0,3569
TAMIL NADU,CHENGALPATTU,2021-01-31,5,2662,0,2667
TAMIL NADU,CHENNAI,2021-01-26,197,10437,4,10638
TAMIL NADU,CHENNAI,2021-01-27,180,8445,9,8634
TAMIL NADU,CHENNAI,2021-01-28,191,10930,10,11131
TAMIL NADU,CHENNAI,2021-01-29,157,8553,9,8719
TAMIL NADU,CHENNAI,2021-01-30,183,10717,5,10905
TAMIL NADU,CHENNAI,2021-01-31,118,7951,14,8083
TAMIL NADU,COIMBATORE,2021-01-26,48,2179,1,2228
TAMIL NADU,COIMBATORE,2021-01-27,52,1976,0,2028
TAMIL NADU,COIMBATORE,2021-01-28,63,2173,1,2237
TAMIL NADU,COIMBATORE,2021-01-29,61,2170,1,2232
TAMIL NADU,COIMBATORE,2021-01-30,58,2310,0,2368
TAMIL NADU,COIMBATORE,2021-01-31,39,1214,0,1253
TAMIL NADU,CUDDALORE,2021-01-26,4,841,0,845
TAMIL NADU,CUDDALORE,2021-01-27,12,1423,0,1435
TAMIL NADU,CUDDALORE,2021-01-28,4,1616,20,1640
TAMIL NADU,CUDDALORE,2021-01-29,3,776,1,780
TAMIL NADU,CUDDALORE,2021-01-30,6,1139,1,1146
TAMIL NADU,CUDDALORE,2021-01-31,4,844,1,849
TAMIL NADU,DHARMAPURI,2021-01-26,4,672,0,676
TAMIL NADU,DHARMAPURI,2021-01-27,0,740,0,740
TAMIL NADU,DHARMAPURI,2021-01-28,4,784,0,788
TAMIL NADU,DHARMAPURI,2021-01-29,3,690,0,693
TAMIL NADU,DHARMAPURI,2021-01-30,4,763,0,767
TAMIL NADU,DHARMAPURI,2021-01-31,3,818,0,821
TAMIL NADU,DINDIGUL,2021-01-26,10,301,1,312
TAMIL NADU,DINDIGUL,2021-01-27,17,276,0,293
TAMIL NADU,DINDIGUL,2021-01-28,4,297,0,301
TAMIL NADU,DINDIGUL,2021-01-29,6,162,0,168
TAMIL NADU,DINDIGUL,2021-01-30,16,228,0,244
TAMIL NADU,DINDIGUL,2021-01-31,14,105,0,119
TAMIL NADU,ERODE,2021-01-26,19,1605,0,1624
TAMIL NADU,ERODE,2021-01-27,17,1393,0,1410
TAMIL NADU,ERODE,2021-01-28,16,1836,0,1852
TAMIL NADU,ERODE,2021-01-29,28,1479,0,1507
TAMIL NADU,ERODE,2021-01-30,9,1486,0,1495
TAMIL NADU,ERODE,2021-01-31,25,1536,0,1561
TAMIL NADU,KALLAKURICHI,2021-01-26,0,595,5,600
TAMIL NADU,KALLAKURICHI,2021-01-27,0,327,0,327
TAMIL NADU,KALLAKURICHI,2021-01-28,3,712,2,717
TAMIL NADU,KALLAKURICHI,2021-01-29,2,164,0,166
TAMIL NADU,KALLAKURICHI,2021-01-30,0,591,1,592
TAMIL NADU,KALLAKURICHI,2021-01-31,3,512,0,515
TAMIL NADU,KANCHIPURAM,2021-01-26,15,2483,1,2499
TAMIL NADU,KANCHIPURAM,2021-01-27,18,2092,0,2110
TAMIL NADU,KANCHIPURAM,2021-01-28,12,1855,0,1867
TAMIL NADU,KANCHIPURAM,2021-01-29,18,2398,0,2416
TAMIL NADU,KANCHIPURAM,2021-01-30,18,2449,1,2468
TAMIL NADU,KANCHIPURAM,2021-01-31,9,2106,1,2116
TAMIL NADU,KANNIYAKUMARI,2021-01-26,9,1553,4,1566
TAMIL NADU,KANNIYAKUMARI,2021-01-27,12,1668,2,1682
TAMIL NADU,KANNIYAKUMARI,2021-01-28,11,1144,1,1156
TAMIL NADU,KANNIYAKUMARI,2021-01-29,18,1653,25,1696
TAMIL NADU,KANNIYAKUMARI,2021-01-30,7,1270,7,1284
TAMIL NADU,KANNIYAKUMARI,2021-01-31,13,798,5,816
TAMIL NADU,KARUR,2021-01-26,0,1034,25,1059
TAMIL NADU,KARUR,2021-01-27,5,1010,0,1015
TAMIL NADU,KARUR,2021-01-28,6,1078,0,1084
TAMIL NADU,KARUR,2021-01-29,7,993,1,1001
TAMIL NADU,KARUR,2021-01-30,1,1083,1,1085
TAMIL NADU,KARUR,2021-01-31,5,1214,1,1220
TAMIL NADU,KRISHNAGIRI,2021-01-26,5,792,1,798
TAMIL NADU,KRISHNAGIRI,2021-01-27,3,1124,0,1127
TAMIL NADU,KRISHNAGIRI,2021-01-28,7,1048,0,1055
TAMIL NADU,KRISHNAGIRI,2021-01-29,7,1392,0,1399
TAMIL NADU,KRISHNAGIRI,2021-01-30,6,1308,0,1314
TAMIL NADU,KRISHNAGIRI,2021-01-31,4,442,0,446
TAMIL NADU,MADURAI,2021-01-26,9,3151,0,3160
TAMIL NADU,MADURAI,2021-01-27,14,2206,1,2221
TAMIL NADU,MADURAI,2021-01-28,9,2716,2,2727
TAMIL NADU,MADURAI,2021-01-29,19,2955,0,2974
TAMIL NADU,MADURAI,2021-01-30,7,3125,0,3132
TAMIL NADU,MADURAI,2021-01-31,9,1880,1,1890
TAMIL NADU,NAGAPATTINAM,2021-01-26,4,1026,2,1032
TAMIL NADU,NAGAPATTINAM,2021-01-27,3,276,0,279
TAMIL NADU,NAGAPATTINAM,2021-01-28,12,948,2,962
TAMIL NADU,NAGAPATTINAM,2021-01-29,9,546,0,555
TAMIL NADU,NAGAPATTINAM,2021-01-30,4,925,0,929
TAMIL NADU,NAGAPATTINAM,2021-01-31,2,492,0,494
TAMIL NADU,NAMAKKAL,2021-01-26,20,1700,0,1720
TAMIL NADU,NAMAKKAL,2021-01-27,5,1318,0,1323
TAMIL NADU,NAMAKKAL,2021-01-28,9,1052,0,1061
TAMIL NADU,NAMAKKAL,2021-01-29,14,1583,0,1597
TAMIL NADU,NAMAKKAL,2021-01-30,22,1495,2,1519
TAMIL NADU,NAMAKKAL,2021-01-31,12,850,0,862
TAMIL NADU,PERAMBALUR,2021-01-26,0,192,2,194
TAMIL NADU,PERAMBALUR,2021-01-27,1,391,0,392
TAMIL NADU,PERAMBALUR,2021-01-28,0,312,0,312
TAMIL NADU,PERAMBALUR,2021-01-29,1,402,0,403
TAMIL NADU,PERAMBALUR,2021-01-30,3,233,0,236
TAMIL NADU,PERAMBALUR,2021-01-31,0,329,0,329
TAMIL NADU,PUDUKKOTTAI,2021-01-26,4,815,1,820
TAMIL NADU,PUDUKKOTTAI,2021-01-27,5,535,1,541
TAMIL NADU,PUDUKKOTTAI,2021-01-28,5,754,2,761
TAMIL NADU,PUDUKKOTTAI,2021-01-29,6,826,0,832
TAMIL NADU,PUDUKKOTTAI,2021-01-30,4,827,1,832
TAMIL NADU,PUDUKKOTTAI,2021-01-31,8,703,3,714
TAMIL NADU,RAMANATHAPURAM,2021-01-26,0,959,0,959
TAMIL NADU,RAMANATHAPURAM,2021-01-27,3,907,0,910
TAMIL NADU,RAMANATHAPURAM,2021-01-28,0,821,0,821
TAMIL NADU,RAMANATHAPURAM,2021-01-29,1,914,0,915
TAMIL NADU,RAMANATHAPURAM,2021-01-30,2,712,0,714
TAMIL NADU,RAMANATHAPURAM,2021-01-31,1,929,0,930
TAMIL NADU,RANIPET,2021-01-26,5,551,0,556
TAMIL NADU,RANIPET,2021-01-27,3,223,0,226
TAMIL NADU,RANIPET,2021-01-28,5,412,0,417
TAMIL NADU,RANIPET,2021-01-29,4,270,0,274
TAMIL NADU,RANIPET,2021-01-30,7,485,0,492
TAMIL NADU,RANIPET,2021-01-31,4,396,0,400
TAMIL NADU,SALEM,2021-01-26,13,964,2,979
TAMIL NADU,SALEM,2021-01-27,13,572,0,585
TAMIL NADU,SALEM,2021-01-28,4,766,0,770
TAMIL NADU,SALEM,2021-01-29,10,809,0,819
TAMIL NADU,SALEM,2021-01-30,12,762,0,774
TAMIL NADU,SALEM,2021-01-31,42,295,0,337
TAMIL NADU,SIVAGANGA,2021-01-26,5,643,0,648
TAMIL NADU,SIVAGANGA,2021-01-27,1,140,0,141
TAMIL NADU,SIVAGANGA,2021-01-28,1,573,0,574
TAMIL NADU,SIVAGANGA,2021-01-29,4,580,0,584
TAMIL NADU,SIVAGANGA,2021-01-30,1,516,0,517
TAMIL NADU,SIVAGANGA,2021-01-31,2,363,0,365
TAMIL NADU,TENKASI,2021-01-26,10,736,0,746
TAMIL NADU,TENKASI,2021-01-27,5,517,0,522
TAMIL NADU,TENKASI,2021-01-28,2,685,1,688
TAMIL NADU,TENKASI,2021-01-29,4,517,0,521
TAMIL NADU,TENKASI,2021-01-30,4,759,0,763
TAMIL NADU,TENKASI,2021-01-31,8,558,1,567
TAMIL NADU,THANJAVUR,2021-01-26,1,647,29,677
TAMIL NADU,THANJAVUR,2021-01-27,2,803,0,805
TAMIL NADU,THANJAVUR,2021-01-28,8,620,6,634
TAMIL NADU,THANJAVUR,2021-01-29,23,721,0,744
TAMIL NADU,THANJAVUR,2021-01-30,13,900,1,914
TAMIL NADU,THANJAVUR,2021-01-31,27,257,1,285
TAMIL NADU,THE NILGIRIS,2021-01-26,10,1080,0,1090
TAMIL NADU,THE NILGIRIS,2021-01-27,8,1060,5,1073
TAMIL NADU,THE NILGIRIS,2021-01-28,13,1080,0,1093
TAMIL NADU,THE NILGIRIS,2021-01-29,4,1032,0,1036
TAMIL NADU,THE NILGIRIS,2021-01-30,7,1045,0,1052
TAMIL NADU,THE NILGIRIS,2021-01-31,11,1018,0,1029
TAMIL NADU,THENI,2021-01-26,3,512,0,515
TAMIL NADU,THENI,2021-01-27,3,1302,5,1310
TAMIL NADU,THENI,2021-01-28,2,699,0,701
TAMIL NADU,THENI,2021-01-29,2,617,0,619
TAMIL NADU,THENI,2021-01-30,3,718,0,721
TAMIL NADU,THENI,2021-01-31,0,255,0,255
TAMIL NADU,THIRUVALLUR,2021-01-26,20,2365,1,2386
TAMIL NADU,THIRUVALLUR,2021-01-27,12,1895,0,1907
TAMIL NADU,THIRUVALLUR,2021-01-28,29,2075,4,2108
TAMIL NADU,THIRUVALLUR,2021-01-29,33,2562,1,2596
TAMIL NADU,THIRUVALLUR,2021-01-30,17,2312,4,2333
TAMIL NADU,THIRUVALLUR,2021-01-31,11,1690,0,1701
TAMIL NADU,THIRUVARUR,2021-01-26,5,325,0,330
TAMIL NADU,THIRUVARUR,2021-01-27,4,621,0,625
TAMIL NADU,THIRUVARUR,2021-01-28,3,365,1,369
TAMIL NADU,THIRUVARUR,2021-01-29,10,827,0,837
TAMIL NADU,THIRUVARUR,2021-01-30,11,603,1,615
TAMIL NADU,THIRUVARUR,2021-01-31,8,137,0,145
TAMIL NADU,TIRUCHIRAPPALLI,2021-01-26,24,1370,0,1394
TAMIL NADU,TIRUCHIRAPPALLI,2021-01-27,10,1210,0,1220
TAMIL NADU,TIRUCHIRAPPALLI,2021-01-28,10,1467,1,1478
TAMIL NADU,TIRUCHIRAPPALLI,2021-01-29,15,1398,4,1417
TAMIL NADU,TIRUCHIRAPPALLI,2021-01-30,15,1428,1,1444
TAMIL NADU,TIRUCHIRAPPALLI,2021-01-31,8,1228,2,1238
TAMIL NADU,TIRUNELVELI,2021-01-26,7,639,0,646
TAMIL NADU,TIRUNELVELI,2021-01-27,8,1043,0,1051
TAMIL NADU,TIRUNELVELI,2021-01-28,7,880,0,887
TAMIL NADU,TIRUNELVELI,2021-01-29,8,1820,0,1828
TAMIL NADU,TIRUNELVELI,2021-01-30,10,1148,0,1158
TAMIL NADU,TIRUNELVELI,2021-01-31,1,256,4,261
TAMIL NADU,TIRUPATHUR,2021-01-26,4,2256,2,2262
TAMIL NADU,TIRUPATHUR,2021-01-27,0,2163,0,2163
TAMIL NADU,TIRUPATHUR,2021-01-28,2,2218,3,2223
TAMIL NADU,TIRUPATHUR,2021-01-29,2,2004,0,2006
TAMIL NADU,TIRUPATHUR,2021-01-30,7,2329,4,2340
TAMIL NADU,TIRUPATHUR,2021-01-31,1,1792,10,1803
TAMIL NADU,TIRUPPUR,2021-01-26,23,1947,0,1970
TAMIL NADU,TIRUPPUR,2021-01-27,23,1931,3,1957
TAMIL NADU,TIRUPPUR,2021-01-28,23,2061,1,2085
TAMIL NADU,TIRUPPUR,2021-01-29,18,1426,2,1446
TAMIL NADU,TIRUPPUR,2021-01-30,24,1883,2,1909
TAMIL NADU,TIRUPPUR,2021-01-31,27,1672,1,1700
TAMIL NADU,TIRUVANNAMALAI,2021-01-26,6,836,4,846
TAMIL NADU,TIRUVANNAMALAI,2021-01-27,1,449,0,450
TAMIL NADU,TIRUVANNAMALAI,2021-01-28,1,368,0,369
TAMIL NADU,TIRUVANNAMALAI,2021-01-29,4,280,1,285
TAMIL NADU,TIRUVANNAMALAI,2021-01-30,6,704,2,712
TAMIL NADU,TIRUVANNAMALAI,2021-01-31,3,313,0,316
TAMIL NADU,TUTICORIN,2021-01-26,2,1036,1,1039
TAMIL NADU,TUTICORIN,2021-01-27,5,734,1,740
TAMIL NADU,TUTICORIN,2021-01-28,2,1015,0,1017
TAMIL NADU,TUTICORIN,2021-01-29,3,754,0,757
TAMIL NADU,TUTICORIN,2021-01-30,1,922,0,923
TAMIL NADU,TUTICORIN,2021-01-31,3,796,1,800
TAMIL NADU,VELLORE,2021-01-26,14,1388,3,1405
TAMIL NADU,VELLORE,2021-01-27,7,1326,0,1333
TAMIL NADU,VELLORE,2021-01-28,21,1721,1,1743
TAMIL NADU,VELLORE,2021-01-29,17,1517,1,1535
TAMIL NADU,VELLORE,2021-01-30,24,1295,2,1321
TAMIL NADU,VELLORE,2021-01-31,6,801,0,807
TAMIL NADU,VILLUPURAM,2021-01-26,5,800,0,805
TAMIL NADU,VILLUPURAM,2021-01-27,3,660,0,663
TAMIL NADU,VILLUPURAM,2021-01-28,2,777,1,780
TAMIL NADU,VILLUPURAM,2021-01-29,4,960,0,964
TAMIL NADU,VILLUPURAM,2021-01-30,4,915,1,920
TAMIL NADU,VILLUPURAM,2021-01-31,7,962,0,969
TAMIL NADU,VIRUDHUNAGAR,2021-01-26,3,658,0,661
TAMIL NADU,VIRUDHUNAGAR,2021-01-27,2,1983,0,1985
TAMIL NADU,VIRUDHUNAGAR,2021-01-28,4,1295,0,1299
TAMIL NADU,VIRUDHUNAGAR,2021-01-29,5,854,2,861
TAMIL NADU,VIRUDHUNAGAR,2021-01-30,3,1310,0,1313
TAMIL NADU,VIRUDHUNAGAR,2021-01-31,4,506,0,510
TELANGANA,ADILABAD,2021-01-26,0,133,0,133
TELANGANA,ADILABAD,2021-01-27,0,228,0,228
TELANGANA,ADILABAD,2021-01-28,0,315,0,315
TELANGANA,ADILABAD,2021-01-29,1,299,0,300
TELANGANA,ADILABAD,2021-01-30,0,343,0,343
TELANGANA,ADILABAD,2021-01-31,0,246,0,246
TELANGANA,BHADRADRI KOTHAGUDEM,2021-01-26,0,179,0,179
TELANGANA,BHADRADRI KOTHAGUDEM,2021-01-27,0,801,0,801
TELANGANA,BHADRADRI KOTHAGUDEM,2021-01-28,0,822,0,822
TELANGANA,BHADRADRI KOTHAGUDEM,2021-01-29,0,832,0,832
TELANGANA,BHADRADRI KOTHAGUDEM,2021-01-30,0,773,0,773
TELANGANA,BHADRADRI KOTHAGUDEM,2021-01-31,0,370,0,370
TELANGANA,HYDERABAD,2021-01-26,10,3046,5,3061
TELANGANA,HYDERABAD,2021-01-27,19,6821,14,6854
TELANGANA,HYDERABAD,2021-01-28,31,6570,6,6607
TELANGANA,HYDERABAD,2021-01-29,36,6459,8,6503
TELANGANA,HYDERABAD,2021-01-30,37,5570,5,5612
TELANGANA,HYDERABAD,2021-01-31,30,3223,11,3264
TELANGANA,JAGITIAL,2021-01-26,0,207,0,207
TELANGANA,JAGITIAL,2021-01-27,0,531,0,531
TELANGANA,JAGITIAL,2021-01-28,0,448,0,448
TELANGANA,JAGITIAL,2021-01-29,0,516,0,516
TELANGANA,JAGITIAL,2021-01-30,0,979,0,979
TELANGANA,JAGITIAL,2021-01-31,0,368,0,368
TELANGANA,JANGOAN,2021-01-26,0,287,0,287
TELANGANA,JANGOAN,2021-01-27,0,508,0,508
TELANGANA,JANGOAN,2021-01-28,0,560,0,560
TELANGANA,JANGOAN,2021-01-29,0,539,0,539
TELANGANA,JANGOAN,2021-01-30,0,565,0,565
TELANGANA,JANGOAN,2021-01-31,0,325,0,325
TELANGANA,JAYASHANKAR BHUPALAPALLY,2021-01-26,0,75,0,75
TELANGANA,JAYASHANKAR BHUPALAPALLY,2021-01-27,0,162,0,162
TELANGANA,JAYASHANKAR BHUPALAPALLY,2021-01-28,0,168,0,168
TELANGANA,JAYASHANKAR BHUPALAPALLY,2021-01-29,0,215,0,215
TELANGANA,JAYASHANKAR BHUPALAPALLY,2021-01-30,0,400,0,400
TELANGANA,JAYASHANKAR BHUPALAPALLY,2021-01-31,0,52,0,52
TELANGANA,JOGULAMBA GADWAL,2021-01-26,0,331,0,331
TELANGANA,JOGULAMBA GADWAL,2021-01-27,0,425,0,425
TELANGANA,JOGULAMBA GADWAL,2021-01-28,0,501,0,501
TELANGANA,JOGULAMBA GADWAL,2021-01-29,0,569,0,569
TELANGANA,JOGULAMBA GADWAL,2021-01-30,0,561,0,561
TELANGANA,JOGULAMBA GADWAL,2021-01-31,0,381,0,381
TELANGANA,KAMAREDDY,2021-01-26,0,81,0,81
TELANGANA,KAMAREDDY,2021-01-27,0,546,0,546
TELANGANA,KAMAREDDY,2021-01-28,0,555,0,555
TELANGANA,KAMAREDDY,2021-01-29,0,608,0,608
TELANGANA,KAMAREDDY,2021-01-30,0,631,0,631
TELANGANA,KAMAREDDY,2021-01-31,0,64,0,64
TELANGANA,KARIMNAGAR,2021-01-26,10,478,0,488
TELANGANA,KARIMNAGAR,2021-01-27,1,950,0,951
TELANGANA,KARIMNAGAR,2021-01-28,0,1151,0,1151
TELANGANA,KARIMNAGAR,2021-01-29,2,1191,0,1193
TELANGANA,KARIMNAGAR,2021-01-30,2,1521,0,1523
TELANGANA,KARIMNAGAR,2021-01-31,0,635,0,635
TELANGANA,KHAMMAM,2021-01-26,0,190,0,190
TELANGANA,KHAMMAM,2021-01-27,1,797,0,798
TELANGANA,KHAMMAM,2021-01-28,0,591,0,591
TELANGANA,KHAMMAM,2021-01-29,0,663,0,663
TELANGANA,KHAMMAM,2021-01-30,0,1064,0,1064
TELANGANA,KHAMMAM,2021-01-31,0,333,0,333
TELANGANA,KUMURAM BHEEM ASIFABAD,2021-01-26,0,336,0,336
TELANGANA,KUMURAM BHEEM ASIFABAD,2021-01-27,0,555,0,555
TELANGANA,KUMURAM BHEEM ASIFABAD,2021-01-28,0,615,0,615
TELANGANA,KUMURAM BHEEM ASIFABAD,2021-01-29,0,504,0,504
TELANGANA,KUMURAM BHEEM ASIFABAD,2021-01-30,0,642,0,642
TELANGANA,KUMURAM BHEEM ASIFABAD,2021-01-31,0,380,0,380
TELANGANA,MAHABUBABAD,2021-01-26,0,180,0,180
TELANGANA,MAHABUBABAD,2021-01-27,0,357,0,357
TELANGANA,MAHABUBABAD,2021-01-28,0,878,0,878
TELANGANA,MAHABUBABAD,2021-01-29,0,376,0,376
TELANGANA,MAHABUBABAD,2021-01-30,1,674,0,675
TELANGANA,MAHABUBABAD,2021-01-31,0,199,0,199
TELANGANA,MAHABUBNAGAR,2021-01-26,0,282,0,282
TELANGANA,MAHABUBNAGAR,2021-01-27,0,434,0,434
TELANGANA,MAHABUBNAGAR,2021-01-28,0,514,0,514
TELANGANA,MAHABUBNAGAR,2021-01-29,0,437,0,437
TELANGANA,MAHABUBNAGAR,2021-01-30,0,736,0,736
TELANGANA,MAHABUBNAGAR,2021-01-31,0,257,0,257
TELANGANA,MANCHERIAL,2021-01-26,0,130,0,130
TELANGANA,MANCHERIAL,2021-01-27,0,707,0,707
TELANGANA,MANCHERIAL,2021-01-28,0,593,0,593
TELANGANA,MANCHERIAL,2021-01-29,0,531,0,531
TELANGANA,MANCHERIAL,2021-01-30,0,753,0,753
TELANGANA,MANCHERIAL,2021-01-31,0,233,0,233
TELANGANA,MEDAK,2021-01-26,0,78,0,78
TELANGANA,MEDAK,2021-01-27,1,229,0,230
TELANGANA,MEDAK,2021-01-28,0,289,0,289
TELANGANA,MEDAK,2021-01-29,0,276,1,277
TELANGANA,MEDAK,2021-01-30,0,339,0,339
TELANGANA,MEDAK,2021-01-31,0,114,0,114
TELANGANA,MEDCHAL MALKAJGIRI,2021-01-26,1,244,0,245
TELANGANA,MEDCHAL MALKAJGIRI,2021-01-27,2,1477,1,1480
TELANGANA,MEDCHAL MALKAJGIRI,2021-01-28,0,1425,0,1425
TELANGANA,MEDCHAL MALKAJGIRI,2021-01-29,0,1341,0,1341
TELANGANA,MEDCHAL MALKAJGIRI,2021-01-30,0,1288,0,1288
TELANGANA,MEDCHAL MALKAJGIRI,2021-01-31,0,231,0,231
TELANGANA,MULUGU,2021-01-26,0,43,0,43
TELANGANA,MULUGU,2021-01-27,0,94,0,94
TELANGANA,MULUGU,2021-01-28,0,69,0,69
TELANGANA,MULUGU,2021-01-29,0,112,0,112
TELANGANA,MULUGU,2021-01-30,0,140,0,140
TELANGANA,MULUGU,2021-01-31,0,53,0,53
TELANGANA,NAGARKURNOOL,2021-01-26,0,462,0,462
TELANGANA,NAGARKURNOOL,2021-01-27,0,1004,0,1004
TELANGANA,NAGARKURNOOL,2021-01-28,0,1264,0,1264
TELANGANA,NAGARKURNOOL,2021-01-29,0,1152,0,1152
TELANGANA,NAGARKURNOOL,2021-01-30,0,1309,0,1309
TELANGANA,NAGARKURNOOL,2021-01-31,0,710,0,710
TELANGANA,NALGONDA,2021-01-26,0,117,0,117
TELANGANA,NALGONDA,2021-01-27,0,545,0,545
TELANGANA,NALGONDA,2021-01-28,0,581,0,581
TELANGANA,NALGONDA,2021-01-29,0,747,0,747
TELANGANA,NALGONDA,2021-01-30,0,974,0,974
TELANGANA,NALGONDA,2021-01-31,1,224,0,225
TELANGANA,NARAYANPET,2021-01-26,0,43,0,43
TELANGANA,NARAYANPET,2021-01-27,0,141,0,141
TELANGANA,NARAYANPET,2021-01-28,0,190,0,190
TELANGANA,NARAYANPET,2021-01-29,0,287,0,287
TELANGANA,NARAYANPET,2021-01-30,0,230,0,230
TELANGANA,NARAYANPET,2021-01-31,0,111,0,111
TELANGANA,NIRMAL,2021-01-26,0,264,0,264
TELANGANA,NIRMAL,2021-01-27,0,950,0,950
TELANGANA,NIRMAL,2021-01-28,0,495,0,495
TELANGANA,NIRMAL,2021-01-29,0,551,0,551
TELANGANA,NIRMAL,2021-01-30,0,657,0,657
TELANGANA,NIRMAL,2021-01-31,0,188,0,188
TELANGANA,NIZAMABAD,2021-01-26,0,135,0,135
TELANGANA,NIZAMABAD,2021-01-27,0,401,0,401
TELANGANA,NIZAMABAD,2021-01-28,0,288,0,288
TELANGANA,NIZAMABAD,2021-01-29,0,498,0,498
TELANGANA,NIZAMABAD,2021-01-30,1,706,0,707
TELANGANA,NIZAMABAD,2021-01-31,1,271,0,272
TELANGANA,PEDDAPALLI,2021-01-26,1,143,0,144
TELANGANA,PEDDAPALLI,2021-01-27,0,987,0,987
TELANGANA,PEDDAPALLI,2021-01-28,1,715,0,716
TELANGANA,PEDDAPALLI,2021-01-29,0,909,0,909
TELANGANA,PEDDAPALLI,2021-01-30,0,1088,0,1088
TELANGANA,PEDDAPALLI,2021-01-31,0,192,0,192
TELANGANA,RAJANNA SIRCILLA,2021-01-26,1,118,0,119
TELANGANA,RAJANNA SIRCILLA,2021-01-27,0,295,0,295
TELANGANA,RAJANNA SIRCILLA,2021-01-28,0,355,0,355
TELANGANA,RAJANNA SIRCILLA,2021-01-29,0,287,0,287
TELANGANA,RAJANNA SIRCILLA,2021-01-30,0,440,0,440
TELANGANA,RAJANNA SIRCILLA,2021-01-31,0,133,0,133
TELANGANA,RANGA REDDY,2021-01-26,0,579,0,579
TELANGANA,RANGA REDDY,2021-01-27,0,1843,5,1848
TELANGANA,RANGA REDDY,2021-01-28,1,2001,0,2002
TELANGANA,RANGA REDDY,2021-01-29,5,1909,2,1916
TELANGANA,RANGA REDDY,2021-01-30,1,2182,0,2183
TELANGANA,RANGA REDDY,2021-01-31,0,724,1,725
TELANGANA,SANGAREDDY,2021-01-26,1,377,0,378
TELANGANA,SANGAREDDY,2021-01-27,9,774,0,783
TELANGANA,SANGAREDDY,2021-01-28,0,848,0,848
TELANGANA,SANGAREDDY,2021-01-29,0,1067,0,1067
TELANGANA,SANGAREDDY,2021-01-30,0,989,0,989
TELANGANA,SANGAREDDY,2021-01-31,0,474,0,474
TELANGANA,SIDDIPET,2021-01-26,0,750,0,750
TELANGANA,SIDDIPET,2021-01-27,0,1313,0,1313
TELANGANA,SIDDIPET,2021-01-28,0,1264,0,1264
TELANGANA,SIDDIPET,2021-01-29,0,1208,0,1208
TELANGANA,SIDDIPET,2021-01-30,0,1620,0,1620
TELANGANA,SIDDIPET,2021-01-31,0,335,0,335
TELANGANA,SURYAPET,2021-01-26,0,389,0,389
TELANGANA,SURYAPET,2021-01-27,0,1009,0,1009
TELANGANA,SURYAPET,2021-01-28,0,801,0,801
TELANGANA,SURYAPET,2021-01-29,0,855,0,855
TELANGANA,SURYAPET,2021-01-30,0,1246,0,1246
TELANGANA,SURYAPET,2021-01-31,0,407,0,407
TELANGANA,VIKARABAD,2021-01-26,0,249,0,249
TELANGANA,VIKARABAD,2021-01-27,0,348,0,348
TELANGANA,VIKARABAD,2021-01-28,0,415,0,415
TELANGANA,VIKARABAD,2021-01-29,0,431,0,431
TELANGANA,VIKARABAD,2021-01-30,0,565,0,565
TELANGANA,VIKARABAD,2021-01-31,0,233,0,233
TELANGANA,WANAPARTHY,2021-01-26,0,96,0,96
TELANGANA,WANAPARTHY,2021-01-27,0,232,0,232
TELANGANA,WANAPARTHY,2021-01-28,0,239,0,239
TELANGANA,WANAPARTHY,2021-01-29,0,293,0,293
TELANGANA,WANAPARTHY,2021-01-30,0,404,0,404
TELANGANA,WANAPARTHY,2021-01-31,0,218,0,218
TELANGANA,WARANGAL RURAL,2021-01-26,5,99,0,104
TELANGANA,WARANGAL RURAL,2021-01-27,1,343,0,344
TELANGANA,WARANGAL RURAL,2021-01-28,4,327,0,331
TELANGANA,WARANGAL RURAL,2021-01-29,1,292,0,293
TELANGANA,WARANGAL RURAL,2021-01-30,1,554,0,555
TELANGANA,WARANGAL RURAL,2021-01-31,0,240,0,240
TELANGANA,WARANGAL URBAN,2021-01-26,0,431,0,431
TELANGANA,WARANGAL URBAN,2021-01-27,1,1632,0,1633
TELANGANA,WARANGAL URBAN,2021-01-28,0,1759,0,1759
TELANGANA,WARANGAL URBAN,2021-01-29,1,1363,0,1364
TELANGANA,WARANGAL URBAN,2021-01-30,1,2086,0,2087
TELANGANA,WARANGAL URBAN,2021-01-31,2,479,0,481
TELANGANA,YADADRI BHUVANAGIRI,2021-01-26,0,31,0,31
TELANGANA,YADADRI BHUVANAGIRI,2021-01-27,0,234,0,234
TELANGANA,YADADRI BHUVANAGIRI,2021-01-28,0,312,0,312
TELANGANA,YADADRI BHUVANAGIRI,2021-01-29,0,314,0,314
TELANGANA,YADADRI BHUVANAGIRI,2021-01-30,0,352,0,352
TELANGANA,YADADRI BHUVANAGIRI,2021-01-31,0,33,0,33
TRIPURA,DHALAI,2021-01-26,0,16,0,16
TRIPURA,DHALAI,2021-01-27,0,10,0,10
TRIPURA,DHALAI,2021-01-28,1,4,0,5
TRIPURA,DHALAI,2021-01-29,1,13,0,14
TRIPURA,DHALAI,2021-01-30,0,17,0,17
TRIPURA,DHALAI,2021-01-31,0,7,0,7
TRIPURA,GOMATI,2021-01-26,0,22,0,22
TRIPURA,GOMATI,2021-01-27,1,33,0,34
TRIPURA,GOMATI,2021-01-28,0,39,0,39
TRIPURA,GOMATI,2021-01-29,0,26,0,26
TRIPURA,GOMATI,2021-01-30,0,33,0,33
TRIPURA,GOMATI,2021-01-31,0,9,0,9
TRIPURA,KHOWAI,2021-01-26,0,37,0,37
TRIPURA,KHOWAI,2021-01-27,0,11,0,11
TRIPURA,KHOWAI,2021-01-28,1,50,0,51
TRIPURA,KHOWAI,2021-01-29,0,20,0,20
TRIPURA,KHOWAI,2021-01-30,0,36,0,36
TRIPURA,KHOWAI,2021-01-31,0,9,0,9
TRIPURA,NORTH TRIPURA,2021-01-26,0,54,0,54
TRIPURA,NORTH TRIPURA,2021-01-27,0,89,1,90
TRIPURA,NORTH TRIPURA,2021-01-28,0,108,0,108
TRIPURA,NORTH TRIPURA,2021-01-29,0,83,0,83
TRIPURA,NORTH TRIPURA,2021-01-30,0,57,0,57
TRIPURA,NORTH TRIPURA,2021-01-31,0,25,0,25
TRIPURA,SEPAHIJALA,2021-01-26,0,119,0,119
TRIPURA,SEPAHIJALA,2021-01-27,2,43,0,45
TRIPURA,SEPAHIJALA,2021-01-28,0,63,0,63
TRIPURA,SEPAHIJALA,2021-01-29,0,61,0,61
TRIPURA,SEPAHIJALA,2021-01-30,0,48,0,48
TRIPURA,SEPAHIJALA,2021-01-31,0,27,0,27
TRIPURA,SOUTH TRIPURA,2021-01-26,0,24,0,24
TRIPURA,SOUTH TRIPURA,2021-01-27,0,102,0,102
TRIPURA,SOUTH TRIPURA,2021-01-28,0,33,0,33
TRIPURA,SOUTH TRIPURA,2021-01-29,0,112,0,112
TRIPURA,SOUTH TRIPURA,2021-01-30,2,51,0,53
TRIPURA,SOUTH TRIPURA,2021-01-31,0,11,0,11
TRIPURA,UNAKOTI,2021-01-26,0,7,0,7
TRIPURA,UNAKOTI,2021-01-27,0,4,0,4
TRIPURA,UNAKOTI,2021-01-28,0,2,0,2
TRIPURA,UNAKOTI,2021-01-29,0,5,0,5
TRIPURA,UNAKOTI,2021-01-30,0,5,0,5
TRIPURA,UNAKOTI,2021-01-31,0,4,0,4
TRIPURA,WEST TRIPURA,2021-01-26,1,192,0,193
TRIPURA,WEST TRIPURA,2021-01-27,0,161,0,161
TRIPURA,WEST TRIPURA,2021-01-28,1,167,0,168
TRIPURA,WEST TRIPURA,2021-01-29,3,221,0,224
TRIPURA,WEST TRIPURA,2021-01-30,1,183,0,184
TRIPURA,WEST TRIPURA,2021-01-31,1,117,0,118
UTTAR PRADESH,AGRA,2021-01-26,6,1618,2,1626
UTTAR PRADESH,AGRA,2021-01-27,7,1643,1,1651
UTTAR PRADESH,AGRA,2021-01-28,10,2416,4,2430
UTTAR PRADESH,AGRA,2021-01-29,8,2078,30,2116
UTTAR PRADESH,AGRA,2021-01-30,7,2116,5,2128
UTTAR PRADESH,AGRA,2021-01-31,1,1034,3,1038
UTTAR PRADESH,ALIGARH,2021-01-26,5,2422,10,2437
UTTAR PRADESH,ALIGARH,2021-01-27,8,2312,4,2324
UTTAR PRADESH,ALIGARH,2021-01-28,11,2622,2,2635
UTTAR PRADESH,ALIGARH,2021-01-29,17,1527,11,1555
UTTAR PRADESH,ALIGARH,2021-01-30,10,3506,2,3518
UTTAR PRADESH,ALIGARH,2021-01-31,7,1698,3,1708
UTTAR PRADESH,AMBEDKAR NAGAR,2021-01-26,0,1023,0,1023
UTTAR PRADESH,AMBEDKAR NAGAR,2021-01-27,1,646,1,648
UTTAR PRADESH,AMBEDKAR NAGAR,2021-01-28,1,1120,0,1121
UTTAR PRADESH,AMBEDKAR NAGAR,2021-01-29,0,910,1,911
UTTAR PRADESH,AMBEDKAR NAGAR,2021-01-30,1,988,1,990
UTTAR PRADESH,AMBEDKAR NAGAR,2021-01-31,0,861,13,874
UTTAR PRADESH,AMETHI,2021-01-26,3,703,10,716
UTTAR PRADESH,AMETHI,2021-01-27,1,1464,11,1476
UTTAR PRADESH,AMETHI,2021-01-28,0,577,0,577
UTTAR PRADESH,AMETHI,2021-01-29,1,1728,0,1729
UTTAR PRADESH,AMETHI,2021-01-30,1,1027,0,1028
UTTAR PRADESH,AMETHI,2021-01-31,1,1419,3,1423
UTTAR PRADESH,AMROHA,2021-01-26,1,412,0,413
UTTAR PRADESH,AMROHA,2021-01-27,0,578,0,578
UTTAR PRADESH,AMROHA,2021-01-28,0,2118,0,2118
UTTAR PRADESH,AMROHA,2021-01-29,1,1185,0,1186
UTTAR PRADESH,AMROHA,2021-01-30,1,964,0,965
UTTAR PRADESH,AMROHA,2021-01-31,0,417,0,417
UTTAR PRADESH,AURAIYA,2021-01-26,11,770,10,791
UTTAR PRADESH,AURAIYA,2021-01-27,0,573,20,593
UTTAR PRADESH,AURAIYA,2021-01-28,0,788,25,813
UTTAR PRADESH,AURAIYA,2021-01-29,0,504,19,523
UTTAR PRADESH,AURAIYA,2021-01-30,0,692,106,798
UTTAR PRADESH,AURAIYA,2021-01-31,0,263,51,314
UTTAR PRADESH,AYODHYA,2021-01-26,3,1303,0,1306
UTTAR PRADESH,AYODHYA,2021-01-27,7,1016,3,1026
UTTAR PRADESH,AYODHYA,2021-01-28,6,1451,0,1457
UTTAR PRADESH,AYODHYA,2021-01-29,2,1396,1,1399
UTTAR PRADESH,AYODHYA,2021-01-30,3,1948,0,1951
UTTAR PRADESH,AYODHYA,2021-01-31,1,1155,2,1158
UTTAR PRADESH,AZAMGARH,2021-01-26,0,218,3,221
UTTAR PRADESH,AZAMGARH,2021-01-27,1,681,0,682
UTTAR PRADESH,AZAMGARH,2021-01-28,1,752,3,756
UTTAR PRADESH,AZAMGARH,2021-01-29,3,787,5,795
UTTAR PRADESH,AZAMGARH,2021-01-30,1,321,0,322
UTTAR PRADESH,AZAMGARH,2021-01-31,4,819,0,823
UTTAR PRADESH,BAGHPAT,2021-01-26,5,704,0,709
UTTAR PRADESH,BAGHPAT,2021-01-27,1,1467,28,1496
UTTAR PRADESH,BAGHPAT,2021-01-28,0,1239,96,1335
UTTAR PRADESH,BAGHPAT,2021-01-29,0,471,55,526
UTTAR PRADESH,BAGHPAT,2021-01-30,0,2039,14,2053
UTTAR PRADESH,BAGHPAT,2021-01-31,0,808,20,828
UTTAR PRADESH,BAHRAICH,2021-01-26,0,1647,41,1688
UTTAR PRADESH,BAHRAICH,2021-01-27,1,1734,49,1784
UTTAR PRADESH,BAHRAICH,2021-01-28,1,1761,13,1775
UTTAR PRADESH,BAHRAICH,2021-01-29,0,1689,21,1710
UTTAR PRADESH,BAHRAICH,2021-01-30,2,1940,13,1955
UTTAR PRADESH,BAHRAICH,2021-01-31,0,1680,27,1707
UTTAR PRADESH,BALLIA,2021-01-26,1,457,71,529
UTTAR PRADESH,BALLIA,2021-01-27,1,546,34,581
UTTAR PRADESH,BALLIA,2021-01-28,1,522,38,561
UTTAR PRADESH,BALLIA,2021-01-29,1,505,4,510
UTTAR PRADESH,BALLIA,2021-01-30,2,504,0,506
UTTAR PRADESH,BALLIA,2021-01-31,0,189,2,191
UTTAR PRADESH,BALRAMPUR,2021-01-26,2,1081,31,1114
UTTAR PRADESH,BALRAMPUR,2021-01-27,3,1103,0,1106
UTTAR PRADESH,BALRAMPUR,2021-01-28,2,995,30,1027
UTTAR PRADESH,BALRAMPUR,2021-01-29,2,877,0,879
UTTAR PRADESH,BALRAMPUR,2021-01-30,3,866,10,879
UTTAR PRADESH,BALRAMPUR,2021-01-31,3,642,0,645
UTTAR PRADESH,BANDA,2021-01-26,0,1339,20,1359
UTTAR PRADESH,BANDA,2021-01-27,3,2408,16,2427
UTTAR PRADESH,BANDA,2021-01-28,1,1776,5,1782
UTTAR PRADESH,BANDA,2021-01-29,3,1680,18,1701
UTTAR PRADESH,BANDA,2021-01-30,2,2315,15,2332
UTTAR PRADESH,BANDA,2021-01-31,6,1591,0,1597
UTTAR PRADESH,BARABANKI,2021-01-26,0,2335,0,2335
UTTAR PRADESH,BARABANKI,2021-01-27,0,1106,2,1108
UTTAR PRADESH,BARABANKI,2021-01-28,1,1308,1,1310
UTTAR PRADESH,BARABANKI,2021-01-29,2,1597,4,1603
UTTAR PRADESH,BARABANKI,2021-01-30,3,1174,3,1180
UTTAR PRADESH,BARABANKI,2021-01-31,0,1033,0,1033
UTTAR PRADESH,BAREILLY,2021-01-26,8,3184,0,3192
UTTAR PRADESH,BAREILLY,2021-01-27,13,1042,0,1055
UTTAR PRADESH,BAREILLY,2021-01-28,16,2496,0,2512
UTTAR PRADESH,BAREILLY,2021-01-29,7,639,0,646
UTTAR PRADESH,BAREILLY,2021-01-30,20,3325,3,3348
UTTAR PRADESH,BAREILLY,2021-01-31,4,2748,0,2752
UTTAR PRADESH,BASTI,2021-01-26,0,1416,89,1505
UTTAR PRADESH,BASTI,2021-01-27,2,836,0,838
UTTAR PRADESH,BASTI,2021-01-28,2,1007,27,1036
UTTAR PRADESH,BASTI,2021-01-29,10,763,11,784
UTTAR PRADESH,BASTI,2021-01-30,5,1136,6,1147
UTTAR PRADESH,BASTI,2021-01-31,0,1109,103,1212
UTTAR PRADESH,BHADOHI,2021-01-26,0,834,647,1481
UTTAR PRADESH,BHADOHI,2021-01-27,0,1520,0,1520
UTTAR PRADESH,BHADOHI,2021-01-28,0,1490,0,1490
UTTAR PRADESH,BHADOHI,2021-01-29,2,1226,1,1229
UTTAR PRADESH,BHADOHI,2021-01-30,3,1488,1,1492
UTTAR PRADESH,BHADOHI,2021-01-31,0,1454,0,1454
UTTAR PRADESH,BIJNOR,2021-01-26,2,1544,0,1546
UTTAR PRADESH,BIJNOR,2021-01-27,1,909,0,910
UTTAR PRADESH,BIJNOR,2021-01-28,2,1400,8,1410
UTTAR PRADESH,BIJNOR,2021-01-29,1,1569,0,1570
UTTAR PRADESH,BIJNOR,2021-01-30,2,1746,1,1749
UTTAR PRADESH,BIJNOR,2021-01-31,3,1498,2,1503
UTTAR PRADESH,BUDAUN,2021-01-26,8,2046,30,2084
UTTAR PRADESH,BUDAUN,2021-01-27,5,1754,6,1765
UTTAR PRADESH,BUDAUN,2021-01-28,3,2129,19,2151
UTTAR PRADESH,BUDAUN,2021-01-29,3,1450,32,1485
UTTAR PRADESH,BUDAUN,2021-01-30,1,1251,25,1277
UTTAR PRADESH,BUDAUN,2021-01-31,0,1924,15,1939
UTTAR PRADESH,BULANDSHAHR,2021-01-26,53,4775,25,4853
UTTAR PRADESH,BULANDSHAHR,2021-01-27,4,462,0,466
UTTAR PRADESH,BULANDSHAHR,2021-01-28,2,2202,55,2259
UTTAR PRADESH,BULANDSHAHR,2021-01-29,1,1467,0,1468
UTTAR PRADESH,BULANDSHAHR,2021-01-30,1,1428,12,1441
UTTAR PRADESH,BULANDSHAHR,2021-01-31,0,369,1,370
UTTAR PRADESH,CHANDAULI,2021-01-26,0,285,0,285
UTTAR PRADESH,CHANDAULI,2021-01-27,2,1301,38,1341
UTTAR PRADESH,CHANDAULI,2021-01-28,1,885,23,909
UTTAR PRADESH,CHANDAULI,2021-01-29,3,1077,0,1080
UTTAR PRADESH,CHANDAULI,2021-01-30,1,1162,88,1251
UTTAR PRADESH,CHANDAULI,2021-01-31,1,1158,21,1180
UTTAR PRADESH,CHITRAKOOT,2021-01-26,0,534,5,539
UTTAR PRADESH,CHITRAKOOT,2021-01-27,1,651,33,685
UTTAR PRADESH,CHITRAKOOT,2021-01-28,2,1361,1,1364
UTTAR PRADESH,CHITRAKOOT,2021-01-29,6,1184,5,1195
UTTAR PRADESH,CHITRAKOOT,2021-01-30,0,1595,1,1596
UTTAR PRADESH,CHITRAKOOT,2021-01-31,0,574,5,579
UTTAR PRADESH,DEORIA,2021-01-26,1,301,7,309
UTTAR PRADESH,DEORIA,2021-01-27,1,1008,106,1115
UTTAR PRADESH,DEORIA,2021-01-28,0,540,9,549
UTTAR PRADESH,DEORIA,2021-01-29,2,793,2,797
UTTAR PRADESH,DEORIA,2021-01-30,0,544,24,568
UTTAR PRADESH,DEORIA,2021-01-31,0,570,35,605
UTTAR PRADESH,ETAH,2021-01-26,0,1558,3,1561
UTTAR PRADESH,ETAH,2021-01-27,0,1582,8,1590
UTTAR PRADESH,ETAH,2021-01-28,0,1009,3,1012
UTTAR PRADESH,ETAH,2021-01-29,0,1256,4,1260
UTTAR PRADESH,ETAH,2021-01-30,0,830,2,832
UTTAR PRADESH,ETAH,2021-01-31,0,1471,6,1477
UTTAR PRADESH,ETAWAH,2021-01-26,0,820,56,876
UTTAR PRADESH,ETAWAH,2021-01-27,0,3870,173,4043
UTTAR PRADESH,ETAWAH,2021-01-28,0,728,157,885
UTTAR PRADESH,ETAWAH,2021-01-29,2,2392,67,2461
UTTAR PRADESH,ETAWAH,2021-01-30,1,1847,97,1945
UTTAR PRADESH,ETAWAH,2021-01-31,6,1680,110,1796
UTTAR PRADESH,FARRUKHABAD,2021-01-26,1,564,15,580
UTTAR PRADESH,FARRUKHABAD,2021-01-27,2,951,3,956
UTTAR PRADESH,FARRUKHABAD,2021-01-28,0,656,34,690
UTTAR PRADESH,FARRUKHABAD,2021-01-29,1,260,21,282
UTTAR PRADESH,FARRUKHABAD,2021-01-30,5,281,0,286
UTTAR PRADESH,FARRUKHABAD,2021-01-31,1,942,42,985
UTTAR PRADESH,FATEHPUR,2021-01-26,0,725,45,770
UTTAR PRADESH,FATEHPUR,2021-01-27,1,982,0,983
UTTAR PRADESH,FATEHPUR,2021-01-28,0,740,0,740
UTTAR PRADESH,FATEHPUR,2021-01-29,0,628,0,628
UTTAR PRADESH,FATEHPUR,2021-01-30,0,1927,43,1970
UTTAR PRADESH,FATEHPUR,2021-01-31,0,1530,262,1792
UTTAR PRADESH,FIROZABAD,2021-01-26,0,563,23,586
UTTAR PRADESH,FIROZABAD,2021-01-27,0,631,17,648
UTTAR PRADESH,FIROZABAD,2021-01-28,3,928,14,945
UTTAR PRADESH,FIROZABAD,2021-01-29,0,4456,4,4460
UTTAR PRADESH,FIROZABAD,2021-01-30,2,1491,13,1506
UTTAR PRADESH,FIROZABAD,2021-01-31,1,557,0,558
UTTAR PRADESH,GAUTAM BUDDHA NAGAR,2021-01-26,17,1291,46,1354
UTTAR PRADESH,GAUTAM BUDDHA NAGAR,2021-01-27,16,2150,126,2292
UTTAR PRADESH,GAUTAM BUDDHA NAGAR,2021-01-28,29,2766,92,2887
UTTAR PRADESH,GAUTAM BUDDHA NAGAR,2021-01-29,35,2725,167,2927
UTTAR PRADESH,GAUTAM BUDDHA NAGAR,2021-01-30,22,2477,90,2589
UTTAR PRADESH,GAUTAM BUDDHA NAGAR,2021-01-31,19,2500,68,2587
UTTAR PRADESH,GHAZIABAD,2021-01-26,23,1935,57,2015
UTTAR PRADESH,GHAZIABAD,2021-01-27,37,3153,105,3295
UTTAR PRADESH,GHAZIABAD,2021-01-28,24,3219,65,3308
UTTAR PRADESH,GHAZIABAD,2021-01-29,33,3375,37,3445
UTTAR PRADESH,GHAZIABAD,2021-01-30,28,4000,82,4110
UTTAR PRADESH,GHAZIABAD,2021-01-31,163,1489,67,1719
UTTAR PRADESH,GHAZIPUR,2021-01-26,1,131,0,132
UTTAR PRADESH,GHAZIPUR,2021-01-27,3,1834,33,1870
UTTAR PRADESH,GHAZIPUR,2021-01-28,2,913,14,929
UTTAR PRADESH,GHAZIPUR,2021-01-29,1,645,28,674
UTTAR PRADESH,GHAZIPUR,2021-01-30,0,851,16,867
UTTAR PRADESH,GHAZIPUR,2021-01-31,1,908,36,945
UTTAR PRADESH,GONDA,2021-01-26,2,1335,0,1337
UTTAR PRADESH,GONDA,2021-01-27,0,1553,1,1554
UTTAR PRADESH,GONDA,2021-01-28,2,1215,0,1217
UTTAR PRADESH,GONDA,2021-01-29,1,1435,0,1436
UTTAR PRADESH,GONDA,2021-01-30,2,1409,0,1411
UTTAR PRADESH,GONDA,2021-01-31,0,1181,0,1181
UTTAR PRADESH,GORAKHPUR,2021-01-26,3,2388,17,2408
UTTAR PRADESH,GORAKHPUR,2021-01-27,3,650,17,670
UTTAR PRADESH,GORAKHPUR,2021-01-28,4,1905,4,1913
UTTAR PRADESH,GORAKHPUR,2021-01-29,2,2401,119,2522
UTTAR PRADESH,GORAKHPUR,2021-01-30,1,2801,147,2949
UTTAR PRADESH,GORAKHPUR,2021-01-31,8,1806,27,1841
UTTAR PRADESH,HAMIRPUR,2021-01-26,0,610,1,611
UTTAR PRADESH,HAMIRPUR,2021-01-27,2,1023,3,1028
UTTAR PRADESH,HAMIRPUR,2021-01-28,0,1029,2,1031
UTTAR PRADESH,HAMIRPUR,2021-01-29,0,905,8,913
UTTAR PRADESH,HAMIRPUR,2021-01-30,0,1154,2,1156
UTTAR PRADESH,HAMIRPUR,2021-01-31,0,873,7,880
UTTAR PRADESH,HAPUR,2021-01-26,0,96,4,100
UTTAR PRADESH,HAPUR,2021-01-27,2,2833,141,2976
UTTAR PRADESH,HAPUR,2021-01-28,1,1401,16,1418
UTTAR PRADESH,HAPUR,2021-01-29,0,753,56,809
UTTAR PRADESH,HAPUR,2021-01-30,0,1932,29,1961
UTTAR PRADESH,HAPUR,2021-01-31,0,260,97,357
UTTAR PRADESH,HARDOI,2021-01-26,0,1371,0,1371
UTTAR PRADESH,HARDOI,2021-01-27,1,1031,11,1043
UTTAR PRADESH,HARDOI,2021-01-28,0,1596,1,1597
UTTAR PRADESH,HARDOI,2021-01-29,1,1009,5,1015
UTTAR PRADESH,HARDOI,2021-01-30,7,1016,9,1032
UTTAR PRADESH,HARDOI,2021-01-31,2,1132,34,1168
UTTAR PRADESH,HATHRAS,2021-01-26,0,1491,2,1493
UTTAR PRADESH,HATHRAS,2021-01-27,1,885,1,887
UTTAR PRADESH,HATHRAS,2021-01-28,0,995,0,995
UTTAR PRADESH,HATHRAS,2021-01-29,1,1588,0,1589
UTTAR PRADESH,HATHRAS,2021-01-30,1,641,0,642
UTTAR PRADESH,HATHRAS,2021-01-31,1,1476,1,1478
UTTAR PRADESH,JALAUN,2021-01-26,0,751,3,754
UTTAR PRADESH,JALAUN,2021-01-27,1,845,0,846
UTTAR PRADESH,JALAUN,2021-01-28,1,1130,0,1131
UTTAR PRADESH,JALAUN,2021-01-29,1,1054,2,1057
UTTAR PRADESH,JALAUN,2021-01-30,0,1085,1,1086
UTTAR PRADESH,JALAUN,2021-01-31,1,759,1,761
UTTAR PRADESH,JAUNPUR,2021-01-26,6,819,0,825
UTTAR PRADESH,JAUNPUR,2021-01-27,2,1547,2,1551
UTTAR PRADESH,JAUNPUR,2021-01-28,3,739,3,745
UTTAR PRADESH,JAUNPUR,2021-01-29,0,1014,25,1039
UTTAR PRADESH,JAUNPUR,2021-01-30,6,1682,26,1714
UTTAR PRADESH,JAUNPUR,2021-01-31,1,631,2,634
UTTAR PRADESH,JHANSI,2021-01-26,5,2426,2,2433
UTTAR PRADESH,JHANSI,2021-01-27,10,1943,4,1957
UTTAR PRADESH,JHANSI,2021-01-28,2,3210,0,3212
UTTAR PRADESH,JHANSI,2021-01-29,12,2441,1,2454
UTTAR PRADESH,JHANSI,2021-01-30,8,2602,2,2612
UTTAR PRADESH,JHANSI,2021-01-31,9,1985,2,1996
UTTAR PRADESH,KANNAUJ,2021-01-26,0,1340,0,1340
UTTAR PRADESH,KANNAUJ,2021-01-27,1,1350,1,1352
UTTAR PRADESH,KANNAUJ,2021-01-28,0,1496,0,1496
UTTAR PRADESH,KANNAUJ,2021-01-29,0,1412,1,1413
UTTAR PRADESH,KANNAUJ,2021-01-30,1,1321,1,1323
UTTAR PRADESH,KANNAUJ,2021-01-31,0,1409,0,1409
UTTAR PRADESH,KANPUR DEHAT,2021-01-26,0,768,0,768
UTTAR PRADESH,KANPUR DEHAT,2021-01-27,2,1700,8,1710
UTTAR PRADESH,KANPUR DEHAT,2021-01-28,0,793,3,796
UTTAR PRADESH,KANPUR DEHAT,2021-01-29,0,1011,4,1015
UTTAR PRADESH,KANPUR DEHAT,2021-01-30,1,1413,3,1417
UTTAR PRADESH,KANPUR DEHAT,2021-01-31,1,1066,3,1070
UTTAR PRADESH,KANPUR NAGAR,2021-01-26,4,2618,3,2625
UTTAR PRADESH,KANPUR NAGAR,2021-01-27,26,2527,7,2560
UTTAR PRADESH,KANPUR NAGAR,2021-01-28,20,2765,3,2788
UTTAR PRADESH,KANPUR NAGAR,2021-01-29,12,2227,2,2241
UTTAR PRADESH,KANPUR NAGAR,2021-01-30,18,2385,6,2409
UTTAR PRADESH,KANPUR NAGAR,2021-01-31,9,2551,6,2566
UTTAR PRADESH,KASGANJ,2021-01-26,0,928,8,936
UTTAR PRADESH,KASGANJ,2021-01-27,0,1331,2,1333
UTTAR PRADESH,KASGANJ,2021-01-28,2,2585,13,2600
UTTAR PRADESH,KASGANJ,2021-01-29,1,892,0,893
UTTAR PRADESH,KASGANJ,2021-01-30,1,1487,10,1498
UTTAR PRADESH,KASGANJ,2021-01-31,0,296,2,298
UTTAR PRADESH,KAUSHAMBI,2021-01-26,0,1859,0,1859
UTTAR PRADESH,KAUSHAMBI,2021-01-27,1,1365,0,1366
UTTAR PRADESH,KAUSHAMBI,2021-01-28,0,904,33,937
UTTAR PRADESH,KAUSHAMBI,2021-01-29,0,1287,2,1289
UTTAR PRADESH,KAUSHAMBI,2021-01-30,0,1131,0,1131
UTTAR PRADESH,KAUSHAMBI,2021-01-31,1,2625,5,2631
UTTAR PRADESH,KHERI,2021-01-26,0,1916,0,1916
UTTAR PRADESH,KHERI,2021-01-27,0,1396,10,1406
UTTAR PRADESH,KHERI,2021-01-28,2,1868,27,1897
UTTAR PRADESH,KHERI,2021-01-29,0,1300,0,1300
UTTAR PRADESH,KHERI,2021-01-30,0,1192,0,1192
UTTAR PRADESH,KHERI,2021-01-31,0,1117,114,1231
UTTAR PRADESH,KUSHI NAGAR,2021-01-26,1,1110,0,1111
UTTAR PRADESH,KUSHI NAGAR,2021-01-27,4,957,35,996
UTTAR PRADESH,KUSHI NAGAR,2021-01-28,1,786,26,813
UTTAR PRADESH,KUSHI NAGAR,2021-01-29,0,224,0,224
UTTAR PRADESH,KUSHI NAGAR,2021-01-30,1,775,29,805
UTTAR PRADESH,KUSHI NAGAR,2021-01-31,0,378,37,415
UTTAR PRADESH,LALITPUR,2021-01-26,6,1364,5,1375
UTTAR PRADESH,LALITPUR,2021-01-27,4,1929,0,1933
UTTAR PRADESH,LALITPUR,2021-01-28,2,1146,1,1149
UTTAR PRADESH,LALITPUR,2021-01-29,5,978,1,984
UTTAR PRADESH,LALITPUR,2021-01-30,2,1184,0,1186
UTTAR PRADESH,LALITPUR,2021-01-31,3,1332,0,1335
UTTAR PRADESH,LUCKNOW,2021-01-26,53,4950,245,5248
UTTAR PRADESH,LUCKNOW,2021-01-27,46,5600,165,5811
UTTAR PRADESH,LUCKNOW,2021-01-28,52,6566,150,6768
UTTAR PRADESH,LUCKNOW,2021-01-29,44,5924,124,6092
UTTAR PRADESH,LUCKNOW,2021-01-30,38,6326,129,6493
UTTAR PRADESH,LUCKNOW,2021-01-31,39,5422,106,5567
UTTAR PRADESH,MAHARAJGANJ,2021-01-26,0,899,50,949
UTTAR PRADESH,MAHARAJGANJ,2021-01-27,0,1136,1,1137
UTTAR PRADESH,MAHARAJGANJ,2021-01-28,0,729,159,888
UTTAR PRADESH,MAHARAJGANJ,2021-01-29,0,774,156,930
UTTAR PRADESH,MAHARAJGANJ,2021-01-30,0,681,123,804
UTTAR PRADESH,MAHARAJGANJ,2021-01-31,0,340,42,382
UTTAR PRADESH,MAHOBA,2021-01-26,0,625,21,646
UTTAR PRADESH,MAHOBA,2021-01-27,0,610,39,649
UTTAR PRADESH,MAHOBA,2021-01-28,0,561,25,586
UTTAR PRADESH,MAHOBA,2021-01-29,0,653,0,653
UTTAR PRADESH,MAHOBA,2021-01-30,0,683,5,688
UTTAR PRADESH,MAHOBA,2021-01-31,0,645,5,650
UTTAR PRADESH,MAINPURI,2021-01-26,0,1355,2,1357
UTTAR PRADESH,MAINPURI,2021-01-27,1,1456,1,1458
UTTAR PRADESH,MAINPURI,2021-01-28,1,1648,0,1649
UTTAR PRADESH,MAINPURI,2021-01-29,1,1607,0,1608
UTTAR PRADESH,MAINPURI,2021-01-30,0,1653,2,1655
UTTAR PRADESH,MAINPURI,2021-01-31,0,1572,6,1578
UTTAR PRADESH,MATHURA,2021-01-26,0,1124,2,1126
UTTAR PRADESH,MATHURA,2021-01-27,4,1298,0,1302
UTTAR PRADESH,MATHURA,2021-01-28,4,1348,1,1353
UTTAR PRADESH,MATHURA,2021-01-29,5,1416,6,1427
UTTAR PRADESH,MATHURA,2021-01-30,4,1320,0,1324
UTTAR PRADESH,MATHURA,2021-01-31,3,1842,8,1853
UTTAR PRADESH,MAU,2021-01-26,1,1309,16,1326
UTTAR PRADESH,MAU,2021-01-27,1,964,0,965
UTTAR PRADESH,MAU,2021-01-28,0,1052,1,1053
UTTAR PRADESH,MAU,2021-01-29,0,1142,16,1158
UTTAR PRADESH,MAU,2021-01-30,0,772,1,773
UTTAR PRADESH,MAU,2021-01-31,1,1324,8,1333
UTTAR PRADESH,MEERUT,2021-01-26,17,2533,14,2564
UTTAR PRADESH,MEERUT,2021-01-27,7,3169,7,3183
UTTAR PRADESH,MEERUT,2021-01-28,16,3996,9,4021
UTTAR PRADESH,MEERUT,2021-01-29,11,4170,35,4216
UTTAR PRADESH,MEERUT,2021-01-30,8,3505,6,3519
UTTAR PRADESH,MEERUT,2021-01-31,8,3219,2,3229
UTTAR PRADESH,MIRZAPUR,2021-01-26,0,1492,0,1492
UTTAR PRADESH,MIRZAPUR,2021-01-27,2,1080,0,1082
UTTAR PRADESH,MIRZAPUR,2021-01-28,0,1820,3,1823
UTTAR PRADESH,MIRZAPUR,2021-01-29,1,1393,0,1394
UTTAR PRADESH,MIRZAPUR,2021-01-30,4,1438,0,1442
UTTAR PRADESH,MIRZAPUR,2021-01-31,2,1124,0,1126
UTTAR PRADESH,MORADABAD,2021-01-26,0,2598,1,2599
UTTAR PRADESH,MORADABAD,2021-01-27,1,3030,0,3031
UTTAR PRADESH,MORADABAD,2021-01-28,8,3326,11,3345
UTTAR PRADESH,MORADABAD,2021-01-29,3,2642,14,2659
UTTAR PRADESH,MORADABAD,2021-01-30,2,1639,1,1642
UTTAR PRADESH,MORADABAD,2021-01-31,1,3302,6,3309
UTTAR PRADESH,MUZAFFARNAGAR,2021-01-26,7,805,0,812
UTTAR PRADESH,MUZAFFARNAGAR,2021-01-27,6,877,0,883
UTTAR PRADESH,MUZAFFARNAGAR,2021-01-28,29,1751,9,1789
UTTAR PRADESH,MUZAFFARNAGAR,2021-01-29,13,1777,7,1797
UTTAR PRADESH,MUZAFFARNAGAR,2021-01-30,7,1352,0,1359
UTTAR PRADESH,MUZAFFARNAGAR,2021-01-31,3,1702,0,1705
UTTAR PRADESH,PILIBHIT,2021-01-26,0,1608,9,1617
UTTAR PRADESH,PILIBHIT,2021-01-27,4,1889,21,1914
UTTAR PRADESH,PILIBHIT,2021-01-28,1,1784,2,1787
UTTAR PRADESH,PILIBHIT,2021-01-29,1,1485,0,1486
UTTAR PRADESH,PILIBHIT,2021-01-30,1,1215,1,1217
UTTAR PRADESH,PILIBHIT,2021-01-31,2,878,1,881
UTTAR PRADESH,PRATAPGARH,2021-01-26,4,1506,24,1534
UTTAR PRADESH,PRATAPGARH,2021-01-27,3,3465,68,3536
UTTAR PRADESH,PRATAPGARH,2021-01-28,1,1771,174,1946
UTTAR PRADESH,PRATAPGARH,2021-01-29,4,1691,151,1846
UTTAR PRADESH,PRATAPGARH,2021-01-30,1,1786,158,1945
UTTAR PRADESH,PRATAPGARH,2021-01-31,3,1622,179,1804
UTTAR PRADESH,PRAYAGRAJ,2021-01-26,6,3581,1,3588
UTTAR PRADESH,PRAYAGRAJ,2021-01-27,11,3071,0,3082
UTTAR PRADESH,PRAYAGRAJ,2021-01-28,10,3760,2,3772
UTTAR PRADESH,PRAYAGRAJ,2021-01-29,8,3496,1,3505
UTTAR PRADESH,PRAYAGRAJ,2021-01-30,13,3250,0,3263
UTTAR PRADESH,PRAYAGRAJ,2021-01-31,5,2717,4,2726
UTTAR PRADESH,RAE BARELI,2021-01-26,7,1671,1,1679
UTTAR PRADESH,RAE BARELI,2021-01-27,7,1735,2,1744
UTTAR PRADESH,RAE BARELI,2021-01-28,8,2154,1,2163
UTTAR PRADESH,RAE BARELI,2021-01-29,15,1783,1,1799
UTTAR PRADESH,RAE BARELI,2021-01-30,9,2073,9,2091
UTTAR PRADESH,RAE BARELI,2021-01-31,1,1434,12,1447
UTTAR PRADESH,RAMPUR,2021-01-26,1,1195,1,1197
UTTAR PRADESH,RAMPUR,2021-01-27,5,1236,35,1276
UTTAR PRADESH,RAMPUR,2021-01-28,1,1465,33,1499
UTTAR PRADESH,RAMPUR,2021-01-29,1,1296,10,1307
UTTAR PRADESH,RAMPUR,2021-01-30,6,1366,30,1402
UTTAR PRADESH,RAMPUR,2021-01-31,0,1128,2,1130
UTTAR PRADESH,SAHARANPUR,2021-01-26,7,2129,1,2137
UTTAR PRADESH,SAHARANPUR,2021-01-27,11,3242,115,3368
UTTAR PRADESH,SAHARANPUR,2021-01-28,6,2915,58,2979
UTTAR PRADESH,SAHARANPUR,2021-01-29,13,2463,21,2497
UTTAR PRADESH,SAHARANPUR,2021-01-30,10,3082,67,3159
UTTAR PRADESH,SAHARANPUR,2021-01-31,8,2323,74,2405
UTTAR PRADESH,SAMBHAL,2021-01-26,0,1886,0,1886
UTTAR PRADESH,SAMBHAL,2021-01-27,3,1411,11,1425
UTTAR PRADESH,SAMBHAL,2021-01-28,1,1468,20,1489
UTTAR PRADESH,SAMBHAL,2021-01-29,1,1209,63,1273
UTTAR PRADESH,SAMBHAL,2021-01-30,0,1802,92,1894
UTTAR PRADESH,SAMBHAL,2021-01-31,0,740,2,742
UTTAR PRADESH,SANT KABEER NAGAR,2021-01-26,0,1328,0,1328
UTTAR PRADESH,SANT KABEER NAGAR,2021-01-27,5,1343,0,1348
UTTAR PRADESH,SANT KABEER NAGAR,2021-01-28,3,2044,1,2048
UTTAR PRADESH,SANT KABEER NAGAR,2021-01-29,0,1058,0,1058
UTTAR PRADESH,SANT KABEER NAGAR,2021-01-30,1,1621,0,1622
UTTAR PRADESH,SANT KABEER NAGAR,2021-01-31,1,1183,0,1184
UTTAR PRADESH,SHAHJAHANPUR,2021-01-26,5,834,14,853
UTTAR PRADESH,SHAHJAHANPUR,2021-01-27,2,1119,0,1121
UTTAR PRADESH,SHAHJAHANPUR,2021-01-28,0,1479,0,1479
UTTAR PRADESH,SHAHJAHANPUR,2021-01-29,1,1367,26,1394
UTTAR PRADESH,SHAHJAHANPUR,2021-01-30,1,1613,24,1638
UTTAR PRADESH,SHAHJAHANPUR,2021-01-31,1,806,5,812
UTTAR PRADESH,SHAMLI,2021-01-26,2,1096,1,1099
UTTAR PRADESH,SHAMLI,2021-01-27,0,195,3,198
UTTAR PRADESH,SHAMLI,2021-01-28,1,1624,0,1625
UTTAR PRADESH,SHAMLI,2021-01-29,3,1700,0,1703
UTTAR PRADESH,SHAMLI,2021-01-30,10,1407,0,1417
UTTAR PRADESH,SHAMLI,2021-01-31,1,715,0,716
UTTAR PRADESH,SHRAVASTI,2021-01-26,0,602,21,623
UTTAR PRADESH,SHRAVASTI,2021-01-27,0,745,0,745
UTTAR PRADESH,SHRAVASTI,2021-01-28,0,792,0,792
UTTAR PRADESH,SHRAVASTI,2021-01-29,1,717,0,718
UTTAR PRADESH,SHRAVASTI,2021-01-30,0,752,10,762
UTTAR PRADESH,SHRAVASTI,2021-01-31,0,592,9,601
UTTAR PRADESH,SIDDHARTH NAGAR,2021-01-26,0,230,0,230
UTTAR PRADESH,SIDDHARTH NAGAR,2021-01-27,0,1129,75,1204
UTTAR PRADESH,SIDDHARTH NAGAR,2021-01-28,0,753,0,753
UTTAR PRADESH,SIDDHARTH NAGAR,2021-01-29,2,1954,1,1957
UTTAR PRADESH,SIDDHARTH NAGAR,2021-01-30,0,472,1,473
UTTAR PRADESH,SIDDHARTH NAGAR,2021-01-31,0,1108,0,1108
UTTAR PRADESH,SITAPUR,2021-01-26,0,1333,19,1352
UTTAR PRADESH,SITAPUR,2021-01-27,6,1565,15,1586
UTTAR PRADESH,SITAPUR,2021-01-28,1,1583,13,1597
UTTAR PRADESH,SITAPUR,2021-01-29,1,1415,14,1430
UTTAR PRADESH,SITAPUR,2021-01-30,1,1372,4,1377
UTTAR PRADESH,SITAPUR,2021-01-31,0,1238,0,1238
UTTAR PRADESH,SONBHADRA,2021-01-26,3,1480,19,1502
UTTAR PRADESH,SONBHADRA,2021-01-27,2,1312,0,1314
UTTAR PRADESH,SONBHADRA,2021-01-28,0,1286,5,1291
UTTAR PRADESH,SONBHADRA,2021-01-29,5,1606,15,1626
UTTAR PRADESH,SONBHADRA,2021-01-30,2,1444,0,1446
UTTAR PRADESH,SONBHADRA,2021-01-31,0,1328,51,1379
UTTAR PRADESH,SULTANPUR,2021-01-26,1,769,2,772
UTTAR PRADESH,SULTANPUR,2021-01-27,6,347,0,353
UTTAR PRADESH,SULTANPUR,2021-01-28,6,1156,40,1202
UTTAR PRADESH,SULTANPUR,2021-01-29,2,664,10,676
UTTAR PRADESH,SULTANPUR,2021-01-30,0,953,7,960
UTTAR PRADESH,SULTANPUR,2021-01-31,2,1029,2,1033
UTTAR PRADESH,UNNAO,2021-01-26,2,2595,35,2632
UTTAR PRADESH,UNNAO,2021-01-27,0,1669,51,1720
UTTAR PRADESH,UNNAO,2021-01-28,0,1754,20,1774
UTTAR PRADESH,UNNAO,2021-01-29,1,1557,42,1600
UTTAR PRADESH,UNNAO,2021-01-30,0,1434,44,1478
UTTAR PRADESH,UNNAO,2021-01-31,1,1850,36,1887
UTTAR PRADESH,VARANASI,2021-01-26,3,1899,25,1927
UTTAR PRADESH,VARANASI,2021-01-27,17,1903,36,1956
UTTAR PRADESH,VARANASI,2021-01-28,10,2398,128,2536
UTTAR PRADESH,VARANASI,2021-01-29,13,1383,104,1500
UTTAR PRADESH,VARANASI,2021-01-30,11,3234,60,3305
UTTAR PRADESH,VARANASI,2021-01-31,9,2133,137,2279
UTTARAKHAND,ALMORA,2021-01-26,0,289,0,289
UTTARAKHAND,ALMORA,2021-01-27,5,241,0,246
UTTARAKHAND,ALMORA,2021-01-28,0,148,0,148
UTTARAKHAND,ALMORA,2021-01-29,2,189,1,192
UTTARAKHAND,ALMORA,2021-01-30,0,40,0,40
UTTARAKHAND,ALMORA,2021-01-31,0,18,0,18
UTTARAKHAND,BAGESHWAR,2021-01-26,0,6,0,6
UTTARAKHAND,BAGESHWAR,2021-01-27,2,190,0,192
UTTARAKHAND,BAGESHWAR,2021-01-28,0,341,0,341
UTTARAKHAND,BAGESHWAR,2021-01-29,0,410,1,411
UTTARAKHAND,BAGESHWAR,2021-01-30,0,249,0,249
UTTARAKHAND,BAGESHWAR,2021-01-31,0,6,0,6
UTTARAKHAND,CHAMOLI,2021-01-26,0,22,1,23
UTTARAKHAND,CHAMOLI,2021-01-27,0,328,1,329
UTTARAKHAND,CHAMOLI,2021-01-28,1,188,0,189
UTTARAKHAND,CHAMOLI,2021-01-29,0,211,4,215
UTTARAKHAND,CHAMOLI,2021-01-30,0,223,34,257
UTTARAKHAND,CHAMOLI,2021-01-31,0,195,0,195
UTTARAKHAND,CHAMPAWAT,2021-01-26,0,1,0,1
UTTARAKHAND,CHAMPAWAT,2021-01-27,1,601,0,602
UTTARAKHAND,CHAMPAWAT,2021-01-28,0,102,0,102
UTTARAKHAND,CHAMPAWAT,2021-01-29,0,235,0,235
UTTARAKHAND,CHAMPAWAT,2021-01-30,0,362,1,363
UTTARAKHAND,CHAMPAWAT,2021-01-31,1,236,0,237
UTTARAKHAND,DEHRADUN,2021-01-26,29,2666,17,2712
UTTARAKHAND,DEHRADUN,2021-01-27,58,2168,5,2231
UTTARAKHAND,DEHRADUN,2021-01-28,27,2151,5,2183
UTTARAKHAND,DEHRADUN,2021-01-29,56,2624,12,2692
UTTARAKHAND,DEHRADUN,2021-01-30,38,2633,7,2678
UTTARAKHAND,DEHRADUN,2021-01-31,16,1145,2,1163
UTTARAKHAND,HARIDWAR,2021-01-26,5,528,31,564
UTTARAKHAND,HARIDWAR,2021-01-27,18,1599,2,1619
UTTARAKHAND,HARIDWAR,2021-01-28,12,2036,1,2049
UTTARAKHAND,HARIDWAR,2021-01-29,11,2301,5,2317
UTTARAKHAND,HARIDWAR,2021-01-30,17,3616,3,3636
UTTARAKHAND,HARIDWAR,2021-01-31,7,3139,18,3164
UTTARAKHAND,NAINITAL,2021-01-26,3,137,0,140
UTTARAKHAND,NAINITAL,2021-01-27,16,1455,1,1472
UTTARAKHAND,NAINITAL,2021-01-28,22,1044,1,1067
UTTARAKHAND,NAINITAL,2021-01-29,13,1016,2,1031
UTTARAKHAND,NAINITAL,2021-01-30,18,1048,2,1068
UTTARAKHAND,NAINITAL,2021-01-31,10,598,0,608
UTTARAKHAND,PAURI GARHWAL,2021-01-26,3,74,0,77
UTTARAKHAND,PAURI GARHWAL,2021-01-27,2,756,7,765
UTTARAKHAND,PAURI GARHWAL,2021-01-28,2,567,0,569
UTTARAKHAND,PAURI GARHWAL,2021-01-29,2,421,7,430
UTTARAKHAND,PAURI GARHWAL,2021-01-30,5,824,22,851
UTTARAKHAND,PAURI GARHWAL,2021-01-31,2,449,4,455
UTTARAKHAND,PITHORAGARH,2021-01-26,0,41,0,41
UTTARAKHAND,PITHORAGARH,2021-01-27,0,164,0,164
UTTARAKHAND,PITHORAGARH,2021-01-28,0,72,0,72
UTTARAKHAND,PITHORAGARH,2021-01-29,2,378,0,380
UTTARAKHAND,PITHORAGARH,2021-01-30,0,36,0,36
UTTARAKHAND,PITHORAGARH,2021-01-31,0,12,0,12
UTTARAKHAND,RUDRA PRAYAG,2021-01-26,0,5,0,5
UTTARAKHAND,RUDRA PRAYAG,2021-01-27,0,159,0,159
UTTARAKHAND,RUDRA PRAYAG,2021-01-28,0,40,0,40
UTTARAKHAND,RUDRA PRAYAG,2021-01-29,1,273,0,274
UTTARAKHAND,RUDRA PRAYAG,2021-01-30,1,65,9,75
UTTARAKHAND,RUDRA PRAYAG,2021-01-31,1,11,0,12
UTTARAKHAND,TEHRI GARHWAL,2021-01-26,0,131,0,131
UTTARAKHAND,TEHRI GARHWAL,2021-01-27,0,645,4,649
UTTARAKHAND,TEHRI GARHWAL,2021-01-28,0,231,0,231
UTTARAKHAND,TEHRI GARHWAL,2021-01-29,1,400,3,404
UTTARAKHAND,TEHRI GARHWAL,2021-01-30,2,502,0,504
UTTARAKHAND,TEHRI GARHWAL,2021-01-31,0,106,0,106
UTTARAKHAND,UDAM SINGH NAGAR,2021-01-26,2,2224,38,2264
UTTARAKHAND,UDAM SINGH NAGAR,2021-01-27,8,2048,63,2119
UTTARAKHAND,UDAM SINGH NAGAR,2021-01-28,7,1509,42,1558
UTTARAKHAND,UDAM SINGH NAGAR,2021-01-29,2,1952,85,2039
UTTARAKHAND,UDAM SINGH NAGAR,2021-01-30,12,1442,105,1559
UTTARAKHAND,UDAM SINGH NAGAR,2021-01-31,9,690,1,700
UTTARAKHAND,UTTAR KASHI,2021-01-26,1,371,15,387
UTTARAKHAND,UTTAR KASHI,2021-01-27,0,100,0,100
UTTARAKHAND,UTTAR KASHI,2021-01-28,1,307,1,309
UTTARAKHAND,UTTAR KASHI,2021-01-29,1,249,5,255
UTTARAKHAND,UTTAR KASHI,2021-01-30,1,344,2,347
UTTARAKHAND,UTTAR KASHI,2021-01-31,1,83,2,86
WEST BENGAL,24 PARAGANAS NORTH,2021-01-26,42,2264,17,2323
WEST BENGAL,24 PARAGANAS NORTH,2021-01-27,73,3690,25,3788
WEST BENGAL,24 PARAGANAS NORTH,2021-01-28,112,4293,30,4435
WEST BENGAL,24 PARAGANAS NORTH,2021-01-29,69,4015,23,4107
WEST BENGAL,24 PARAGANAS NORTH,2021-01-30,58,3679,27,3764
WEST BENGAL,24 PARAGANAS NORTH,2021-01-31,46,2729,12,2787
WEST BENGAL,24 PARAGANAS SOUTH,2021-01-26,8,2127,4,2139
WEST BENGAL,24 PARAGANAS SOUTH,2021-01-27,27,3997,15,4039
WEST BENGAL,24 PARAGANAS SOUTH,2021-01-28,13,2520,2,2535
WEST BENGAL,24 PARAGANAS SOUTH,2021-01-29,16,3635,25,3676
WEST BENGAL,24 PARAGANAS SOUTH,2021-01-30,10,3273,10,3293
WEST BENGAL,24 PARAGANAS SOUTH,2021-01-31,6,2825,4,2835
WEST BENGAL,ALIPURDUAR,2021-01-26,0,111,4,115
WEST BENGAL,ALIPURDUAR,2021-01-27,0,397,0,397
WEST BENGAL,ALIPURDUAR,2021-01-28,0,332,0,332
WEST BENGAL,ALIPURDUAR,2021-01-29,0,284,0,284
WEST BENGAL,ALIPURDUAR,2021-01-30,1,398,0,399
WEST BENGAL,ALIPURDUAR,2021-01-31,1,358,0,359
WEST BENGAL,BANKURA,2021-01-26,12,436,6,454
WEST BENGAL,BANKURA,2021-01-27,10,902,9,921
WEST BENGAL,BANKURA,2021-01-28,18,738,1,757
WEST BENGAL,BANKURA,2021-01-29,11,768,4,783
WEST BENGAL,BANKURA,2021-01-30,11,545,0,556
WEST BENGAL,BANKURA,2021-01-31,5,501,0,506
WEST BENGAL,BIRBHUM,2021-01-26,3,500,6,509
WEST BENGAL,BIRBHUM,2021-01-27,6,833,7,846
WEST BENGAL,BIRBHUM,2021-01-28,2,935,15,952
WEST BENGAL,BIRBHUM,2021-01-29,1,971,2,974
WEST BENGAL,BIRBHUM,2021-01-30,2,876,0,878
WEST BENGAL,BIRBHUM,2021-01-31,3,633,8,644
WEST BENGAL,COOCHBEHAR,2021-01-26,1,1980,9,1990
WEST BENGAL,COOCHBEHAR,2021-01-27,2,1963,0,1965
WEST BENGAL,COOCHBEHAR,2021-01-28,0,2117,0,2117
WEST BENGAL,COOCHBEHAR,2021-01-29,4,2117,0,2121
WEST BENGAL,COOCHBEHAR,2021-01-30,0,1912,0,1912
WEST BENGAL,COOCHBEHAR,2021-01-31,0,1480,0,1480
WEST BENGAL,DARJEELING,2021-01-26,11,83,1,95
WEST BENGAL,DARJEELING,2021-01-27,10,825,0,835
WEST BENGAL,DARJEELING,2021-01-28,12,921,0,933
WEST BENGAL,DARJEELING,2021-01-29,22,665,1,688
WEST BENGAL,DARJEELING,2021-01-30,13,808,9,830
WEST BENGAL,DARJEELING,2021-01-31,10,364,2,376
WEST BENGAL,DINAJPUR DAKSHIN,2021-01-26,2,700,1,703
WEST BENGAL,DINAJPUR DAKSHIN,2021-01-27,0,664,0,664
WEST BENGAL,DINAJPUR DAKSHIN,2021-01-28,0,691,6,697
WEST BENGAL,DINAJPUR DAKSHIN,2021-01-29,3,754,6,763
WEST BENGAL,DINAJPUR DAKSHIN,2021-01-30,0,762,0,762
WEST BENGAL,DINAJPUR DAKSHIN,2021-01-31,1,717,0,718
WEST BENGAL,DINAJPUR UTTAR,2021-01-26,1,132,0,133
WEST BENGAL,DINAJPUR UTTAR,2021-01-27,0,159,0,159
WEST BENGAL,DINAJPUR UTTAR,2021-01-28,3,321,0,324
WEST BENGAL,DINAJPUR UTTAR,2021-01-29,6,408,0,414
WEST BENGAL,DINAJPUR UTTAR,2021-01-30,3,265,0,268
WEST BENGAL,DINAJPUR UTTAR,2021-01-31,0,25,0,25
WEST BENGAL,HOOGHLY,2021-01-26,24,488,3,515
WEST BENGAL,HOOGHLY,2021-01-27,10,907,66,983
WEST BENGAL,HOOGHLY,2021-01-28,17,786,12,815
WEST BENGAL,HOOGHLY,2021-01-29,15,942,78,1035
WEST BENGAL,HOOGHLY,2021-01-30,10,741,4,755
WEST BENGAL,HOOGHLY,2021-01-31,16,581,16,613
WEST BENGAL,HOWRAH,2021-01-26,8,1030,117,1155
WEST BENGAL,HOWRAH,2021-01-27,13,932,77,1022
WEST BENGAL,HOWRAH,2021-01-28,10,1283,194,1487
WEST BENGAL,HOWRAH,2021-01-29,18,1347,73,1438
WEST BENGAL,HOWRAH,2021-01-30,11,1244,163,1418
WEST BENGAL,HOWRAH,2021-01-31,3,1088,110,1201
WEST BENGAL,JALPAIGURI,2021-01-26,3,409,7,419
WEST BENGAL,JALPAIGURI,2021-01-27,9,534,0,543
WEST BENGAL,JALPAIGURI,2021-01-28,1,443,0,444
WEST BENGAL,JALPAIGURI,2021-01-29,3,412,0,415
WEST BENGAL,JALPAIGURI,2021-01-30,2,411,0,413
WEST BENGAL,JALPAIGURI,2021-01-31,6,130,0,136
WEST BENGAL,JHARGRAM,2021-01-26,0,63,0,63
WEST BENGAL,JHARGRAM,2021-01-27,0,75,0,75
WEST BENGAL,JHARGRAM,2021-01-28,0,50,0,50
WEST BENGAL,JHARGRAM,2021-01-29,1,56,0,57
WEST BENGAL,JHARGRAM,2021-01-30,0,83,0,83
WEST BENGAL,JHARGRAM,2021-01-31,1,35,0,36
WEST BENGAL,KALIMPONG,2021-01-26,0,101,0,101
WEST BENGAL,KALIMPONG,2021-01-27,1,128,0,129
WEST BENGAL,KALIMPONG,2021-01-28,0,61,0,61
WEST BENGAL,KALIMPONG,2021-01-29,1,82,0,83
WEST BENGAL,KALIMPONG,2021-01-30,0,143,0,143
WEST BENGAL,KALIMPONG,2021-01-31,0,22,0,22
WEST BENGAL,KOLKATA,2021-01-26,96,2290,17,2403
WEST BENGAL,KOLKATA,2021-01-27,100,2723,12,2835
WEST BENGAL,KOLKATA,2021-01-28,102,2693,14,2809
WEST BENGAL,KOLKATA,2021-01-29,111,2974,26,3111
WEST BENGAL,KOLKATA,2021-01-30,86,3096,11,3193
WEST BENGAL,KOLKATA,2021-01-31,47,1953,8,2008
WEST BENGAL,MALDAH,2021-01-26,6,52,32,90
WEST BENGAL,MALDAH,2021-01-27,3,553,1,557
WEST BENGAL,MALDAH,2021-01-28,4,695,5,704
WEST BENGAL,MALDAH,2021-01-29,3,435,2,440
WEST BENGAL,MALDAH,2021-01-30,5,636,4,645
WEST BENGAL,MALDAH,2021-01-31,0,187,2,189
WEST BENGAL,MEDINIPUR EAST,2021-01-26,4,366,6,376
WEST BENGAL,MEDINIPUR EAST,2021-01-27,5,799,0,804
WEST BENGAL,MEDINIPUR EAST,2021-01-28,9,1009,1,1019
WEST BENGAL,MEDINIPUR EAST,2021-01-29,12,959,2,973
WEST BENGAL,MEDINIPUR EAST,2021-01-30,5,726,1,732
WEST BENGAL,MEDINIPUR EAST,2021-01-31,9,501,2,512
WEST BENGAL,MEDINIPUR WEST,2021-01-26,1,205,1,207
WEST BENGAL,MEDINIPUR WEST,2021-01-27,0,435,3,438
WEST BENGAL,MEDINIPUR WEST,2021-01-28,4,400,0,404
WEST BENGAL,MEDINIPUR WEST,2021-01-29,3,473,8,484
WEST BENGAL,MEDINIPUR WEST,2021-01-30,3,377,2,382
WEST BENGAL,MEDINIPUR WEST,2021-01-31,4,380,5,389
WEST BENGAL,MURSHIDABAD,2021-01-26,3,1141,7,1151
WEST BENGAL,MURSHIDABAD,2021-01-27,5,1457,18,1480
WEST BENGAL,MURSHIDABAD,2021-01-28,5,1415,0,1420
WEST BENGAL,MURSHIDABAD,2021-01-29,1,1100,1,1102
WEST BENGAL,MURSHIDABAD,2021-01-30,2,1513,1,1516
WEST BENGAL,MURSHIDABAD,2021-01-31,3,860,3,866
WEST BENGAL,NADIA,2021-01-26,9,622,9,640
WEST BENGAL,NADIA,2021-01-27,11,765,10,786
WEST BENGAL,NADIA,2021-01-28,13,698,9,720
WEST BENGAL,NADIA,2021-01-29,7,843,12,862
WEST BENGAL,NADIA,2021-01-30,13,790,14,817
WEST BENGAL,NADIA,2021-01-31,13,670,18,701
WEST BENGAL,PASCHIM BARDHAMAN,2021-01-26,19,786,5,810
WEST BENGAL,PASCHIM BARDHAMAN,2021-01-27,16,924,1,941
WEST BENGAL,PASCHIM BARDHAMAN,2021-01-28,8,679,2,689
WEST BENGAL,PASCHIM BARDHAMAN,2021-01-29,13,923,5,941
WEST BENGAL,PASCHIM BARDHAMAN,2021-01-30,15,1054,5,1074
WEST BENGAL,PASCHIM BARDHAMAN,2021-01-31,9,739,2,750
WEST BENGAL,PURBA BARDHAMAN,2021-01-26,3,718,0,721
WEST BENGAL,PURBA BARDHAMAN,2021-01-27,1,603,0,604
WEST BENGAL,PURBA BARDHAMAN,2021-01-28,7,965,1,973
WEST BENGAL,PURBA BARDHAMAN,2021-01-29,3,911,0,914
WEST BENGAL,PURBA BARDHAMAN,2021-01-30,7,841,1,849
WEST BENGAL,PURBA BARDHAMAN,2021-01-31,1,726,1,728
WEST BENGAL,PURULIA,2021-01-26,0,525,0,525
WEST BENGAL,PURULIA,2021-01-27,3,379,0,382
WEST BENGAL,PURULIA,2021-01-28,12,521,0,533
WEST BENGAL,PURULIA,2021-01-29,10,622,0,632
WEST BENGAL,PURULIA,2021-01-30,0,383,0,383
WEST BENGAL,PURULIA,2021-01-31,3,311,0,314
